جوان تر ین پسر او نزد او نشسته بود	his youngest son, sat next to him
مثل این که در آن طرف اتفاق جالبی افتاده باشد و او بخواهد آن را به دقت ببیند.	if he had discovered something of interest going on in that direction.
جاذبه دل انگیز طراوت آن از بین خواهد رفت.	the sweet charm of freshness would leave it.
صورتش را به دقت دیدم و همه چیز را درک کردم.	I saw his eyes and understood all, at once
همه چیز را به دور افکنند و به هر طرف که میسر باشد بگریزند.	might have thrown up everything and run away anywhere.
یارو میاد به چادرتون سر میز نه میخواد به بینه دی گه چیزی دار ین بخور ین یا نه	he'll look in your tent an' see if you got anything lef' to eat.
قدری توتون دیگر با نوک چوب کبریت درونش جا داد و بعد کبریت کشید.	poked a few wisps back inside the tube with a match end, struck the match and lit up.
کاملاً راست نشسته و دستهای خویش را روی یکدیگر بر یکی از زانونها گذاشته بود	sitting perfectly upright, with her hands folded on one knee, and looking grimly on the speaker.
هیچ درکی از مقاومت در برابر آن نظام نبود	at the same time no notion of trying to resist.
که پدرش با تمام وجود آرزو داشت آن را پاره کند و پرت کند به صورت رؤسای جمهور	which his father desired ardently to tear and fling into the faces of presidents
که این دویست هزار نفر با هم پیکار خواهد کرد.	the thing is that these two hundred thousand men will fight
هرچند که رفتن هنری از نظر او هیچ لطفی نداشت.	however disagreeable to her his going.
روی خود را به پنجره که حاشیه سفیدی از یخ داشت کرد.	with his face turned to the frosted window.
او تحمل راه انداختن یک زندگی با مسئولیت در یک شهرستان کوچک را نداشت	he couldn't stand a decent respectable life in a little country town
تابوت ساز که دوباره عازم فرار بود گوشه کتش را گرفت.	catching at the undertaker's coat, as he once more moved towards the door.
اما با چهارده تا می تونی یک لیوان نوشیدنی شکلاتی داغم بخوری.	but for firteen you get 'ot chocolate
کاغذی مچاله شده را از جیب شلوار جین ام که از دیروز در ان جا بود در آوردم و نشانش دادم	I pull the crumpled ad out of my jeans pocket, where it's been since yesterday.
چمدانم که شب قبل آن را به آنجا آورده بودند طناب پیچ شده و در کنار در بود.	my trunk, which had been carried down the evening before, stood corded at the door.
شیر نر در قفس جلو ارابه است و شیر ماده در قفس عقب	the male is in that first cage and the female in the one behind
صورتش را با شال پوشانده بود تا کسی نه از او سؤالی بکند و نه از شوهرش.	her face covered by a mantilla to avoid questions for herself and her husband.
خشم شعله کشید و از ظلم زندگی به شدت مغموم و دل شکسته شد.	anger flamed in her at the unfairness of life.
با نهایت خونسردی خانم سرپرستار را در آغوش گرفت.	deliberately kissed the matron.
تا صبح روز بعد آن را برای آقای کازوبن بفرستد.	he might send it in the morning.
از ایشان نیز هر یک نزد آن دیگران معمایی چنان سر به مهر بود که گریی در کالسکه شش شصت اسبه دیگری نشسته است	they were mysteries to one another, as complete as if each had been in his own coach and six, or his own coach and sixty
با قیافه پرمعنی و بی اعتناء از برابر در گذشت و نگاهی به داخل اتاق پذیرایی انداخت	passed by it with a dignified and indifferent air, glanced into the little drawing room.
هر دو دستم را در موی او دفن کردم.	I buried both my hands in his fur.
اما شراب و عرق نیشکر و کنیاک و لیکور در میخانه بویی تند تر از طعم خود داشت	but the stock of wine smelt much stronger than it ever tasted,so did the stock of rum and brandy and aniseed.
به همین خاطر بود که دفعه قبل متوجهش نشده بودم.	which is why I didn't spot it during my previous visit.
بی آنکه لذت گرفتن دنبش را میان پاهایش حس کند فرار خواهد کرد.	he'll sneak off without the poor satisfaction of feeling his tail between his legs.
سپس چون تشخیص داد که به قدر کافی او را به خاطر جنایات مرتکبه تنبیهش کرده	having, by this time, inflicted as much punishment as she deemed necessary for the offence
من دی گه از این جا دربیا نی سم.	I ain't ever going to shake them any more.
از آن پس چون بنابر عقیده مردم متعصب کانون کفر بشمار رفته بود.	was, according to the zeal of those people, looked upon as profane.
این وسیله دور خودش می چرخه و چراغش روشن می شه.	it's supposed to light up and spin.
تا بتواند جواب منفی بدهد و بگوید که همه چیز خاتمه یافته است.	so that he could tell her no, that everything was over
به این نتیجه رسید که احتمال زیاد دارد برای پیدا کردن آبجو برای جو سفری طولانی بود.	but the half mile walk down to the village to find out seemed a long journey to him.
به نظرم دنیا به خیلی چیزها بیشتر از تابلوی نقاشی احتیاج دارد.	it seems as if there were so many things which are more wanted in the world than pictures.
شماها بروید توی حیاط و تا موقع زنگ سر خودتان را یک جوری گرم کنید.	I think you'd all better go out to the playground and amuse yourselves until the next lesson.
در نقاط مختلف همان حول وحوش مخفی شده بودند.	in hiding in different places round about
ولی بهر حال امکان داشت به همچنین روزی گرفتار آیم	but that I might have done so
روی چرخ دستی خم شد و شروع به دویدن کرد.	leaning forward on his cart, he broke into a heavy run
در هیچ جای کشور مثل اینجا مردم کوته فکر نیستند	there is no part of the county where opinion is narrower than it is here
من منتظر طبیعی هستم که بدانم پدرتان زنده خواهد ماند یا نه.	I am waiting till the doctor comes to know if there is any hope of your father's life.
بعد نیز پوست و استخوانی بیش از او باقی نماند.	then her bones were starting through the skin.
تا همه مردم از آن محظوظ و مستفیض گردند!	for the universal entertainment of the people!
اما هر لحظه امکان داشت دوباره حواسش متمرکز شود	but it was quickly getting over that
مسیو مورل مخارج تکفین و تدفین او را متحمل گردید و مختصر قروضی که ایام بیماری به هم بسته بود از کیسه خود داد	MMorrel paid the expenses of his funeral and a few small debts the poor old man had contracted
شوهر ظاهرا برای تبرئه خویش در مقابل مرد بیگانه آهسته به همسرش	said her husband to her in a low voice, evidently only to justify himself before the stranger.
بار دیگر از تپه پایین آمد تا از آن پس خود را وقف بازسازی کند.	he strode down hill again resolved henceforward to devote himself to the furnishing of the mansion.
البته رضایت جیم را با دادن چند گیلاس آبجو به دست آورده بود.	the latter's consent being obtained at the expense of several glasses of beer.
فقط امروز بود که برای اولین بار دیدم ممکن است بتوانم تنها با او صحبت کنم.	it was only today for the first time that I saw a chance of having a few words with her alone.
به کشتی آمد تا با فانوسی غنایم جنگی را بازرسی کند.	came to check the booty alone with a lantern.
طولی نخواهد کشید که به اندازه خود من قوی و کارآمد خواهی شد و به کمک من احتیاجی نخواهی داشت.	soon you would be as strong and apt as myself, and would not require my help.
گویی چون نوری متحرک به او منتقل شده است.	it looked as though it had passed like a moving light, from him to her.
لوسیند نیز با هزاران قسم و غش و ضعف این قول را تأیید کرد.	she confirmed it with vows and swoonings unnumbered.
ما به این جهت این سخن را به خود گفتیم	we said so because we had nothing to fight for there
به شرط آن که حاضر باشید مبلغی برای جبران خسارت به من بپردازید.	if you are in a position to pay the indemnity stated in the contract.
زن پرستار تا دو ساعت بعد هنوز نفهمیده بود که او مرده است.	that her caretaker did not realize she was dead until two hours later.
که بسیار روشن بیان شده و بعلاوه تهدیدی هم هست که اگر من بیایم او فوراً خواهد رفت.	put in very significantly and plainly, and there is besides a threat that he will go away at once if I am present.
روی تخت دراز کشیدم و قضیه را چندین و چند بار در ذهنم مرور کردم.	I lie in bed, my heart hammering, going over it again and again.
همه فهمیدند که او از اهالی خود آن شهر نیست	no one doubted that he came from far away
تا اینکه اندکی بعد در آهسته باز شد و پیشخدمت وارد شد.	until after a while the door of the room opened softly, and the butler came in.
مگر اینکه قبول کنید با آرامش به خانه برگردید	but to submit quietly and return home
سپس به پشتی تکیه داد و چندین نفس عمیق کشید.	leaning back he drew several deep breaths.
که چگونه مطلب مهمی را که باعث آمدنش به اینجا شده بود عنوان کند.	how to broach the so much more important matter that had brought him here.
یک بار مردی که چاقو خورده بود با کاردی در پشت از اتوموبیل در حال حرکت به بیرون پرت شد.	once a man who had been stabbed, ejected from a moving car with a knife in his back.
سروان تر نر اخمی کرد و گفت مایلم با برقکار ی که روز قبل از حادثه به ان خانه رفت صحبت کنم.	I'd like to talk to the electrician who went out there the day before the fire.
دستی مثل آهن سوزان بر وجودم چنگ انداخته بود.	a hand of fiery iron grasped my vitals.
که غیرمترقبه آن خبر را شنیده بود مثل همیشه لباس پوشیده بود.	he was dressed just as he had been when he first heard the news
در این صورت چکش تنها بدرد متلاشی کردن مغز من خواهد خورد.	I should only smash my skull with the hammer!
کاری نکن که بار دیگر متوجه وجود نحست بشوم.	don't remind me of your existence again.
من می خوام بدونم موضوع چیه تا بتونم در این بحث شرکت کنم.	I want to know so that I can argue with these thoughts.
حاکی از نفرت و تمسخر است و دختر میکوشید از روبهرو شدن با او بپرهیزد.	expressed a feeling of hatred and contempt, and she tried to avoid meeting him.
از افسر دیگر به سبب مستقیم نبودن صف ایراد گرفت و قرق رکنان به گروهان سوم نزدیک شد.	at another because his line was not straight, he reached the third company.
نتوانسته بودند مرا که تا سینه در آب فرو رفته بودم تشخیص دهند	could not discern me, who was up to my breast in water.
اما دلیل وجود ندارد که وی زندگی خود را تباه کند و به خاطر یک زن بد و بیایمان شخصاً رنج ببرد.	but there was not, and there could not be, any sort of reason that his existence should be troubled, and that he should suffer because she was a bad and faithless wife.
که از آن زمان تاکنون کتاب را در همان جا نگه داشته بود یا جای دیگر!	whether she had kept it there ever since
به طوری که چون به دربار پادشاه بزرگی در آید قبلاً با کارهای خود شناخته شده باشد	such that when he betakes himself to the court of some great monarch the knight may be already known by his deeds
با خوش خویی و دل زندگی او ارتباط داشت	was as kind and hearty
نفس عمیقی کشیدم و به وی او را استشمام کردم.	I took a deep breath, pulling in her scent.
زن تناردیه به وی غرولند کند و کتکش بزند.	theThenardier would scold and beat her.
اما وقتی حرف بزند بهتر آن است که خوب گوش کنی.	but, when he does speak, then you may well listen.
اما به گمان من دلیل دیگرش بهبود وضعیت خودش بود.	but also, I suppose, to better himself.
شایعه پیشنهاد خواستگاری برادر زن تو از او یا موضوع دیگری نظیر آن به گوش من رسیده است.	have heard reports of your brother in law having sought her hand, or something of that kind.
من با احتیاط لباسا رو بین دندونام گرفتم آه و او نا رو بین درختا بردم.	I took the clothes gingerly between my teethughand carried them back to the trees.
زیرا خوب میدانم که او احتیاج به پشتیبانی شما داد گول زده است	he evidently needs support, I quite see that! .
با چه توجیهی گذاشتی اون دختر در قعر دریاچه بمو نه	how can you justify your leaving that girl in that lake
نیاکانشان با کار و کوشش و عادات نیک اجتماعی آنجا را به زیباترین شهر در استان تبدیل نموده بودند.	with their work and their good habits, had transformed into one of the finest towns in the province.
با چشمانی پر اشک پیپ خود را زیر لب گذاشت.	resumed his pipe with tears in his eyes.
به تصور اینکه تمام ملاحت گفته او در آن یک کلمه نهفته است آن را آهسته برای یکدیگر تکرار کردند.	the one coarse word she had used, supposing the whole sting of her remark to lie in that word.
با نگاهی حریصانه میهمان نور رسیده را جستجو کرد.	eagerly sought thenew comer with her eyes.
آن گاه از کاری که کرده بود به وحشت افتاد.	was appalled at what he had done.
عقیده دارم حتی ممکن است مرا هم دوست بدارید.	I think you ought to love me
چنانش سخت و محکم به باد کتک گرفت که وی را با وجود سلاح رزم برتن مانند گچ کوبید.	notwithstanding and in spite of his armour, he milled him like a measure of wheat.
چهار نفری خودشان را به پشت در اتاق نشیمن رساندند.	all four of them crept towards the dining room door
تا وقتی به یه نخ دی گه نیازمند به شم همین یکی کافیه.	one is enough till another is wanted.
دستم لرزید و گیلاس از دستم افتاد و شکست و شیر بشکه را غلطی چرخاندم	I broke one glass and fouled the tap
تا به امروز این لفظ را در سلاطین شنیده بودم.	I thought, sir, that it was kings alone who abdicated!
معناً بیشتر ستایشش میکرد و سعادت خود را بیشتر ارج مینهاد.	morally bowed down lower than ever before her, and prized more highly than ever his undeserved happiness.
در برابر این تصمیم او نه تعجبی از خود نشان دادم و نه کوشیدم که او را از آن کار منصرف کنم.	I neither expressed surprise at this resolution nor attempted to dissuade her from it.
زیرا اکنون مراقبت او به من محول شده است.	because I wait upon him alone in his room now.
وقتی پا به این سرزمین گذاشت فقیر بود ولی از فقر هم نترسید.	when he come to this country and was pore, that didn't scare him a mite neither.
توقع نداشتم که تمام این پول را تو به رام تهیه کنی.	I didnt expect that you could get it all for me
امیدوارم در سپردن مدیریت بیمارستان جدید به دست ایشان محق باشم.	I hope to find good reason for confiding the new hospital to his management.
با فروتنی آن را به روی زانو نهاده بود	white hands meekly folded on his knees
به این دلیل حال که پیدا بود مشکلی پیش آمده است درمانده بود که که چه رفتاری در پیش بگیرد.	he was puzzled as to just what attitude to assume in a situation where obviously something was wrong.
قسمت عقبی کشتی را به صورت زرادخانه کشتی درآوریم	to make a garrison of the stern part of the ship
به طرف حمام رفتم تا نگاهی به خودم بیندازم.	I walked to the bathroom to check for myself.
من هیچ گونه رحم و انصافی درباره اش ندارم.	he has no claim on my charity
اگه بلد بود چه جور باید آب بارون زیگیلشو خوب کنه	if he'd knowed how to work spunk water
منم کردم و بعد هر سه نفری راه افتادیم.	I done so, and then we all three started on again.
که به ویژه در پرورش کیش نسبت به پیروان خود به شدت خشمگین شده باشد	especially in inculcating the religion of rowing.
خیلی چیزها را از دست داده بود و اگر شوکه شده بود اصلا تقصیر او نبود.	to cry for the things he had lost, that he had a right to be in shock if that was what this was.
آن گاه از جایش برخاست و دنبال مدیر هتل از سالن غذاخوری بیرون رفت.	standing up quickly and following her from the dining room.
مبلغ یک صد هزار فرانک زیادی طلب شما ماند.	there is still a sum of one hundred thousand francs?
زمانی که پیرمرد از من خواست تا پدرخوانده باشم	when you old man asked me to be a godfather
زیرا در دنیا کارهای آبرومندتر و پردرآمدتری از قبیل بنائی وجود دارد.	while there's an honest trade to be learnt, or brick making to turn to.
آن را نیافت. بار دیگر نومیدانه عقب آن گشت و آن را یافت.	she searched for him where he was not, she searched again without hope, and she found him
که در این سرداب بیست و پنج میلیون وجه نقد تمام طلا بود	the pouches contained 25,000,000 of money in gold
این را به خود قول داد و کوشید تا قولی مردانه باشد.	he vowed, and hetried to make it valiant.
چون به عادت همیشگی آماده خنده و مسخرگی بود	embracing him as he had done before
زیرا به اندازه کافی سر ما شلوغ هست که نگو و نپرس	for our places are hard enough.
جی رینگ جی رینگ به در و دیوار خورد.	pinged off the walls
دست راست وی همیشه به قنداق آن چسبیده بود	his hand, which was always on the butt of the pistol
تا چنانچه ناگزیر شود از آن سگ استفاده کند	so that, in case he was driven to use the dog
زیرا کسی این برج را تمام خواهد کرد که به آنان غذا بدهد	for he finishes the building who feeds them.
که تا سخن دوستش به پایان نرسید لب از لب نگشود.	that, except to say what has been already mentioned, he did not open his lips until the other had finished.
باز خو به تو خوابت ای نا یادت بود.	I'm glad your dreams could take even that much trouble about us.
اما تو اگر شتاب در دیدار ایشان نمایی بهتر است	but you were right to return as soon as possible my boy
آب سرد را تا آخر باز کرد و بعد مشتی آب به صورتش زد.	ran the cold water on full, and then splatted cupped handfuls against her cheeks
کارگر جوانی در کارخانه سه چهار ماه بعد از ازدواجش همسر خود را باردار کرده	that he had been approached by a young working man in the factory, newly married, who
باز او موظف است زیر لب سخنانی زمزمه کند	he is bound to say certain words between his teeth
او با خضوع و خشوع تمام در برابر اربابش به زانو درآمد و خواست تا دست وی را ببوسد.	who came in very humbly, and falling on his knees begged for the hand of his master
اما تردیدی نیست که خندید و سرخ شد و سپس فریاد زد	but certainly she laughed and blushed and then cried out
گذشته از این ما دو متحد نیرومند هم داشتیم که یکی آب بود و دیگری هوا.	besides that, we had two able allies rum and the climate.
ولی قبل از او عدهٔ کثیری داخل تالار شده بودند.	but a number of men had already made their way in, and met him.
خود را در نیم تنه پوست پیچیده روی زین نشسته بود	glittered more than usual, and as he sat in his saddle
شما برده موهومات و شهواتید و هرگز سایه یک فکر شخصی در ذهن یا قلب شما مشاهده نخواهد شد	you have no chance of ever fathering the pettiest idea of your own.
همه چی سرش ون می شه اما هیچ وقت بروز نمی دن.	they know things'jus' don' let on much.
واقعا حماقت به خرج داده که به این شکل به فکر کمک به دیگران آنهم یک کارگر کارخانه افتاده است.	was foolish to be helping anybody else in this way particularly a working man.
بعد دست خود را در برابر نور شمع حایل ساخت	shading the flame of the candle with his hand
چیزی را به دهان نگذارد مگر این که او قبلاً قسمتی از آن را خورده باشد	not to eat anything he had tasted
گو اینکه برف تمام زمین را مستور کرده باشد	if the snow was on the ground
ظرفی به سوی دیگر پرتاب شده بر مغز شخصی تازه وارد فرود آمد.	flung it full at that young gentleman.
یکی دو تکه از آن را بریده بودند .	only one or two slices had been cut from it.
صاحب جریب در جریب زمین سبز که در جلوی چشمانش گسترده شود.	he wanted to see his own acres stretching green before his eyes.
به خاطر همین بهتر از آن چیزی بود که اِما انتظار داشت.	therefore better than she had expected.
من برای تو شرح خواهم داد! همه چیز را خواهم گفت.	I'll explain it, I'll explain all to you.
به اضافه یک پاداش 5000 دلاری برای اولین محموله که به فاصله ده هفته از حالا خواهد بود.	plus a five thousand dollar bonus for the first shipment, which is due ten weeks from now.
که فراخوانی نشست ویژه مانع از آن خواهد شد	that the calling of a special term was likely in any wayto prevent
تصمیم گرفتم خانم دانورس را تنبیه کنم به همین سبب مداد قرمز را برداشتم و سراسر صورت را خط زدم.	I put a pencil through the list.
باز پیش رویش انسانی بود دردمند و شاید استخوان شکسته.	in front of him, also, was a human creature, in pain and perhaps with a broken bone.
تا باران چنین مهری را از دستهاشان به یکدیگر انتقال دهند.	soak it in through every pore.
البته از لحاظ نسبت این رقم بسی ناچیز است ولی از جهات دیگر اهمیت خاصی دارد.	a relatively insignificant number, no doubt, but remarkable enough from another point of view.
ژول ین در کنار او خوابید و او را در آغوش گرفت	he took him into his bed, held him in his arms
دیگر هیچ نیرویی قادر نبود از نومیدی مطلق بیرونش بکشد.	there was no power on earth that could raise him from his prostration.
اگر پای مقایسه با آقایان متشخص به میان بیاید	when he came to be contrasted with gentlemen
تا شنل او را از دوشش بردارند و عصا و کلاهش را بگیرند.	to help him off with his cloak and take his hat and stick.
من از شنیدن این جور خبرها خیلی ناراحت میشم	I always hate to hear of anything like that
در آنجا نامزدها باید تردستی خود را به نحوی بنمایند و بیازمایند که با آنچه پیش از این گفتم به کلی فرق دارد.	where the candidates are to undergo a trial of dexterity very different from the former.
ولی خوشحال بود که محل مرگش آن خندق گل آلود نیست.	, but it wasn't going to be alone in that muddy ditch.
به محض این که نشستم آن زوج وارد ساختمان شدند.	as I resumed it the pair came in.
باری در برابر چنین اربابی محال بود که بتوانم کاری جز آنچه گفتم انجام دهم.	besides, it was impossible for me to do
بین هشت هزار و یازده هزار روبل اختلاف است	there's a difference between eight thousand and eleven thousand.
برای خاییدن و دریدن در و دیوار محبس و زندانبان	which frequently gnaw the bars, and sometimes the keepers also.
گفتند که این کار زشت عاقبت خوشی ندارد .	no good would come of it.
بعد مقداری نوار و یک حلقه برداشت و به ادامه دوخت و دوز خود پرداخت.	taking up another ring and more tape, went on with her sewing.
بدبختانه در خواب دچار کابوس وحشتناکی شدم و جیغ کشیدم.	I had the misfortune to scream in my sleep, owing to a frightful nightmare.
در هر وضعی که باشم همیشه چنین خواهد بود.	that always will be so in whatever circumstances I may be placed.
برای همین بدون احساس گناه اینو بهت پس می دم.	so I don't feel guilty about giving you back this as well.
یک دستگاه پیانو کنار صفه از ایوان مفروش به اطلس آبی رنگ نمایان بود.	containing an upright piano and a blue satin couch.
اما هنوز حالت آن را نداشت که چیزی بگوید.	but could scarcely move or speak
دی گه آدمی با این شرافت و اصالت نمی تون ین پیدا کن ین	we ain't likely to see many more like him
حال آنکه اگر ایشان به هدایت آن فنون و قواعد نوشته بودند	for writing without paying any attention to good taste or the rules of art
او را به اوپرا دعوت کرده بود بدون هیچ توضیحی	, in which, without assigning any reason, he begged him to go to the opera
ولی بعد حس کرد که امکان چنان سفری وجود دارد.	but all she had to do was admit the possibility for it to be considered a reality.
غالباً وی در آبدارخانه کنار بخاری نشسته و مشغول مطالعة روزنامه بود.	generally while he read the paper by the pantry fire.
اما حالا آوردن آب به نظری کار بدی نیامد.	but now it did not strike him so.
او خودش را به صورت شیطونک در او رده بود.	dressed as a joker with a red and yellow pointy hat.
از لحاظ بدست آوردن مقام این اشخاص مهارت خاصی دارند	they are first rate, these people, at making a career!
اما ضم نا گوشزد کرده بود که این موضوع عجالتا نباید به گوش کس دیگری برسد.	but that it had to be kept secret for the time being.
من بسیار وقت است که با او مختصر عداوتی دارم.	whom I've hated for a long time, there.
یکجا آبشار باشکوهی درست در وسط جاده سرازیر بود تا به رود بپیوندد.	at one spot a magnificent waterfall spilling to join it from somewhere up above, right athwart the road.
شما بهتر است همه آن غذاها را دور بریزید.	you had better throw the stuff away.
از من خواست تا از بو مراقبت کنم .	he questioned, not turning his head.
پیروزی شب پیش نیز وجهه و اعتبارش را در نظر ملوانان بسیار بالا برده بود.	his last night's victory had given him a huge preponderance on their minds.
او را صحت یافته دوباره به ما بازگشت دهید.	will you restore him to us cured of his melancholy?
بنابراین ناچار است که خانه را بفروشد و هرچه زودتر برگردد.	so he must hurry and settle up the estate right away and leave for home.
برای آن دختر همه ی روزها مثل هم بود و اگر امروز و فردا برای مردم هیچ فرقی نداشته باشد	for her, every day was the same, and when each day is the same as the next,
که حتی خود افراد از شماره نیروی این قشون عظیم به وحشت افتادند.	joyfully that the men themselves were awed by their multitude and the immensity of the power they constituted.
من واسه بیست سال عجیب غریب گرگ هار و نگاه کردم.	 'I've watched wolves for twenty odd years.
چون به سطح زمین رسید و چشمش به آفتاب آسمان دیگری افتاد	but when he came to the surface and beheld the sun of another heaven
امسال مفتخریم که به دو استاد جدیدم ون خوشامد به گم.	I am pleased to welcome two new teachers to our ranks this year.
مبلغی را هم که او خواسته است نخواهم داد	nor yet can I give her what she asks
اما بدون اراده به طرف یک قفسه دیگر راه افتاد.	but for some reason she found herself instinctively walking past that particular shelf.
بحث مفصلی که میان مصنف و تنی چند از مردان نامی آن سرزمین در ین باره در گرفت.	with many conversations between the author and some eminent persons upon that subject.
حالا به عمده فروشی و ساخت مختصری پوشش مقوایی پیش ساخته برای پشت بام مشغول بود.	he was now a wholesaler and small manufacturer ofprepared paper roofing.
به تلاشم ادامه می دم و بعد شروع به خوردن کردم	I'll keep trying, I promised, and then I dug in.
فارق التحصیل کالج بود و صورت و اندامی زیبا داشت و بارها در مسابقات زیبایی برنده شده بود.	a college graduate, with a face and figure that had won several local beauty contests.
گرچه که می دونیم صدای ما رو می شنوه.	though we know he hears us.
ربرتا تا این زمان او را این چنین تلخ و عبوس ندیده بود.	more contentious and bitter than at any time ever between them.
برای این که اشک نریزد واقعیت را انکار کرده بود.	he had avoided reality in order not to cry.
ساعتی هم بود که به حکم عادت خیلی مهم شده بود.	an hour made solemn by old traditions.
من می دونم که با من شخصاً تا حالا کاری نکردی.	I know you haven't done anything to me personally.
به سمت خو نه به راه افتادم و ادوارد دنبالم کرد.	I started walking to the house, and he followed.
این حرف مرا به خاطر بسپار و کاری نکن که اوقات من تلخ شود.	I shall put you in the corner.
راستش از همین حالا آدم شماره یک من شده.	quite a first rate favourite with me already
! ناتاشا احساس کرد که یک نفر بازوی او را چنان فشرد که به درد آمد.	she felt her hands being painfully pressed.
اما کیمیاگر به او کمک کرد تا از چادر بیرون بیاید	but the alchemist helped him out of the tent.
فکر کردم بهتر است منتظر بمانم و تماشا کنم.	I thought it better to wait and observe.
کم از این حیرت نبود که در امری چنین ناگهانی و مهم چه تصمیمی اتخاذ کند.	as at the position in which he found himself, not knowing what course to take in a matter so sudden and unexpected.
هنگام آن رسیده است که نوع بشر را نورانی کنند.	it is time to enlighten the human race.
که موفق شده است بفهمد که محل غرق شدن کجاست.	he had determined the site of the shipwreck.
که زیر این پرچم جمع بشوند و در این تلاشها به من بپیوندند.	under the same banner, to join in the same enterprise.
داس را از برزگران گرفته و خود به درو پرداخته بود.	he took a scythe from a peasant and began mowing.
آن قدر صبر و تحمل به خرج داد تا بالاخره فکرهایش را عملی کرد.	he had gone steadily on, with these objects in view, till they were accomplished.
روی پاشنه پا چرخیدم تا به ان طرف خیابان بروم.	I turn on my heel and start striding across the road again.
اما به طور قطع از آمدن سرباز زده است.	, but had flatly refused to return.
باری سانکو چون نتوانست جلو شکم پرستی خود را بگیرد	unable to control himself or bear it any longer
اما چون قصد دارم که به زودی کتابی جداگانه در ین باب بنویسم	but intending in a short time to publish a volume by itself, expressly upon that subject
پیش از آن که راه دریا را در پیش بگیرد	before he came to sea
کافی بود سر برگرداند و چمن را تماشا کند.	so that by simply turning her head she could look out across the lawns.
هنگامی که با سر خود رو به یک جهت دارد	when, sounding with his head in one direction
چون مثل برف بادآورده یخ کرده بودم امشب نتوانستم جای دیگری برای سرکشی بروم	cold as that of the snow drift I almost stuck fast in to night.
شاید به این مناسبت که محبوس ین این زندان دندان و چنگال دارند.	probably because the captives possess teeth
گهگاه ه یاد بیاورید مردی وجود داردکه آماده است جان خود را بدهد تا جان کسی که شما دوستش دارید محفوظ بماند.	think now and then that there is a man who would give his life, to keep a life you love beside you! 
من هم پدر دخت ره رو با خودم میارم اینجا تا هویت جسد و تشخیص بده.	I'll bring the father backwith me, too, to identify the body.
عقایدی که در واقع مال طبقه او نبود و به او تحمیل شده و مال او شده بود.	that had not always been hers but had become hers more than anyone' s.
همچنان که دستم را برای خداحافظی به طرف او جلو برده بودم برایش سفر خوبی آرزو کردم.	I tendered my hand, and wished him a pleasant journey.
یا این که کبوتر را پس فرستاده بود تا او بار دیگر آن را برایش بفرستد.	or she had returned the pigeon so that he could send it back to her again.
ناچار شد نقاب کلاه خودش را بالا بزند تا بتواند عرق صورتش را پاک کند.	push up his visor to mop his sweating face.
اما گذشته از آن به ما مور آن پلیس بد گمان بود	in any case, he had deeply mistrusted the police
متوجه گردید که آتش در حال خاموش شدن است	when she discovered that the fire was out.
من قبلاً هم قسمتی از اون دنی ای دی وانه کننده بودم.	I've been part of that crazy universe before.
اما افسوس کسی برای مراقبت از کندو آنجا نماند.	but it was a pity there was no one standing by with a stopwatch.
عاقبت پیشخدمت آمد و مرا صدا زد و گفت که آقایی در انتظار من نشسته است.	until I was admonished by the waiter that the gentleman was waiting for me.
اما کالب از گفتن نتایج بعدی آن خودداری کرده بود.	but had kept back the further result.
کام لا مشخص بود با کشف جنسیت مشابه رفتار او تغییر کرده شیوهی چاپلوسانه و متظاهرانه از بین رفت	it was remarkable how soon, on discovering that they were of the same sex, her manner changed and she dropped her plaintive
مثل اهل نانتوکت کوششی ندارند که معاش خود را از دریای ژرف تحصیل کنند.	without seeking to draw their living from the bottomless deep itself.
به جای این کار چند تا سگ شکاری نگهدار.	you may as well keep a pack of hounds.
همان طور کتاب به دست به دنبال او دوید.	with all his might, made off after him, book in hand.
برایم اهمیت حیاتی دارد و نباید آن را فاش کرد.	of vital importance for me, and not to be put into words.
چون معروف است که در هر خانه روغن انبار دارند	for, they say, they have reservoirs of oil in every house
او را به صورت کسی که از دستور سرپیچی کرده به تالار خواهم آورد.	fetch her in case of contumacy.
بدو رفتم و توی انبار آرد بی زی پی داشان کردم.	I went out and found them by the mill.
اما روت هیچ تلاشی برای برگشتن به حال نخست به خرج نداد	but she made no effort to retrieve it.
جز آنکه نقطه پلید ترحم انگیزی را که از قضا خودت در این کره وسیع بر آن واقفی و دستی که تو را نگاه داشته است معین کنی.	but what after all canst thou do, but tell the poor, pitiful point, where thou thyself happenest to be on this wide planet
چون او حاضر نبود سرش را به کسی بگوید.	for he refused to part with his secret.
آماده بود که اولین کلمات انتقاد آمیز او حمله سخت خود را آغاز کند.	ready to pounce upon the old lady at the first words of condemnation.
اون الآن تونست راحت نظرشو گفت اما این کار و نکرد.	she is allowed to speak her mind now, but she won't do it.
من فقط اینجا هستم تا کاری و که گفتم انجام بدم.	I just have to do what I'm told.
ستاره شناس متفننی است و تلسکوپ بی نظیری دارد.	being an amateur astronomer, he has an excellent telescope
با این همه چون دار نی در برابر او ظاهر شد	when her husband stood upon his feet
اما او هم به وسایل ماهیگیری من کاری ندارد.	but then he doesn't care about my fishing tackle.
کف زیرزمین و دریچه چنان به هم شبیه بودند	it blended so perfectly with the dusty floor that
هنگامی که دیدند وی از حل مسأله فراغت یافته است	when they saw he was at leisure
سپس در اتومبیل را قفل کرد و از آنجا دور شد.	locked them all inside the car, and disappeared.
قبل از اینکه حضرتعالی برای برانگیختن احساسات خشم و غضب به من نزدیک شوید چنان به ضرب چماق خشم و غضب شما را بخوابانم	before your worship comes near enough to waken my anger I will send yours so sound to sleep with whacks
از میان جنگل به سوی دهکده پیش رود و مواضع دشمن را دور بزند.	through the wood on the village and turn the enemy's position.
اما ده است که در این تفریح شرکت کند.	ready to join in the fun.
ظاهرا هم از این رفتار بسیار مغرور بود و هم در عین حال شرمگین.	was evidently very proud of this but at the same time felt shy.
آ مه می دونی قضیه چند تا نکته مبهم داره.	it's a great myst'ry
ناچاراً جهت خود را عوض کردم و به سمت چپ پیچیدم.	so I changed off and went that way.
فقط برای این که مرا مطمئن کند که همیشه گرمای جنوب را احساس خواهم کرد.	just for reassurance that I would continue to feel the warmth of the south.
با یک حرکت سریع خودم را پیچ دادم و بلند شدم.	I wrenched myself erect in one quick move.
من نمی تونم هیچ احساسی رو از ورای حفاظش حس کنم.	I can't feel a way through her shield to get a sense of it at all.
اما اینکه چگونه زین اسب تبدیل به پالان خر شده است	as to its having been changed from a caparison into a pack saddle
این روزهای ممنوعه با خطوط تار عنکبوتی ارغوانی رنگ مشخص گردیده بود.	were spread out through a web of purple crosses.
زیرا که بین راه یک عاریه دسته جمعی از یک دکان اسلحه فروشی کرده بودند.	for, on their way, they had effected a wholesale loan from an armorer's shop.
یک ماه طعم دربدری و ماجرا را کشیدم و دیدم که برم بس است.	I have had a month of exile and adventure, and I find that has been as much as I want.
از بیرون دارای شبکه سیمی آهنین بود تا در سفرهای دور و دراز مانع بروز حوادث شود.	each window was latticed with iron wire on the outside, to prevent accidents in long journeys.
مواظب باش تو نباید او را هم سرزنش کنی.	you mustn't scold him either, mind.
بالاخره تمام کسانی که در آن کاروانسرا بودند کام لا خرسند و راضی بودند	in short everybody in the inn was full of contentment and satisfaction
آنجا تاریک و گرم وپراز صدای به هم خوردن بال حشرات بود.	it was dark, hot, and alive with the softly whirring wings of the barnswallows.
ولی حالا دلم می خواد که وسط همین مردم زندگی کنم دلم می خواد به من احترام بذارن و دوستم داشته با شن .	my pet, not my own the calm dignity life can have when it's lived by gentle folks, the genial grace of days that are gone.
زیرا که وی در نظر پهلوان مردی محترم و متشخص جلوه کرده بود.	who struck him as being a man of intelligence.
با چه تلاشی همه این افراد را به اینجا آورده تا بر علیه او شهادت دهند!	how hemust have worked to get all of these people here to testify againsthim!
یا سربازانی که مأموریت داشتند در محل خود توقف کنند	soldiers ordered to remain where they were
میان آزردن احساسات یک زن و ترس اینکه مانع کارشان شوم گیر کرده بودم.	I was torn between the fear of hurting a nice woman's feelings and the fear of being in the way.
من آن سواران را که مسلح بودند و بر اسب نشسته بودند بدست گرفتم و در آن دست نهادم	I took them up, one by one, in my hands
شاید شما فکر کن ین که من دارم پا از گلیم خودم بیرون میذارم	maybe you think I'm gettin' above myself, speakin' first
از کتاب به گفتگو درباره مناظر بیرونی گوناگون و دینی این شهر مشهور پرداختیم.	from that we went to jabbering the best we could about the various outer sights to be seen in this famous town.
همه مکنونات قلبم را با شما در میان بگذارم.	will open all my heart'or nearly so.
هر چند که به زبان دیگری هم آشنایی نداشت	though he knew no other language
یکی از آنان به خشکی پرید و ناپدید گشت.	one of them whipped ashore and disappeared.
اگر مالک این عمارت پول کافی برای نگهداری از آن نداشته باشد	if he has not money enough to keep up the property
در صورتیکه کشته نشود زیرا کشته شدنش بسیار محتمل بود	even if the messenger were not killed which he very likely would be
طرفدار چیزی شدن است با همان اندازه قوت که دیگران مخالف آنند.	it is to be so strongly for, as to be against.
آنگاه نفر سوم رفت و او نیز مانند دو رفیق دیگر نامراد بازگشت.	then the third went forward, but with the same result as the first and second.
اما او با یک اشاره سر امتناع ورزیده بود.	he had refused with a sign of the head.
هنگامی که هری در اتاق با آن تنها بود	while he was alone in the office with it
سنتان یک روز هم بیشتر از چهل و پنج سال نیست.	you can't be a day over forty five.
به آهستگی داخل اتاق غذاخوری شدم و در قفسه را باز کردم.	I went across the hall and into the dining room once more.
اما وقتی که از صبح تا شب چیزی گیر نمی آوردیم بخوریم	but when we hadn't had a bite since morning
بی درنگ با عزمی راسخ سینه خود را بر نوک تیز شمشیر انداخت.	he swiftly, coolly, and deliberately threw himself upon it
سپس به سوی منزل روان شد و صبح زود به آنجا رسید.	he walked home, and it was early morning when he arrived.
این همان پارو بزن بود که در آن روز که سه تن از قایق لرزان بیرون افکنده شدند عقب مانده بود.	when on the last day the three men were tossed from out of the rocking boat, was dropped astern.
بدون حضور وی از استحکامات مواضع او بازدید کنند	to inspect and criticize his camp in his absence.
از درون جعبه ساعتی از طلا و جواهرنشان را بیرون کشید.	took from it a magnificent gold watch, sparkling with jewels.
بگذارید تا قهوه ای شوید و برای درمان این وضعیت میل کنید.	let it turn brown and eat it to cure this condition.
چگونه پسر عمو و مدیرهای کارخانه مقررات کارخانه را به او گوشزد کرده بودند.	instructed by his cousin and the foreman asto the various rules
باور کن این جور افراد اصلا به وقت شناسی اهمیت نمی دن.	I daresay their kind don't set much store by punctuality.
که احساس کند شخصی از او شفاعت کرده است	to feel at that instant that, for him too, there is one to pray
اما باید فرصت بررسی داشته باشم که قولم تا چه اندازه عملی است.	but I want time to consider how much of what I promised is possible.
زیرا او از این تابلو و یا منبع دیگری که من قبلاً با آن تماس نگرفته باشم اطلاعی ندارد.	since she has neither knowledge of the painting nor any assets that I have been able to uncover.
من بعد از اون دی گه هیچ وقت ندید مش.	I never saw him after that.
اگر دانش او از انواع شراب نبود که درزنان نادر است	had she not shown a knowledge of wines rare in a lady
اگر چه میدانست ایشان چاکران سلطانی هستند که تا این اواخر دشمن سرسخت اعلی حضرت امپراطور بود	although he knew them to be servants to a prince who was lately an open enemy to his imperial majesty
بعد در بیشه به راه افتادند تا جاهای تازه را کشف کنند.	then went off through the woods on an exploring expedition.
تنها دو سه قاشق و آن را هم گویی بدون اراده خورد.	three or four spoonfuls, without appetite, as it were mechanically.
درست فردای همان شبی که افتخار دیدنشان نصیبش شده بود.	on the very morning after his having had the pleasure of seeing her.
هر چند در قضیه هم بستر من قدری قصه سرای کرده بود.	though he had been skylarking with me not a little in the matter of my bedfellow.
حتی پیش از آنکه حوالهء گهوارهءتان بکنند هم قبایتان را به عزوبت بریده بودند.	you were cut out for a bachelor,before you were put in your cradle.
به عبارت دیگر ازمرد سعادت مرد عقل حاصل دارد.	inother words, the man of wisdom should be made to emerge from the manof felicity.
آن قدر هم ادامه دادهای تا مغز دخترک را خراب کردهای.	you've gone on till you've turned the poor wench's head.
اما وقتی خوب پول درمی آورده هیچ پولی پس انداز نکرده و حالا باید با پول مردم شهر زندگی کند.	he never saved his money when he was earning good wages, so now he has to live on the town.
امافقط کالبدی پیر و فرتوت که به پشت افتاده و تا روی چانه اش را پوشانده بودند با چشمانی باز و چنان بی حرکت که انگار دیگر نفس نمیکشید.	but it was only a senile body, lying on its back, covered to the chin, with open eyes, and so still that you might have said it was breathing no longer.
لرزشی دیگر بر اندامم انداخت و چیزی نمانده بود روی زانوهایم بیفتم.	racked me with another shudder and I nearly went to my knees.
پس بهتر است که این چیز پیش من بماند.	so the thing had better be with me.
حالا طوری رفتار می کنه که انگار من جزئی از خانواده شو نم.	she feels that way, as though I were a part of the family.
نزدیک به یک ساعت کنار بخاری نشستم و به غرش خفه طوفان گوش دادم.	after sitting nearly an hour on the hearth listening to the muffled fury of the tempest
به این نکته پی بدم که هر دو کما بیش سن و سال مرا دارند یا شاید از من اندکی نیز جوان ترند.	I also observed that they both looked of about my own age, or rather younger
بعد پیش از آنکه او رهایش کند سر را جلو برد	then he tipped his head forward before he could lose her
متحیر بودم که چرا از شوهرش آن همه نفرت داشت.	I wondered why she hated him so much.
من اطلاع نداشتم که ایشان قبلاً چنین دستوری به شما داده بودند.	I had no idea he was having rooms redecorated and furnished.
که اکنون تنها راه مراوده با آنان را معاشرت با دختران تلفنی با نرخ گران تشخیص داده بود.	that his only association with them now was with high priced call girls.
چنان خرناس بلندی کشید که همه را به خنده انداخت.	purring so loudly that everyone laughed.
سپس دست او را گرفت و به داخل اتاق کشانید	then she took him by the hand and drew him into the room.
تا همزادشان هدیه درخشیان در آن گذارد به یاد آورد.	there to await in the darkness some sparkling gift from their good fairy.
آن شبت تا صبح خواب به چشم هری نیامد و تمام مدت به روز بعد و مدرسه فکر کرد.	spent a sleepless night imagining school the next day
که آن قسمت از توده روغنی را جای بدهد و در زیر قاعده طویل این هرم در حفره دیگری که طول آن به همین اندازه است	while under the long floor of this crater in another cavity seldom exceeding ten inches in length and as many in depth
من ترا بیشتر و بهتر از پیش دوست دارم.	I love you more, better than before,
خود در کنار آتشی که سربازان در میان جاده روشن کرده بودند نشست.	sat down by a bonfire the soldiers had kindled on the road.
دستور داد این کلمات را برای او تکرار کنند.	he ordered these words to be repeated.
اجازه دادم کلمات با صدایی آرام به بیرون سرازیر شوند .	I let the words spill out, my voice low.
پس از آن سر خود را به زانو نهاده و از شدت تب بنای لرزیدن گذاشت	then let her head again drop upon her knees
صورتش را در دستانم گرفتم و صبر کردم تا چشمانش را باز کند	I grabbed his face in my hands and waited until he opened his eyes.
عینک خود را که به ریسمان سیاهی آویزان بود بر چشم زد	opening a double eye glass, which hewore attached to a broad black riband
بی درنگ دستور داد که او را به سربازی بفرستند.	instantly gave instructions to have him conscripted for the army.
برعکس شروع به پوشیدن لباس کردم و با دقت خود را پوشاندم.	on the contrary, I began and dressed myself carefully.
ولی برای تا نی چی چو ان به اندازه کافی جا داشت.	but it was large enough for t'ai chi ch'uan
ما در اینجا به خوشی او خوش خواهیم بود	we on our part will make the best of it
به مراسم تسلیم بدون قید و شرط خودشان پایان داده و به کسی مجال سخنرانی نداد.	closed the ceremony without allowing any speeches.
هر چند وقت یک بار با یک حرکت ناگهانی نزدیک بود هری را سرنگون کند.	every now and then making violent swishing movements that almost unseated him.
با وجود این سفیدی کودکانه چه رفتار متین و زیبایی دارد.	yet with this infantine blondness showing so much ready, self possessed grace.
با عجله تو را به طرف این زندگی کشانیدم.	I rushed you into it.
اونوقت یادت میاد که من دلم میخواد قوی باشی .	then you'll know that I'm wanting you to brace up
اما از اتاق خواب پدر صدای چکش به گوش او رسید.	but she heard a low hammering sound in his bedroom.
زنگ را به صدا درآوردم و دستور دادم سینی را بیرون ببرند.	I rang the bell and ordered away the tray.
آن را بالای پیش بخاری اتاق نشیمن آویزان کردند.	being hung over the mantelpiece of the common sitting room
باید بروم گوسفندانم را جمع و جور کنم و راه بیفتم.	I have to go and gather my sheep and get going.
روی یک صندلی نشستم و به فکر فرو رفتم.	I seated myself in a chair, and rocked to and fro
خانه او سابقاً دیوار به دیوار خانه پدر و مادر آن دخترک زیبا بود.	he lived in the house next door to that of her parents
از او قول گرفتند که سرش را تو بگذارد و صبر کند.	were cautioned to be mum and wait.
به محض این که یک اسب پیدا کنم تو را فرمانده سواره نظام خواهم کرد.	I am going to make you a captain of cavalry directly we get within sight of a horse again.
با آهنگی در کمال سکونت و نظری در نهایت اطمینان	in so calm a tone, and with so steadfast a look
آنچه را که برای جنایتکار بودن لازم است نیز داشت.	he had all the requisites for a blackguard.
افکارش را رها کرد تا در پیوند با یکدیگر به سراغش بیایند.	let coherent thought gradually return.
با شتاب به طرف اتاق تلفن رفتم و در را بستم.	I went through the library to the little room beyond.
من با دست خالی با دشمنانم رو به رو خواهم شد.	I face mine enemies naked
این دفعه بنابر مصلحت آن را هم ارضا کردم و هم بر انگیختم.	for once, and from motives of expediency, I would e'en soothe and stimulate it.
به شکل مربعی که مساحت آن چهارده گره مربع بود محکم در زمین جای دادم.	fixing them firmly in the ground in a quadrangular figure, two feet and a half square.
این بود که با اطمینان صد قدم باقیمانده را شنا کرد.	so he struck out confidently to swim the remaining hundred yards.
آیه دیگری هم از کتاب مقدس یادم افتاد که باید برایت بخوانم.	here is another thing that now comes to me as some thing that I should say to you.
همراهش مردی است مسن با سر و وضعی ساده. او تمام مدت مهمانی را به بازی گنجفه گذرانی ده است.	with a plain elderly gentleman who has been playing whist all night
بجای آنکه به طرف هشتی عقب عمارت که کالسکه در آنجا بود برود	instead of going to the back entrance where his carriage awaited him
اونها فکر کرده ان که از کارخونه اخراج خواهی شد و همین را لازم داشتن.	thinking you'd be discharged, and it would serve you right!
در تهیه جوجه و بوقلمون و اردک برای اطای اشتهای تابستانی میهمانان و کودکان هیچ دردسر نداشت.	had no little trouble to get all the chickens, turkeys, and geese, of which so many were needed to satisfy the summer appetites of the visitors and children.
سعی کردم ازش بپرسم کی این کار و کرد	I tried to ask him who did it
از وی دور شد و با نشاط به گفتگو با دومین زن پرداخت.	she turned away from her, and began gaily talking to the other lady.
آرزوی رهایی از این درد و سرچشمه آن یعنی جسم.	the desire to be rid of all his sufferings and their source, the body.
فکورانه دستش را به سر طاسش کشید و ادامه داد	running a hand reflectively over his bald crown
کوشیدم با یک نیروی دقیق و موشکاف آنچه را در میان برهوت بی پایان و بی رد و نشان تخیل سرگردان بود به محدوده امن عقل سلیم هدایت کنم.	endeavoured to bring back with a strict hand such as had been straying through imagination's boundless and trackless waste, into the safe fold of common sense.
در یک دست کلاهش را نگاه داشته و با دست دیگر عصایش را محکم گرفته بود	he holding his hat in one hand, and his stick in the other
او پیش از آن هرگز به این موضوع توجه نکرده بود.	he had never quite noticed that before.
جزئیات بیشتری از این پروندة عجیب را در اختیارت بگذارم.	I cannot give you a more detailed account of this curious case.
هم او بود که پنج فرانکش را گرفته بود و اکنون دیگر برای باز ستادن آن پول بسیار دیر بود زیرا که تک اسبه از آنجا رفته و درشکه حامل مسی و لوبلان نیز بسیار دور شده بود.	it was she who had his five francs, it was too late to demand them back, the cab was no longer there, the fiacre was far away.
هدف ملامت ننمایید آنکه را بعد از این امیدوار است	for you surely would not wish to compromise one who from this day regards herself as destined, honorably and happily
اما این جانور کثیف هم در سایه رضایی که از کاخ زیر زمینیش دارد رام شده است.	but even these vermin grow tame, so satisfied are they with their subterranean palace.
بهتر آنست که نخست در بزنم بنابراین در زد	I'd better knock first, and he knocked.
همگان در پشت صحنه یعنی در گور یکسان خواهند شد.	all are equal in the grave.
به سرعت پایین رفت و خود را به چمدانش رساند.	dashed back downstairs to his trunk
در کنارش ناراحت است و نمیتواند مستقیماً به صورتش نگاه کند.	ill at ease with him, and could not look him straight in the face.
مورل حرف او را تمام کرد و گفت آن وقت من تمامم مسیو بالکلیه تمام	I am ruined completely ruined
اگر در پایان آن مدت به نزد وی بازنگشت	if he should not have returned by that time
کلیسای زردرنگ چون گلویی از نوای غمگین آواز پر شد.	the yellow church swelled like a throat with the sound of sad singing.
تو باید قبلاً مقدمات کار را فراهم کنی و ذهنش را برای ملاقات با من آماده سازی.	you must prepare her
با کمک و یاری یکدیگر این جنگ را بو جود آوردند.	that was happening or coincided with it.
من نقشه نداشتم که از تو سوء استفاده بکنم.	I didn't set out to use you.
به دیوار کنار در تکیه دادم و منتظر ماندم.	I leaned against the wall by the door, waiting.
مشاهده اینکه همه فضائل در آن قوم پاک نهاد مهربان جمع است	such a constellation of virtues, in such amiable persons
دانتس قدری مضطرب جواب داد که مشغول صرف غذا بودم در مجلس ولیمه برای عروسی مخصوص خودم	I was at the festival of my marriage monsieur said the young man his voice slightly tremulous
گویا عمویش و شاید پدرش بود که برای شرکت در مراسم تاج گذاری آمده بود.	he was her uncle perhaps, or perhaps her father, to attend the coronation.
به قدری تو را دوست دارم مثل اینکه یکی از خویشان من هستی.	I feel as if you were my property.
در بی صدا باز و آنگاه بسته شده بود.	the door having swung open and swung back again without noise.
دامن قبای خود را تا کمر بالا زد و به سرعت آهو در دشت پا به گریز نهاد.	he hastily hitched up his tunic under his girdle and took to his heels across the country like a deer.
در غیر این صورت قسم به خدا اسم من این نیست که حالا هست و دختر پدری که مرا به جهان آورده است نخواهم بود.	or my name is not what it is, and I am not my father's daughter.
هرچه از دستش برآید در حق او نیکی خواهد کرد.	he will do him all the good that lies in his power.
بوی اسپرسها با بی نمناک گچ راهرو درهم آمیخته بود.	the smell of sainfoin mixed up with the damp plastery smell that belonged to the passage.
جمع کل پنجاه و شش دلار و ده سنت	grand total, $56. 10.
اما پدر که چنین جواهر نفسیی در اختیارش داشت	but he, as one might well be who had the disposal of so rich a jewel
فقط وقتی که نور شمع را به بستر نزدیک کردند از آن خواب برخاست.	from which he was awakened by the light of a candle
بعد در حالت تفکر و جذبه نشاط آمیزی ساکت باقی ماند.	then remained absorbed in ecstatic contemplation.
متحیر بودم که چه پرتگاهی از ظلم باید پیش چشم خیال او گسترده شده باشدکه از وحشت دیگر مایل به زندگی نباشد.	I wondered what an abyss of cruelty she must have looked into that in horror she refused to live.
این که اتفاقات گوناگون چه طور او را به آن نقطه کشانده بود.	but irrevocable accidents that brought him to that point.
مدتی طول کشید تا مردم شهر بتوانند خود را با صدای تاپ تاپ موتور ژنراتور وفق دهند.	it took time and effort for them to grow accustomed to its obsessive toom toom.
در یکی دو سال اخیر وضع سیاسی کشتارگاه به علت ظهور ناگهانی یک حزب جدید رو بوخامت گرائیده است.	there had been a curious development in stockyards politics in the last year or two, a new party having leaped into being.
بدین گونه از مرگ حتمی در آب نجات یافته است.	so was saved from a watery doom.
من به وسایل و لوازم کار مجهزت کردم و فرستادمت که برایم الماس پیدا کنی.	I outfitted you and sent you to find diamonds for me.
چون همین حالا هم باید چیزی را نگه دارد.	because he was already carrying something.
خیلی از آن سنگ مرمر بالای سرت بهتر است.	better by far than that chunk of marble above your head.
در عوض منهم صلیبم را بت و خواهم داد.	I'll take it off at once.
ربرتا بر خود لرزیده و حیران شده بود که چگونه زنی است آن کس که در عین برخورداری از امنیت ازدواج و عشق شوهر	for a woman when she was safely married and sustained by the love and strength of a man
آخر تو فکرکن که ما اکنون در چه وضعی هستیم!	only think what a position we are in!
دو مسافر دیگر پشت سر او منتظر نوبت بودند.	the two other passengers were close behind him, and about to follow.
حال آنکه من با دو چشم خودم دیدم که سر بریده شده بود	though I saw it cut off with my own eyes
از مرزهای اصلی جز با بمب نباید عبور کرد.	the main frontiers must never be crossed by anything except bombs.
از دست هر که نخستین بار با وی روبرو شود سلاح پهلوانی برگیرد.	he made up his mind to have himself dubbed a knight by the first one he came across
اما تا هنگام فروکش کردن آن خوش نداشت مادرش را گریان ببیند	but in the mean time it was disagreeable to see his mother cry
دو گلدان چدنی در هر یک از دو طرف پلکان سرسرا قرار دارند.	two brass vases are at each end of a flight of steps
از طرز حرف زدنش فهمیدم که به تو خیلی علاقه دارد.	 I knew from the way he said it that he loved you
به قدری حواسم پرت بود فراموش کرده بودم از او بپرسم کجا قرار بوده به دوستانش ملحق شود.	I'd been too distracted to remember to ask her where she was supposed to meet her friends.
هنری قرار بود روز بعد برگردد تصمیم گرفت وقت تلف نکند.	who was expected on the morrow, there was no time to be lost.
من نیز انتقام خود را از کسی که دیگر آرزویش به دلم نیست نستانم.	I reap not a revenge I would not have.
اما او کلاه و روسری را بیشتر روی صورت خود کشید و باز هم به من اشاره کرد که بروم.	but she drew her bonnet and her bandage closer about her face, and again beckoned me to depart.
شنیدم که او این جمله را در تلفن گفت.	I heard him say it on the telephone.
در یک طرف قاب مذکور عکس مادرش و در روی دیگر عکس جوانی پدرش قرار داشت.	two pictures in a gold case, on one side her mother, and on the other uncle, when they were young.
اما نظم و ترتیبی در ین کار رعایت نشده بود.	but without any order.
در صورتی که همه به قدری مستند و به قدری واقعیند	which are so authentic and true, that
صدای اتومبیلی را شنیدم که به داخل جاده فرعی پیچید و جلو آمد.	 I heard a car pull into the driveway and straightened up.
هیچ چیز به این اندازه برای ما دردناک نبود	nothing distressed us so much
موجودی فانی که نام او در عنوان این فصل آمده	the item of mortality whose name is prefixed to the head of this chapter.
حتی اگر بچه برای یک لحظه ناراحتی کرده باشد.	if the child appeared in the slightest degree disordered, were it only for a moment.
ولی او مقاومت کرد و موفق شد آن خوش کذائی را بچشد.	but he struggled and succeeded in tasting the famous dish.
بدانید که من یک نوع قدرتی در این عالم دارم	to remember that I have some power in this world
که بر اسبان تناور نشسته و مسلح به نیزه و سپرند	riding a la jineta, with lances and bucklers
در این اعلان پانصد سکه صلا به کسی وعده داده شده که پدر کشی را با این مشخصات دستی گر کند.	offering five hundred gold coins for the apprehension of a parricide, and containing a description of his person.
اما چنان سقوط کردند که در یک لحظه دو تن از ایشان بار دیگر به کناره قایق چنگ زدند	but so fell, that, in an instant two of them clutched the gunwale again, and rising to its level on a combing wave
مضمون آن قشنگ و در عین حال احمقانه بود.	very pretty and very silly.
زیرا همه چیز کامل و پاک است جز انسان.	for all, all except man, is sinless
با تنفر رویش را برگرداند و به جانب دیگری معطوف کرد.	as it turned, in its aversion, elsewhere.
من و شوهرم با کمال میل حاضریم اتاق خود را در اختیار معظم له بگذاریم.	for my husband and I will give up our room to accommodate his worship.
شاهزاده خانم به تمنا از پهلوان بخواهد که هر چه ممکن است کمتر او را به فراق خویش مبتلا سازد.	the princess will entreat him to make his absence as short as possible
به خاطر همین هم خبر امروز برای ما خوشحالی مضاعفی داشت.	which makes this day's news doubly welcome.
داشتن یک برادر برایم از هر چیز دیگری مهم تر است.	having a brother matters to me more than anything else.
این صندوق روی سربخاری قرار گرفته بود و با آن فاصلة کمی داشت.	so immediately over the mantelshelf, that I wondered
آن وقت به کلی رشته الفت دیرین را از هم بگلسد.	to decline the honour of his farther acquaintance.
نیز نبودن آن عاطفهٔ ساده و پر توان که برای زنده بودن به دوست داشتن و صرف محبت سرشار خود نیاز دارد.	they lacked that puissant and naive sympathy whose vital need is of love, the need of giving out its overflowing love.
ملتفت شدم که داستان ما فقط یک سراب است و بس.	I realized that what is between us is nothing more than an illusion.
پس از ادای این سخنان افسار خر خود را گرفت و از اربابش خواهش کرد که به دنبالش برود.	driving his ass before him he begged his master to follow, who
از سکوهای متناوب تاریک در شب نازک به سرعت گذشتند	going fast through the alternating banks of darkness and thin night
چون هم پدر وهم مادرش بارها و بارها تأکید کرده بودند	since both his mother and father had so often emphasized that
همانند اینکه او یک دوست یا صاحب آن عمارت است	as if he had been a friend or the master of the place.
اما سرسختانه در کوره راه ناهموار و پیچان چندین مایل پیش رفتند.	but they trudged doggedly along the rough and winding track for many miles.
به این ترتیب بی آن که بیندیشد آداب اجتماعی خود را به دور ریخت .	thus shedding her company habits in a second, without thinking.
با تولید ثروتی که گاهی توزیع آن محال بود	by producing wealth which it was sometimes impossible not to distribute
با این حال از تأثیرش سخت خرسند و مغرور بود.	was still not a little pleased and impressed by the effect of it all.
می دونی چیه ژاکتش رو سر کار جا گذاشتم.	I think I left it at work.
لیکن چون دیدند که موسیقی بدل به ناله و مویه شد	but perceiving that the music had now turned to sobs and heart rending moans
به همین دلیل نیکول صدایش را بلندتر کرد و پرسید	so she raised her voice and called
خیلی خوشم او مد که اون طوری حریف اژدهاهه شدی!	the way you got past that dragon'well
مگر آنکه یا به او معذرت بگویید یا با او بر وفق قانون مبارزت نمایید.	without demanding honorable reparation
من بیش تر از آنچه اکثریت مردم تا به حال تجربه کرده بودند شاد بودم.	I'd had more happiness than most people ever experienced.
حالا به صورت اجسادی در آمده بودند چنان سخت و سرد و کبود که هرگز امکان نداشت بار دیگر جان بگیرند.	they lay stark, chill, livid corpses that could never revive.
متظر نبودم در این موقع مهمانی سرزده به ماند رلی بیاید به این دلیل بیرون آمدم تا ببینم کیست.	I did not expect any callers this afternoon.'I was not quite sure who it was.
به منظور تأمین نیک بختی آنان وجود داشته است.	so as to make them happy.
بدتر آنکه گروهی نادان هستند که مدعیند تنها این گونه نوشته کامل است	the worst of it is, there are ignorant people who say that this is perfection
ولو ظاهرا از آن فرزند خطائی سر زده باشد.	however dreadhis erring ways might seem?
چاقوی ملوانی خود را بیرون آورد و آن را باز کرد	drew and opened a sailor's clasp knife
من نفس غیر ضروری ای کشیدم تا خودم را جمع و جور کنم.	I took an unnecessary breath to settle myself.
من برای این قبیل مباحثات نه وقت دارم و نه انرژی کافی.	I have neither leisure nor energy for this kind of debate.
که با میزانی از خوش خدمتی که در هیچ سیاره دیگری سابقه ندارد	who with a degree of footmanism quite unprecedented in other planets
حالا تبدیل به یک واقعیت تلخ عینی شده بود.	became a concrete and dramatic reality.
دامن چین چین خود را تا زانو بالا گرفته بود تا به زمین مالیده نشود.	her ruffled skirt raised to keep it from dragging on the floor.
مرگ بسی زودتر خود را در دسترس گذاشته است.	death is sooner over with.
او را پسرهٔ جعلق خواندند و از او خواستند که گورش را گم کند.	he was called a snotty little kid, and told to go to bed.
به این ترتیب به پرسش اول از سه پرسش او پاسخ داد.	answering the first part of her tirade.
ساعتی درنگ کردم تا جزر و مد دریا اندکی فرو نشست.	waiting about an hour, till the tide was a little fallen
نازک اندیش تر از آن بود که حد و اندازهٔ خود رانشناسد.	she had too much tact, and knew her limitations.
روی زمین هنوز از برف چند روز پیش اندکی باقی مانده بود.	a sprinkling of snow covered the ground
روت خندان گفت این یکی را فراموش کرده بودم.	I'd forgotten that, she laughed.
خودتان از درستی و عمق فکری که اظهار داشتید آگاه نیستید.	you do not realize how profound is your thought, nor how true.
به این ترتیب اسم دومشان. دیگر شباهت بسیار به اسم اولشان نداشت.	so that the second name bore almost as much resemblance as thefirst.
عروسکی که فراموش شده در اتاق خواب افتاده بود.	now relegated forgotten to the bedroom.
به آن راه چمن زار رسید که تقریبا تپه را دور میزند	reached that turf alley which nearly makes the circuit ofthe hill
من تفصیلات را به شما میگویم تا خیالتان راحت باشد.	I give you these details, in order that your mind may be set at rest.
فکر کنم که بهتر با شه به گم در تجارت کمکش کردم .	set her up in business' is the correct term, I believe.
ژان وال ژان به نظر آورد که ممکن است خفتن در شب سرد در هوای آزاد منجر به هلاکت شود.	jean valjean remembered thatsleep in the open air on a cold night may be fatal.
این بنا نیز همچون برج و باروی فیلسوفان فرو ریخت.	this edifice crumbled into dust like the philosophers' edifices.
تا دوشی بگیرد و به او لباس دادم تا بپوشد.	for a shower and got her a change of clothes.
که ممکن نیست بتوان خصایل او را به وصف آورد.	that it's hardly possible to give him as much praise as he deserves.
لکن آنچه در اینجا اهمیت دارد اصل موضوع است و هرگاه صد و پنجاه روبل کم است این یک امر جزئی و فرعی است.	but in this case the principle is the main point, and that a hundred and fifty roubles are missing is only a side issue.
تلألؤ آن گویی سراسر آینده لایدگیت را با آفتابی ملایم روشن ساخت.	the radiance seemed to light up all his future with mild sunshine.
آنگاه وطن پرست از عیب مبرایی که از او نام رفته بود در محل شهود ظاهر شد.	the unimpeachable patriot appeared in the witness box.
در میعادگاه دیرین به دیدار یار نازنین نایل آید	sees his lady where he was wont to see her
برخلاف زن ای دی گه در مورد خودش حرف نزد.	with never a word to say for herself, like a woman should be.
میدان گرفته و نظر همه را جلب کرده بودم.	I was their chief exponent
سپس برای یک سال و شاید برای ابد در ظلمت فرو رود.	then lapse into darkness for a year or for ever.
در حالی که تفنگ را در دست داشت بیرون آمد	left it his gun in his hand
چون دیدم که بهتر از ین کاری برایم میسر نیست عاقبت به رفتن رضا دادم	I complied at last, finding I could not do better.
دیگر لازم ندیدم زحمتی به خود داده و برای دیگران تحصیل مال نمایم.	I will not be the foundation of another man's fortune.
فقط دخالت فوری و بلادرنگ یک باغبان بود که او را نجات داد.	it was only the prompt intervention of a gardener that saved her.
من از ساعت هشت و نیم در اینجا بودم	I had waited since half past eight
همسر خودش ایمانی کودکانه چون باور خود او در زمان خردسالی داشت	his wife believed as simply as he had believed in his earliest childhood
زیاده از حد دل به این استنتاج داده بود که مادرش خود مسؤول این ویرانی عظیم است.	too busy resenting the inference that she herself had made just as big a mess of things.
سخت مراقب خود بود که مبادا تیری خائنانه به رویش خالی کنند	keeping himself carefully out of the way of a treacherous shot, should any be intended.
دو تن دیگر هر یک در طرفین او مطابق مرسوم برای ملازمت ایستاده بودند.	the other two stood one on each side to support him.
اما این موارد نادر و ناچیز بود و در باور او داستانش به آخر آمده بود.	but they were few and slight, and she believed them over.
میل دارد به جایی که امکان دیدن او هست به مهمانی شام برود.	is willing to dine where he may see her again.
اما فریت که نگاهش متوجه دست من شده بود با تعجب پرسید.	but I saw him glance at my hand in surprise.
امید داشتم که پس از دویست سال بتوانم توانگرترین مردم کشور باشم.	I might reasonably expect, in about two hundred years, to be the wealthiest man in the kingdom.
فرضیة تو را دربارة این قضیه به خاطر آوردم	I remembered your theory of the affair
باور کنید هرکس قبلاً این بانو را دیده باشد و حالا باز او را ببیند دلش ریش خواهد شد.	his heart rend in twain, I trow, who saw her once, to see her now.
اما مری به چابکی از کنارش گریخت و به سمت در رفت.	but she slipped away quickly towards the door and said
چند بار از آن فتوکپی بگیر تا رد تغییر نام شرکت استخدام کننده از بین برود	have it photocopied to hide the traces of the change of name of the employing company
در همان لحظه متر بر روی زمین افتاد و به دور خود پیچید.	the tape measure crumpled into a heap on the floor.
هرلحظه فکر می کرد مالان است که آن را با زور باز کنند.	at any moment I thought they would burst it open.
من خودم هم استعدادم در یادگیری زبان خوب است	I, too, have a talent for languages.
او پس از اینکه از سر مهر شکوه و گله آغاز کرد خواهشم را به لطف پذیرفت.	after some kind expostulations, he was pleased to grant.
به همان اندازه ناممکن بود که کسی کودکی را که در آغوش دارد به زمین بی اندازد.	as impossible as to fling down a child one is carrying in one's arms.
برشتوکی را که برای صبحانه خورده بود بالا آورد	he lost the cornflakes he had eaten for breakfast
از آن پس دیگر به هیچ وجه مأذون نیستند که بار دوم هم آن را بیازمایند.	that therefore they need not try it again.
کالسکه از ساعت ده در کنار خیابان منتظر بود.	it has been waiting round the corner there since ten o'clock.
اما حالا عصبانی تر از آن است که به این قضیه فکر کند.	but she's too mad to think of it now.
تصمیم گرفت قیمت نیم تنه را به جای صد و پانزده دلار صد و بیست و پنج دلار اعلام کند.	she decided to say that it cost one hundred and twenty five instead of one hundred and fifteen.
ولی این چند سطر برای آن که موجب قبولی او شود کافی نبود.	but it was not enough to place him.
عادلانه است که شوهرش پول ثابتی در طول حیاتش در اختیار ویل بگذارد و	he should find himself in possession of a rightful income which should be paid by her husband during his life
طول آن قریب به شش گز و نیم و عرض آن نزدیک سه گز و نیم بود.	was about seven feet long, and four wide, moving upon.
زیرا که در درهای بزرگی که وسیله گذشتن از یک مربع به مربع دیگرست هرکدام به بلندی هیجده و به پهنای هفت بند انگشت است.	for the great gates, from one square into another, were but eighteen inches high, and seven inches wide.
باید راجع به موضوع جدی و دردناکی با شما مشورت کنم.	I must talk with you of a grave and painful subject.
که اگر تو او را بجا بگذاری او جان خود را بر این ساحل خلوت بجا خواهد گذاشت.	who will yield up his life on this barren strand if thou dost leave him.
حالا که قرار بود نگهبانان در اطراف مدرسه مستقر شوند	if they were stationed all around the school
اگر بروی من تمام شب را نگران و ناراحت خواهم بود و نباید راضی شوی که برای خاطر تو هم ناراحت بشوم!	I should be miserable all night, and I won't be miserable for you!
بعدها توانستند ک قایق دو پهلوی بزرگ جنگی را از وحشیان جزیره بگیرند	eventually, as it turned out, seizing a large double war canoe of the savages
زیرا من جمعیت کشورمان را با حساب کردن شماره پیروان چندین حزب سیاسی و فرقه مذهبی برآورده بودم.	in reckoning the numbers of our people, by a computation drawn from the several sects among us, in religion and politics.
بعد یک تکه از بال طیاره روی درختی در همان حوالی افتاد	left a piece of wing in a nearby tree
آرزوی سردوشی و صلیب افتخار و عنوان و مقام به دلش راه یافت.	he longed for epaulettes, crosses, titles.
که حتی جرأت ندارد این تقاضا را به کنت عرضه کند.	that he dare not even mention the matter to the count.
به فاصلهٔ یک ساعت همهٔ اسرار خود را با هم در میان نهادند.	after an hour they told each other all their secrets.
آن را در هوا حرکتی داد و بعد نگاه داشت.	poised and switched in the air.
حاضرم این وال مرده را یک لقمه کنم اگر دروغ بگویم.	I'll eat this whale in one mouthful.
طیور و حتی دام و کل اعضای خانواده کشاورز اجاره کار را پناه داده بود.	the fowls, and even the cattle, together with the whole family of the tenant farmer.
که بر آن بودم که همه چیز را فدای آن کنم.	that I determined upon sacrificing every thing to it.
سپس با لاقیدی از آنچه سر شب گذشته بود پرسید.	then asked carelessly what had happened that evening.
به زیر آب فرو رفته و سرانجام توانسته بود دوربین را بیرون بیاورد.	finally succeeded in bringing up a camera.
در آنجا مادیانی زیبا با دو کره نر و ماده دیدم که روی بوریا چم بک زده بودند	where I saw a very comely mare, together with a colt and foal, sitting on their haunches upon mats of straw
با اینکه هیچ یک از جای خود تکان نخورد	though none of them started
همین موجب شد که در دربار امپراطور برتری بسیار حاصل کنم.	which was represented very much to my advantage at court.
ولی به طور کلی باعث تغییر زیادی نمی شن	but it doesn't make any real difference
اما این لرزش از سرما نبود بلکه از نفرت و وحشت نامفهومی بود	not from cold but from a sense of disgust and horror he did not himself understand
چنانکه گویی هرگز گامی که به ن بینجامد یا انجامی دن به آن را بازدارد برداشته نشده است.	as if nothing had ever been done, or omitted to be done, that had led to it
دی گه می تونی آهسته آهسته به درمانگاه بری	just toddle up to the hospital wing
من خودم هیچ دوست ندارم جاهای دیگر شهر زندگی کنیم.	I should be unwilling, I own, to live in any other part of the town.
اما هنوز به پهلوی کشتی خود برسیده بود که فریاد وال!	but he had not gained his ship's side
نه.راضی هستم که صد بار بمیرم و چنین کاری را نکنم.	I would rather die a hundred times oh, yes, die!
هیچ یکی تا فیصله یافتن قطعی این مسئله نمی توانستند کام لا آرام بگیرند.	there was no real relief now until this problem should be definitely solved.
به عینه مثل آن است که قطره به دریا برده شود	no more than a drop of water in the ocean
دست چاقش را به سوی خانم می سون خیالی دراز کرد.	offering his fat arm to an invisible woman.
روی میزی که تازه خالی شده و پزشک یار آن را شسته بود گذاشتند.	laid on a table that had only just been cleared and which a dresser was washing down.
درمیان جانوران چگونه یکی در نیرو از او برترست و دیگری در تک و پو و این یک در تیزبینی و آن دیگر در کار و کوشش.	how much he was excelled by one creature in strength, by another in speed, by a third in foresight, by a fourth in industry.
خاله جانش در دل پیش او زانو زده است.	in her heart his aunt was on her knees to him
در کنار کارهای دیگرش به آزمایش تولید برق از طریق شیمیایی مشغول بود	just at the time when, over and above his other work, he was occupied with some galvanic experiments.
اما اگر روزی خودم به این خاطر خواستم ازدواج کنم	but when I am in need of that, I hope some one will tell me so
به علت پرده ضخیمی که وسط معبد آویخته بود ببیند.	because of the serge curtain
همان افسر سابق که پنج سال پیش وی را ترک گفته بود.	the one who threw her over five years ago,
کار ما غارت کاروان و ماسک گذاشتن و کشتن مردم و دزدیدن ساعت و پول مسافری نه.	with masks on, and kill the people and take their watches and money.
از پنجره خارج شد و از نظر ناپدید گشت.	it zoomed out of the window and out of sight.
برای روحی که از میان ما پر کشیده است	for the soul of the departed
هر چند در این اواخر مدل موی او افتضاح بود.	even if her last haircut was a bit severe.
ولی وقتی که تودهٔ مردم را در برابر خود داشت از چنین کاری عاجز بود.	but when he found himself face to face with the people, he was impotent to do anything, in spite of his good will.
از بیست و سه یا بیست و چهار سالگی امکان پذیرد.	than the age of twenty three or twenty four years.
را که بیشتر از همه در هلاک پدرم سعی کرده بود.	who had more than any contributed to the death of my father,
برکه دارای آبی شفاف و روشن و عمیق بود.	pool was very clear water and immensely deep.
که من او را چون یک پدر تربیت کردم	whom I have brought up with the love of a father
لیکن به این استناد نباید چنین پنداشت که لازم نیست پهلوانان سرگردان به همراه خود پول داشته باشند.	it was not to be supposed therefore that they did not carry them
یک روز ظهر یکی از نگهبانان شب پیش او آمد	there had come to him one noontime a man who was employed as a night watchman
زیرا از هنگامی که مرا زندانی کرده بودند چند تن از ملاحان مرده بودند.	several among them having died since my confinement.
جواب داد که برای قضاوت دربارة هر کس باید شخصاً و از نزدیک او را دید و شناخت.	he answered that one could never judge of a man without seeing him close, for oneself,
چگونه ترتیب داده تا خودش در اتاق رخت کن مخفی کند	how he had arranged to hide himself in the closet
زیرا در آن هنگام که پای جان خودشان در میان است	when their own skins were in danger
برای اثبات کاردانی و دوراندیشی و نبوغ این دو سردار جنگی محیلانه دلایل مجعولی اقامه کردند	the historians provided cunningly devised evidence of the foresight and genius the generals who
در را گشود و مادام بواری را مثل یکی از آشنایان خانواده به اتاق ناهارخوری هدایت کرد.	he came to open the door almost familiarly, as to an acquaintance, and showed her into the dining room.
که خودش هم از این دگرگونی به حیرت افتاد.	that had characterized him that even now he was ,not a little impressed by the difference
ولی تو نباید این کار را بکنی و او را نگران کنی.	I dare say, but you ought not to go and worry him.
آن را به دست گرفته و از درون آن به طرف کشتی نگاه کردم.	I took his glasses and looked at the ship.
علیا حضرت در مدت بیماری چندین بار از من عیادت کرد.	her majesty made me several visits during my sickness.
از این پس من کنیز تو خواهم بود کنیز تو تا پایان عمر.	I'll be your slave now, your slave for the rest of my life.
محتضر به وضع باشکوهی که نتیجه انجام تشریفات مذهبی بود	on which the sick man had been laid in a stately pose in keeping with the ceremony just completed.
جوف تو را کاویدم و آنچه ناشایست و بد بود از تو بیرون آورده و دور افکندم.	I have dug deep into thy very entrails to root out evil thence.
از هریت هم خواسته بودند تا آن موقع پیششان بماند تا با هم برگردند.	she was invited to remain till they could bring her back.
باید از تمام اخبار دست اول مطلع به شم.	I must know from first handall there is to know.
که همسرش به طور غریزی از این امر آگاه است	that she was instinctively aware of this
سپس علف آبشش زا را از دست دابی قاپید و در جیب ردایش گذاشت.	grabbed the gillyweed, and put it into his pocket
آن وقت با شمع علامتی گذاشتند برای راهنمایی آینده گان.	they made a smoke mark for future guidance
بلافاصله صدایش در فضای روی سطح دریاچه طنین افکند و به جایگاه تماشاگران رسید.	his voice boomed out across the dark water toward the stands.
اما نهایتا با ایقان و طمانینهء لازم سر از خواب برداشت.	but awoke gradually and surely.
اما از بیزاری و تنفر خود به شاهزاده به هیچ وجه آگاهی نداشت	with a sense of antipathy to the old prince which
که دیگر از شراب مطلوب موجود نیست در گوشش گفت که دیگر مهمات وجود ندارد.	as a butler at dinner informs his master that there is no more of some wine asked for that there were no more charges.
ده نفر بودند. بالای عرشه بیست نفری تا آن موقع بی طرف مانده بودند.	ten in number leaving on deck some twenty or more, who thus far had remained neutral.
هرکدام یک لنگه از کفهاشان را در بخاری نهاده بودند.	each of them had set one of her shoes on the hearth.
فعلاً به خورجینت نگاه کن و ببین اگر چیزی برای خوردن داری بیاور تا بخوریم	see if thou hast anything for us to eat in those alforjas
شراب میخورن.غوغایی به پا میکنن و از چپ و راست مردمو ماچ میکنن.	drinkin' and raisin' hell and screwin' around.
آرزو کرد که از این بلاها سر خودش نیاید.	hoped nothing like that ever happened to her.
ده دقیقه دیگر بقیه نان و شیر را به او بده.	in ten minutes more, give her the remainder of that milk and bread.
فقط فکر کردم شاید بخوای موقع غذا خوردن اطراف آرنجت آزاد با شه	I just thought you'd like some elbow room while you ate.
هرگاه یک مداد و یک قطعه کاغذ وجود داشت ممکن بود حساب آن را رسید.	I haven't got a pencil and paper or I could work it out.
جوان بلافاصله افراد دسته خود را رده بندی کرد و به رقص واداشت	he at once began to execute complicated figures with the rest of his comrades
کمترین شکی ندارم که هنوز به این خیال پشت گرم است که محال است	I have no doubt that he still has some comforting thoughts to the effect
بعد هم به اتاقی رفتند که قرار بود اتاق پذیرایی باشد.	afterwards into what was to be the drawing room
به یاد آورد که نا دین دفتر را دوباره زیرسنگ شومینه گذاشته بود.	remembering that she had put the ledger back under the hearthstone.
به احتمال زیاد همه چیز تا امشب موقع خواب روشن شده است.	I shall be very much surprised if it is not clear enough before we go to bed this night.
مسلم است که مقدرات من در دست شما قرار دارد.	I rest all my hopes on you, and, of course, my whole life is in your hands.
که تاکنون اطلاع از او ندارد به صدای بلند بخواند و مضطرب نشود.	which had hitherto been a mystery
در این صورت جهتی از آسایش و نیکبختی ابتدایی را یافته بود.	he would have found one of the conditions of man's primitive blessedness.
اقوام و کسان خود را مردمی حریص و طماع و فاقد احساسات بشری جلوه داد و خود را نیز چنان عاقل و دانا شناساند	made his relations appear covetous and heartless, and himself so rational
یعنی کاری که آن قدرها هم برایش مشکل نبود.	a task which she seldom found difficult.
من رو هم سوار کرد و رس وند خو نه .	he gave me a lift home.
متاسف تر از او نم که بتونم بهت به گم .	I am more sorry than I can tell you.
اما این کیفیت پیش افتاد و آن مطلب از میانه رفت	when your majesty's attention was attracted by the terrible event that has occurred in the gulf
من بر استی افراد بشر را دوست دارم. آه!	I love men genuinely
بر اثر اتفاق سعادت آمیزی اگر ذکر این کلمه در این مورد ممکن باشد	by some happychance, if that word is permissible here
با اشخاصی که آنجا جمعند از اشخاص صاحب شأن.	with that little group of great geniuses
مدتی دراز دست زنش را فشرد و لبخند زنان او را در کالسکه نشاند.	with a long pressure of her hand and a meaning smile, he put her in her carriage.
زمین آسایشگاه بیشتر از 5 تا 10 هکتار نبود.	the grounds of the loony bin weren't likely to be more than five or ten.
کار راندن گاری و تحویل الوارها به مشتریان را به او سپرد	put him to driving a lumber wagon
اگر دامن قباتان را بگیرد پای تا سرتان را در کام خواهد کشید.	if it catches hold of the skirt of your coat, you will be drawn in bodily.
قبل از رفتن به اتاق بیمار افکار خود را منظم کند.	to arrange her thoughts before going to her father.
درست به سخنان من گوش دهید زیرا ممکن است بار دیگر دچار اشتباه شوم.	follow me carefully, or I may get confused again
سعی کردم طوری وانمود کنم که هیچ چیز بدتر از آن دردنیا وجود ندارد.	I tried to look as though, to my mind, there was nothing worse in the world than that.
بعد هم بدون این که خم به ابرو بیاورد دستور اضافه شده را شنید	also received with indifference the added cruelty of a command
مطمئن نبودم که چه جوابی برای این سوال دارم.	I wasn't sure I knew.
آن جناب به یکی از خادمان خود که اسبی کرند و نیرومند و بسیار امین و نیک نهاد بود فرمان داده بود که پاسدار من باشد	his honour ordered one of his servants, a strong sorrel nag, very honest and good natured, to be my guard
هر یک به اندازه ارزش یک سر تیر یا یکی دو میخ یا پایه الوار از کشتی مالک بود.	each owning about the value of a timber head, or a foot of plank, or a nail or two in the ship.
که بسی شتاب و عجله دارم از برای آموختن علوم	I am in a hurry to begin
اگر چه این زبان با زبان مردم آن جزیره تفاوت داشت.	although it was different from that of this island.
چون اگر او را به حال خودش بگذاریم طبیعت مطمئناً بهتر از هر طبیب و دارویی عمل خواهد کرد.	nature, he was sure, would manage best, left to herself.
بهتر است به رغم میل خودت هم که شده کمی بیشتر بمانی.	you would stay a little longer than you might wish.
متوجه شد که بر پیشانیش عرق سرد نشسته است.	he felt cold sweat on his face.
در روی روپوش مخملی مطرز که روی میزی زراندود	on the velvet cloth embroidered with gold
حل شده و تردید در صحت این تصمیم به مثابه ابراز حماقت و معرف عدم لیاقت برای زندگی در میان اشراف و طبقات ممتازهاست.	to doubt the correctness of that decision would be to risk exposing one's stupidity and incapacity to live in society.
چندین بار نیز مرا مجبور کرد به همراهش تا نزدیک در باغ بروم تا از مسافران استقبال کنیم.	she obliged me, by constant worrying, to walk with her down through the grounds to meet them.
یادم است که در یک شب پول کلانی باخت	I distinctly remember that in a single evening she lost an enormous sum.
به آرامی کنار هم در زیر یک تخته سنگ به خاک سپرده شدند	laid quietly side by side under one slab.
در وسط میزی قرار داشت که به روی آن چند سبد خالی گل گذارده بودند.	there were basket chairs stacked against the wall
اما با یک تکان روی نیمکت نشست و چشمانش را باز کرد.	but all at once he jumped up, sat up on the sofa, and opened his eyes.
همه خوش و خرم و کامیاب به اتاق نشیمن بازگشتیم.	we went down to the drawing room again, well pleased and gratified.
اگر به واسطه آن خصایص که در وال شمردیم و نیز به واسطه صدها رویداد ملازم چنان شغل خطیری است	as well as to the thousand concurring accidents of such an audacious enterprise
انگار میخو است آن را در بدن زن فرو کند.	as if to plunge it into her.
دم دمای آخر دیگر نای حرف زدن هم نداشت.	at the end, almost too weak to speak
بالاخره مردی که دفعه اول ظاهر شده بود قبول کرد که پیغام او را برساند.	the result was that the man who had first appeared undertook its delivery.
محصور شده بین مرز تاریکی و نوری که پیاده رو را در بر داشت.	fenced in by the line between dark and light that stretched across the sidewalk in front of me.
با این عمل یکی دو تنی را نفله کند.	crush a man or two below.
یا شادی شغالی که به دریدن گاو میش بیماری پرداخته باشد و آن گاو میش آنقدر مرده باشد که از خود دفاع نکند	the joy of a jackal which is beginning to rend a sick bull, so nearly dead that he can no longer defend himself
اما گرگ فقط از گوشه چشم نگاه سریعی به او انداخت	but the wolf turned its head to face her
تصور کردم که در لحن کلامش اندک اثری از کلافگی بود.	I fancied there was in his tone a slight note of exasperation.
شاید به این دلیل بود که مرا نشناخت یا مقصود مرا نفهمید.	I don't think she knew who I was.
قبل از اینکه شما بتوانید سالن را طی کنید و خود را به من برسانید	before you can come across the room to get it.
ظرف بزرگی پر از خوراک قلوه و جگر کپک زده	there was a great maggoty haggis
زیرا بی رحمیش خبر داشت ولی باز هم او را نگه داشته بود.	, for she had kept him in charge after learning of his brutalities.
که مرگ وارد آن خانه شده و منسوباتش را گرفتار کرده است	that death had suddenly and unexpectedly entered that house
شکی نیست که باید حمله از راه دریا صورت گرفته ومستقیما از دریا بر خود کاخ وارد آید.	there is no doubt the attack must be from the sea, and launched directly from the sea at the palace itself.
من اجازه نمی دم بیشتر از این برای بچه تعریف کنی.	I forbid you to tell the boy anything!
ناگهان به طور مطبوع و انامطبوعی بر وی چیره ساخت	suddenly affected her both agreeably and disagreeably
در واقع در بین این گروه به حرف مادرش اعتقاد نداشت.	she did not feel that way here.
نژاد آن بومیان به خباثت و زرنگی شهرت دارد	a race notorious for a certain diabolism of subtilty
اما چون روح حیوانات خالص نیست توی بدنش ون راحت نبودم.	but I was little better off inside them than as pure spirit
هرمیون بدون آن که حرف دیگری بزند با عجله به سوی خوابگاه دخترها رفت.	she swept off toward the girls' staircase without another word.
چند نفر دیگر هم هنوز در خرید مردد بودند.	more of the listeners plainly hesitated.
هشت یا ده آهن دوم در آن واحد گرداگرد وال در آب شناور باشند.	eight or ten loose second irons may be simultaneously dangling about him.
به آنان اطمینان داد که جناب دیوان بیگی همان برادر او است.	assuring them that the judge was his brother.
زیرا همان نیرو که از آغاز مرا واداشت تا تو را از آن خود کنم	for the same cause and force that drove me to make you mine
به هیچ قیمتی حاضر نبود با ایشان بدی کند.	no power on earth could have made her do anything to hurt them.
احساس کردم که باید از این هوای بهاری استفاده کنم.	I felt I'd got to get out and have a smell at the spring air
وصف طرز بیان عاری از احساس او در گفتن این جمله از من ساخته نیست.	I cannot describe the extraordinary callousness with which he made this reply.
معنا و مفهومی که باید همچون آب زاید هرز ناپدید شود.	a significance which is to vanish as the waters
دخترک از روی شفقت هم که شده نگاهی به او نینداخت.	who did not even respond with a charitable glance.
قادر نبودم که برای مدتی طولانی او را نزدیک خودم نگه دارم.	I wouldn't be able to stand being close to her for very long.
که مادر کروسیفیکسون طبق آرزوی خودش در تابوتش زیر محراب ما دفن شود.	have decided that MotherCrucifixion shall be buried, according to her wish, in her own coffin,under our altar.
سرانجام دیگر تاب نیاورد و خواست سرکشی آغاز کند.	finally he could stand it no more, and tried to revolt against it.
دهانش به یکی پاسخ نی گفت و نگاهش بدی گری.	her mouth replied to one, and her glance replied to another.
بلکه واقعیتی است که در حال حاضر وجود دارد.	but an immediate reality.
به خاطر خودش و از فرط غرور و تحریک عصبی بود.	by a diffusion of egotism, of nervous irritation.
همان انحطاطی که در هر عصر و زمان به حق مایه شکایت آدمیان شده است.	so justly complained of in all ages.
دستور داد از مدیر بیمارستان تقاضا شود که از راه لطف تا خانه او آید.	he had the director requested to be so good as to come to his house.
چون هیچ لذتی در کشتن یک حیوان بی احساس وجود ندارد.	there would be no satisfaction in killing a senseless animal.
در ضمن حاضر نبود از دیناری از طلب خود نیز چشم بپوشد.	it was obstinately unwilling to be content with less.
با انگشتم به او اشاره کردم که به من ملحق شود.	I motioned with my finger for her to join me.
بلکه خود گوسفند است. مثل اینکه خیال دارد داخل کلیسا شود و عذر گناه بخواهد و به راه راست هدایت شود.	but mutton half making up his mind to come into the church.
که تو می خو ای با من به مهمونی رقص بهاره بیای	if you would go to the spring dance with me?
حالا اهمیتی ندارد این دیدار چندان هم مهم نبود.	it is no matter I need not recall when.
نه برای اینکه پسری پدرش را به قتل رسانیده است من با این امر موافق نیستم	not better that a son should have killed his father, I don't defend that.
گفت که با کمال میل حاضر است حرکت کند.	said, somewhat hastily, that he was ready.
نشستیم در سکوت مطلق به کشیدن سیگار برگ پرداختیم.	sat smoking cigarettes without making the least sound.
چون به اندازهء کافی گرفتاری جواب دادن به این آقا را داری.	you'll have trouble enough with giving your attention to that gentleman.
طبیعت به من یک قلب خوب و بانشاط ارزانی داشته است.	I have naturally a kind and merry heart.
اما مهارتشان در ین بیش از آنست که نخستین بار دیده و گمان برده بودم.	this with greater dexterity than I could at first imagine.
دو برگ کاغذ را که تا کرده بود به دستش داد.	handed over the sheets of paper, folded small.
پس از اینکه مدتی با صاحب مهمان سرا مشورت کرد	after consulting awhile with the inn keeper
در حالی که باید چند ساعت پیش به خواب رفته باشند.	when they ought to have been asleep hours ago.
دیگران نیز هر یک دلایلی بر دلایل کشیش افزودند	they added to these such other forcible arguments
چند نفری را در راه رضای خدا بکشد من هیچ حرفی ندارم.	kill a few people for charity I have no objection.
فقط فکر کردم شاید بهتر باشد گفت و گویی با هم داشته باشیم.	I just thought we might have a talk.
انتظار داشتیم که به زودی از خط آهن عبور کنیم.	expecting in a little to cross the line.
از ین گذشته من نه تنها از نعمت قوه نطق و بیان برخوردارم	besides I was not only endowed with the faculty of speech
از زنجیر کندی که به چرخ زده بودند آویزان بود.	he swung by the chain of the shoe'the drag.
اما گاهی در مسائل بسیار ساده هم تحملی نداشت.	sometimes a little intolerant of easy going things and people.
که بازوی اولین راننده از جا در رفته بود.	that it had dislocated the shoulder of the first driver.
نیمی از صورتش پشت موهای صاف پنهان بود و نیمی دیگر پشت عینک ته استکانی مروارید نشانش.	half hidden behind lank hair and thick, pearly spectacles.
من با هشتاد و پنج کو پک سسی درست کردم که همگی پسندیدند.	I made them sauce for eighteen pence, and everybody was very much pleased with it.
او با ایشان تندی کرده بود و یا آنان کوشیده بودند او را فریب دهند	some whom he had treated with contumely, and who had tried to cheat him,
خوشحال بودم که از دست آن اندرزگوی پیر خلاص شدم.	glad to quit my gloomy monitress.
در نتیجه وقت برای گشت و گذار من مناسب بود.	so that the time was propitious for my excursion.
کنت و رکاب دارش چند لحظه خاموش گوش فراداده بود	the count and his attendant convinced themselves
فشار این محاکمه خاص بسیاری از کارهای آنان را عقب انداخته بود.	with many matters waiting on account of the pressure of this particular case
ناگهان فکری به ذهنم رسید و بعد هم نتوانستم از این فکر بیرون بیایم.	a suspicion darted into my head, and I have never been able to get it out again.
که برای ابراز خوشبختی خود کسی را بهتر از همسر و خواهر زن سویاژسکی نمیداند	it occurred to him that there was no one to whom he could more suitably speak of his happiness,
از لطف شماست که دوباره آزاد هستم و خوشحال.	I am free and happy once more, thanks to you, she said.
رقاصان حرکاتی چنان عجیب کردند و چندان مهارت و تردستی از خود نشان دادند	with so many turns and so great dexterity
مانعی در این راه به وجود نیاورد از هم امروز او زن من خواهد شد.	offers no impediment, this very day she shall become my wife.
ضم نا بدگمان شده و بیمناک بود که مبادا این مرد به او نا رو بزند.	she suspected and feared that this defendantwould fail her.
از تنفس هوایی که تازه آن زن با عطر خودش آن را تقدیس کرده بود خوشحال بودم.	happy to breathe the air consecrated so lately by her presence.
اما شما حتی در این مورد استثنائی جرئت نکردید مرا بزنید.	but you, even in an exceptional case, did not dare.
منظورم این است که هر چند او از نظر من نامزدی عجیب و بی نقص نبود	I mean, as if he wasn't already the perfect boyfriend
دوقلوها به زور بلوز بافتنی را تن پرسی کردند	as the twins forced the sweater over his head
درخشندگی نشاط انگیز روز پاییزی با خبر پیروزی موافق و سازگار بود.	the cheerful glitter of that autumn day was in keeping with the news of victory which was conveyed
اگه کسی تورو نشناسه فکر می کنه از مهم ون گریزونی.	one would almost think you didn't want visitors.
اما شما حالا یک خان وم جوان هست ین و به یک مستخدم خوب احتیاج دار ین.	but you a young lady now and needs a good maid
ولی در پایان آن با مداد شرحی نوشته شده بود که حاکی از عذرخواهی ایزابلا و تمنای بخشایش و آشتی از جانب وی بود.	but at the bottom was dotted in with pencil an obscure apology, and an entreaty for kind remembrance and reconciliation
سرت را از روی شانهء او برندار تا من بیایم.	don't move your pretty head from his shoulder as you have it now, till you see me again!
سعی کردند به عقب برگردند و خودشان را به میدان کوچک برسانند.	tried to go back to the small square
اما پر آشکار بود که از مرگ وحشت دارد.	but it was clear that he looked upon death with horror.
در آنجا من شمشیرم را که سراپا خون آلود بود به او بنمودم و با دامن قبا خون از آن ستردم و در نیام کردم.	where I showed her my hanger all bloody, and wiping it on the lappet of my coat, returned it to the scabbard.
اگر در حفظ و نگاه داری دارایی خود باهوش بود	had he been as clever in preserving his property
هم اکنون ورود شما را به او اطلاع خواهم داد.	I'll tell him at once
چنان که وقتی هم همین صحبت در میان بود.	as it was once proposed.
امّا تأثیری بر عشقش به او یا بر عشق او به خودش نداشت	but it did not affect his love for her, nor her love for him.
دیگر خورجین بزرگ دریا نوردی که به جای چمدان زمینی حاوی البسه زوبین انداز بود.	also a large seaman's bag, containing the harpooneer's wardrobe, no doubt in lieu of a land trunk.
من هم برای این که به احساسات وی با همان گرمی پاسخ گفته باشم چندین بار همین جمله را تکرار کردم.	I disliked being outdone, so replied with a dozen as solemnly.
متنفرم فکر کنم که تا دههی آینده زیر یه تخته سنگ قایم شده	I'd hate to think of him hiding under a rock for the next decade.
من یقین دارم این بهترین روشی است که باید در برابر تو پیش بگیرم.	this is the best plan to pursue with you, I am certain.
این دفعه که او را از دست داده بود حالت خیلی خطرناکی داشت.	he never was a wild man, but he got dangerous after he lost her.
خوشحالی زایدالوصف خود را با در آغوش گرفتن موجودی خیالی نشان داد.	literally hugged himself for joy.
سرزمینی پهناور متشکل از دشتها و کوه ها و مردمانی رنجور و خاموش که با صبر و تحملی آمیخته به سکون و رکودی رقت انگیز در انتظار آینده بودند.	a great land of plain and mountain and people, suffering and mute, waiting for the future in a pathetic immobility of patience.
در حدود ساعت یک و نیم و به اصطلاح دریانوردان زنگ سه بود	IT was about half past one three bells in the sea phrase that
بیوه ای پرزرق و برق را با املاک و سه پسری که داشت به زنی گرفته بود.	had married a florid widow with property and three boys
تنها نگرانی او از بی تکلیفی و تردیدی بود که در سرنوشتش وجود داشت.	agitated by no stronger feeling than a doubt where to go.
این زندگی کنونی و جهان گذران برایم کافی است.	this present life and passing world suffice to me.
از میان این پرده غبار رقیق و گرم خورشید مربی بود	through the screen of its hot fine particles one could look with naked eye at the sun
دست پیش برد و کشید به طرف راه پله	advancing towards the back staircase
جایی که نه پست وجود داشته باشد و نه تلگراف	where there was no mail and no telegraph
تا آنکه به دو برادر خبر دادم بیمار در حال موت است	until I had told the brothers she was sinking fast
این موضوعی است که دربارهٔ آن من باید اطلاعاتی کسب کنم و با شخصی مشورت نمایم.	I am going to see now if can get good advice about it.
زیرا به نظر خود دن کیشوت آن ماجراها ناشی از حقیقت و خیال هردو بوده است.	for to him they appeared to partake of both.
تا شاید بدین وسیله یکی از دشمنان جادوگر خود را که ممکن است در وجود او نهفته باشد بکشید.	perhaps in him you will kill one of your enemies, the enchanters.
فکر نکنم اگه اتفاق مشابهی پیش به یاد بتونم جلوی خودم رو بگیرم!	I don't think I could restrain myself if I ran into your other friends again.
او مردی قد بلند بود با هیکل لاغر و عضلانی.	he was tall and lean and muscular.
که در آنجا از اندوه و ناله خبری نیست و سراسر شادمانی و آسایش جاودانی است.	reaching at last the place where there is no more sorrow or sighing, but eternal joy and bliss.
من هم به اطاقم رفتم و همچنان که ایستاده بودم از در نیمه باز آن متوجه صدای رفتن او شدم.	I heard him go as I stood at the half open door of my own room, to which I had now withdrawn.
تا وقت یکه کنت به نام همسرش دستور نداد	she brought them until the count himself, in his wife's name
زیرا هر لحظه انتظار داشت طلسمی به بدنش برخورد کند.	feeling their curses following him
از بالای تخته سنگی به زیر افتاده و به پهلوهایش اندک آسیبی رسیده است.	only that he had fallen down from a rock and had his ribs a little bruised.
من تصمیم دارم علاقه و دوستی او را منحصراً معطوف به خود سازم	I'm jealous of monopolising his affection.
به مسافرخانه برگشت و دوباره به دفتر تئاتر رفت.	came back to the inn, returned to the theatre
این کار را در مدت دو سال شعر حفظ کردن کرده بود.	it was the patient work of two years
من درباره مطالب مختلف شرح مختصری بر او بیان کردم	I gave him a short account of some particulars
به داخل رفتم تا برای رفتن به مدرسه لباس عوض کنم.	I went inside to change into fresh clothes for school.
ولی اِما مطمئن بود هریت گلویش پیش کسی گیر نکرده	but she trusted there was no other hold
چون ته دلش تقریباً این پیرزن فلفلی مزاج را دوست داشت.	for in her heart she rather liked the peppery old lady.
اما عزیزان من بد وقتی است و این جزئی تنخواهی که دارم مال من نیست مال دیگری است پس مرا معذور دارید	but times are changed and the little money that remains to me is not my own
من می دونم این گستاخیه که چیزی بخوایم و وقتی شما می خو این در آرامش باش ین مزاحمتون بشیم.	I know it's bold to ask, to disturb you when you wish for peace
اما به نظرش سگ حق نداشت آن را بردارد و ببرد.	but he did not think it was upright in him to carry it off.
بعد از آن که او را به تالار خدمتکاران بردم	having directed him to the servants' hall
بلافاصله یک نفر دیگر دنبال دختر دوید و فرار کرد.	as a boy went rushing after her.
اما انتظار نداشت آن حالت نشاط و شادابی تأثیر گذار را در او ببیند.	but he was still unprepared for the overpowering vitality of the man.
حس کردم مثل یک برنامه کامپیوتری شده بودم که فقط کلمات را گفت.	I felt like a cad just saying the words.
بهتر است تا گردباد به شهر نرسیده سر پناهی برای خودتان پیدا کنید!	better get under cover before the cyclone hits town!
من که نمی دونم چی باید بهش به گم.	I wouldn't know what to say to him.
که این زن که صاحب دلی بس نجیب است	that so noble minded a woman should thus through selfishness
قبلا هم اینو بهت گفته بودم و تو اون قدر نجابت نداشتی که بفهمی .	I told you that once before and you weren't enough of a gentleman to understand.
من نمیدونستم با چه جور آدمهائی میخواد زندگی کنه.	I did the kind of people andall.
بر روی صفحه طلایی ساعت بر روی نه قرار گرفت	pointed to nine on its golden face
صدای شلیک کر کننده تپانچه که همه چیز را در دود باروت مستور ساخت به گوش رسید.	there was a deafening report, and all were enveloped in a cloud of smoke.
تعمدی در کار هست که من در دانستن آن راز با دیگران شریک نباشم.	that from participation in that mystery I was purposely excluded.
که چه بسا انسانی را متهم به کاری کنند که از او سر نزده است	is such that oftentimes a man may be accusedof something that he did not do
ناگهان به نظرش آمده بود که گویی قبلاً آن را حدس زدهاست.	she suddenly fancied that she had really foreseen this very thing.
برای او شرح داد که تمام شب نتوانسته به علت سکوت چشم برهم گذارد.	explained that he had not been able to sleep a wink all night because of the silence.
تمام مدارک همه جلسات هیئت مدیره را تا دوازده ماه قبل بررسی کن.	check through the documents of all board meetings over the past twelve months.
ولی خود او تغییر مکان داد و به اتاق خواب طبقه دوم رفت. جایی که اتاق زناشویی در نظر گرفته شده بود.	but he moved to the room planned as the conjugal bedroom on the upper floor.
به خدا اگر من حاضر باشم یک دینار برای شنیدن سرگذشت خود بدهم!	I would not give a farthing to be told what's past with me
فقط سعی کنید که سر ساعت معینی به او بخورانید.	he, evidently sincerely satisfied with his success.
اطمینان یابد که مدارک آن کامل بوده وبیمه باشد.	making sure it was licensed and insured.
چون خود او حاضر است به محض اینکه موقع را مناسب تشخیص داد شروع به اجرای آن کند.	for he would undertake the task himself, and would begin it as soon as he pleased.
در این موقع بود که اِما نشست و فکر کرد چه چیزی را از دست داده است.	she had then only to sit and think of what she had lost.
باز ضربه وارد آمد و باک سخت بر زمین افتاد.	again the shock came and he was brought crushingly to the ground.
چیزی شبیه به یک لنگه دستکش لاستیکی به رنگ پوست انسان	what looked like a thick, flesh colored rubber glove.
زیرا روز کوتاه بود و روز همه چیز بود.	for the day was brief and the day was all.
سعی کرد با نگاهش او را متقاعد کنند که چنین چیزی واقعیت نداشته است	tried to tell him without words that this wasn't true
در نتیجه به عمق عواطفی که در بالا به آن اشاره کردم افزوده شد.	thus evoking more decisively those affections to which I have but now referred.
پسرک چوپان در آفتاب دراز کشیده و سرگرم تخیلات خود بود.	the young shepherd lay dreaming in the sun.
به جای این که در خانه باشم و تفریح کنم .	when I'm longing to enjoy myself at home,
خشم و غضب شما برای من چندان اهمیتی ندارد	I do not mind if you ARE angry.
بلکه آن بدخواهی هوشمندانه و و بی نظیر او موجب این هراس شده بود	as that unexampled, intelligent malignity
ولی از نوک دیگری بالاترین طبقهٔ کاخ به وضوح پیدا بود.	but from the other spit the uppermost story of the palace was plainly visible.
روی داد و افکار سعادت بخش آن دقیقه را آشکارتر از تمام خاطرات دیگر در نظر مجسم ساخت	those new thoughts had come to him which promised him happiness.
این شادترین روزی بود که بعد از بروز بیماری گذرانده بودند.	it was the best day any of them could remember since the superflu had drawn away
اما در سمت غرب آسمان یاقوتی و درخشان به نظر می رسید.	but to the west there was a ruby red glow.
به نحوی که هرگز ممکن نبود تصور کند که یک نفر بتواند به یک نفر دیگر آن قدر فکر کند.	as she never could have imagined thinking about anyone
که به هم قطاران و همکاران خود به صحبت مشغول باشد	who immediately entered into conversation with two or three of the industrious idlers
به نظر من که این یک جور دیوانگی است.	I reckon it's a form of madness.
حال اگر حریف نیاید ننگ و فضیحت شکست دام نگیر او خواهد بود	if his adversary does not come, on him lies the disgrace
لیکن این مطلب را صریحا به او نگفته بود	but had not said this
دی گه احتیاجی به کابوس واسه وحشت کردن ندارم.	I don't need bad dreams to scare me anymore.
تازه آن وقت ملتفت شد که با چه موجود کوچک و نحیفی سر و کار داشته است.	she saw what a little creature I really was.
که آنچه کردم از ترس نبود بلکه آنچه ضمیرم به من فرمان داد همان را کردم	for acting as my conscience dictated.
این کتاب اثری بزرگ و عالی قدر است و در آن منتهای تبحر و استادی به کار رفته است	is a work of great erudition and research
روی تخت افتاد و صبر کرد تا آرام شود.	she fell back onto the bed, waiting for the pain to recede.
چون ساحرهای عجوزه در میان دیگر درختان نخل که با برگهای پژمرده و خشک بر فراز ماسه های زبر و خشن در نمایی محنت انگیز و مغمومانه خش خش میکنند.	a very witch amongst palm trees, rustles a dismal bunch of dead leaves above the coarse sand.
با این تقاضا آثار حجب و عجز و ناتوانی در چهره پیرمرد ظاهر شد.	a childish, timid expression of doubt showed itself on his face as he spoke.
آهسته آهسته به اتاق کنت رفت و او را دید	on hearing of the arrival of the letter went softly into the room
زیرا معنی و منظور آن را نکته به نکته دریافت	for he at once comprehended its meaning perfectly
اگر زمانی برسد که در آن جهان کوچک اما بسیار مسکوت شهرت واقعی به چنگ آورم	if I shall ever deserve any real repute in that small but high hushed world
چنانکه پس از چندی گفتند که من در آن هنگام هشت ساعت خفته بودم.	I slept about eight hours, as I was afterwards assured.
زمانی رسید که مالکان به کلی کار در مزارعشان را ول کردند	it came about that owners no longer worked on their farms.
به این نتیجه رسید که در کنار هم اوقات خیلی خوبی دارند.	she expressed with the thought that they seemed to have a very good time.
که همیشه آسمان را ببیند حتی در اثنای شب هم.	to look at the sky even at night
طوری که بیست و سه سال زندگی مشترک هم کافی نبود تا همسر به شخصیت او پی ببرد.	that the experience of three and twenty years had been insufficient to make his wife understand his character.
گویی در این اندیشه بود که اینک با چه کس باید کشمکش را شروع کرد.	back again as if considering whom he ought to fight now.
من من امیدوار بودم که تو هرگز نفهمی او چه بلایی بر سرم او رد چون او دوست تو بود	I I was hoping you'd never find out what he did to me, because he's your friend.
به این ترتیب با بیماری ریویش به جامعه خدمت بزرگی بکند.	thus make the disorder of his pulmonary functions a general benefit to society.
تنها نقطه ضعفش داشتن یک اتومبیل خوب و بسیار تندرو بود.	his only weakness being a good and very fast car.
آن را در اوج شور و غلغله ی حیاتش هم دیده بود و هرگز فراموشش نمیکرد.	he had already seen it when it was teeming with life, and he would never forget it.
ولی من می تونم اینو برات راحت تر کنم	but I can make this easier for you.
چهارده بازیکن به سمت آسمان خاکستری رنگ به پرواز درآمند	the fourteen players rose toward the leaden sky
اما حرکت بعدی او این بود که خم شد کلاه بر سر و چکمه به دست و زیر تخت رفت	but his next movement was to crush himself boots in hand,and hat on under the bed
خوشحال میشوم که از رویه ی جاری اطلاع پیدا کنم.	I should be glad to have an idea of the forms in which such things are done in practice.
بی آنکه در صومعه مورد نظر پسر عمو بمانند یکسر به کاروانسرا بروند و شب را در آنجا به سر برند.	go and pass the night at the inn instead of stopping at the hermitage, where the cousin would have had them halt.
به سبب درویشی و تنگدستی نتوانسته بودم خویشتن را شایسته خدمت شاهان کنم.	for which I was unqualified by the meanness of my condition.
به سختی یک بلدرچین خشک شده را در دهنش نگه داشته بود.	stiffly holding a stuffed quail in its mouth.
که تمام ارتفاعات آن سوی دره را فرا گرفت.	that it covered the whole approach on that side of it.
من به تو سیصد لار می دم و تو معشوقه من میشی.	I'll give you three hundred dollars and you'll become my mistress.
تا بدین تدبیر بتواند به تارها قوت و استحکام بخشد.	to give a strength and consistence to the threads.
تپانچه را از دست ما کار آلکسیویچ بیرون کشیده به سوی افسر دوید	snatching away the pistol and throwing it down, ran up to the officer
برایش مقدر شده است کاری برای مردمش انجام بدهد.	that he was destined to do something for his people.
الوی را حتی در صدد استمداد از آنان برنیامد.	she failedeven to so much as think of them.
در گذشته هم لغزش تصادفی با حوادث ناگواری به بار آورده بود.	it was not unprecedented that an accidental slip of the foot should have brought these grave consequences.
گمان کرد اژدهایی در آن جاست و سرش را برگرداند	twisted around to see if it was a dragon
این معرکه را قبل از وقت تهیه دیده بودند.	, and this scene was premeditated
دکتر مهربان از اطاق بیرون آمد تا بر بستن بارها نظارت نماید.	the good doctor bustled out, to see it packed.
ولی بعد از بروز بیماری به نظر میاد که عوض شده	but after the flu he seemed to change
این اعترافات او درمورد ارتکاب به جنایت که نبود	not a confession to the crimes of the world
آن را بدو نشان داد و درباره اخبار و امور سیاسی به تحقیق پرداخت.	pointed to it and began questioning him about political affairs and news.
تنها آرزویم این بود که شیر یا افعی یا هر حیوان خطرناکی که ممکن بود به ما حمله کند	only wished that a lion or a serpent, or any ill disposed monster, would make an attack upon us,
چون روز به آخر رسیده بود مأمور پلیس ردش را گم کرد	as twilight was beginning to fall, the agent lost trace ofhim
دربان را دید که کلاه در دست ایستاده است	when the porter met him with a parcel in his hand
حتی خود واعظ روی منبر اختیارش را به دست احساساتش داده بود	the preacher himself giving way to his feelings
پس خود را مسلح و مکمل برای جنگ نموده	to make up for the sharp words he had uttered during the day
فقط برای اینکه نشون بدن این جور چیزها اصلاً براشون اهمیت ندا ره.	just to show how they didn't care and was proud to wear them.
چنان اسلحه را گره زد و به گوشه اتاق پرتاب کرد که انگار پلاستیکی بود.	bent it into a knot as easily as if it had been made of rubber, and threw it into a corner of the room.
ولی به محض اینکه پایش را از اتاق بیرون گذاشت او بار دیگر گریه را سر داد.	but she began again the instant he left the room
گرگ با حالتی شیطنت آمیز که مملو از قاطعیت و موذیگری بود گفت من	I did the wolf answered in a petulant half crowing half cowering voice
اگر بخواهید بار دیگر به همان منظره باز گردید	but if you wish to return to such a sight again
سرم را زیر انداختم و به قالی کرم رنگ خیره شدم.	I keep my eyes fixed on the beige carpet.
یکی دو اینچ آن را در معرض دید من قرار داده بودید.	all the time that you have been talking.
که با دهان باز از پنجره به بیرون خیره مانده بود	who had been sitting with his mouth hanging open
یا این که آسانگیر باشی و حتی با طنز تلقی کنی.	or it may be looked at simply and even humorously.
پس به این نتیجه رسید که من با زن ثروتمندی ازدواج کنم.	I must be provided for by a wealthy marriage.
که طنابی بدان بسته است تا به وسیله آن به ازش آورند.	to which is attached a rope for hauling it back again.
شاهکاری بود از احتیاط و خلط مبحث و کنایات و اشارات و ادب و نزاکت.	it was a masterpiece of prudence and transitions, of subtle turns and delicacy
دوشیزه اسمیت در ادامه گفت که بعد از برگشتنش	when she had come away
ولی اگر کسی به خودش جرات بدهد که فکر کند جرات که آن طور به تو نگاه کند ..	but I'm wounded, humiliated that anybody dare think, that anybody dare look at you with eyes like that.
همچنین با خود شش گاو ماده با دو گاو نر و عده فراوانی میش و قوچ برداشتم تا به کشور خود برم.	I took with me six cows and two bulls alive, with as many ewes and rams, intending to carry them into my own country.
مطمئن بود که آن را بعد از آخرین استفاده روی رختخوابش گذاشته است.	she was sure she had put on the bed
که هرچه ممکن شود بیشتر سود برند و بهتر وسایل تفریح و شادمانی خود را فراهم آورند.	as much advantage and pleasure for themselves as possible.
که به او خبر دادند تلگرافی بسیار فوری در انتظار اوست.	when he was told he had an urgent telegram on the line.
این ازدواج هرگز حرف زدنش رو تغییر نمی ده.	marriage won't improve his grammar any.
نامفهومم و وحشتناک را کشیدن مافوق تحمل و طاقت ایشان بود.	uncomprehended, and terrible, was becoming unbearable.
زیرا ممکن بود مردم بگویند که مانند هر مردی چشمش پی آن دختر است.	because people might deem him interested in her as a man.
دیدم که حسابی افتادم تو تله و راه فرار ندارم.	I see I was up a stump and up it good.
بعد برگشت و با تمام قوا پا بگریز نهاد.	scoured away at his hardest speed.
کشیش که از این صحنه دل خراش سخت به رقت آمده بود وصلت روحانی ایشان را تقدیش کرد	the priest, deeply moved and with tears in his eyes, pronounced the blessing upon them
هیچیک نباید راجع به دیگری چیزی بداند وهریک باید ازراه متفاوتی سفرکند	none of them to know about the others and each to leave on a different road
اما چون هیچ گونه عنوانی را از زبان من نشنید بسیار متأثر و اندوهگین شد.	but who, to his chagrin, got no title from me!
من تعلیم او را بعهده گرفتم و فکرش را پرورش دادم.	I am teaching him, developing him.
حتی بدون این که مزه آش را در دهان خود بفهمند.	not tasting the soup
آن را بالا آورد و به صورت من پرتاب کرد.	she hurled them full in my face.
امکان داشت که پیروزی مبارزه را فدای خودپسندی عقاید خود کند.	he would have sacrificed the victory of his cause to his pride of principle.
یمتنه سیاهش را به کناری افکنده سینه برهنه خود را با تمامی آن قسمت از بدنش که از لبه قایق بالاتر بود نمایان ساخته بود	he had thrown aside his black jacket, and displayed his naked chest with the whole part of his body above the gunwale
زیرا من دیدم چگونه شما پنهانی در جیبش نهادید!	for I saw how you slipped it in her pocket.
همچنین ترس از قولی که به مقامات مافوق خود داده بود.	as well as fear of his own word given to the officials abovehim
که آن فرمان چه بود یا چگونه به یونس رسید	never mind now what that command was, or how conveyed
گنجه تکانی خورد و محکم به دیوار کوبیده شد.	the wardrobe gave a sudden wobble, banging off the wall.
سپس دستم را به سوی در کمد دراز کردم.	then reaches for the door.
مجبور بود با تبری از پولاد سرد به جان آن افتد.	but must hack at it with a chopper of cold steel.
دو مشتری دیگر هم در مغازه قدم میزدند و در استکان بلور چای مینوشیدند.	while two other customers walked about the shop, drinking tea from crystal glasses.
من از همه چیز و همه کس عقم گرفته!	I'm sick of everything and everybody!
فکر کنم میدانم چه بلایی سر ان پول امده است	I think I know what happened with that money
در برابر بخاری دود زده و تیره رنگی غرق در فکر بود.	brooding over a dull, smoky fire.
چنان تحت تأثیر تیزهوشی و ذکاوت شغلی او قرار گرفته	has been so impressed by his mental and business acumen
اراده من نیز اینست که در این چند صباحی که خداوند از عمر من باقی گذاشته است در صلح و صفا و آرامش به سر برم.	that is to live in peace as long as heaven grants me life.
همچنین امکانات مالی این کار را هم داشته باشد.	would also have the property qualification for doing so.
هیچ دلیلی برای این تصور احمقانه ندارم که هر کس با من چند کلمه حرف بزند حتماً عاشقم شده باشد.	I have no ground for the nonsensical vanity of fancying everybody who comes near me is in love with me.
با قریب پانصد تن از همراهان خود آنهم با شکوه و جلالی که مناسب با عظمت مخدوم و اهمیت کارشان بود به آن دیار فرود آمدند.	a train of about five hundred persons, and their entry was very magnificent, suitable to the grandeur of their master, and the importance of their business.
اولیور که سرگرم چرخانی دن کلید و کشیدن زنجیر بود	undoing the chain, and turning the key.
چون می دونم که خودت از هرکس دیگری صلاحیت بیشتری برای این کار داری.	because I know you can tell it better than any one.
از بیم اینکه مبادا پدرم او را بشناسد و به راز دل ما پی ببرد	i am terrified lest my father should recognise him and come to know of our loves.
بر اصول قرارگرفته و جرات تکان خوردن به میل خود را ندارند.	you won't venture to turn round on your own account.
برادرش را دید و توانست او را به مشورت با پزشک و عزیمت به چشمههای آب معدنی در خارج ترغیب کند.	to his brother's and succeeded in persuading him to see a doctor and to go to a watering place abroad.
دیدم که در نگاه آقای ویکفیلد نوعی سرزنش و ملامت نهفته است.	she seemed to me to avoid his look with such unwonted hesitation and timidity
من به این مشک شراب چندان ارادت و اخلاص دارم که	it is such an object of worship with me, and I love it so, that
مسکن ما در حومهٔ شهر در خانه بیوه یک استوار سابق تعیین شده بود.	I was quartered at an old widow's house, a lieutenant's widow of eighty years of age.
اگر به راستی چنین باشد نباید بر من خشم بگیری و ترکم کنی.	if you did, it wouldn't harm you.
اما به خلاف عادت سابق هرگز شب را در آنجا به روز نیاورده بود.	but he had not once stayed the night there, as it had been his habit to do in previous years.
رویدادی که بعد از یک قرن برای اولین بار برگزار می شه.	an event that has not been held for over a century.
من میدانم شما برای خاطر پدر و برادران خودتان ناراحتید.	I know your brothers and your father are worrying you, too.
که پس اکنون وقت جستن در کام مرگ و انهدام است با حال خونسردی و مجموع و پس پشت من نصیب شیطان شود.	here goes for a cool, collected dive at death and destruction, and the devil fetch the hindmost.
هر چند موارد عجیب و غیرقابل شکی هست که عکس این نکته به ثبوت رسیده است.	though there are peculiar and unquestionable instances where the contrary of this has proved true.
وقتی دید که به جد رفتاری چنین ناهنجار با او کردند	found himself roughly handled in such good earnest
من باید خیلی خوشحال باشم ولی ابر کوچک و ترسناکی افق را تیره کرده است	I should be perfectly happy except for one little threatening cloud on the horizon.
اما با هشیاری کامل از تکان و جنبشی که در پلکان و بیرون در باغ بود.	but with great alertness of movement down the staircase and out into the garden.
کارهای من پایان یافته است و ناگزیر به حرکت هستم.	I've finished what I had to do, and I am going.
من جرئت کردم پرداخت ده هزار روبل را به شما پیشنهاد نمایم	I dared to offer you ten thousand roubles
چون ممکن است گمراهمان کند و ناراحتی به بار بیاورد.	since it can deceive and pain you.
بلکه صلاح جامعه و خانواده در این بود که مردم هرگز به عقاید خود عمل نکنند.	but the great safeguard of society and of domestic life was, that opinions were not acted on.
روز گذشته به محض رسیدن میز جدید فوری او نو برداشت.	this new desk arrived the other day, and she just took it 
به خصوص اگر شیرین باشد و آلو داشته باشد.	especially if they are sweet and have plums in them.
امروز صبح بعد از صبحانه بلافاصله آمد پیش من	was with me this morning immediately after breakfast
اما همین عمل بر کارهنین مسلم کرد که حدسش صائب بوده است .	but from that action he saw he had guessed right
آن شب برای شب به خیر گفتن به اتاق تو هم نیامدم.	I didn't bid you good night that evening
مثل جوانی بیست ساله از جای برجست و کاردش را تکان داد.	he sprang up, drawing his knife as if he had been twenty.
لذا نه تنها باید از ایجاد موانعی در سر راه او که پایش را بلغزاند و به سقوطش بکشاند اجتناب ورزید	that impediments are not to be placed in her way to make her trip and fall
اما اگر این معدن از کار بماند این دولت نیز زوال پیدا خواهد کرد.	, which might be momentarily lost by the failure of the mine
ولی قبلاً آنچه که از شما تقاضا کردم انجام دهید	but do what I ask you first
بعد نگاهی به مادر انداخت تا رضایت او را جلب کند .	he looked anxiously toward his mother for confirmation.
تمام ترس من از این بود که مبادا با چهره دیگری از اینجا بروم	I feared for a time he might be otherwise.
وقتی به پایین خم شد و شاخ و به رگهای پشت آن را کنار زدم توانستم تمام آنچه را آن سوی پنجره بود	when I stooped down and put aside the spray of foliage shooting over it, I could see all within.
لااقل تا وقتی که بچه به دنیا به یاد و من هم بتونم جلوی پدر و مادر و دوست و دشمن آبروی خودمو حفظ کنم.	at least long enough for me to have the baby andplace myself right before my people and every one else that knowsme.
میدونستم که اتفاق وحشتناکی افتاده. احساسم قطعا همین بود.	I knew it was terrible. I felt that it was, of course.
کسی حرفی را جه به کاکا سیای فراری نزد و ما هم ترسیدیم موضوع را علم کنیم	they didn't happen to say nothing about any runaway nigger, and we was afraid to try to work up to it.
زیرا طریقی که باید از آن بگذری دیرگاهی است	that his rut had long been shaped
هرچند که خود او هم براثر ترس کبود شده بود	although she was blue with fright herself,
فکر کرد بهتر است موضوع صحبت را تغییر دهد.	the latter gentleman thought it advisable to change the subject.
سپس ناگهان گویی کسی شخصی را به زور کنار زد	then someone gave a violent shove
چون من سواد خواندن ندارم به کار من نخواهند آمد.	for, as he could not read, he did not want them himself.
زیرا مستمعین شما همه خردمند و هوشمند نیستند تا هر چیزی را به جای واقعی خویش بگیرند.	for it is not everyone that is shrewd enough to hit the right point of a thing.
زیرا بنا به عقیده آنان چون نوع بشر از داشتن حکومت ناگزیرست از ای نرو هرکس که قوه فهم و درک آن به حد عادی باشد برای احراز مشاغل و مناصب شایسته است.	for, since government is necessary to mankind, they believe, that the common size of human understanding is fitted to some station or other.
آقای تیلنی و همراهش نیز انگار با او بوده باشند ایستادند	this lady stopping to speak to her, they, as belonging to her, stopped likewise
چیزهایی که برای اسکار لت نه معنی داشت و نه تفاوت.	things that made no sense.
گلوله به استخوان گردن او اصابت کرد و به پشت در افتاد.	who fell back with a broken collar bone.
حق داشته باشیم که این دم دوست بوده دمی بعد همدیگر را دوست نداشته باشیم.	I ask only the right to love now, and next minute, if needs must, to be out of love.
اما در به پایان رساندن آن دست و پایش را گم کرده بود.	he felt an awkwardness at finishing it.
منشی دادگاه با صدای شمرده و نازک و خراش دار و پیرش اعلام کرد	the clerk of the court announcing in a clear, thin
اگرچه قدری به خود مشغول و حالت متفکرانه داشت.	though rather melancholy.
وقتی بیدار شدم آفتاب همه جا را گرفته بود.	when I awoke it was broad day.
خیلی دوستش دارم. خوشحالم که تو هم از او خوشت آمده.	I love her exceedingly, and am delighted to find that you like her too.
در هر حال بد نیس آدم اونجا رو هم یک نی گایی بک نه.	anyway, says I, it's worth the trouble to give the place a hunt.
ولی ابتدا چشمان خود و سپس عینکش را پاک کرد	but wiping her eyes first, and her spectacles
به گمانم برای خلاصی از شر شماها باید در اولین فرصت نصفتان را از اینجا بیرون بیندازم.	I can see that I'm going to have to expel as many of you as possible as soon as possible to save myself from going round the bend.
هم از رنگ کلشهای زرد روشن مزارع کشت تابستانی و حاشیه سرخ رنگ گندم سیاه کشت تابستانی متمایز بود.	against the pale yellow stubble of the spring buckwheat.
ناگهان صدایی مرتعش و لرزان افکارم را به هم ریخت.	when a tremulous voice interrupts me.
در صورت اول هم از امروز با ایشان خواهم بود.	in the first case, I shall leave directly
که همین دیروز به دست جدیدترین نژاد انسان ساخته شده است.	but yesterday planted by the recentest race of men
کم مانده بود فریاد بزند و همه چیز را بگوید.	could scarcely restrain herself from crying out the whole story
زیرا بطوریکه میدانی من در مقابل الهامات هنری بسیار حساس هستم	you know how susceptible and esthetically impressionable I am.
برای آنکه درخشان است و برای آنکه نفوذناپذیر است.	because it is luminous, and because it is impenetrable.
کاری که در طول چند ماه اخیر هر شب انجام داده بود.	as she had done almost every night for the past few months.
در مدت عمرم این اولین دفعه است اما ایشان از راه لطف اجازه خواهند فرمود متذکرشان سازم که من در حدود وظایفم هستم.	it is for the first time in my life, but he will permit me to remark that I am within the bounds of my authority.
من به گم چطور میتونین او نارو پیدا کن ین.	I'll tell you how to find them.
کتابی که کمتر از این زیان داشته باشد تاکنون دیده نشده است	least injurious entertainment that has been hitherto seen
به نظرم تنها کاری که می تونم بکنم ای نه که خودمو در تیررس اون قرار ندم	I suppose all I can do is try to avoid him.
پشت یقه هری را گرفت و او را سر جایش نشاند.	pulled him back by the scruff of his neck.
چون همه این افراد فقط به خدمت قانون درآمده بودند نیازمند کمک است.	since these,all of them, were the veriest servants of the law.
من هر کاری به خاطر تو انجام خواهم داد.	I'm going to do all that for you.
پیش دوست و آشنا هم نمی تونی بری چون حتما لو میدنت.	because you haven't any friends here you can go to.
وانمود کردم که یه پرستارم و خونش رو گرفتم.	I pretended to be a nurse and I drew his blood.
احساس ناتوانی و رنج و عذاب قلب او را در هم فشرد.	the feeling of her helplessness and of the wrong done to her made her heart throb
صدای عجیبی را از دهان خارج ساخت اما بی درنگ این صدا را قطع کرد.	producing a queer sound which immediately broke off.
لیکن من باز همانم که پیش از این بودم	but I have not therefore ceased to be what I was before
بی آنکه منتظر شنیدن صدای شیپور یا علامت دیگری برای حمله شود	without waiting for any sound of trumpet or other signal to direct them
ولی از تأثیر وحشت این خبر در ناتاشا حس همدردی و غمخواری ایشان به مردی که هر دو او را دوست داشتند خاموش شد.	if she heard this news stifled all sympathy for the man they both liked.
چنان فشاری به بازویم داد که فریادم بلند شد	wrench that made me cry out.
صندلی خالی او بین بلناپ و جفسن قرار داشت.	between them avacant chair for him.
پس از آنکه به او سفارش کرد که با لوتر مانند خود وی رفتار کند	that she was to treat him as she would himself.
دوباره پنداشتی انفجار وحشتناک حس سامعه او را فلج ساخت.	but again the sound as of a frightful explosion struck his ear
این عمل شاید مبین خیالات و آرزوهای دور و دراز او بود.	perfectly embodying his dream of happiness.
لرزیدم. آن زمان را از دید خودم به یاد آوردم.	I shuddered, remembering that time from my own perspective.
برادرهایش مانعش شدند و شروع به نیشگون گرفتنش کردند.	his brothers held him back and began to pinch him.
آری زندگی پایان یافته و دیگر برای من باز نخواهد گشت.	there is no more life for me and will be no more time!
چون ممکنه مجبور به شین از خودتون دفاع کن ین	in case you ever need to defend yourselves
در این وقت صدای چرخ گاری از آن سوی خیابان برخاست.	a wobbly wheeled wagon swayed out of a side street and creaked up to them.
مایل بودم در روشنایی و گرمای قلب جوان او خود را گرم کنم.	I was disposed to bask in her youthful lightness of heart.
این سؤال را هیچ وقت از خود نکرده بودم.	I have not asked myself the question.
دستت را به من بده و بگذار آرام آن را به فشارم	give me your hand and let me press it gently
یکی از سربازان او را باید برای محافظتش به پاسداری بگماریم!	here is one of his soldiers to be left on guard!
به او اطمینان داد که دیگر نیازی به طبیب نیست.	assuring him that no other treatment would be required
پس قبل از بسته شدن در نمیتونین بیرون برین.	this grave, and to reach the gate in season topass it before it is shut.
سرکرده دزدها و ما بقی ایشان با شمشیرهای آخته مستقیما به طرف درب رفتند.	the captain and the rest went directly to the door, with their naked sabres in their hands,
ولی خودش را عقب کشید و گفت حالا دیگر بچه نیست و از من گریخت.	but she covered her cherry lips with her hands, and said she wasn't a baby now, and ran away
اولین و آخرین دوستانی که او در طول عمرش پیدا کرد.	the first and last friends that he ever had in his life.
بخصوص که هیچ خانه اربابی واقعی هم در آن حول و حوش نیست.	especially as there is no real squire's house to dispute the point
با این همه هنگامی که هر دو اسب سرگرم گفتگو بودند	yet while the two horses were busy in conversation
مردانی که در پس درختان جنگل پنهان شده بودند	the men among the trees
