با زبانی قاطع و مهربان و کلامی سنجیده و ماهرانه گفت	his kind, strong mouth said thoughtfully and deliberately
من که خوش ندارم برادرمو در هم چین وضعی ببینم.	I'd hate to see a brother of mine in on anysuch game.
حالا ترتیب کارهایمان را دادیم شما از جانب من هیچ گونه نگرانی نداشته باشید.	our arrangement thus made, you have nothing to fear from me.
احساس کرده بود که مرد جا خورده و توهم رفته بود.	she felt him wince.
اورسولا هم از او درست مانند دختر خودش مراقبت کرد.	rsula took care of her as if she were her own daughter.
من خیلی عقب افتاده بودم. چون خون دن و نوشتنو خیلی دیر یاد گرفتم.	I was way behind because I started to read & write so late.
سه دستگاه واکی تاکی کریستال با میدان بردی که کمتر از پنج مایل نباشد	three fixed crystal walkie talkie sets with a range of not less than five miles
یا بعضی از قضایا را چنانکه باید مطابق واقع بیان نکردم	or not as precise as I ought
فقط نشانی دوزنده را به من بدهید و سفارش کنید که در اختیارم بگذارند.	you can give me the maker's address, and tell him to have it ready for me.
تا به همه بفمانند که هیچ کس حق ندارد به چنین کسانی که جیبشان به چنین تاجی آراسته است توهین کند.	as if to show that they whose brows are honoured and adorned with such a crown are not to be assailed by anyone.
تحمیل تن ناخوشایندش که مردم تحمل دیدنش را نداشتند.	the infliction of her unlovable body which people could not bear to see.
ولی این مانع از اون نیس که همه تو یه راه پیش برن	but they're all layin' 'em down the same direction, jus' the same.
بدون آنکه فریادی از گلوی زن زیبا خارج شود.	so that she did not even cry out.
کمی از کرم را دور چشمانم مالیدم و سعی کردم چند نفس عمیق بکشم تا کمی آرام شوم	I dab the eye gel on my eyes and force myself to breathe deeply until I'm completely calm again.
تعدادی در پائین و تعدادی در بالاتر موضع گرفته بودیم.	one near the bottom, one by the top.
اما یک مرتبه روی سینه بالای لباس رسمی شمایل کوچک آویخته به زنجیر ظریف طلا نمودار شد.	but the little icon with its thin gold chain suddenly appeared upon his chest outside his uniform.
آرامشی بهشتی برقرار بود که فقط ساکنان نواحی استوایی و نیمه استوایی از آن خبر دارند.	the heavenly stillness only tropical and subtropical latitudes can ever know.
به علاوه آن پانزده هزار که در جیب نهادید	with the fifteen thousand already in your pocket
که تا درست ما فی الضمیر او را بفهمد.	as if to get at the truth from the bottom of his heart
آمادهء هر کاری بود تا از کامروا شدن پرهیز کند.	he would have done anything to escape his happiness.
وقت ما رو تلف کردین و حالا تشریفتون رو می برین.	take up our time an' then walk out!
در شنل ارغوانی رنگی که روی پیراهن ابریشمی کرم رنگ بسیار نازکش انداخته بود شاداب و با طراوت بود.	brilliant in a scarlet cloak over a frock of thinnest creamy silk.
من یقین دارم که این کار را ضروری خواهید دانست.	I am sure you will perceive the necessity of it.
به اطراف نگاه کردم و گوش فرا دادم به این امید که شاید صدای پای اسبی دوباره بر سنگفرش آن جاده طنین بیندازد	looked round and listened, with an idea that a horse's hoofs might ring on the causeway again
زن و فرزند خود را بار دیگر سلامت یافتم .	found my wife and family in good health.
فرض را بر این نگذاشتند که بعداً ممکن است بدِ او را بشنوند.	it was not their way to suppose any evil could be told.
اگر هم خواستگار مناسبی برایش پیدا شد جواب رد بدهد.	prevent her from accepting offers even if they are made.
تسلیم موج احساساتی که بر من غلبه کرد شدم.	I was caught off guard by the wave of emotion that crashed over me.
این بار دیگر نه مشقی برای نوشتن بود و نه تخم مرغی برای خوردن.	this time there was no homework to finish or egg to eat.
همه شب و نصف روز بعد راه رفتم تا همان طور که گفته بودند به این رفیق برخوردم.	I walked on, that night and half next day, until I met as I was warned I should this comrade.
تا زحمت رفتن به خانه و بازگشتن به اینجا را متحمل نشوید.	you will save yourself the trouble of coming back.
یعنی هر وقت او در مجلس بود مثل اینکه هوا صاف و آفتابی است.	I mean he made it seem like good weather.
دست آخر هر کدام روی صندلی خودمان به خواب رفتیم.	ended by each of us falling asleep in our chairs.
او به من یک دست لباس ابریشمی صورتی هدیه داد.	I unwrap this pair of gorgeous pale pink silk knickers.
اصلاً وظیفه داشت از هر نوع دلگرمی دادن و تشویق کردن فرانک چرچیل خودداری کند.	it would be incumbent on her to avoid any encouragement of his.
به نظرم هم ون جی گر بهتر با شه	I think darling is better.
که به طور مجموع در شصت سال اخیر از شغل رفیع و دشوار وال گیری با قوه بیشتری در سراسر جهان کار کرده باشد.	hich within the last sixty years has operated more potentially upon the whole broad world, taken in one aggregate, than the high and mighty business of whaling.
خوب نیست که اصلاً ایشان در دادسرا حاضر شوند.	there's no earthly reason why she should be present at all.
باید بی درنگ این نبرد عاشقانه را آغاز کنی	thou will at once engage in this love struggle
تا خودشان نتیجه بگیرند که این مطالب روی هم رفته توجیه سنگدلی والدین است یا اجر نافرمانی فرزندان.	whether the tendency of this work be altogether to recommend parental tyranny, or reward filial disobedience.
امیدوارم صرفاً حقایق را به بهترین نحو ممکن به من گزارش کنی	I wish you simply to report facts in the fullest possible manner to me
خوب است هر کس در خود بنگرد و به انتقاد از خود بپردازد.	let each one mind his own business, and he will be doing enough.
این شد که ماجراها را هم همان طور انجام دادند.	so these adventures were carried out.
پس این مدت قلیل که تو را باز حیات و مهلت داد از برای این است	has given you this quarter of an hour for repentance
امّا همسایگانش جز مختصر چیزی که در جنگل پنهان کرده بودند و یا در زمین دفن کرده بودند چیزی نداشتند.	but the little they had been able to hide in the woods and bury in the ground.
که سه دختر با حیرت یک صدا فریاد زدند	cried the three girls
کلاه و شال خود را سریعاً از سر برداشت	she tore off her bonnet and shawl, with the rapidity of lightning
اما هر دو از فلزی ناب ساخته شده بودند.	but they were both pure metal.
اما پس از استدلالات فراوان عالمانه خود را به اظهار این عقیده خرسند کردند که بگویند از کجا معلوم که بتوانم چنین حشراتی را هم بخورم .	which they offered, by many learned arguments, to evince that I could not possibly do.
هزار مرتبه بدتر از این بود که از من نفرت داشته باشد.	that's a thousand times worse than unkindness!
من هم پهلوی او در همان محل اولیه نشستم.	I sat down in my seat in the front.
تمایل داشت تنها به کار و کوشش خود تکیه کند.	he intended to stand on his own efforts.
من همان موقع که آمدم از شما تقاضا کردم.	I asked you as soon as I came into the room
این آمد و رفت تا آنجا ادامه یافت که اسب پیر سقط شد.	making trip after trip until the old horse was lathered.
گفت که باید از آن یک تصویر کامل درآورم.	he said I must make a finished picture of it.
زیرا بزودی ملکه او را به یکی از بانوان سرشناس بخشید.	for soon after the queen bestowed him on a lady of high quality
روی درازترین تیغه آن بسازند و میگویند که باید سنگ را بشکافد و مجرائی برای آب احداث کنند تا سپس آب را به مدد لوله و موتور به آن برسانند.	on the long ridge whereof a long canal must be cut, for a repository of water, to be conveyed up by pipes and engines to supply the mill
از یکی از شما تمنی دارم که بگذارد مانند اسب حقیقی بر پشت او سوار شوم و مرا به خانه یا دهی که ممکنست در آنجا از من دستگیری کنند برساند	I entreat one of you to let me ride upon his back, as if he were a real horse, to some house or village where I can be relieved.
نگذاشتند آنان را بیش از این در این راه پیش برانند.	could neither be led nor driven any further.
چون شاگردان زودباور او معتقد بودند که به جای آنکه به طور کلی پیشگویی کرده باشد	because his credulous disciples believed that he had specifically fore announced it, instead of only making a general prophecy
دست دیگرم را دراز کردم که قبل از اینکه بیفتد او را بگیرم	I held one hand out to catch her, but she righted herself before it was necessary.
آن گاه هری غلتی زد و به پشت خوابید.	rolled over on his back
شک دارم که استعداد یادگیری هم داشته با شه.	I doubt if he'll ever learn.
باز ناراحت شد و نگاهش را به پایین انداخت.	again overcome with confusion and looking down.
اینک ساعت دوازده و نیم شب بود و شب را بیهوده در اجتماع مذهبی و خیابان گذرانده بود.	at half past twelve o'clock, after he had wasted the night at the meeting and on the street.
چون هر دو مجذوب زیبایی و صفای محل شدند	by this time was beginning to come on oppressively.
فقط کشیشی است که سعی دارد زندگی اعضاءِ کلیسایش را بهتر کند.	he is only a parson among parishioners whose lives he has to try and make better.
کت و شلوار به تن داشت و کروات هم زده بود.	wearing a jacket and tie.
به هر کس دیگری در این دنیا راست خواهم گفت.	as I do and mean to do with everybody in the world.
به موقع دیدبانی خود بازگشت و بی حرکت نشست.	she returned to her post of observation and sank into repose again
شاهی که همچون بهار خرم و مانند تابستان آسوده.	pleasant as the spring, comfortable as the summer.
هری فوراً کتاب را در قفسه جا داد و فرار کرد.	stuffing the shrieking book back on the shelf, he ran for it.
در دادگاه نظامی آنچه واقع شده حکایت خواهید کرد!	you can tell all about it at the court martial.
فکر پدر شدن مرا دست خوش عواطف بسیاری کرد.	THE IDEA OF FATHERHOOD unleashed a swirl of emotions in me.
پس او را قسم دادند که آنچه دیده و فهمیده بروز ندهد او قسم یاد کرد	he was made to take an oath and did so
من برفراز جائی که دویست گزی از کرانه ارتفاع داشت ایستاده بودم	I stood upon a height about two hundred yards from the shore
یا همان پیشخدمت کذایی بیاید و مرا بیدار کند و سپس قهوة صبحانة خویش را در همان تالار عمومی صرف کنم.	to the solitary box in the coffee room and the familiar waiter again.
به من کمک کرد تا به راحتی آن را پیدا کنم.	enabled me to find it without difficulty.
کلاه حصیری سفری خود را هنوز از بندهای بلندش به دست آویخته داشت.	still holding her straw travelling hat by its ribbon in her hand.
کودک با از یک پا و یک بازو خوشبختانه آن بازوی سالمش را گرفت و به سوی دالان دوید	seizing the boy by one leg and one arm fortunately not the broken limb lugged him straight into the hall
آن هم به شادمانی نخستین فرصتی که پیدا بکنم.	of course, the first chance I have.
هزاروچهارصد روبل کافی است هیچ تفاوتی با هزاروپانصد ندارد.	why not fourteen hundred?
که رئیسه دیر برای قدردانی از او قبول کرده است	that, by way of thanks, the prioress
که واقع است در بالاترین ارتفاعی که در آن صحرا موجود است.	situated, as every one knows, upon the highest point of the plain of that name
ظرف شیر را از یخچال بیرون آوردم و در یخچال را محکم به هم زدم.	I get a pint of milk from the fridge and slam it shut
. کمی موقعیت رو بررسی کردم و سپس به طرف جایی که سِثْ ایستاده بود حرکت کردم.	I made the little clearing then, moving immediately to the point.
آن هم در عمل ایمان به قوه قضاوت خودمان است	it is virtually our own judgment
وقتی هم که در روز رستاخیز بیایند این دکل کهنه را در آوردند و ببینند یک اشرفی در آن نشسته	so they'll say in the resurrection, when they come to fish up this old mast
حالا مواظب هر قدمی که برمیداشت بود. آتش خیلی آرام ازاودورتر ودورترمیشد.	, feeling for each step, watching as their campfire receded with agonizing slowness.
از روی درد و عصبانیت زوزه کشیدم و به طرفش چرخیدم.	I howled in pain and fury and turned on him.
به شرط آن که خود او نیز از آنان تمجید نماید.	if he had admired them.
فقط پیشانی خود را به پیشانی او گذاشت و آن را لمس کرد و چنان محکم دستش را فشرد	but only bending his forehead to hers just touched it, and pressed her hand so
این همه را به بهترین وجهی که توانستم نقل کردم	I have narrated all this as best I could
اما من از ازدواج که تنها برای پول باشد نفرت دارم.	but the very idea of marrying for money is repugnant to me.
مغز این حیوان که فقط یک مشت است قرار دارد.	reposes the mere handful of this monster's brain.
گو این که اکثرشان لباس مرتب و شیکی بتن داشتند	although they were well enough dressed, some even particularly well.
روز سوم اتاق خود را از داخل کلید کرد.	on the third, he locked his door.
به تحصیل و نیز خدمت در دستگاه دیپلماسی گذرانده بود.	where he had been educated, and had been in the diplomatic service.
در او این یقین ریشه گرفته بود که اگر این بانو وانمود کند او را دست اندر کار قتل و از آن پس پوست کندن کسی دیده است.	he felt assured that if she should take it into her brightly ornamented head to pretend that she had seen him do a murder and afterwards flay the victim,
اما اشتباه در آنجا شایان تعظیم است از بس که شامل شجاعت است.	but error is worthy of veneration there, so thoroughly does it imply heroism.
امیدوار بود با این کار به این که صرفاً یک زن عادی باشد خاتمه دهد	in the hope that thus she would cease to be a private woman
البته ایراد من از این جهت نیست که آن داستان بد بوده یا خوب تشریح نشده است	not that it is bad or ill told
او را به حال خود رها کرده و رفته بود.	abandoned her to her fate.
من آن را با رنج بسیار با هر دو دست برداشتم.	I took up the vessel with much difficulty in both hands.
آخر مادرش غرقه در دوست داشتن او روی در نقاب خاک کشیده بود و او به سبب نوجوانی و خودخواهی پاسخ محبتش را نداده بود.	because she had died loving him, when he was too young and selfish to love her in return
جای اتصال برگ و ساقه پر از غبار بود.	the cups where leaf joined stalk were filled with dust.
راهی که توانمان بخشد تا زندگی را سرشار تر کنیم به کام خویشتن.	,new ways to help us make a richer life for ourselves
زیرا به حقیقت در سخنانی که گفتم رمزی نهفته است.	but the truth is there is a certain mystery in the words I used.
بی آنکه بداند که چه باید کرد و چه باید گفت به حیرت در او نگریست	stood staring at him in bewilderment, not knowing what to do or say
گویی همین دیروز بود که این سرزمین خاطرات را ترک کرده بودم.	as though we ourselves had left but yesterday
متوجه سکوت او شد و با کمال شگفتی دریافت	, noticed his silence, and was struck by the fact that her
به نظر من که تو خیلی عالی بازی کردی.	I think you did really well
قصد داشت تا آنجا که جمع تحمل دارد سرگرم بماند.	still enlarged upon his man like a spectre, as long as they could bear it.
اما تفسیرها حد و مرزی ندارند و زنان جوانی که سرشتی پرشور و مهربان دارند	but interpretations are illimitable, and in girls of sweet, ardent nature
بچه را هم که در آن قفس بزرگ حصیری خفته بود همراه آورده بودند و روی قفس هم یک پارچه توری انداخته بودند.	carrying the baby, who was asleep in the wicker cage covered with gauze.
من سعی کردم که به یاد آورم تا با او ملایم باشم اما واقعا کار سختی بود که چیزی را در هجوم شور و احساس به یاد آوری.	I tried to remember to be gentle with him, but it was hard work to remember anything in the onslaught of sensation, hard to hold on to any coherent thoughts.
ترسیدم که مبادا مغز من از فرط رنج و بدبختی تکان خورده باشد	I feared my brain was disturbed by my sufferings and misfortunes.
ولی بعد پشیمان شد و تصمیم گرفت پیاده برود.	but instead had decided to walk.
ارز و کرده بود که پدر و مادرش دست از دعوا و مشاجره بردارند.	wishing that her parents would stop quarreling.
جز آن که با شوهر خود چنان تشریک مساعی کند که حتی المقدور به خوش و خرمی روزگار بگذرانند.	but share her husband's efforts that her time should pass as happily and as agreeably as possible.
امیدش بدان بود که ترتیبی پیش آید تا بعد از مرگش دختر دلبند وی در دنیا تنها و بی کس نماند.	drawing comfort from the hope that she would not now be left entirely alone after his death.
پیش بینی نکرده بودم که اون دختر می تو نه این قدر واسش خوب با شه.	I didn't foresee that she would be so good for him.
هنگام یکه کمک گرفتن از یک عده دیگر را برای تقویت خود لازم شمرد.	when he judged it necessary to obtain reinforcement.
دست او را در دو دست خود گرفت و نگه داشت.	took' and kept'her hand in both his own.
چه قدر هم خوب است که آدم خیالش از خورد و خوراک و معاش راحت باشد.	how important to her to be secure of a comfortable provision
به اندازه ای تفاوت داشت که یک دم در تردید بود که بایستد و لحظه ی دردناک توضیح را اندکی به تعویق اندازد.	that she was for a minute in uncertainty whether to remain, whether to put off a little longer the painful moment of explanation.
یعنی اگه بخواین با پولدارها بگری دن حتما باید پول داشته باشین.	that is, if you want to run with people who have.
وقتی او را از خانه بیرون انداختم خوشحال شدم.	I was glad to get her away from the house.
هیچ وقت هم مثل این دیدار نامنتظره مودب و ملایم حرف نزده بود.	never had he spoken with such gentleness as on this unexpected meeting.
این اعتبار اینک پاک از بین رفته و به خاک سپرده شده است.	that credit at present was dead and buried.
این باعث شده که رنگ پریده به نظر بیایی.	it has made you look pale.
تا از دم نسیم صبح تازه و خنک بماند.	the air might keep them cool.
من با تو صحبت نخواهم کرد و حتی پالتو خود را در نخواهم آورد.	I won't keep you long, I won't even take off my coat.
خیال این وقایع در ذهن مشوش او مانده و مخلوط شده بود با خیالات وهمیه	her thoughts wandered in a confused maze
من از تو خیلی متشکرم که عین حقیقت را گفتی و قصد بدگویی از من یا دست انداختنم را نداشتی!	I'd thank you to adhere to the truth and not slander me, even in joke!
بی درنگ همه چیز را رها خواهم ساخت و به سوی تو خواهم شتافت	I will throw up everything and fly to you
فقط سه چهار نفر بودند که نخندیدند شاید شش نفر.	except three or four, or maybe half a dozen.
دوباره فریاد کشید و دوباره روی پای راستش فرود آمد.	screamed again, came down on his right leg once more
گویی شاخة نحیفی شکست و باز همه چیز آرام گشت.	like the snapping of a splinter and all was still again.
دل هیچ یک از اعضای دسته در آن کار نبود.	nor was the heart of any dog.
شانس این داشتم که امیدوار باشم شاید در خواب او هستم.	did I have a chance to hope she might be dreaming of me.
تا پشت خود را بخاراند. با یک چیزی که برای پشت خاراندن درست شده بود	to scratch his back with a long handled back scratcher
تا به حال ندیده بودم که او ان قدر بی نزاکت رفتار کند.	I'd never heard him be so impolite before.
یکی راه علم و دانش و دیگر راه شمشیر و سلاح.	one is that of letters, the other that of arms.
پدرم را نیز به خاطر دعوایی که با او کرده است سرزنش خواهم کرد.	I'll scold papa for quarrelling with him.
بلکه انواع مختلف ادویه را خروار خروار خریده و در میان صندوق بزرگی که در آن باز بود ریخته بودند.	but by the quarter, and all lay open to view in a great chest.
این امر را چون یک دستور عمومی شهرداری بود	this being amunicipal regulation
به محض اینکه او پشتش را به من کرد تا برود شکلکی برای او در آوردم و مشغول ریمل زدن شدم	I pull a face at her behind her back as she leaves, and start putting on my mascara
جاستین را آرام گرفت و سرش را به صندلی تکیه داد.	then relaxed his hold on her and laid his head back against the chair
می دونم که مجبور نیستم ولی بذار یه چیزی بهت به گم.	I know I don't have to.
از اینکه با نقل چنین داستان جذابی مرا محظوظ فرمودید سپاس گذارم.	I thank you for the pleasure you have given me by relating so interesting a tale.
من میل دارم که دین خودم را ادا کرده باشم.	I like to pay my debts
اگر حکیمی از یاران مشفق او در آن مخمصه به دادش نرسیده بود	if he had not been succoured in that sore extremity by a sage, a great friend of his
شکستن هیزم و چوب و پرستاری از چهارپایان بی رمق و چیر خود بودند که دیگر جشن و مهمانی و لاس زدن را فراموش کرده بودند.	splitting rails and nursing sick old animals that they had forgotten such things as balls and pleasant flirtations ever existed.
نجیب زادگان اصاهای سر طلایی را بین زانوان خود قرار داده بودند.	the gentlemen balanced gold mounted canes between their knees.
بلکه به این جهت به صدور آن مبادرت ورزید	but because he knew that the enemy was beaten
او برای اینکه از آن سود ببرد ابراز نکرده است.	that the merchant had for his own advantage kept it secret.
تکه گوشتی را برید تا از سیم جدا شد .	sawed through a piece of meat until it was free of the wire.
تفنگ را برداشته و به دستی هم تیشه را گرفته	took his gun in one hand his pickaxe in the other
سپش بازوانش را گشود و دخترش را برای گفتن شب به خیر در بر گرفت	he raised his arms to embrace his daughter good night.
شعر برای کسانی خوب است که چیزی برای گفتن ندارند.	_Poetry is all very well for those who have nothing to say_.
ارلاندو یکی دو گلبرگ زنبق پاییزی را که در نظر برخی به همان مصداق است برداشت	she picked up one of those autumn crocuses which to some people signify that very word
زود لگن سلمانی و پالان و جل و افسار خر مرا که از من دزدیده بودی به من پس بده!	hand over my basin and my pack saddle, and all my trappings that you robbed me of.
وقتی به نظر خودم تقریباً به حد کافی راه رفتم	when I thought I had nearly done enough,
از ای نرو دو ماه پس از بازگشت به وطن خود دوباره ترک دیار خود گفتم.	in two months after my return, I again left my native country.
ساز یک طرف بود و ساززن در طرف دیگر.	the instrument was on one side, the performer on the other.
نسیم در سرخی شامگاهان وزیدن گرفت و ستیغ درختان کاج را تکان داد.	the breeze whistled low in the dusk among the tossing pines.
با زحمت کنار گذاشته بود صرف خرید چنین کت و شلواری کند.	hard earned savings and indulging in a suit of this kind.
هیچ اطلاعی از آن ندارم و قضیه را تعقیب نخواهم کرد.	I know nothing about it and won't begin proceedings
جایی که مواد غذایی جنان غنی و پاکیزه بود	where the provisions looked so splendid and clean
حال آنکه کولیان مردمانی جاهل بودند که چندان از بربرها بهتر نبودند.	whereas these gipsies were an ignorant people, not much better than savages.
همه اشکال و اقسام هرزگی و تبهکاری جریان داشت	villainy were practised
مانند یک کیل که انباشته از جو باشد گودال را تا لبش مالامال کرده بودند.	reached the brim like a well filled bushel of barley.
درست مثل دست مالکان و زمین داران بزرگ .	remarkably well tended for a farmer's hands.
هم ون مهی که شب تا صبح افتاده بود.	de fog dat's been aroun' all night.
به آن طرف خیابان رفتم و داخل دکان شدم.	after I had read these words from over the way, that I went across the road and looked in.
جاهای دیگر و حتی پناهگاه چوبی هنوز در تاریکی فرو رفته بود	the rest, and the block house itself, still lay in a black shadow chequered
سپس همه در سر جای خود به انتظار ایستادیم.	we stood there, each at his post
دانسته است که این معنی برای من تازگی دارد	that I received it as a thing wholly new
مثل سیخونک زدن به چشم یک اژدهای خفته بود.	it was as safe as poking a sleeping dragon in the eye.
اما برای تحریک عشق و نفرت جمعیت وسیله مشخصی لازم است.	but to animate it the crowd needed a tangible object to love and a tangible object to hate.
رضایت داد که نزد پدرش لب به شکایت نگشاید.	she assured me she would not complain.
برای من نیز ممکن نیست از اظهار عقیده خودداری کنم.	I can no more help talking about them
سپس ناگهان باران شدیدی باریدن گرفت که چهار روز طول کشید	then came a sudden heavy fall of rain that lasted for nearly four days
سرنوشتش باید اکنون تعیین شود وگرنه هرگز سرنوشت او تعیین نخواهد شد.	that her fate must be decided now or never.
که در تمام این فصل اول تیاتر درش بسته و خالی بود.	which remained obstinately closed during the whole of the first act
که او وجود مرا به سادگی فراموش کرده بود.	she's simply forgotten my existence.
ژنرال هر جنایتی هم که مرتکب شده باشد آن قدر عمل و درایت داشته که ردی باقی نگذاشته باشد.	whatever might have been the general's crimes, he had certainly too much wit to let them sue for detection.
خیال داشتم این یکی را هشتاد پوند یا بیشتر بفروشم	I was going to sell for eighty or more
باید برم و مردمی رو که توی جاده حرکت میکنن ببینم.	I gotta see them folks that's gone out on the road.
به هر زبانی که بود از او خواهش کردم در آرایش خود تا حدی تسریع کند و به خصوص هر چه زودتر شلوار به پا کند.	I begged him as well as I could, to accelerate his toilet somewhat, and particularly to get into his pantaloons as soon as possible.
من در لحظه خیلی بزرگی درگیر یه کار شدم.	I am engaged in a work of very great moment.
اما اطلاع دیگری از خاست گاه او نداشت که جای گزین این برداشت کند تا حقیقت معلوم شود.	they did not have any information enabling them to replace it with the true one.
به فرمان او ریسمان بدهد یا آن را بکشد.	haul in or slacken the line, at the word of command.
معلوم بود که چقدر کارش را با دلگرمی و شوق انجام داده است.	which plainly showed how ernest her work had been.
لکن آن را تنها بم نزله امکانی تلقی نموده و تاریخ جنایت و چگونگی آن را تعیین نکرده است.	I was firmly convinced that he had pictured the fatal moment beforehand, but had only pictured it, contemplating it as a possibility.
تا مثلاً از بنیان گذار خود بدان نحو تجلیل کرده باشند.	that felt obliged to pay tribute to the memory of their illustrious patron
پایش لغزید و مجبور شد از روی چند پله بپرد.	tripping down a couple of steps
او را با یکی از حیوانات چاق و چله ای مقایسه میکنم که در نمایشگاه های دامپروری جایزه ی اول را میبرند.	a prime, well fed beast such as takes medals at the cattle shows, and nothing more,
به هم هشدار دادن که حق ندارم چیزی به کسی به گم.	warned me to keep my mouth shut.
میخ وام در مورد ما استثنا قائل به شی.	I want you to grant us an exception.
آن گاه از میان مه غلیظی که او را در بر گرفته بود	then, through the fog that was drowning him
اما تا ساعت یک بعدازظهر بیشتر متحمل تو نمیشم.	but I'll endure it till one o'clock.
اما متوجه شدم که متوسط القا مه و کاملاً چهارشانه است.	but I traced the general points of middle height and considerable breadth of chest.
کار از گفتگو هم گذشته قرار حتمی داده است.	it is not only projected but arranged
بیش از آن که حقه باز باشد ارباب منش است	more masterful than crafty
خودش را به او چسباند و به او درآویخت.	tugging at his arm.
میدان او همواره نشانی از شکوه و جلال مفرط دارد.	its flexions are invariably marked by exceeding grace.
چون مبلغ را بالغ بر شصت و سه رئال یافت	found that it came to sixty three reals
زیرا در آن هنگام تا گردن در آب فرو رفته بودم.	because I was under water to my neck.
شاید باور نکنید که من به آن تعلق دارم.	you might have a bit of difficulty in believing I ever belonged to it.
دو تای دیگر سه ساله و چهار ساله بودند.	two others were three and four years old.
زیرا اگر چه سرانجام وی از دام فریب بدر آمد و با زن خود آشتی کرد	although he was at last undeceived and reconciled to her
از زیبایی گلها لذت برد و متوجه ذوق و سلیقه ای شد که در انتخاب هر چیز به کار رفته بود.	the beauty of the flowers, and the taste with which everything had been selected.
اگه گناهکار نباشه باید در چارچوب قانون ازش دفاع کنیم.	if not, to defend him to the limit of the law.
فورا به این نتیجه رسید که یا باید آن دسته را کنار بگذارد	then decided that there was but one thing to do lay the bundle aside
من به هیچ کس نمی گم چی کار کنه	I'm not telling anyone what to do.
حتی در راهروهای مسیر حرکت مردم و در روی یک میز دراز چیده شده بود	even in the spaces that were supposed to serve as passageways.
این موجود کوچک اندام و نیکو سعی کرد بازوهای کوچکش را بر سینه گذارد و بعد سر را تکان داد.	said this least of women, trying to fold her short arms, and nodding her large head.
همان گونه که در جنگ بکار بردن خدعه و نیرنگ برای غلبه بر دشمن مباح و جایز است	as in war it is allowable and common to make use of wiles and stratagems to overcome the enemy
یک دهقان درشت هیکل نزدیک به سی ساله با زن جوانش.	a healthy peasant of thirty and his young wife.
توانستم به هویت آن مرد و آن زن پی ببرم	I was able to establish the identity of the man and the woman
تا آخر سال نیز بحث ما تمام نخواهد شد.	we shall not make an end of it this twelvemonth.
تا آنجا که اسبش را یارای رفتن بود در امتداد صف سواران پیش تاخت ولی با این همه نتوانست به موقع از مقابلشان بگذرد.	galloped along the front as hard as his horse could go, but still was not in time to avoid them.
با این پست شما که در ساعتی بیشتر از دو لیو است	, with your posthorses going at the rate of two leagues an hour
چون تا حالا در عمرم سوار قطار نشده بودم.	I never rode in one before.
مشروط بر اینکه قانون منع ناله شامل حال مهتران پهلوانان سرگردان نشود.	unless this rule about not complaining extends to the squires of knights errant also.
از این آتش برای پختن او نا استفاده کردم.	I took advantage of the fire to cook them.
چون او عقل خود را از دست داده است.	as he was out of his senses.
در این جا بحث به موضوع دیگری یعنی آموزش زنان کشیده شد.	the conversation at once passed to the new subject of the education of women.
بداقبالی بزرگی بود که موفق نشدیم خودمان او را دستگیر کنیم و برگردانیم.	it is hard lines that we have not actually had the triumph of bringing him back as our own prisoner.
یک فنجان قهوه فوری با مقدار زیادی خامه وشکر به آن اضافه کرد.	added a cup of instant coffee with a lot of cream and sugar
زیباترین چهره گلگونی را که در دنیا ممکن است داشت.	with theprettiest little rosy face in the world.
کف عرشه دراز به دراز افتاده به حلقه زن جر چنگ انداخته قسم خورده است	throwing himself at full length upon the deck, grappled a ring bolt there
جملگی به تخته پوستی چنان زرد و یکدست بدل شده بود	faded down to such a dull uniformity of parchment yellow
همه خاموش بودند چشمهاشان بر آتش دوخته شده بود	they were quiet, staring into the fire.
هر دو مرتبه نیز با رگبار چهار توپ مزبور مواجه شد و ناچار عقب نشست.	but on each occasion had been driven back by grapeshot from the four isolated guns on the hillock.
حال بفرمایید آیا کشتن دیو بیشتر صواب دارد یا زنده کردن مرده	now tell me, which is the greater work, to bring a dead man to life or to kill a giant?
من در این تصور آن قدر باقی ماندم که برای ترک کردنش دیگر کار از کار گذشته بود.	I wallowed in that delusion so long I left it too late, too late!
بلکه آن چهره محجوب و ضعیف را مشاهده نمود	but the timid, feeble face she had seen for the first time quite closely
در وسط آن محوطه جنازه دختر بینوا همان جا که از اسب فرو افتاده بود قرار داشت.	there in the centre lay the unhappy maid
یا به قدری دلش پر بود که با این حدیث را ممکن بود هرکس در میان نهد.	or whether she was so full of the subject that she would have talked about it to the very twins
من نم یخ وام حالا باعث درد و رنجش به شم	I won't cause her pain now.
حیف که با این معلومات سو راح دعا را گم کرده	yet that you should fall into a delusion so great
آنگاه روی نوک پا از کنار بیمار دور شد.	took himself off on tiptoe.
در هر چیز سر الهی را درک خواهید یافت	you will perceive the divine mystery in things.
پیاده رو مثل سابق شلوغ و پر ازدحام بود.	she found the sidewalks just as crowded as they were at the height of the war
من میل دارم عمر جاودانی بیابم و به راه حل دیگری تن نخواهم داد	I want to live for immortality, and I will accept no compromise.
وی با کنجکاوی تمام به شیوهی داستان سرایی راوی توجه کرد	for he had remarked with particular attention the manner in which it had been told
تبدیل به نوزادی گردید که مادر سخت به او عشق ورزیده بود	was one with the babe whom she had loved
اومیخواست دفترچه همیشه پیش او باشد تا بتواند آنرا ببیند	that wouldn't do he wanted it with him where he could look at it
بلکه تا سال 1925 حتی به فکرم هم نرسید که باید چنین کاری بکنم.	about 1925 in fact it even crossed my mind that I might have done so.
با صدای موسیقی وار موزونی زمزمه کرد می تونم صدای ضربان عجیبش رو بشنوم.	I hear her strange heart, he murmured with an almost musical lilt to his words.
برای ناهار توقف کردند و از قسمت جنوبی شهر صدای فریاد شنیدند.	they had stopped for lunch and heard weak cries coming from the south side of town.
پدر سخت خشنود شد گره از ابروان انبوهش گشود	the expression of his large brows softening
من و تو باز هم با هم به دریا برویم.	you and me'll go to sea again.
در یر این صورت ممکن است هرگز برای تسخیر دمشق موفق نشویم .	than never to have taken it at all.
برگشتم و به دفتر کار خلوت و بی سر و صدا نگاهی انداختم.	I come back and look around the quiet office
البته هنوز چیزهای تو رو جمع و جور نکردم.	I haven't quite sorted out your stuff yet
من زنگ زدم تا این مطلب را به شما گوشزد کنم.	I rang to tell you that.
چهار پوند و نیمی که من به او بدهکارم پرداخت کنی.	that you have come to pay the four pound ten I owe him.
بلکه اطمینان حاصل کرد که هر لحظه ممکن است تکرار شود.	but was certain that it would be repeated at any moment.
من یک چیزی بهش زدم و اون زیر جاکتابی دوید	I poked it out, and it ran under the bookcase.
از ای نرو جرأت نکردم که حتی بینی خود را بگیرم.	therefore I durst not so much as stop my nose.
جلوی خانه به آرامی شروع به قدم زدن کردم.	I paced quietly in front of the house.
نمی خوام کاری رو که ازش مطمئن نیستی انجام بدی	I don't want you to do anything you're not sure about.
5 و در گردنش طنابی است از لیف خرما	5 upon her neck a rope of palm fiber
بر جان من نیز چنان حکمروا است که اگر خود نخواهد از آن بگذرد جان من تا ابد متعلق به او خواهد ماند.	that one in my heart which he holds so firmly shall never be taken from him, unless he be willing to surrender it.
زیرا هم خودش و هم شوهرش به بیماری کاترین که هنوز حالش کاملاً خوب نشده بود مبتلا گردیدند و به فاصله چند روز یکی پس از دیگری از این دنیا رفتند!	she and her husband both took the fever, and died within a few days of each other.
حال اگر آن گونه که من انتظار دارم او در این نبرد پیروز بیرون آید	if she comes out, as I know she will, victorious from this struggle
چون هنوز این مسئله مشکل لاینحل مانده است و این عقدة سرسخت هنوز باز نشده و چون ممکن است ما از عهدة حل کردن آن بر نیاییم و اشتباه کنیم بهتر است تا مدتی از آن منصرف شویم.	as this knotty point is still unsettled, and as we must not make a mistake in our decision if we can help it, I think we had better take a little breathing time.
باید به خاطر بسپارم چطور آن را ادا کرد.	I must remember how you said that.
فکر کردم فوری و فوتی چیزی سر هم کنم	I thought I'd just quickly make something up.
که یکی از افسران ستاد با ملتزمین رکابش به جانب او آمد	a chief of staff followed by a suite galloped up to him.
ما نیز شعبهٔ مخصوصی داریم که کارش گرد آوردن اطلاعات است.	for we have our secret police department where private information is received.
من از جای خود برخاستم و صندلی را که روی آن نشسته بودم به او تعارف کردم.	I got up and offered her my seat in the arm chair.
به نحوی که این اهتمام در نظر ما ممکن است ناچیز جلوه کند.	so that among us, it would be little esteemed.
او نیز پریشانیش را از دیگران خوب پنهان کرده بود.	she hid her distress too well.
به زودی ملکه از آنچه بر من گذشته بود خبر شد	where the queen was soon informed of what had passed
در تمام بازوی او دو قسمت که هم رنگ باشند وجود نداشت	no two parts of which were of one precise shade
این همه را از زبان چرب و نرم و از میمون باهوش و دستگاه خیمه شب بازی خود دارد.	all by his tongue, and his ape, and his show.
ما عزیزانم هر چه هستیم و هرچه خواهیم بود در چشم او تنها درخششی هستیم.	we, my dears, everything we are and ever will be are just a twinkle in her eye
به نظرش رسیده بود که او مردی است بیمار.	because it seemed to her that he was sick.
خاموش و در انتظار ختم سخن فرمانده خود بود	waited in silence for him to finish speaking
اما از جفتک زدن و خوش رقصی کردن معذور بود چون قدرت این کارها را نداشت.	for as to capering, begging his pardon, he knew not what it meant.
به شاهزاده خانم ماریا گفت که او نباید به اتاق وارد شود.	said she could not enter.
اما آقای لاری پیش از آن صلابت ذهنی خویش را بازیافته بود و به یاری نیازی نداشت.	but he was by that time clearheaded, and had none.
پدرش عمدا در حضور وی این عمل را انجام داده است	she thought her father did it purposely when she was there
دارم بهت می گم که من نمی تونم تحمل کنم .	I tell you I can't bear it
من در صدد هستم که درباره سگ پشمالوی یک کنتس یک بیت قافیه دار بنویسم.	I long to compose rhymed couplets upon the poodle of a countess.
پس از مرگ مایکل مادرم و من تنها ماندیم.	I was left alone with my mother.
نیکلای که به زحمت خود را روی زین نگه داشته بود مشاهده کرد	almost before he had righted himself in his saddle
آن جوانک ریز نقش در دفتر پیک اکسپرس که یادت هست	you remember the little chap at the express office
با مراقبت کنتس و توجه کنت اشیاء لازم و پول کافی برای تجهیزات و لباس رسمی افسر جوان مهیا شد.	money and all things necessary for the uniform and equipment of the newly commissioned officer were collected.
اتومبیل با صدای گرم پی به زمین فرود آمد.	with a slight bump, they hit the ground.
ارد تو نابکار تا دسته در سینه من جای گیر شده بود.	which protected my breast!
آماده شد تا به شهر و سپس نزد مادرش برود تا امضای او را برای وکالت نامه بگیرد.	he began to get ready to drive into town, and again to his mother's to get her signature to the deeds.
به عبارت دیگر یک مرد در میان دو دیوانه ساز وارد اتاق شد.	or at least one man, flanked by two dementors.
من میرم ترموستات رو پیدا کنم و درجه گرما رو بالا ببرم.	I'm going to find the thermostat and turn the heat up.
در همان جای و به همان وضع که حاجب او را گذاشته و رفته بود ایستاده بود.	in the same place and the same attitude in which the usher had left him.
بلکه از آن بیچارگانی است که به بازوی توانای او نیازمندند تا پهلوان ایشان را در بدبختی و سیه روزی یاری کند و به حمایت آنان برخیزد.	but to all those who had need of him to protect and aid them in their misfortunes.
حالا حالاها باید درس به خونی تا به اون حد برسی.	yeh'll need a lot more study before yeh get ter that level.
بعداً باید حسابی برایم تعریف کنی چه جور جایی است.	I shall depend upon a most particular description of it.
زیرا تا زمانی که چیز دیگری از ذرات باقی بود. احتمال داشت نابود شود.	for the corn could go, as long as something else remained.
با این حال با حداکثر توان خودم در این امر خیر تلاش خواهم کرد.	yet I am willing to aid you to the utmost of my power in a purpose so honest.
از سال 1980 به طور علمی مورد بررسی و آزمایش قرارگرفت.	has been scientifically tested and measured since the 1980s and,
کورکورانه و سکندری خوران به فروشگاهش بازگشت و در را پشت سرش قفل کرد	blindly stumbled back into his shop, bolting the door behind him.
می تونم بذارم که بره ولی ازلحاظ اصولی این کار درست نیست.	I could let him go, but it's the principle of the thing.
این میز لنگه دری بود که روی دو بشکه تکیه کرده بود	made of a door with its hinges still hanging on it, laid across two barrels.
لکن از اینکه مبادا از راه ناامیدی بعضی حرکاتی به میان آید وحشت دارم	but I fear I am not altogether wrong in dreading some desperate attempt
بهتر است بمیرد تا آن که دیگر بزرگ نباشد.	then it were far better to die rather than to sink from greatness.
تا شب هنگام جریان خونش خلاف جهت جریان عظیم مغناطیسی قطب نباشد.	at night, the circulation of his blood might not be interfered with by the great electric current of the globe.
سراپا لخت و عور با یک فکل ارگاندی روی سر.	stark naked, with an organdy ribbon in her hair.
از فکر این که این جور خر شده و گذاشته است که آن جور برانگیخته بشود	to think he had been such a goose and betrayed such a suspicious excitement
همین که پا به پانزده یا شانزده سالگی گذاشت	she was filled once she reached fifteen and sixteen
گویا به سرعت اندیشید و تصمیم گرفت که چه بایدش کرد.	having evidently reflected and decided how to act
اما زنم حاضر نیست آن را به اطاق نشیمن ببریم.	but my wife will not have it in the drawing room.
یکی از جواهرات خود را بفروشید تا پدرتان بطرزآبرومندی به آرامگاه ابدی خود سپرده شود.	he wrote hastily in the porter's room, so that your father may be decently laid in his last resting place.
راجع به عللی که به سبب آن از قبول این پیشنهادها امتناع کرده بود سخن گفت.	the reasons why he had declined them.
بازوانش دور کمر من قفل شدند و مرا محکم به بدنش چسباند.	his arms locked around my waist and pulled me tight against his body.
از صبح تا شام هم همین برایمان بس است	it gives us, from morning to night, enough to think about
تا رفته رفته در فن مهر زنی مهارت بیشتری بیابند و بتوانند پول بیشتری درآورند.	they had mastered the technique, when of course they would be able to earn more.
که گویی با هلن زیر تاج گل عقد ایستاده است	as if he had been standing at the altar with her.
من عداوتی از تو در دل نداشته و ندارم.	I don't bear malice about it.
فقط یک موجود دم انفجاری دیگر باقی مانده بود.	finally, only one skrewt was left.
که باید مراسم وحشتناکی را که همه از او انتظار دارند انجام دهد و به این جهت باید خدمت گزاری همه را بپذیرد.	which everyone expected of him, and that he was therefore bound to accept their services.
به من گفته شده بود که تو صندوق پست بندازمش.	I was told to put it in the post.
او هنوز یک دفعه هم از پنجره کالسکه به بیرون نگاه نکرده است.	he hasn't once looked out.
به جای یک عمارت اربابی بزرگ و سنگی به خانة آبرومند کشاورز مرفهی تبدیل کرده است.	had hindered it from becoming anything more than the substantial dwelling of a gentleman farmer.
با مهربانی او را به خود نزدیک کرد و هیچ نگفت.	drew her comfortably close and said nothing.
من هم با شما خواهم آمد و هر گاه مرا برانند باز هم تا پایان خواهم ماند.	I'll go in with you, and if they don't turn me out, I'll stay to the end.
سپس در حالیکه صدای خود را اندکی خفیف کرد چنین افزود	she added quietly.
ولی باید اعتراف کنم که به چنین تغییری عقیده ندارم.	though I confess I don't think I shall.
اگر سعی کنی چیزی را از من مخفی کنی ممکن است حسابی توی دردسر بیفتی.	you may find yourself in a pretty bad position if you try to hide anything from me.
زیرا ساکنین آن همچون تنه درختان جنگلی که بریده باشند در خواب خوش غنوده بودند.	for all the inhabitants were asleep, and stretched on the broad of their backs, as the saying is.
ولی از لذتی که در روزهای قبل احساس کرده بود خبری نبود	but the pleasure she had felt on other days was gone today
اما آخرین حلقه زنجیر این بود که شوهرش در تعادلی دادن برادر و کوچک شمردن خودروی هم رفته صادق نیست.	but the last link in it was that her husband, in exalting his brother and abasing himself, was not quite sincere.
سرزندگی ای که صرفانشان نشاط جسمانی و مکانیکی نبود بلکه حکایت از هوشی آکنده از اشتیاق داشت.	which was the sign of no mere mechanical sprightliness, but of an eager intelligence.
من مطمئنم که اگر به حساب خودم قمار کنم و مثلا دوازده فردریک داشته باشم خواهم برد.	I am certain that, as soon as ever I 'begin to play for myself' and I still have 120 gulden left , I shall win.
او عادت داشت حین این کار سیگار برگی هم بکشد.	in the course of which he was in the habit of smoking a cigar.
در ارتش هیچ کس کاری جز کشته شدن نداشت.	nothing to bother about in the army except getting killed.
که در این باب صاحب تصمیم و ثبات قدم همیشگی خود نیست.	he lacked that strength of will which he had known in himself and really possessed.
هر وقت که خود بخواهم یا لازم باشد باران خواهم بارانید.	will rain as often as it pleases me and may be needful.
لکن در این لحظه درآمدن به اینجا فکر بدی نکرده است و بهرشکل که به اینجا راه یافته باشد	but it is rather a good thing that he has arrived just at this moment.
یا دست کم زبانش چندان کوچک است که امکان بیرون آمدن ندارد.	or at least it is so exceedingly small, as to be incapable of protrusion.
همدردی عمیقش خاموش ماندن را به او آموخته بود.	her great pity had taught her silence.
ناگهان چیزی در زیر لحاف به روی دست و پایش دوید.	suddenly something seemed to run over his arm and leg under the bedcloth
من انتظار داشتم که دیوارها تا آخر مرز هر مربع امتداد داشته باشند.	I would have expected walls stretching the entire length of the boundaries.
خیلی هم بهش احتیاج داشتی که حاضر شدی این نمایش رو راه بند ازی.	you wanted it badly enough to put on quite a show.
بگویند که من در آنجا انتظار صدور فرمان اعلی حضرت را دارم.	let him know, I there waited his majesty's command.
تا آنجا که نیرو در تن داشتم چنان به یک مرغ کتان پرتاب کردم	threw it with all my strength so luckily, at a linnet
که زودتر از موعد پیر و فرسوده شده بود.	but haggard and old before her time
این جمله آخری را با صدای بلند و با ناامیدی اداء نمود.	she cried aloud in her despair.
دو ماه پیش خوشوقتی آن را داشتم که آن را در سخن ماهانه بخوانم.	I read it with pleasure two months ago in the _Periodical Review_.
هواخوری یا ورزش کنند. و یا به میل خود به جست و خیز بپردازند.	to practice calisthenics orrun and leap as they chose.
تا حالا اصلا هیچ زنی رو دوست نداشتم که به وام باهاش ازدواج کنم.	I've never yet wanted a woman bad enough to marry her.
من همچنان روی نظرم ایستادم و مطمئنم هیچ ضرری به رایشان ندارد.	I am equally stout in my confidence of its not doing them any harm.
اگه به هم فرصت بدی می تونم جبران کنم.	I can make this right if you give me the chance.
فی الحقیقه این دو نفر صدای دانتس را به هنگام رسیدن به آب شنیده بودند	doubtless these strange grave diggers had heard his cry
البته در صورتی که خودتان مایل به ایجاد روابطی با او نباشید.	unless, of course, you are yourselves desirous of getting into communication with him.
که وظیفه دارد به این نقاش صرف نظر از خوبی یا بدی کارش کمک کند.	it was his duty to assist the artist regardless of whether the picture were good or bad.
درک خیلی از مسایل نقاشی احتیاج به یادگیری دارد.	there is a great deal in the feeling for art which must be acquired
که مانند یک اعتقاد باطل عمومی در همسایگی پاریس	which is all the more curious and all the more precious
در ساعت چهار بعدازظهر به کارها سر و سامان بخشید.	by four in the afternoon she was successful.
من هم راحت و آسوده نبودم اما با این وصف کلاهم راور نداشتم.	I warn't easy myself, but I didn't take my hat off, all the same.
کنار گودال و تیر جمعیت کثیری به شکل نیم دایره ایستاده بودند.	near the post and the pit a large crowd stood in a semicircle.
کمرش یا از پیری یا از رنج و خستگی خم گشته بود	he was hunched, as if with age or weakness
به طوری که صدای تیک تاک ساعت روی پیش بخاری مثل صدای چکش بود.	so that the clock ticking on the mantelpiece beat like a hammer.
میخ وام که گزارشی راجع به ان تهیه کنی.	I want you to cover it.
پلیس حدس زد که جبر کار باید سوی پاریس رفته باشد.	the police had supposed that he had betaken himself toParis.
تابستان در کالبد درختان به خواب عمیقی فرو رفته بود.	summer lying dormant in unnumbered skeleton trees.
کاش آن چای و نان و شوربا رانیز نخورده بودم.	I wish I had not taken that.
که خواهرش بود و ده سال کمتر از او داشت.	who was his sister, and ten years his junior.
آنگاه که به او رو کرده بود آن حال دیگر در چشمش نبود.	when she turned back the expression was gone.
که شوهری که خداوند زنی صاحب جمال به او عطا فرموده است	that a married man upon whom heaven had bestowed a beautiful wife
تا وارد شود و خود را به گرد قلب خسته و فرسوده آن سرزمین بتند.	to enter and twine itself about the weary heart of the land.
روی همان نیمکتی که در ایام اخیر از آن بیم داشت خواباندند.	laid on the very couch he had so feared of late.
در اینجا باید درباره ریسمان جادویی و گاه وحشتناک وال سخن بگویم.	I have here to speak of the magical, sometimes horrible whale line.
آنگاه بیک ضربت سر دوست خود را درست مانند سر گوسفندی از تن جدا کرد و ساعت او را ربود.	 he cut his friend's throat like a sheep, and took the watch.
اکنون نوبت او بود که به فکر فرو رود.	it was her turn to think.
تا لباس کشیشی او را برای همیشه از تنش بدر کنم	I'll pull off his cassock,
از روی پاتختی عینکش را برداشت و به چشمش زد و با عجله به سوی پنجره رفت.	snatched up his glasses, and put them on, then hurried back to the window.
زیرا هشت روز دیگر من از این مملکت دور خواهم شد.	in a week I shall have left this country
یک زمانی آنجا ساکن بودم و هنوز هم اگر بتوانم برمی گردم آنجا.	I dwelt there once, and still I return when I may.
اما شباهت آن دو فقط در همین جنبه است.	but there the similitude ceases.
حیوانی که دراز به دراز جلو ما افتاده بود	was lying stretched before us.
هم به خاطر کنجکاوی و هم به منظور احتیاط.	partly curiosity, perhaps, and partly as a kind of precaution.
که سروان از عنایت ایشان قرین وجد و مباهات شد.	that the captain was much gratified by their good will.
او که مقصود مرا حدس زده بود اعتراض کرد	she objected, guessing my motives.
همیشه در زندگی یه احساس به خصوص داشتم که بالاخره یه روزی یه اتفاق معرکه به رام میافته.	all my life I had this feeling that something wonderful was about to happen to me.
چون که از بس که در آب مانده بود صورتی برایش باقی نمانده بود.	because it had been in the water so long it warn't much like a face at all.
چنان بخواب خوش فرو رفتم که هرگز در عمر خود نظیر آن را به یاد ندارم.	where I slept sounder than ever I remembered to have done in my life
آن دو مسافر دیگر نیز در میان جاده بر جای خود متوقف ماندند.	they re mained in the road below him.
بتواند از این دورنمای وحشی از صمیم قلب سرمست شود	should yet exult to the depths of his heart in this wild panorama
من هم کابوس اون موجود رودیده ام. می دونم که همیشه دنبال ماست	I dream of him, how he's lookin for us even now
شاهزاده یقین حاصل نمود ناستازی گرفتار وهم شده است	so that the whole thing turned out to be an illusion on her part.
حتی اگر کسی هم از گذشته او به نویسنده این آگهی اطلاعی بدهد همین جایزه را دریافت خواهد داشت	or tend to throw any light upon his previous history, in which the advertiser is
از من خواهش کرد که بدی دن او بروم.	he asked me to go and see him.
پس از اینکه مردی بی درنگ پنج شش هزار تن از رعایای اعلی حضرت خواهند توانست که در دو سه روز گوشت ترا از استخوان جدا کنند.	immediately upon your death five or six thousand of his majesty's subjects might, in two or three days, cut your flesh from your bones.
همه مرتباً در حال رفت و آمد و انجام کارهای مربوطه بودند	as much dashing about as in those days
زیر مسیر شراع پرنده خزید و سریع سر طنابی را به دست گرفت	crawling under the path of the boom, whipped hold of a rope
قبل از اینکه کارشو بسازم بهش گفتم که برای چی اومدم.	I told him why before I lit into him.
بعد به سرعت به روی تمام زندگی دنیوی او و همه چیزهائی که دیده بود بسته شود.	but whichwas as quickly closed again on all the earthly life he had everknown.
گمانم همیشه راجع به این موضوع متأسف خواهم بود.	I guess I'll always be sorry for that.
زیرا در او کشش و تمایل بسیار زیادی وجود داشت	absorbed in the irresistible attraction
در میان افرادی متعجب و واله قرار گرفته بودیم.	I was in the midst of the astonished family
حالا آنجا نشسته بودم و شش دانگ حواسم متوجه بساط چای و قهوه بود	I'm sitting here, my attention firmly on the tea trolley
یه اتاق دی گه تو یه خو نه دی گه	some other room in some other rooming house maybe
اگر حاجت افتاد پیکی را که برده است با خود به حضرت شاهانه ما باز گرداند.	once in every moon, and return the said messenger back if so required safe to our imperial presence.
من عاشق اینم که اون زالوهای نازنین رو ناز کنم	I just love to coddle those darling leeches.
شما قادر نیستید آن را با کمتر از سالی و هزار پاوندبگذرانید.	you can't do it on less than two thousand a year.
شایسته نیست بیش از این کشیش را منتظرم بگذاریم	it won't do, to keep the clergyman waiting.
در عالم خیال خود را به فرمانداری ایالت رسانده بود.	he saw himself becoming governorof the state.
هنگامی که از تابلو رو برگرداند روی مبل نشست	turning from the miniature sat down
گفتگوی با کندو دار که به وی برخورده بود سخن گفت.	a talk with a beekeeper she met
پس از چند لحظه از روی ناچاری وارد حیاط خلوت عمارت شدم و یه پشت دری رسیدم.	I walked round the yard, and through a wicket, to another door
سر را نیز به جلو خم کرده بود تا بهتر بتواند سخنان رئیس را که مشغول قرائت خلاصه اتهامات او برای قضات بود بشنود.	his head thrust forward to enable him to catch with greater distinctness every word that fell from the presiding judge, who was delivering his charge to the jury.
همچنین اقدامات جوانمردانه و عادلانه کسانی را که افتخار مستشار بودن شاه را دارند خواهند ستود.	as well as the fair and generous proceedings of those who have the honour to be his counsellors.
با این همه من این را نوعی تعارف می شمارم.	which, however, I take for a great compliment.
آنهم در حالی که خویشتن را یگانه حیوان عاقل و حاکم کشور خود بداند.	when he considers himself as the reasoning, governing animal of his country
پدرش را دید که همان پالتوی رنگ و رو رفته ده سال پیش را به تن داشت	she observed her father in the same old winter overcoat he had worn for a dozen years
در تمامی دوران رنج بار تولد حزب هواداری سرسپرده باقی مانده بود.	had remained, through all its travails, a committed supporter.
من این زن را با اندوه و نفرت ترک گفته بودم	I had left this woman in bitterness and hate
غیر از خودش کسی نیست که از آن دفاع کند.	with no one but himself to defend it.
اکنون که من این قایق را پیدا کرده بودم	now that I had found the boat
خواستم آن را بردارم. اما مناعت نفسم مانع شد.	which I was too ashamed to touch.
همونطور که بهش خیره شده بودم منتظر مو ندم تا حالم بهتر به شه.	I stared at his face while I recovered, recognizing another change there.
چون در واقع دیواری تمام محوطهٔ کاخ را احاطه نموده است.	by virtue of the wall surrounding the entire place.
به همان اندیشه و احساس تبدیل شود کاری بس دشوار است.	transmute itself back into the selfsame feeling and sensation.
بعید نیست که آنچه به نظر ما یک ساعت آمده است به نظر او سه روز و سه شب آمده باشد.	maybe what seems to us an hour would seem three days and nights there.
آنگاه زورق خود را در استخر بزرگی که نزدیک خانه ارباب بود محض آزمایش در آب انداختم	I tried my canoe in a large pond, near my master's house
لذا او لحن خود را عوض کرد و با خشونت دستور داد تا شلوارم را درآورم.	so he changed his tone, and sharply ordered me to take off my drawers.
در قانون مذکور مصرح است که هرگاه کفشدوز با قالب کفشی که در دست دارد ضربتی به دیگری بزند هرچند واقعاً آن قالب از چوب باشد	if, for instance, the cobbler strikes another with the last which he has in his hand, though it be in fact a piece of wood
به زحمت از وسط اتاق ردشدم و جعبه را زمین گذاشتم.	I pick my way across the room, dump the box on the floor
در این میان صدای سرفهٔ خشک و کوتاهی به گوش رسید	they heard a little dry cough on the staircase
بنابراین مقدر من چنین بوده است که این راه را در پیش گیرم	I am, therefore, in a measure constrained to follow that road
حقیقتش ای نه که من نمی تونم به این کار رضا بدم.	I will notconsent to it.
دیوید بی اختیار از خودش پرسید کدام یک از آن پسرها خوش شانس تر است که دل کیت را به دست آورد.	he found himself wondering which would be the lucky one.
دربارهٔ موضوع دیگری با شتاب شروع به سخن گفتن کرد چنانچه گویی اکنون بیشتر به آن موضوع علاقمند است.	she began immediately talking of other things, as though they were of absorbing interest to her at the moment.
امّا من برای همیشه یک دختر نابالغ خواهم ماند.	I shall never be grown up as long as I live.
از اینکه باید به شما تبریک بگویم بسیار خوشحالم.	I have great pleasure in congratulating you.
زیرا تا آن زمان نخواسته بود حرفی از آن بزند	for he had never yet liked to mention the subject
در حقیقت ببینم که آیا فروشگاهی در آنجا باقی مانده است.	rather my job was to find out whether any stores existed.
گر نه ممکن است به گوش ایشان بخورد و به دریا سرنگونشان کند.	else it may box his ears and pitch him headlong overboard.
اتاق شطرنج که معدودی در آنجا به بازی سرگرم بودند	the divan room, where they were playing chess
که در ذهن نابینای او وال با عظمت چیزی جز از موش باد کرده یا دست کم موش آبی نبود	that in his poor opinion, the wondrous whale was but a species of magnified mouse, or at least water rat
تا به دعاوی و حقوق مالکیت مردم رسیدگی کنند	presided, for determining the disputed rights and properties of men
سفارش کرد که از جانب او از تجاوزی که ناگزیر به ایشان کرده است عذر بخواهد.	beg pardon of them on his part for the wrong which he could not help doing them.
به من قول داده بودی که باهم به ماهیگیری بریم.	you promised to take me fishing?
تقاتعی که به طرف آن نگاه کرد را شناختم.	I recognized the cross street he stared toward.
آخرین فنجان چای ایام تعطیل را به دستم داد.	gave me the closing cup of tea of the vacation.
البته نه به آن آسانی که شوهرش خیال کرده بود.	but not as pliant as he thought
با نهایت صداقت دریچهٔ دل خود را به روی ژنرال گشود و اعتراف کرد	he had made a full and candid confession.
متوجه نبودم که آن خصائصی که برای ساختن یک موجود بشری بکار می روند چقدر درهم و متعددند.	I did not realise how motley are the qualities that go to make up a human being.
عادات و نقاط ضعف هر یک را میشناخت و میدانست که چه کسی ریگی به کفش دارد.	she knew their habits and weaknesses, and where the shoe pinched each one of them.
اما بی درنگ از آن چه گفته بود وحشت زده و سرخ شد.	but was at once panic stricken at what he had said, and blushed.
خود من هم تا وقتی استحقامو نداشته باشم انتظار زیادی ندارم.	I wouldn't expect very much until I was able toearn it, of course.
امّا نتوانست کمر راست کند و بی درنگ سقوط کرد و باز به پهلو افتاد.	but unable to lift her back, she quivered all over and again fell on her side.
اما پدر من هرگز رأی نداد و راضی به کشتن لویی شانزدهم نبود	but he was not among the number of those who voted for the king's death
که موضوع مورد بحث شورای جنگی یعنی پیکار آینده و پیروزی قطعی حاصله از آن دیگر به آینده ارتباط ندارد بلکه عملی است که واقع شده و خاتمه یافته است.	the coming battle and the victory that would certainly result from it no longer seemed to be in the future but in the past.
بِهِت اطمینان می دم که این برادر عزیزت مست کرده بود.	I tell you that precious brother of yours was drunk.
پرسید که آیا بهتر نیست قبل از معرفی خود بیازماید تا ببیند برادرش او را به گناه فقر از خود خواهد راند	or to ascertain beforehand whether, when he had made himself known, his brother, seeing him so poor, would be ashamed of him
در حالی که دستانم را بردهانم نگه داشته بودم به سمت دست شویی دویدم	I streaked for the bathroom with my hand clamped over my mouth.
ولی بهر حال اوضاع و احوال به هیچ وجه مانع اشتهای زایدالوصف او نبود	which, however, had no injurious effect upon his appetite
در راه بیرون رفتن عکس را به او دادم.	I handed her the photo on her way out.
که هر یک واجد بیست تا پنجاه وال است.	embracing from twenty to fifty individuals each.
سرانجام مجبور شدم از اربابم کمک بخواهم تا او را به رفتن ترغیب کند.	I had to call for my master's assistance in coaxing him out of bed.
فقط به شرط آنکه مجبور به ازدواج با او نشد.	if only he did not need to marry her.
من هیچ عکسی ندارم که واقعاً نشون بده چه خبره.	 'I don't have any photos that really show what's going on,
یعنی آیا آن قدر شجاعت دارد که همراه او به سرزمینی چنان دوردست برود.	whether she would have the courage to go with him so far away?
که چگونه در مجاورتشان گلوله توپی روی یک خانه افتاد.	told how cannon balls had fallen on a house close to them.
در این مسأله مثل دیگر مسایل حق با او است.	he is right in this as in all things.
زیرا این من بودم که او را بر خود برانگیخته بودم.	because I had given the provocation.
بیا با هم جستجو کنیم تا این وجه فراهم شود.	let us see if we can find them for her.
خوب حالا می خوام موضوع رو عوض کنم و تو رو خوشحال کنم و خبری بهت بدم که خوشحال به شی.	change the subject and cheer you up by telling you some news that will amuse you.
از ان جوان ساده دل 18 ساله و کمال گرا که او بود هیچ چیز باقی نمانده بود	idealistic, eighteen year old boy he had been.
البته برای تو به جز مدرسه چیزی جالب تر از کارهایی نیست که شب انجام می دی	apparently there's nothing interesting for you to do at night besides study.
در جای همیشگی خود در اتاق نشیمن زیبا که در میان اتاق خواب دو خواهر قرار داشت نشسته بود	was taking her usual place in the pretty sitting room which divided the bedrooms of the sisters
چه همین جا در زندان و چه در جای دیگر همه چیز را برای مکمیلان اعتراف کند	here or some where and tell him all and get him to say how really guilty
صرفاً به این خاطر که روش کار من است.	if it were only because they are mine
یکی زیباترین موجودی است که چشم هیچ مردی به زیبایی او ندیده است.	she the fairest mortal ever set eyes on.
خلاصه منتی هم برگردن ما گذاشت و چیزی هم طلبکار شد.	that he had conferred a great boon upon us by unselfishly doing it.
یک دستمال پر از پرتغال هم با خود داشت.	with a bundle of oranges tied up in a handkerchief.
میدانم! منظورم این بود که به سخنان من بیشتر توجه کنید.	I know, I only said it to finish the sentence.
بنابر حسابی که کردم بیش از نه ساعت خفته بودم.	as I reckoned, about nine hours.
هیچ دلم نمیخواد که ازت پول بگیرم ولی اوضاع یه طوریه که مجبورم.	I hate to charge you, but with things the way they are
با توجه به اینکه زمین روح بیکران مردی بود که همه ارقام را زیر فرمان خود داشت و این عمل ضرب بسیار آسان بود.	a very poor rate of multiplication when the field is a young gentleman's infinite soul, with all the numerals at command.
در زیر باران نمنم و از بین ردیفهای درو شده به سوی اسب خود رفت.	slightly sprinkled with rain, to get their bread from the heap of coats, he went towards his house.
لباس زرد رنگی بر تن و روسری سفیدی بر سر داشت.	dressed in a yellow print gown, with a white kerchief on her head.
معلوم بود که همه جا و همه چیز برای او ظلمت محض است.	one saw that all to him was void darkness.
در صورتی که ایشان حاضر شدند نخستین کلمه حرف او را بشنوند دیگر تا پایان آن را استماع خواهند فرمود	that if the lady will only hear the first word she has to say, she will know whether to hear her business
گنج حقیقی من حضور شماست و بودن در خدمت شما و تعلیم گرفتن از شما	my real treasure is not that my dear friend it is your presence our living together five or six hours a day in spite of our jailers
از شیر دیگری کف سفید و غلیظ بیرون زد.	another poured ice white foam so thick
بیست تا نجیب زاده رو با هم یک پنی نمی خرن.	fine gentlemen are going twenty for a penny?
هر سه نفر ما به آن زل زده بودیم	we glared at it, all three
پیراهنی اسپرت شبیه به روپوش بیماران به تن داشت	with his sport shirt which looked like a hospital jacket
در ایام قدیم معروف بود که معبد تمام خدایان یونان است	called in ancient times the temple 'of all the gods,
از آن نجابت که این دختر به جهت تحصیل انتقام پدر ظاهر ساخت.	with that noble girl, thus pursuing paternal vengeance
در آن موقع هنوز از گناه دائمی زن خبر نداشتم.	I did not then know the besetting sin of woman
نخست پنداشت که چون حمله او بدون دستور بوده بی شک فرمانده کل او را احضار کرده است	remembering that he had charged without orders,felt sure his commander was sending
بلکه حداقل نرخ مجلات درجه یک دو سنت برای هر کلمه است.	but that the minimum rate paid by first class magazines was two cents a word.
تنفس کوچولویش که آنقدر شیرین است به من لذت خواهد داد.	her little gentle breathing will do me good.
من هم قصد ندارم این فرصت را به کس دیگری بدهم.	I dont intend giving anyone else a chance.
خدا کند آرزوی مشترک ما هر دو برآورده شود	heaven grant that your wishes and mine may be realised
چون تمام نفرات آرام به ته دریا خواهند رفت.	on account of all hands gently subsiding to the bottom.
اگه خودت و برادرت پول هاتونو جمع کن ین شاید بتون ین یه شاخه یه شاخه بخر ینش.	I suppose you and your brothers have to save up twig by twig.
همان وقت که با رای مجلس مخالفت کنید .	even if you disagree with the council's decision.
در حالی که قایق کوچک بخاری را چنان به شدت هل داد	she exclaimed, launching a penny steamer so vigorously
دختر جوانی پشت میزی نشسته و پیشخدمتی در کنار او بود.	the maitre d'hotel and a waiter and a girl behind a desk.
از قطار شترها و افراد گذشتم و دور شدم.	, back past the long line of men, and past the baggage into the emptiness behind.
آری طلا و تو باید توی طلا غلط بزنی!	you may lay to that!
برای ده کوچکی که آن دور در آن طرف آب پهناور در خواب بود	for the little village sleeping in the distance beyond the majestic waste of water.
من دو ساعت پیش او را ترک کردم و قرار است چند دقیقهء دیگر نزد او بازگردم!	I left him safe and free within these two hours, and am about to return to him!
تا وقتی که گوشی را بر نداشته بودم متوجه اشتباهم نشدم.	I didn't realize my mistake until I held it to my ear.
دلاک قبضی به شکل مرسوم دایر بر وصول پول به کشیش سپرد	the barber executed a full receipt
هاک حاضر بود هرچه داشت بدهد و جواب مناسبی گیر بیاورد.	he would have given anything for material for a plausible answer
کبوتر با کبوتر باز با باز کند همجنس با همجنس پرواز.	wipe the nose of your neigbbour's son, and take him into your house.
خانم و مالک امپراتوری ای از گرد و خاک و تار عنکبوت شده بود	but the lady and mistress of an empire of dust and cobwebs
من ملوانی هستم که باید در اینجا سوار کشتی بشوم.	I'm the seaman who's got to join his ship here.
من هم ون موقع بهش گفتم که یه مدتی از لیکرگس بره بچه شو یه جای دی گه به زاد.	I told her right away if she wouldgo away for a while while she had her baby
در گوشة دیگر اتاق روی صندلی نشست و به زمزمه کردن پرداخت.	remained at the other end of the room, and sat singing to herself.
چه عروسی زیبای قشنگ دلربای کوچولویی سر خواهد گرفت!	what a sweet, charming little wedding this will make!
خانم کار سن اصرار داشت که قبل از دفنش نامه را بخواند.	she had insisted he read it before he buried her
چون هر چیزی در اطراف مادرش همیشه هیجان آور بود.	for everything around her was always exciting.
این پول را به طور مسلم تو به من نشان دادی تا متقاعدم کنی.	you showed me those notes just now to convince me.
بعد هم نیم ساعت طول میکشه که به در خو نه اصلی برسیم.	then another half hour before we git to the main house.
من فکر تو راحت میخونم ولی خودتو کنترل کن.	I can read you like a book but control yourself.
حالا با کسی به مقابله ایستاده بود که از نظر او احمق بود.	faced by a man whom he considered dumb, one
وقتی شما بروید او هم دست از گریه و زاری برمی دارد.	or else she will be sick, only to grieve us.
میل نداشت دفتر خساب مغازه را که جلدی کثیف داشت در اختیارش قرار دهد	was reluctant to give her the large dirty backed ledger.
ولی اتفاقی که برای ما خواهد افتاد بسیار عجیب و خوش خواهد بود.	but it is very strange and pleasant whatever it is.
می خوام فقط واسه یه مدت کوتاه دور به شم.	I want to just get away for a little bit.
خود را چنین دل خوش کرده بود که شاید روز دیگر خود او اشتباهاً به آنجا بیاید.	convinced that he was going to arrive on some other day by mistake.
او در حال نوشیدن یک لیوان آب از دیدن من هاج و واج شد.	is drinking a glass of water and looks startled to see me.
خیلی خوشحالم که بالاخره برای خود سرگرمی و مایه تسلی پیدا کردهای. برو.	I'm glad you possess a consolation
وقتی این اسم را شنیدم یک مرتبه از جایم بلند شدم.	I started to my feet when I heard the name.
پیش از آن که ما از دید آنان دور بشویم	just before we lost sight of them behind the little point
به کناری نهاد و سر مرا در بین بازوان گرفت و تنگ فشرد.	opening her arms wide, took my curly head within them, and gave it a good squeeze.
نمیخواسم اونجا وای سم ترسیدم دی گه نتونیم رد به شیم	I didn' wanta stop there, fear we wouldn' get acrost.
بعد از آن دیگر کسی از پس او بر نیامد.	after that there was no doing anything with him.
تنها گرد بارد میس انان را در امان نگه داشته بود	land mines and only the mis kept them safe.
میس استپلتن هم زن بسیار جذاب و دلربایی است.	she is a very fascinating and beautiful woman.
در ین هنگام چشمم به جزیره کوچکی افتاد که نیم فرسنگ با من فاصله داشت	when I spied a very small island about half a league off
دیگران خود را وارد زندگی او کرده و از رسیدن به هدف بازش داشته بودند.	others had thrust themselves into his life and thwarted his purposes.
آن قدر این کارت به نظرش قشنگ او مد	she just figgered it was so purty
اما هیچ دوست و آشنایی در آن سالن نداشت.	but she had not an acquaintance in the room.
که کشتی اوریون که بعدها در برست بم نزله کشتی تعلیم بکار رفت	the in habitants ofToulon beheld the entry into their port, after heavy weather
کامیون من یک زندگی دراز و پربار داشت و به دلایل طبیعی اوراق شده بود.	my truck had lived a long, full life and then expired of natural causes.
بیست و پنج سنت باقیمانده را به کلاید پس داد و در را بست.	handing him the quarter and closing the door.
ما مجبوریم به طرفش خم بشویم تا بتوانیم صدایش را بشنویم.	we have to lean in to hear.
در نتیجه ناگزیر شدند قشون خود را هنگام نبرد از راست به چپ انتقال دهند.	consequently had to move their forces from right to left during the battle.
انگار که دیگر در دنیا هیچ بدی به من نکرده بودند.	it seemed like I couldn't ever feel any hardness against them any more in the world.
حالتی که چندان نگذشت که به سرخوردگی بدل شد.	in a very thoughtful mood, which turned rapidly into a depressed one.
در همین فاصله کوتاه هر دو در اتاق را از داخل قفل کرد	in that interval he fastened the two doors of the house against me
ولی می گم یه وقت نکنه که تصمیمتون عوض به شه .	only, well'm, you mout change yo' mind.
تلفنم را کنار گذاشتم و دستی به موهایم کشیدم.	I put the phone away, run my fingers through my hair
به او فرمان داد تا عشق خود را در اختیارش بگذارد.	the command to give him love.
بیشتر وقت را در اطاق به قدم زدن پرداختم.	I walked about the chamber most of the time.
یقیناً از آن روی گردان شده و از محل کار نیز فرار خواهد کرد.	he'd run away simultaneous, your worship
اشک از چشمش جاری شده بود و فقط با آهنگی مرتعش توانسته بود سخنان خود را تمام کند.	before tears gushed from his eyes and he concluded in a trembling voice.
منی دانم که چند نفر این توانایی را دارند.	I don't know many who could.
لکن شاید در قلب شما یک غم اسرارآمیزی لانه کرده باشد.	but I think you may have some secret sorrow.
خانم دست دراز کرد و از او خواست زوبینش را بدهد	the lady reached forth her arm, and demanded his harpoon
هیچ قسمت از بدنش درد سر خاصی برایش درست نکرده بود	no part of her body was giving her particular misery
من توانستم قایق را به نیرومندی به سمت مقصد برانم.	I could keep her steady for the goal.
چیزی هست که باید به سادگی روشن گردد و نگریسته شود.	there is that whichit is simply necessary to elucidate and examine.
امکان ندارد کسی پسری بهتر از این داشته باشد	that it was impossible for any body to be a better son
از طرف اورسولا نیز به عنوان عضوی از خانواده پذیرفته شد.	but 'rsula received him as a member of the family.
چه قدر دلم میخواس همه چیز به دلخواه با شه!	I wisht it could be all'nice.
برای مشورت یا کار دیگری از او سر بزنند.	by to see him about something.
شاید در آن زمان قدرت من برای تحمل آن زیادتر باشد.	by that time I may be enabled to bear it better.
بعدا که شهر کمی نظم و نظام یافت همین مسئله را به او گفتم	I made that remark to him afterwards when we met after some sort of order had been restored in the town
بار دیگر آرامش خود و شور زندگی را به دست آورد.	which restored her tranquillity and her will to live.
با رنج و اندوهی شدید بار دیگر روی بالش افتاد و حالت ضعف به او دست داد	then sank back in a swoon.
سپس کشیش و دلاک در طرف دیگر بانوان مستقر شدند.	by the side of the ladies, the curate and the barber.
مقتولین شماره نشده به شماره آید و فرماندهان جدید به جای مقتولین تعیین شوند	the slain reckoned up, new officers appointed to replace those who had been killed
از قضا همسرش موسیقی شناس بود و ارزش داشت به دیدارش رفت.	he happened to have a wife who was musical and altogether worth calling upon.
که البته مارتین خیلی زود اجازه ورود به آن جا را یافت	where he had of course obtained admission at once
اما مشاهده کرد که هنوز به بینوایی واقعی پی نبرده است.	but he now perceived that he had not known real misery.
آماده برای گریختن به ساحل بدون اینکه برای جنگیدن درنگ کنند	ready to flee at once on shore without waiting to be assailed
کاملاً بم وقع است که بداند مادرش که بوده!	it's quite time he did know what his mother was!
یک دقیقه منتظر ماند تا از او فاصله بگیرد.	gave it a minute's head start
نه به خاطر حرفی که زد بلکه به خاطر صدایی که آن را گفت.	not from what he said, but the voice that said it.
فقط آن را پهلوی جو از خودتان و من بگذارید.	put it up carefully with mine and your own.
من ترتیب ان را از طریق گمرک خواهم داد.	I'll make the arrangements with customs.
آن مرحوم مارسل را نخستین بار در پای همان چشمه دیده بوده است.	that was the place where he first saw her.
آخر قرار بر این بود که با هم باشیم.	has it not been agreed that I should take you with me
از ای نرو اگر برخلاف انتظار آنان و پس از آنکه حکم به مردن بیمار کردند آثار بهبود در او هویدا شد به جای آنکه به عنوان پیغمبر دروغین متهم شوند	therefore, upon any unexpected signs of amendment, after they have pronounced their sentence, rather than be accused as false prophets
به یاد آن محکوم در خلنگ زار بادگیر و سرد و بی پناهگاه افتادم.	I thought of the convict out upon the bleak, cold, shelterless moor.
کسی هم به فکر نیفتاده بود بپرسد همه هستند یا نه.	no one thought of inquiring if any one was missing.
که از کمیابی آن در جهان هنر بیش از هر جای دیگر خبر داشت.	he knew its rarity in the world of art more than anywhere else.
اما در آن هنگام هنوز به درستی فشار پیشامدهایی ناخوشایندتر از این کار را احساس نکرده بود.	but he had not then known the full pressure of alternatives yet more disagreeable.
چند آجر هم از سقف طویله به پایین افتاد.	several tiles were blown off the roof of the barn.
رنگ آن ستون کاملاً سفیدست تا هم از فاصله دور و هم در تاریکی دیده شود.	whitewashed, I suppose, to be more obvious at a distance and in darkness.
که فساد طبیعت و شرارت نفس تو از جانب پدر توست	the crime is that of your father, not yours
بنابراین نه تنها باخت 1600 روبل بلکه لزوم نقض عهد با پدر به هفت خال بستگی داشت.	so that this seven of hearts meant for him not only the loss of sixteen hundred rubles, but the necessity of going back on his word.
اگر جواب منفی بدهی تا آخر عمر حتماً احساس پشیمانی خواهی کرد.	because whatever you do, you will be sorry all the rest of your life if you say no.
ولی او به رغبت حاضر به این کار نبود.	but he only consented grudgingly
را با آراستگی تمام به روی پیشانی انداخته بود به درون اتاق آورد.	braid of hair laid carefully above her forehead, into the middle of the room.
از آنجا که آن شب تا دیروقت بیدار مانده بودم	as I was sitting up late
به خاطر تنگدستی یا به سبب ارتکاب جنایات ناگزیر از زادگاه خود گریخته بودند.	forced to fly from the places of their birth on account of their poverty or their crimes.
که جوهر و ماهیت روح است و به مراد و مقصود خاصی نیز ندارد.	which is the very essence of the soul and does not require an object.
به من مربوط نیست که نِسی تنها خون آشام دورگه ایه که با اون نسبت فامیلی ندا ره	I don't care if she is the only half vampire he's not related to.
تنها حرفی که مارتین توانست بزند چنین بود به گمانم تو از اصطلاحات فلسفی گریزانی	I imagine it's the philosophic slang that bothers you, was all he could say.
ظاهراً هدویگ نیز به اهمیت مسئله پی برده بود	who seemed to have realized how important this was
دختر سرش را تکان تندی داد و خود را از او کنار کشید.	the girl hitched herself away from him with a toss of her head.
به منظور آنکه قطعا دخترش را تنها ملاقات کند صبح زود نزد او رفت.	she drove to her daughter's early one morning so as to find her alone.
حتی تصمیم گرفتم که برای خاطر ان هم شده رژیم بگیرم و وزن کم کنم	I even decided I must have lost weight, because they didn't feel too bad.
قبل از رفتن هم از کاترین خواست زیاد سرو وضعش را تغییر ندهد.	left her with an anxious entreaty that she would make as little alteration as possible in her dress.
اینجا و آنجا جاشوهای پیر توی آفتاب نشسته بودند.	here and there old seamen were basking in the sun.
برای آنکه در ازاء آوردن این اخبار خوش و غیرمترقبه مژدگانی خوبی به تو داده باشم	in guerdon of this news, as unexpected as it is good
آن کافر احمق نبود و از شیوهی سگ آبی تقلید کرد	the pagan had shown his discretion and imitated the beaver
تا اینکه برفراز سرخود صدائی مانند صدای به هم خوردن بال و پر مرغان شنیدم.	I heard a noise just over my head, like the clapping of wings.
حتی استعداد آن داشت که به مسائل معنوی توجه کند.	he was even not incapable of taking an interest in the things of the mind.
ما به همین منوال به زندگی خود ادامه دادیم.	so we lived,' he said
از کودکی عادت داشت که بر لبهٔ چنین پرتگاهی قدم بردارد و در کام آن نیفتد.	from his childhood on he had been used to treading on the edge of such abysmal depths, and contriving not to topple over.
با این همه تصدیق کنید برای انتشار این مقاله نیازی بمو افقت او نبود.	but you will admit that I might have done so without his consent.
ببخشید که دیر شد و این قدر منتظر ماندند.	I'm sorry you were kept waiting
هنوز چهارصد و بیست و دو صفحه مو نده!	I've still got four hundred and twenty two pages to read!
تو که نمیذاری من به ارتش ملحق به شم.	since you wouldn't let me go in the army.
اما برایت امن تر است که بی گدار به آب نزنی.	but it's safest not to tempt fate.
هنگامی که من و مادرم در آن شب سرد و یخبندان پای در این راه خطرناک نهادیم	when we two set forth in the cold night upon this dangerous venture.
این خواسته که خود را کام لاٌ به او تسلیم کند	this demand that she should surrender herself up to him entirely
آن هم اگر تحقیر من تغییری در حالت شما نسبت به من نداده باشد.	if contempt has not banished it from your heart
ملاحظه کرد که به چند پنجره هلالی رسیده است و آنجا روشنایی کمی دید.	he observedthat he was coming to some arched windows, where he perceived a light.
که طفل خود را در آغوش گرفته و از این خانه بیرون برد.	take the child in his arms, and flee far, far away.
چند تن از سرکردگان را که فرمانده آنان بودند نیز در آنجا قرار دادم تا سواران را مشق دهند.	ready mounted and armed, with the proper officers to exercise them.
میخ وام تا بهارآینده اونا توی سوراخ موش باشن.	I want those people hiding in holes by next spring.
این که ابتدا به او اطمینان ببخشند که نابغه است	to be assured of his genius, first of all
این شیوه زندگی ناگهان تمام جذابیت و فریبندگی خود را از دست داد.	the news of which reached him almost at the same time.
یه کسی یه بالش پر زیر سرم گذاشته بود.	I rolled over and wrenched myself into a sitting position.
من دیدم که او چیزی از کف دست خود که چوب دستیش را با آن گرفته بود بیرون آورد و در کف دست ناخدا نهاد	I saw him pass something from the hollow of the hand that held his stick into the palm of the captain's
تا یک جوری از مذهب و اخلاق در آن چیزی بگویند.	to squirm it into some aspect or other that the moral and religious mind could contemplate with edification.
به پدر و مادر خود نوشت که مایل نیست بین آن همه موهومات زندگی کند	she wrote to her father and mother that she wouldn't go on living conventionally
به سویش آمده است به این امید که او از این مجال بهره بجوید.	she was courting him, giving him the opportunity he was seeking, wishing him to take advantage of it.
من به کلی نومید شده بودمکه وقتی بتوانم با آن دقت یا آن سبک سری سخن بگویم.	I despaired of ever expressing myself with such aptness or with such fluency.
با سبیل جوگندمی و صورت سرخ بیرون دروازة باغش ایستاده بود	was standing, gray whiskered and red faced,outside the gate of his garden
من فوری سرم را پایین انداختم تاکسی از من انتظار نظری داشته باشد.	I lowered my head instantly, and became very busy with the emptying of my own teacup, screening myself behind the cosy.
فهمیدم که این جام نصیب تیم ما می شه.	I've thought the thing was in the bag.
تصمیم گرفت تا از تلفن دفتر پدرش استفاده کند.	she decided to use the extension in the study.
به مین سبب بیشتر به لزوم آن اعتقاد داشت.	but felt the more convinced that it was necessary.
از دری که پشت آن گوش ایستاده بود به اتاق وارد شد	entered the room from the door at which she had been listening.
تو به محض اینکه فرصت مساعدی به چنگ آوردی تا مرا از این زندان آزاد کنی	when thou seest an opportunity for effecting my release
نمی دون ستم می تونم جسد پسر مُرده رو استفاده کنم یا نه.	I wasn't sure if I could use the dead boy's flesh.
خیلی وقت بود که مریض و بی خال بود.	he's been off color for ages, he was wasting away.
تا خود را گم نکند و خدای نکرده تصورات غلطی به سرش نیاید.	for goodness only knew what she was fancying herself.
اما یک خواهش از شما دارم.مرا دوست خود بدانید	but one thing I beg of you, consider me your friend
جای زخم چاقوهایی که به شکمشان فرو رفته بود.	scars of knife thrusts in the belly
یعنی فراموشی مطلق و استراحت کامل و فقد زندگانی	that is forgetfulness, repose, exclusion from life
طومار بافتهء خویش را علیه او باز خواهد کرد	would produce against him that fatal register
همین کار سبب شد که داروساز از خواب بیدار شود.	this awoke the chemist.
که اگر بخواهم چنانکه شایسته است او را وصف کنم و به تو راست بگویم ناگزیرم ادعا کنم که او بسیار شبیه به شما است.	that, to describe her worthily and tell thee the truth, she is very like thee.
کام لا شباهت به چوبه داری داشت که روی زمینش خوابانده باشند.	outlined, with considerable exactness, a gibbet laid flat on theground.
به دو دلداده بیشتر شباهت داشتند تا به یک معلم و شاگرد.	more like two lovers than teacher and pupil.
از سه تن مردی که همراه او بودند بلندتر بود.	was taller than any of the other three who attended him.
اون هم درست موقعی که خیلی از مردم نمی تونس تن حتی یک وعده غذا برای خودش ون فراهم کنن.	when all the rest of us didn't know where our next meal was coming from.
یک حلقه گل سفید را به سوی پیشانی برد و رفت.	raising to her forehead a wreath of white flowers with which she went.
بعلاوه راستوپچین از نظریه جدید که در اردوگاه بر وی مکشوف شد	amazed also at the novel outlook revealed to him at the camp
شاگرد جدیدم حداقل با اکراه خودش را از من کنار نکشد.	that my new pupil would not at least recoil from me with antipathy.
هر دو حاضر بودند با رضایت کامل او را هدف گلوله قرار دهند.	whom either of them would have shot with the greatest satisfaction.
پس از چندی که در آن سرزمین به سر بردم سه چهار بار راه خود را تا مسافتی گم کردم	I afterwards failed very narrowly, three or four times
خیانت ناتاشا را به نامزدش و دوستی خود را به ناتاشا برای سروان حکایت کند.	her betrayal of him, and all his own simple relations with her.
اما قبلا اجازه دهید دربارهٔ روح قهرمانی و نجابت که برادر شما در آن روز ابراز داشت سخنان خود را به پایان برسانم.	in that case allow me to tell you of your brother's highly chivalrous soldierly generosity, for he did give expression to it at the time.
حتی در این لحظه هم به نحوی از او دفاع کند.	in mute appeal that he would, even then, urge something in his behalf.
من در جواب ایشان خواهم گفت که دروغ هرچه کمتر صورت دروغ داشته باشد بهتر است	I would reply that fiction is all the better the more it looks like truth
من هر چند ساعت یک بار باید غذا بخورم.	when I need feeding every few hours?
چیزی نمانده بود قایق نگون بخت در امواج برنزی فام غرق شود فریاد زد	the poor little boat almost sank in the bronze coloured waves.
ولی سرشت تند و ایمانش سرکشی کردند و راست به دامش انداختند.	but he fell straight into it in the violent expression of his convictions.
این گند و کثافت او مد جلو زندگیمونه خرابش کرد!	here this dern foolishness has got to come up and spile it all!
این جا بود که ناگهان فکری از خاظرش گذشت که بدنش را به تکان آورد	then an idea suddenly struck her, which made her shudder
بسیار بلند حرف خواهند زد و دعای خیر در حق تو خواهند گفت.	which will make a great noise, which will talk very loud, and which will bless you
که تجدید این حادثهٔ رسواکننده برای من بسیار دردناک است	that I feel it almost repulsive to recall that event which caused such frivolous agitation
چنان استوار درباره او فکر کنید که او نیز ناچار به شما اندیشد.	to think of her so intently that she is constrained to think of you.
بعد از آنکه قریب به ده دقیقه با سکوت راه رفتند	, after their walk had continued ten minutes in silence
به خصوص که اربابی به نیکی و نیرومندی جنابعالی دارم	specially as I have a man of such quality for a master in your worship
آهسته به پس و پیش گام زدم تا آن مردم بدانند که آهنگ گریز ندارم.	walked slowly backward and forward, to let those people see I had no intent to run away.
زیرا خشم او را بدان حد برانگیختم که ممکن بود هر لحظه جانم را تباه سازد.	because I had succeeded in rousing his rage a pitch above his malignity.
پس بهتر آن است که از رسیدن به او صرف نظر نمایم.	therefore I had better stop.
فرمان دهد که تنها هر دو چشم ترا بر کنند.	only give orders to put out both your eyes.
هم از دسترس بسیاری از رهگذران دور و بر کنار بود.	out of most people's way.
مسابقه به پایان رسید و تماشاچیان را در بهت و حیرت باقی گذاشت.	the game ended in complete confusion.
چنان در میان شال و شنل پشمین خود با دهان پر از سیب نشسته بود	sat there in her plaids and farthingales with her lap full of apples
به آن علاقه پیدا کردم تمام جمعیت قمارخانه در اطرافم ازدحام کرده بودند.	I joined the ring of players, while the rest of the crowd massed itself around me.
در اتاق کار خود را به او نشان داد و خود کمی کنارتر ایستاد تا کریستف داخل شود.	he pointed to the door of his office, and stepped aside to let him pass.
بلکه مانند دزد و راهزن از بالای پرچین دیوار وارد شده است.	but over the wall like a thief and a robber.
این هم نوایی در میان آنان که سهم بیشتری از شراب برده بودند	which led, especially among the luckier
من تنها برای این منظور در اینجا هستم که به او و به شما کمک کنم.	I came simply to help him and you.
این عکس موقعی از او نقاشی شده بود که هنوز عروسی نکرده بود.	this portrait was painted before that, when she was still unmarried.
قبلا در زندگیم آدم خوبی مثل شما ندیدم .	I never before knew anybody who was really good.
تا بدانید این سگ دوپایی که در منزل شما آمده کیست.	if you had them, to know who your two legged spaniel was.
بتواند پیش از آنکه ایشان کام لا به او برسند و از او پیش افتند نیزه خود را به سمت وال پرتاب کند.	he would be enabled to dart his iron before they could completely overtake and pass him.
به خاطر عشقی که برای خود او وجود نداشت.	that for her had never existed
قرار گذاشت که ظرف چند روز آینده به آن اتاق نقل مکان کند.	the room within the next few days
سپس با بار خود از میان آب با پا گذشتم.	I waded through the middle with my cargo.
یک چمدان کوچک متعلق به ما را زیر بغل گرفته بود	a small box of ours under his arm
که طول آن بین هشتادوپنج تا نود قدم باشد	between eighty five and ninety feet in length
آنگاه یک پای خوود را در آن نهاد تا بهتر بتواند دستگیر لیز خود را بر خود تازیانه محکم کند	putting one foot into it, so as the better to secure his slippery hand hold on the whip itself
ولی این بار کریستف بیش از حدّ لزوم به مقصودش پی برد.	but now it was only too dear to him.
من این نقشه را ریختم و او فقط آن را اجرا کرد .	I planned it, and she only gave in after lots of teasing.
شارپ سرخی را روی یک شانه انداخته وارد تالار شد	a red shawl draped over one shoulder
هنگامی که آن جانور موذی را در دست گرفته بودم	while I held the odious vermin in my hands
زیرا که این شخص که هیچ توقعی و چشمداشتی از دانتس نداشت	since this man who had nothing to expect from his comrade
حالا خوشحال شدم که دیدم شما هم این نظر را دارید.	I'm glad you feel that way.
اما بعد سوسوی نوری از صفحه نمایش به چشممی خورد.	but then the screen flickers.
من اجازه ندارم مرد با خودم به خانه ببرم.	I'm not allowed to take gentlemen in there.
تا به اسلوب سال 1829 جایی برای یک دسته زلف باز گذارد.	in order to make room for a tuft of hair, after the style of 1829.
حالا عصبانیت اجتناب ناپذیر همیشگی اش با ضربان خفیف درد درمغزش به هم آمیخته شده بود.	the familiar helpless anger now compounded by the dull throb in his head.
او شال سیاه زیبای خویش را بر شانه داشت.	with her magnificent black shawl on her shoulders.
از این که پدر بی چاره آن خانه را گرفت خیلی خوشحالم.	I am so glad poor father did get that house.
چهره رت ناگهان آرام شد و در هم فرو رفت.	he said and his face went suddenly quiet and somber.
که گویی توده زنده بزرگی از مارهای به هم تافته است.	as if it were a great live mass of plaited serpents.
وجدانم برای آن زن جوان و قشنگ ناراحت بود.	I'd a tender conscience about that pretty young woman.
اما من مث کره اسب شروع به جفتک اندازی کردم.	I bucked like a colt.
گذشت قرون و اعصار نخواهد توانست که به این شش تن هفتمینی بیفزاید.	a sextumvirate, to which all the ages of the world cannot add a seventh.
در سراسر مهمانی عاشقانه و هشیار رفتار کرده بود.	then warmly loving and attentive toward her all through the party.
که برای یاد گرفتن یقه سازی به اینجا بیاید.	that he come to learn the collar business.
در این اثنا از درون کالسکه مردی پیاده شد که از لباسش معلوم بود چه مقامی دارد.	but in the meantime a man had got out of the coach whose dress indicated at a glance the office and post he held
آن وقت این فتنه را با دعای خیر خودتان تسکین خواهید داد.	will quiet them by bestowing your blessing upon them.
سعی کردم او را در آفتاب کنار ساحل مجسم کنم.	I tried to picture her in the sun on the beach.
هیچ لازم نیست دنبال کسی بگردم که بایید و مرا با خود به تئاتر ببرد.	I need never want for men who'll take me to the theatre.
به دخترک نزدیک شد تا به او چیزی بگوید.	drawing close to the girl, said, in a whisper.
اما همین الان به خاطر یک کار ضروری به استودیو احضار شدم.	but I've been called to the studio on an emergency.
یک کشمکش بعد شاید هر پنج ماه یک بار.	a bad bout perhaps every five months or so.
وقتی حقیقت امر را دربارة زنی که عاشقش بود فهمید	when he learned the truth about the woman whom he had loved.
لباس و قیافه و آرایش او به زنان قرن هفده و هیجده بیشتر شباهت داشت.	a vague gesture to some past century but whether seventeenth, eighteenth, or nineteenth.
زیرا کاملاً غیرممکن است که تألیف آن کتاب چنان باشد که خرسندی و رضای خاطر تمام خوانندگان را فراهم آورد.	for of all impossibilities the greatest is to write one that will satisfy and please all readers.
دیروز او و ری تا مرد نگون بخت را در سنترال پارک دیده بودند.	they had found when they walked down to the park yesterday.
دری را که در کنارش ایستاده بودند باز کرد	opened a small door, near which they stood
دست از کار کشیده و سر را داخل خوابگاه او نمودت	stopped and leaned over the bed
تا به آن موقع قلعه را به آن شلوغی ندیده بود.	had never seen it so crowded after sunset.
مثل تبدیل کردن چوب کبریت به سوزن و از این جور چیزها.	just matches into needles and that sort of thing .
فرمان مشهور امپراطور الکساندر پاولویچ را که تازه دریافت کرده بود برای حاضرین خواند.	had received and read the then famous rescript of
در حالی که او معیار سنجش و ارزیابی بود.	herself the unit of weight and measure.
اما شرم بیش از حد مانع چنین خواهشی بود.	but was too timid to ask it.
من پنج روز سرگرم گفتگو با بسیاری دیگر از دانشمندان قدیم بودم	I spent five days in conversing with many others of the ancient learned
اما حرکت او باعث شده بود که پرده از طرف نقاشی رو بزمین بیفتد.	but his movement caused it to fall, face downwards, on the ground.
یقین کرد که مشکلش به نحو مطلوب حل شده است.	counting the business as good as settled
به این آقایان بگو که جریان از چه قرار بود	tell these gentlemen what took place
ولی تا به حال هیچ حیوانی واقعاً بازنشسته نشده بود.	but in fact no animal had ever actually retired.
انگار آماده بودند تا آهنگی غیرطبیعی را با پیانو بنوازند.	as if she were about to play some abnormal tune on the piano.
با آن اونیفورم نظامی قلابی و آن همه مدال تقلبی	in his bogus military uniform with his fake decorations
مخصوصاً در موردی که پای حقوق یکی از افراد خانواده در میان باشد.	perhaps the most unnatural to the claims of your own family.
اما او به سرعت دریافت که قادر به همدردی با آنان نیست.	but he had quickly found he was unable to sympathize with their problems.
چون دیوار گویی ما را به میان خود راه داده بود تا پشت ما به هم آید.	the wall that had only admitted us in order to shut us up.
هنوز محرمات و منهیات زنانه در دنیای او راهی نداشت.	the taboos and inhibitions of womanhood not yet a part of her world.
این کار خیلی سخت نبود و ما هم کردیم.	that was all easy, so we done it.
چون در دلش بود که او را در افتخاراتی که به زور بازو بدست خواهد آورد سهیم گرداند.	to whom he was beholden for the favour he had received, as he meant to confer upon her some portion of the honour he acquired by the might of his arm.
چون در غم و غصه مجرب شده بود و یقین داشت که دیگر پایان نخواهد داشت.	for she had the experience of grief, with the certainty that it would not end.
به جبران گناهی که دیروز مرتکب شده بود بالش را به کناری نهاد و روی زمین خالی و نمور زانو زد.	in penance for some sin of yesterday, pushed away the hassock and knelt on the bare stones.
هری نیز صد در صد همین وضعیت را داشت.	he most certainly had been.
لری با حالتی عصبی برگشت و نزدیک بود بیفتد.	he turned stiffly, almost stumbling.
دختر خودم را یک جور عشق دوست دارم و این دختر را طوری دیگر.	I love my daughter with one love, and her with another.
به هر حال صحبت در این زمینه را به وقت مساعدتری موکول کنیم	but let this stand over for some more convenient time
تا به هرشکلی که او فرمان خویشتن را تسلیمش کنند.	to yield themselves to him in any way that he might dictate.
استاد چندین جلد کتاب که تا آن هنگام به قطع بزرگ فراهم شده بود به من نشان داد	the professor showed me several volumes in large folio
همین حالا هم شاید برای خودتان حسابی گرفتاری درست کرده باشید چون ممکن است کسی برود از شما شکایت کند.	you might be in for it now, if anybody informed against you.
با چشمی که سیل اشک از آن جاری و دلی که از غم مالامال بود ارباب و بانوی خود را بدرود گفتم.	I took leave of my master and lady and the whole family, my eyes flowing with tears, and my heart quite sunk with grief.
خدمتکار پیری که دست کنت را نگه داشته بود برخاست و به جانب بانوان برگشت.	the old servant who was holding the count's hand got up and said something to the ladies.
در حقیقت قسمت بالایی بدن من درست شبیه به لوله است.	in fact my upper half is almost exactly the shape of a tub.
دوان دوان از پلکان مرمری بالا رفت.همه با نگاه او را تعقیب کردند.	they all watched her run up the marble staircase.
وی بدون اختیار چون کودکی مجذوب شعله شمع شد	he attracted like a child to a candle
کوشیدم کاری کنم که پا به پای داستان جلو بیاید اما کاری سطحی بود.	I tried to make it keep time with the story itself, which was only superficial after all.
از رأس المال سابق هم یک صد هزار فرانک هم سود دارید.	besides the 100,000 you furnished me to begin with
با سر جیمز و لیدی چتام عازم یورکشایر هستم.	I am immediately otherwise engaged,' she says.
که او را در عقب تو آمده و مراقب تو بوده.	that he followed and watched you the whole time
چون به عنوان شحصی اهل حساب و کتاب دربارهء آن هیچ اطلاعی ندارم.	for, as a man of business, I know nothing of it.
بولسترود لای در را اندکی باز کرد تا بواند صدای آهسته او را بشنود.	he opened it an inch, so that he could hear her speak low.
چیز صورتی چسبناکی در یک قوطی بیضی شکل با یک قاشق حلبی برای خوردن آن که فقط نیم پنی ارزش داشت	also a kind of sticky pink stuff in an oval matchwood box with a tiny tin spoon to eat it with, which cost a halfpenny.
تا روی صورت کوچک و خوش ترکیب و نمکینش پائین کشیده بود.	was pulled low over a face that was small and regular
از بانوی با تقوی و خیری که او را که یتیم بوده به فرزندی قبول کرده	from the pious and charitable lady who adopted her in her orphan state
اندکی بعد وال به فاصله دو کشتی از صیادان خود به روی آب آمد.	soon the whale broke water within two ship's lengths of the hunters.
من از میان سر و صداهای زیادی گذشتیم که	we went on through a great noise and uproar that
من با عضویت او در حزب هیچ مخالفتی ندارم.	have no objections to him being a card holder.
اینجا دیگر لازم نیست که سر خوانندگان را با شرح این چیزها به درد آورم.	I need not stop here to relate.
تا به حال این جور تشبیهاتی از دهانت نشنیده بودم.	I never heard you make such a comparison before.
که در مدت عمرش بقول کودکان و مطابق فهم آنانیک	to make use of the expressionwhich all children will understand.
در دل تصمیم گرفتند که هرچه زودتر آن کار را یاد بگیرند.	secretly resolved to acquire it shortly.
فرزندان من! از مادر خودتان کینه به دل نگیرید.	don't blame your own mother!
خیلی بیشتر از آرزوهایی است که برای خودم دارم.	much more than I am for myself.
سپس با سر و سینه بر زمین نقش بست.	then crashed to the ground on his head and chest.
اما برای روزنامه نگاری با توانایی من کس دیگری هم در پس پرده هست.	but there is the other one in the background for a journalist of my ability.
او ما را به این دنیا آورده تا تکلیفمان را نسبت به وطن و به خانواده انجام دهیم.	I care little who has placed us here below to fulfil our duties as citizens and fathers of families
اتاق کاملاً تاریک بود و او قادر به تشخیص جهت خود نبود.	as though he'd been hit in the face.
هیچ لازم نیست در میان نزدیکانش این کلاه را بر سربگذارد.	she need not wear that cap any more among her friends.
که در این مواقع باید دوش آب گرم گرفت.	you ought to get into a hot bath till it was all over.
اینک از رفتارش چنین هویدا بود که در انتظار حادثه بسیار مهمی حرکت خود را به تعویق انداخته است.	one might have imagined that he was expecting something very important to himself, and that he had decided to wait for it.
برای این کار و به خاطر من نقشه را عمداً روی زمین گسترده بودند.	which was laid on the ground on purpose for me
تا به ما اصول و مبانی شرافت و عدالت و حقیقت و وفاداری را بی آموزند.	by teaching us the first principles of honour, justice, truth, temperance, public spirit, fortitude, chastity, friendship, benevolence, and fidelity.
اما دیگر هیچ یک از تیرها به ایشان اصابت نکرد.	but there were no more hits.
خودم در جوانی مدتی به این کار علاقه داشتم.	I had a notion of that myself at one time.
تقریبا یک ثانیه از زمینی که روی میز بودم گذشته بود.	almost a whole second had passed since I'd been on the table.
این قیمت برای سگ به آن خوبی زیاد نبود.	it was not an unfair sum for so fine an animal.
وقتی راجع به خودم همه چیز را به تو گفتم.	when I've told you every single little thing about me.
شاید هم او را فوراً به اقدام حادی وادارد.	or it may drive him to desperate measures at once.
همه جا سرد و یخ زده و آسمان صاف است.	frozen and icy and clear.
زیرا بسیار زننده است که حقایق بدون حضور خود من به ثبوت رسد.	for if it all happens without me, it will be too unfair.
کسی را دست چین کردم که بسیار جذاب بود	I selected someone very attractive
اما متأسفانه باید اقرار کنم که نظارت در تزیینات قصر هم از من ساخته نیست!	but I'm afraid I should not be able to do that very well either.
من و ناخدا را سرپا در برابر یک دیگر نهاد.	leaving the captain and myself, facing each other, on our feet.
نیکول با خنده بر نظر خود پافشاری کرد و گفت	she insisted, laughing
در آن حال و هوا چنین به نظرم رسیده است که این صداها از پای کسانی است که به زندگی من و پدرم وارد خواهند شد.	then I have imagined them the footsteps of the people who are to come into my life, and my father's.
فردای آن روز هم شما را تا بنگاه رهنی دنبال کردیم.	watched you too, next day, to the pawnbroker's shop,' said the first.
با وقار و تأنی معمول به راهی که کشیش تعیین کرده بود ادامه داد.	at his usual deliberate pace took the road the curate directed
به قسمی که تعادلی از لحاظ سن بین زن و شوهر برقرار بود.	sothat there existed a balance of age between husband and wife.
قسم خورده بود که هیچ گاه پا به این محل نگذارد.	he had sworn never to come near the place again.
حرف من این نیست که آدرست را در دفتر پستت نگذار!	I am not warning you against leaving an address at the post office!
ولی از بیم آنکه مبادا راستوف تصور نماید که منظور وی از اظهار این کلمات تحریک حس رقت و ترحم اوست	then, as if fearing he might take her words as meant to move him to pity
بعد جعبة کار خود را بیرون آورد و روی میز مخصوص خود گذاشت که در کنار پنجرة باز قرار داشت	brought out her work box to her own table in the open window
یک نفر اسفنج نم داری را روی پیشانیش گذاشته است	someone was sponging his forehead in the dark
من بودم که او را تحریک با ین جنایت کردم.	I have brought him to this
حتی اگر مشخصاً ثابت شده باشد که دزدی است.	even though it is stolen.
سعی کرده بود خود را مدام شاگرد اول نگاه دارد.	for she was always at the head of her class so that
اما او پیروی از مصنفان دیگر را به متابعت از عقیده من ترجیح داده است.	although he has rather chosen to follow other authors.
عده دیگر را نیز به جاهای بدتری تبعید کنیم.	transporting the rest.
مسلمه که اونوقت دی گه من نمی تونم کمکت کنم.	I certainly couldn't look after you then.
چون نسبت به این مسئله رویکردی کام لا عاطفی داشت.	because he viewed it emotionally.
هیچ بعید نبود از شما بخواهد وسط روز در آسمان ستاره ببینید.	a girl who would have been requiring you to see the stars by daylight.
به هر حال او احتمالاً به یک کوتوله تبدیل خواهد شد.	anyway she's most probably going to be a dwarf.
حالا کمی به من فرصت بده و بعد قضاوت کن!	I'm sure I shall.
آن را به قسمت پایین توده نیمه معلق کوفت و انتهای دیگر آن را مثل چوب زیر بغل زیر بازو گرفت	striking it into the lower part of the half suspended mass, placed its other end crutch wise under one arm
که او بدان وسیله هویت خودش را ارائه خواهد داد.	by which he will identify himself.
قرار بود این سیگار زهر ماری را ترک کنی.	goingt' cut down my fool smoking.
به طوری که اکنون بیش از چند کپک در جیب خود پول ندارم	so that now I have but a few copecks left.
در اینجا هیچ آرامشی و هیچ لذتی در انتظارم نبود.	I expected no peace no pleasure there.
! واقعا سعی کردم مکالمه را به همان مسیر پیش پا افتاده برگردانم.	I tried to steer the conversation back to trite paths.
دو نکته بود که ذهن اِما را در قبال زن دیگر دارد زیر پا گذاشته باشد.	there were two points on which she was not quite easy.
ولی در نگاه جولی همان مسخرگی که وقت یکه او را احمق خطاب کرد وجود داشت.	but in it he saw that same teasing light as when she had called him dummy it was not a twinkle but a hard mirthless shine.
حالا دراز کشیده و چپقش را چاق کرده بود.	he was lying off, now, in comfort, with his pipe.
من این مطلب را از آن جهت به تو گفتم	I say this lest thou shouldst imagine
یعنی فرانک چرچیل عقل به خرج داده و زیاد نمانده تا مبادا بار دیگر عنان اختیار از کف بدهد.	a discreet resolution of not trusting himself with her long.
او ترا نابود کرد! آن افعی سرانجام نیش خود را زد!	your serpent has destroyed you!
تغییر در ضربان قلب و به نفس نقس افتادن	changes in heart rate and breathing patterns
چنان دودی در اتاق پیچیده بود که نور چراغ روی میز محو و تار شده بود.	the room was so filled with smoke that the light of the lamp upon the table was blurred by it.
سر خود را عقب نکشیدم مگر وقتی که نیزه قراولان را دیدم که چیزی نمانده بود که مرا ببینند	that made me draw in my head so quickly for I was fearful he might also see me
حال بدون مشورت با پدر و مادرش به چنین کاری اقدام کرده است!	to take such a step without father's or mother's consent!
فقط خواهش کردم بگذاری کمی برایت مفید باشم .	I only begged you to let me be of some good to you.
که غفلتا با لکه شمع بر او عیان شده بود.	as it had suddenly come to him from the spot of tallow.
جارو از روی تخت بلند شد و در ارتفاع مناسبی برای سوار شدن هری در هوا شناور ماند.	it hung in midair, unsupported, at exactly the right height for him to mount it.
در خود شهامت آن را نیافت که به خاطر بخشایندگی خواهرش سخنی خوشایند بر زبان آورد.	dared not say even anything pretty about the gift of the ornaments
معلوم بود که راه درازی را پیاده طی کرده است.	to have travelled some distance.
آن قدر این حرف را تکرار کرده که در شرایط عادی آدم انتظار ندارد این قدر تکرار کند.	oftener than I should suppose such a circumstance would, in the common course of things, occur to him.
بلکه فقط ادب و نزاکت و رفتار مطبوع در هر دو طرف دیده بود.	had seen only proper attention and pleasing behaviour on each side
فسادی چنان بارز و علنی که برای مردی شجاع مردی که از پیامدهای ویرانگر فساد هراسی به دل راه نمیداد حتی جای نفرت هم باقی نمیگذاشت.	so naively brazen as to disarm the hate of a man courageous enough not to be afraid of its irresponsible potency to ruin everything it touched.
انگار نگران بود که او را تعقیب کرده با شن.	as one who dreads pursuit.
با وجود صمیمیتی که با خانواده او دارد و با عوالم دوستی قدیمی که با پدرش داشت	in spite of his devotion to her family and his old friendship with her father.
من باور ندارم که بتوانم از اینجا بیرون آیم.	I do not think that I shall escape from this place.
بعد در اثر جریان هوا با پیچ و تاب مفصلی در فضای بخاری به پرواز درآمد.	caught by the air, whirled up the chimney.
بالاخره به این نتیجه رسید که دوباره در میان صندلی خود فرو رود	again forced himself into the little chair
او دامن سبز خود را در چنگ گرفت و بالا کشید	she boldly snatched up her green flowered skirts
من به محض این که این چیز را دیدم که به دور گردنش آویخته بود عمداً آن را دزدیدم	I stole it in my heart when she first showed it me hanging round her neck
من سلامتم و پدرت در اینجا نفوذ بسیار دارد.	I am well, and your father has influence around me.
تا اینکه دیگر عطری از او در میان آن نمانده بود.	until there was no more of his scent caught in it.
حالا بگذار از موضوع دیگری با تو حرف بزنم.	now, let me talk to you of something else.
یعنی آنچه که فرانسویان بیش از همه در جهان از آن بیم داشتند	which they feared more than anything in the world.
آنگاه قطع و یقین کردم که تمام این ظواهر چیزی نیست مگر آثار سحر و جادو و احضار ارواح.	I then absolutely concluded, that all these appearances could be nothing else but necromancy and magic.
از همه جهت آن را به باد عرضه کنند.	every way expanded to the breeze.
در این هنگام خدمتکار نامه به دست وارد شد.	 she was beginning, when a footman came into the room with a letter.
اینکه مرد را بکشم اما زن به من گفت اگر حادثه و گزندی بر نامزد من وارد آید را هلاک خواهیم کرد	I would stab the man but the woman told me that if any misfortune happened to her betrothed she would kill herself
تنها اسناد هویت طفل در اعماق رودخانه مدفون شده	the only proofs of the boy's identity lie at the bottom of the river
چون منهم میدانم با رؤیا زندگی کردن چه معنی دارد.	for I too know what it is to have dreams.
در اون صورت از دست من کاری ساخته نیست.	I can't prevent that.
شکلکی درآوردم و خودم را دوباره روی صندلی پرت کردم	I grimaced, throwing myself back in the seat.
نواختن گیتار پشت سرش با صدای زنگداری متوقف شد.	the guitar came to a jangling stop behind him.
میخ وام تا صبح ۱۰۰ مایل از اینجا دورشده باشیم.	I want to do a hundred miles before sunup.
به نحوی که مغز هرکدام به نسبت مساوی تقسیم شود	in such a manner that the brain may be equally divided
خلاصه بهت به گم که به من اعتماد داره.	knows he can trust me, see.
این نکته بسیار موجب خنده و سرگرمی او گردید.	with which he was not a little amused.
مخصوصا پس از آنکه ربرتا خود را تم اما تسلیمش کرده بود.	especially after she had abandoned herself to him, his thoughts ran.
می دون ستم که اونها صدای اومدنم رو با موتور یا بی موتور می شن ون. در نتیجه سورپرایزی وجود نداشت.	I knew they would hear me coming, bike or no bike, so surprise was out.
با این وصف ضربت چراغ آسیب مهیبی به سر او نرسانده و فقط دو برآمدگی نسبتاً بزرگ بر پیشانی او پدید آورده بود	which had done him no more harm than raising a couple of rather large lumps
سپس تمام ما را فرا خواند و در مقابل شمایل قرار داد.	called us all to him and, will you believe it, placed us in front of the icons.
ولی عقل و شعورش بیشتر از حد تصور شماست	but she has better sense than you are aware of
او از صمیم دل آرزو میکرد که ای کاش آن روز هرگز به پایان نرسد	the boy found himself wishing that the day would never end,
اگرم گرفتار یه همچی فقر باطنی ای با شه با یه میلیون جریب هم دردش دوا نمی شه	if he's poor in hisself, there ain't no million acres gonna make him feel rich
من عقیده دارم پو لارو ورداریم و بزنیم به چاک.	I'm for knocking off and lighting out.
فقط شبهه نداشت که ژاور آمده است خود او را دستگیر کند.	but the only thing which she did not doubt was that he had come to get her.
او را در آن هزار راه پر از پیچ و خم خانوادگی پیش برد و به سرچشمه اصلی رساند.	guiding her with joyful spirit through the tangled complexities of her blood to the very source of her origins.
دیگر نه کشتی پیدا بود نه هیچ قایق دیگری.	neither ship nor boat to be seen.
پرستار گفت خَشی در صدایش بود مثل جیرجیرک که تیرة پشتش را خراشی لذتبخش داد و امواج صدا را به سوی مغزش بالا فرستاد که آنجا در تصادم با هم شکستند.	deeply, softly, like a mellow organ, but with a roughness in her voice like a grasshopper's, which rasped his spine deliciously and sent running up into his brain waves of sound which, concussing, broke.
را که از صبح تا ظهر نتوانسته بود بنویسد نوشت.	which she had been unable to write all the morning.
من از جا پریدم و تلفنی را که روی پیشخوان جا گذاشته بود چنگ زدم.	I whirled and scooped up the phone he'd left on the counter.
کتاب دوم ثامن فصل سوم وال شاخ دار یعنی وال من خر	BOOK II. OCTAVO , CHAPTER III. NARWHALE , that is, NOSTRIL WHALE.
به آینه قدی که در سمت راستش آویخته بود نظر کرد.	glanced into the mirror which stood on her right.
بلکه اگر بخواهم که جان خود را برهانم و از نابودی کلی رعایای رفادار خود جلوگیرم بهتر آنکه دست او را در تصرف مملکتم آزاد بگذارم	but that I should leave the kingdom entirely open to him if I wished to avoid the death and total destruction of my good and loyal vassals,
بدون اجازه پدرم حق ندارم نامه را دریافت کنم.	I cannot accept it without my father' s permission.
اما این دفعه خبری از قهوه و یا گفتگوهای دوستانه نبود.	but there passed no talk or coffee making for this time.
من و شوهرم بی آنکه فکر بکنیم به اندازه کافی باید برای باز نگه داشتن این میخانه زحمت بکشیم.	I and my husband have enough to do to keep this wine shop open, without thinking.
زیرا نخست میزان مالیات سالیانه را قریب به پنج شش میلیون تخمین زدم	because I computed our taxes at about five or six millions a year
سفری که قرار بود سه سال به درازا انجامد اما در پایان ماه ششم به علت کشتی شکستگی نیمه کاره ماند.	a voyage that was to have been for three years and which had terminated in shipwreck at the end of six months.
او دیگر وسیله این را نداشت که منشی نگه دارد.	for the reason that he could not afford to keep a secretary only an unpaid servant.
از خوابگاه بیرون آمدم و داخل سرسرا شدم و گوش کردم.	I went out into the corridor and listened.
همه چیز حاکی است که این اتفاق خواهد افتاد.	I see by everything that it will often be repeated
سبزیجات باقی مانده در ته کاسه را در درون ظرف غذای خالی هدویگ ریخت.	tipped the soggy vegetables at the bottom of the bowl into her empty food tray.
آن را گرفتم در حالی که اندکی ناراحت شده بودم. باز کردم. یک ورقه کاغذ کوچکی بود که در آن یک جمله نوشته شده بود.	I opened it, and found a single sheet of note paper inside, with a few words written in an unfamiliar hand.
در این توطئه بر ضد من هم داستان بودند.	joined in the plot against me.
اما بیش از ین مدت قادر نیست که آنان را نگاه دارد	but no longer
او را تا به این سایگاه غم زده رهنمون شده بود.	had brought him to these gloomy shades!
چرخیدم و دستم را دور کمر خنک او حلقه کردم	I turned around, wrapping my arms around his cool waist.
هلن لباس رقصی که نشان بانوان درباری را داشت پوشیده بود.	she wore a ball dress and her badge as maid of honor.
در جائی که به خشکی فرود آمدم مردمی ندیدم	I saw no inhabitants in the place where I landed
چشمش را بالا آورد ولی در همان لحظه فرو انداخت.	raised his eyes, and instantly dropped them again.
قفلی بر آن در زد و قفل بزرگ در را با دو پیچ بست.	double locked it with key and chain
جالب است که در سال 1938 کسی وجود رادیو را در خانه تحمل نکند.	it tickles me, in 1938, to find someone objecting to having a radio in the house.
در نظر من نقشی از ملال بر آن منطقه روستایی سایه انداخته بود که نشان آن سال رو به پایان را با وضوح بسیار بر خود داشت.	to me a tinge of melancholy lay upon the countryside, which bore so clearly the mark of the waning year.
به هوای دیدن یه نفر اومده بود این جا.	she was hoping she might run inter someone else at my house.
به جانب عمل قهرمانی بزرگ و سعادت عظیم راهبری نماید.	lead him to a great achievement and great happiness.
در حقیقت در ظاهر آن کولی چیزی نبود که آرامش آدم را بر هم بزند.	there was nothing indeed in the gipsy's appearance to trouble one's calm.
علاوه بر این اما زمانه به موانعی دیگر نیز انباشته بود.	but, the changed times were fraught with other obstacles than these.
در صورتیکه او بجای آورده جبران نماید تا پس از بیست و دو سال خدمت	so that he, an exemplary officer of twenty two years' service
پس از ان که خوب فکر کرد عنان رسی نانت را رها کرد	after having deeply considered it
گرچه واضح بود که دو سال اخیر مثل ده سال روی او اثر گذاشته است.	but it was evident that the last two years had been as hard on her as ten difficult ones.
که فریاد نشاط انگیز معمول از بالا به گوش رسید	when the customary cheering cry was heard from aloft
حداقل دمی به ما فرصت دهند تا بتوانیم به عنوان زندگی نامه نویس فکر کنیم	at least, a breathing space in which we could think as a biographer
خوب است یک نفرتان بدود کتاب دعا و چاقوی قلم تراش بیاورد زنجیرهای بزرگ را قطع کند.	run one of ye for a prayer book and a pen knife, and cut the big chains.
نگاهی به همسرش انداخت و بلافاصله دست خوش تشویش و شک و ترس شد.	he glanced down at her, and at once fell a prey to distress, incertitude, and fear.
صدایش چون طفلی که آماده گریستن است مرتعش بود.	her voice quivered like that of a child about to cry.
اغلب نیز روی اسم مارسل تاجی نقره شده است	above some a crown carved on the same tree
که امکان دارد استقرار زناشویی او را مختل کند.	that could endanger the stability of his marriage.
به شما بگویم که وال سر زا حاضر به قبول هیچ پرت و پلایی نیست.	I tell you, the sperm whale will stand no nonsense.
ولی آدم تا ندیده باشد تصور درستی که ندارد.	but one never does form a just idea of any body beforehand.
سومی با سنگی به سوی کلاغی نشانه رفته بود	a third with a stone raised to throw at the ravens who sat
اما آن سور دیگر که مردم خوب میشناختندش پر شور و سرحال بر روی اسب خوش تراش	but neither did the other horseman, well known to the people, keen and alive on his well shaped
هر آن ممکن بود غش کند و از حال برود.	before her spirits were quite overcome.
در موقع بر زمین افتادن سرش نیز شکسته بود.	his skull fractured in falling
هر کشوری در چنین موارد ناچار به اجرای چنین قوانینی است	such as any other country would be under the necessity of enacting, in the like circumstances.
به این نتیجه رسیدند که برای یک هفته به خواب رفته بود.	gave it as their opinion that he had been asleep for a week.
عرق آتشین را همه با هم با صدای فس فرو دادند.	the spirits were simultaneously quaffed down with a hiss.
چون دیگر حالت آن را نداشت که به اتاق والانتین داخل شود.	he had not the courage to again visit the death chamber.
رویم را برگرداندم وقتی صدای دری پشت خود شنیدم .	I turned round when I heard the soft closing of the door.
زنی که دیروز برای روشن کردن موضوعی و دادن آرامش به او از خانه بیرون رفتم	a woman towards whom she had set out with a longing to carry some clearness and comfort into her beclouded youth.
خود را یک ملت ممتاز میشمارد نه یک توده ملت.	regards itself as a nation, and not as a people.
ناگهان از عقب یا از پهلو مرا با ناوکی از پای درآورند.	suddenly shot with an arrow from behind, or on either side.
از آنجا درشکه گرفته و زود برو به منزل.	there take a cab
صدای درشکه رو شنیدم که جلوی خو نه ایستاد.	I heard the carriage come round to the front of the house.
برای بار آخر نفسی عمیق کشیدم و بعد آن را حبس کردم و به داخل کلاس کوچک و گرم قدم گذاشتم.	I took one last deep breath at the door of the classroom, and then held it in my lungs as I walked into the small, warm space.
این کشتی به ناچار در این مناطق ساحلی هر جا که توده ای از کلبه های مردم بومی به چشم میخورد لنگر میانداخت تا تولیدات بومیان را جمع آوری کند بسته های سه پوندی لاستیک که با بافه های علف خشک بسته میشدند.	stopping obligingly before every cluster of huts to collect produce, down to three pound parcels of indiarubber bound in a wrapper of dry grass.
ولی دریافت که این حرف خوبی برای گفتن نیست.	but realized that would not be the right thing to say.
اما باید زن هم مانند شوهر سهم خود را بیاورد.	but a wife should bring her share and a husband his.
راه بند از بریم هرچه زودتر به آب بزرگ برسیم.	just shove off for the big water as fast as ever you can.
تا چنین وانمود کند که آن را فقط برای بازی برداشته بود	as if to induce the belief that he had caught it up, in mere sport.
آن دو خواهر در صدد هیچ نوع کنجکاوی و حدس و گمان آزارنده ای نبودند	for I was troubled with no inquiries no surmises.
جعبه چوب صندلش که خیلی دوستش دارم خیلی چیزهای دیگر.	her sandal wood box which I am so fond of plenty of things.
چون از این که سرم خلوت بشود ترس و نگرانی ندارم.	for I had no fear of retirement.
مردی آرمانی که به او عشق می رو زد.	the ideal man who was in love with her.
اینک امیدوارم که این مطلب یک بار برای همیشه روشن شده باشد.	I hope now that this question is at an end, once and for all.
من همان دختر جوانی هستم که در چهار دیوار عصمت زندگی سعادتمند و آرامی داشتم	I am she who in the seclusion of innocence led a contented life
شادمان از این که امشب به تحقق رؤیاهای دو ماه گذشته اش نزدیکتر شده است.	happy in the sense that he had got nearer to the attainment of his aims that evening than during the last two months.
از حالا جیره کاه و جو او را دو برابر کن	double his feed
لعنت بر من و بر ایل و تبار من!	woe betide me and all my kindred!
با عینکی جدید که به او حالت خانم معلمی بخشیده بود.	with the new eyeglasses that gave her an academic air.
مابقی شب را به تفریحات سالم صرف چای و شیرینی و بستنی بگذارند.	to be followed by a social with games, cake, tea and ice cream.
آن هم از ترس این که مبادا فرصت دیگری پیش نیاید.	one he had rushed into for fear that the opportunity would never be repeated.
در برابر معشوقه خوار گردیده و او را برای ابد از کف داده و برای او چیزی جز خاطره ی ننگین از خود باقی نگذاشته است.	he had been humiliated before her, and had lost her forever, leaving with her nothing of himself but a shameful memory.
چون من در آندم برای بوسیدن زمین ادب با سینه بر دست راست ملکه افتاده بودم شاه گفتی چنین پنداشته بود که من همان جانورم.	for such it seems he took me to be, as I lay upon my breast in her majesty's right hand.
خاکستری و خمیده همانند درختی خشکیده در مقابل هجوم توفان.	grey and bent, like a wizened tree before the onset of a storm.
مجروح را در بستر خواباندند و واریا برای پرستاری ماند.	she got the wounded man to bed, and remained to nurse him.
اما از آنچه روی داده بود چندان پریشان و مشوش بودم	but I was quite unsteadied by all that had fallen out
حس کردم زمانی که دست او را پس زده بودم چقدر او ناراحت شده بود.	I felt how it had hurt him when I'd cringed away from his hand.
این نام شماست و علامت ضربی هم که پهلوی آن گذارده به معنی این است که با شما ملاقات کرده.	a big cross beside it, to show that the appointment was kept.
پهلوانان سرگردان آینده برای رسیدن به اوج افتخار سپاهی گری به راه ایشان بروند.	whereby knights errant may see the footsteps in which they must tread if they would attain the summit and crowning point of honour in arms.
با او از خانه بیرون بیا دی و کیفیت ماوقع را از وی بپرسد.	that he might go out with him and question him as to his success.
من هم به خاطر او گفتم که می تونیم	I thought we could
نشان داد که دارای همان قوت نفس و خصوصیات اخلاقی اوست.	revealed the same strength of character.
آن هم این که خودم او را بزرگ و تربیت کنم.	I will bring him up.
مردی به نقشه دیجیتالی روی صفحه نمایشگر رایانه نگاه کرد.	a man was looking at a digital map on a computer.
دخترها بی آن که خجل و دستپاچه شوند لبخند به لب عقب رفتند	the girls, unabashed, stepped back smiling
سپس برگشت و سکندری خوران از آپارتمان وی بیرون رفت.	then turned and stumbled out.
او هم قبول داشت که اصلاً جای نگرانی نیست.	they both agreed with him in there being nothing to apprehend.
پهلو یا شکم او به طور مرئی از سطح آب بالاتر است.	with its side or belly considerably elevated above the surface.
آهسته آن را به دهانم نزدیک کرد و مرا بدین کار سرفراز فرمود.	he did me the honour to raise it gently to my mouth.
منزل ما منزل خودتان است. بسیار موجب امتنان ما خواهد شد.	we shall be glad for you to stop as long as you like.
به شرط اینکه او را از او جدا نکنند.	on condition that she should never be separated from hiM
دخترش بیدار شده و به چیزی احتیاج داشته باشد	daughter were awake and needed anything.
ولی در عوض هر وقت سرم را روی بالش بگذارم فکر بدی مرا آزار نخواهد داد.	but I shall lay my head on the pillow at night untroubled by evil thoughts.
مطمئن بودم کسی هم آن موقع شب در قبرستان کاری ندارد.	no one else had business to bring them there.
در حیرت بودند که این برق تا کی نخواهد زد.	wondering to see how long the stroke was delayed.
وقتی در را گشودم چشمم به جا سپر افتاد که پهلوی بخاری نشسته بود.	I was glad to see the dogs there, sitting before the fire
یک بار هم به تنهایی به یک لشکر بسیار عظیم و بسیار قوی حمله برد	another time he attacked a very great and powerful army
اما دیگران احساس کردند که این حرف خلاف دیانت است.	but the others felt that this wasirreligious.
چیزی جز یک قسم احساسات حقیقی وجود ندارد و آنهم دوستی بین دو مرد است.	there is only one real sentiment comradeship between man and man.
زیرا کاترین باید یا او را به همین وضعی که دارد قبول کند و یا در اینجا زندانی باشد.	because she must either accept him or remain a prisoner
تا ببیند که در غیا او کسی به جمع آنان ملحق شده است.	for any new customer who had dropped in while he stepped over the way.
چون عجالتاً نه دعوایی بود و نه سرو صدایی .	for the time neither quarrelling nor crying
من شام را خارج از هتل خواهم خورد. بنابراین دیگر امشب شما را نخواهم دید.	I shan't see you in the restaurant this evening as I'm dining out.
لیکن همان گونه که کسی قبل از اعتراف به گناهان و پذیرفتن مقررات صومعه بخواهد از آنجا بیرون آید	but just as when one quits a religious community before making profession
عاقبت مردی در را به روی ما باز کرد.	the man opened it
خود را در پشت سنگی که در کنار آن جوی کوچک بود پنهان کردم	hid myself behind a stone by the little brook
در تابوت را خیلی ملایم جلو کشید و محکم پیچ کرد.	just slid the lid along as soft as mush, and screwed it down tight and fast.
چنان ضربتی سهمگین بر فرق قاطرچی نواخت که او را نقش زمین ساخت	with it smote such a blow on the carrier's head that he stretched him on the ground
دری در سمت راستش باز شد و شترق صدا کرد.	a door right next to him opened with a bang.
آبپاش را کنار زد و روی برافروخته ی خود را به سوی او گرداند.	pushed away the watering pot, and turned her flushed face towards him.
تا بیایم بفهمم سینه به سینه به او برخوردم.	I was right on him before I could shirk.
قصد داشتم در این مورد با او صحبت کنم.	I had a mind to speak to him about it
مگر شما خودتان نیامدید و در برابرم زانو نزدید	well, you came crawling on your knees to me
چون دیگر نه وقت داشت و نه صبر و حوصله این که خودش سیگار بپیچد.	because she no longer had time or patience to do it herself.
از یک طرف درستی و اصول اخلاقی و از طرف دی گه پول. یک وسیله کام لا عملی و سودمند.	it's the sight of your mental struggles when a matter of principle is laid up against something practical like money.
از یک راهروی باریک گذشتند تا به یک پلکان زیگزاگی و عجیبی رسیدند.	down a narrow passageway to an uneven staircase
پس از این که اندکی روی پاهای عقب خود بلند شد	supporting himself for a short time on his hind legs
چه بسا ضربه او به علت همان خشم چنان شدتی گرفته بود.	even now, that had given that blow its sodestructive force.
گفتم که مردها دور شدند و آن وقت بیرون آمد	I told him they were out of sight, so he come aboard.
