یک موجود فقیر و بیچاره آمد دم در خانه و مادرتان رفت ببیند به چه چیزی احتیاج دارد.	some poor creeter came a beggin', and your ma went straight off to see what was needed.
ناچار دلاک دیگی بزرگ پر از آب سرد از چاه کشید	until the barber brought a great pot of cold water from the well
با دیدن شما برای نخستین بار در عمر خود با یک مرد حسابی مواجه شدم!	I have seen a man for the first time in my life.
از چیزهایی که مطبوع هستند نهایت لذت را ببرد.	enjoy all that was enjoyable to the utmost.
به نسبت دوازده بر یک از قامت آنان بلندترست.	finding it to exceed theirs in the proportion of twelve to one.
دنبالت به کتاب فروشی ای که تو ذهن جسیکا دیده بودم رفتم.	I went looking for you at the bookstore I saw in her head.
صدای خود را پائین آورد تا برای این موضوع هولناک فضای راز آمیزی درست کند.	yet lowering his voice in order to give the dreadful subject its proper medium of obscurity
اعضای دو خانواده فکر کردن بهتره ازدواج او نا هرچه زودتر انجام به شه.	everybody in both families thought it would be better to get married soon.
از جوابی که احتمال داشت مرا ناامید کند به شدت وحشت داشتم.	I so dreaded a reply that would crush me with despair.
اما آن اندازه پول دارند که بتوانند به بیمارستان کمک کنند.	but of funds which she can well spare.
اگرچه چییز که بالمره او را مطمئن و آسوده نماید تحصیلی نکرده بود اما اقلا چیزی که موجب دهشت و وحشت او گردد استماع نکرد	although he had learned nothing really satisfactory
یا در زیر جامه رزم خود حیله و نیرنگی به کار برده باشد که ما از آن بی خبر باشیم چه باید کرد	whether one carries relics or any secret contrivance about him
جایگاه دائمی او مثل گذشته قسمت غربی بنا بود.	she was in that room in the west wing.
دوچرخه را گوشة حیاط انداخت و یک راست به خانة اربابی رفت.	flung it down in the yard and rushed straight into the farmhouse.
بلکه روح جدیدی بود با نیروهایی که به خیالش هم نرسیده بود.	but a new soul with unsuspected powers.
شب گذشته مدت کوتاهی بیدار شده بود و دیده بود	last night he had awakened briefly
بار آخر به طور مشخص نوع به خصوصی کلف بزرگی را زیر چشم وال باز شناختم.	the last time distinctly recognised a peculiar sort of huge mole under the whale's eye, which I had observed there three years previous.
ولی از زندان جادوگرها فرار کرده والان فرا ریه.	but he's broken out of wizard prison and he's on the run.
که بال کون بر سر آن قرار داشت از جا در رفت و نزدیک بود بر زمین افتد.	which support the balcony, became loosened, and was on the point of falling.
کلاه به دست منتظر ماند تا ببیند چه پیغامی را باید به کتاب فروشی ابلاغ کند.	waited, cap in hand, to hear what message he was to take.
از آن به بعد دوباره همان ماجرای خواب سحرآمیز را بازگو کرد.	he reverted to the bewitched sleep version of events.
نامه در همان قفسه به حال خود رها شد	there it remained
شهرت او به عقل و دانش چنان استوار و پابرجا بود	his reputation being so well established
اما مسلم بود که ایثورن دعوت کشیش خود را رد نخواهد کرد.	SurelyEathorne would not refuse his own pastor.
من هم امروز در نیمکت سبز وعده ملاقات داشتم	that I, too, was given an appointment at the green bench today!
با سکوت شب در هم آمیخت و آرامشی سنگین به بار آورد.	added to the stillness of the night, made it very quiet indeed.
زود توانست او را به شوق و شور آورد.	soon revived his spirits by her direct and lively manner.
خواستم در ین باب به شرح و تفصیل بیشتر بپردازم که ارباب فرمود خاموش	I was going on to more particulars, when my master commanded me silence.
می تونم زیرا این درختا دراز بکشم و اگه دلم بخواد هزار سال بخوابم	I can lie down under them trees an' sleep for a thousan' years if I want to.
ولی شیب در اینجا بسیار شدیدبود وسطح آن کاملا صاف بود.	but the grade here was very steep and smooth.
قضیه پدر و مادرت رو به راش تعریف کردم و گفتم مشکلت همین بود.	I told her about your parents and said that's what was wrong with you.
کرام مایو پوشیده و چوبدستیش را آماده نگه داشته بود.	who was wearing swimming trunks and was holding his wand ready.
من آن موقع فکر کردم چه رفتار نامعقولی دارد.	which I then thought most unreasonable.
هیچ یک جرأت نداشتند که به سرزمین آبا و اجدادی خود بازگردند	none of these durst return to their native countries
اندکی کنار پنجره ایستاد و به بیرون نگاه کرد .	she stood a moment to look out .
کوهی نه چندان نزدیک به دریا که فضایی ولو اندک برای پیاده شدن نداشته باشد.	not so close to the sea but that it left a narrow space on which to land conveniently.
به پرس و جو دربارة بانویی پرداختم که برای تحقیق از او به آنجا رفته بودم.	I made inquiries for the lady whom I had come to interrogate.
ولی از مغازه ابزار فروشی چند تا باطری برداشتم.	but I got some batteries from the hardware store.
با وضعی فاتحانه که ملایمتش اندکی با آن مباینت داشت	compressing in a triumphal attitude thatwas some what contradicted by his peaceable air
دختر جان باید موضوعی را با تو در میان بگذارم.	I've got something to tell you, my dear
بار دیگر پسرم را تشویق به نافرمانی و تمرد از امر من نکنی.	you'll not encourage my son to further disobedience.
چون حالا دیگر موضوع لباسش را فراموش کرده بود و به علاوه کسی هم نبود که دائماً ابروهایش را برایش بالا ببرد.	because her dress was forgotten and nobody lifted their eyebrows at her.
آفتاب کام لا پشت سرش بود و او کلاه به سرنداشت.	the sun was right behind him, and he wasn't wearing _ a hat.
حاضر بودم بمیریم ولی به او نا خیانت نکنم.	I would have died before I betrayed them.
کافی بود تا پیچش مختصر دهان او را در زیر سبیل مرطوبش ببیند	only to catch the faint movement of the mouth under the sticky mustache
چون به رگهای این گیاه روی آن قسمت از دیوار خانه که این پنجره در آن تعبیه شده بود را کاملاً پوشانده بودند.	whose leaves clustered thick over the portion of the house wall in which it was set.
انگار آنتون یا نیز دچار همان بلاهت و کند ذهنی غیر قابل توضیح زنانه شده بود	as if she, too, had suffered from that inexplicable feminine obtuseness
همان دم برای اولین بار تمامی موضوع در پرتوی دگرگون و به طور کلی تازه بر او ظاهر شد.	only then for the first time the whole thing presented itself in a new, different aspect
به خوبی از وضع اثاثیه خانه باخبر شده بود	ascertained to a nicety the exact condition of the furniture
دیروز برایتان تعریف کردم که وضع مالیم از چه قرار است.	I mentioned to you yesterday what was the state of my affairs.
هر یک به قدر چشم یک انسان ارزش دارد.	every one of them worth an eye of one's head!
بر اثر فقر و بدبختی این طور باید نتیجه گرفت که دوران این قبیل جنایات فرارسیده است.	because he was in misery, the world must be coming to an end.
نه به او نگاه کرد و نه به رغم اصرار او دنبالش راه افتاد.	nor could he persuade her to come inside.
که در رختشورخانه به آن کار نامطبوع مشغول بود	the shrinking room which was so eminently distasteful to him
من به چالاکی بسیار تا ساحل در آب راه رفتم	I waded ashore in great spirits
دو کلمهٔ دلپسند بت و خواهم گفت که از شنیدن آن خرسند خواهی شد.	I've two words to say to you, something pleasant, very pleasant.
دیدم که او چنان معصومانه به هیکل عظیم وی آویخت که پنداری به بهترین حامی و پشتیبان خویش متوسل شده است.	I saw her innocently kiss her chosen husband on the cheek, and creep close to his bluff form as if it were her best support.
ولی به هر حال به زحمت روی پاهایم ایستادم و دیدم هیچ پوششی بر بدنم ندارم.	in which I struggled nakedly to my feet, and rocked moaning in wonder that it was not a dream
من گفتم که طالب کشتن و تلف کردن شخصی نیستم	I have already told you answered the abbe that I loathe the idea of shedding blood
از بیم آنکه مبادا مهمات خشم را بیهوده آتش کند و خود را ضعیف سازد	afraid of weakening and letting the force of her anger run to waste
پس اگر نخستین غول از ین غولان وحشی بر حسب اتفاق مرا بگیرد جز ین نباید چشم داشت که مرا یک لقمه کند و در دهان خود بگذارد.	what could I expect but to be a morsel in the mouth of the first among these enormous barbarians that should happen to seize me?
من یکه خوردم و دست و پای خودم را گم کردم.	I felt stunned and shaken.
پس این شاهد حتما آن ضربه را دیده است.	the witness must have seen that?
بازویش را گرفتم و سعی کردم او را بلند کنم.	I grab his arm and try to lift him up
اما رالف از درد فریادی زد و خود را پس کشید.	he could not stop himself flinching, suppress the exclamation of pain.
پایش به چیزی گیر کرد و با سر به زمین افتاد	when he tripped headlong over something
اما شاید اونجا جایی برای یه کشیش باقی مو نده با شه.	but maybe there's a place for a preacher.
اما این نه اسم آدم است نه اسم حیوان.	but that is no name either for man or beast,
به طور کلی باید حواسمان باشد که به او برسیم.	want of attention to her here should be carefully avoided.
در وطن خود با زن و فرزند خود به سر برم	live at home with my wife and children.
اما از دست دادن پول شبیه آن است که کاسه آبی بر شنها بپاشید.	losing money is like pouring water on the sand. 
شاگرد آشپز و سورچی هم اخطار به رفتن کرده بودند.	the kitchen maid, and the coachman had given warning.
اما در روزهای دیگر هفته اصرار داشت که غذای خود را در فواصل نامشخص صرف کند	but on other days persisted in taking her meals at unknown periods,
مثل اینکه آن احوال در چیزی بود که در خواب و خیال دیدم و هرگز واقعیت نداشته است.	as something I have passed, rather than have actually been and almost think of him as of someone else.
نقش آن زیگزاگ وچهارخانه نبود بلکه از گروهی دایره و خط تشکیل شده بود	not a waffle or zigzag pattern but groups of circles and lines
از نظر مال اندیشی برای سلب مسئولیت خویش تقاضا کرده بود بنویسند.	to avoid personal responsibility, very judiciously wished to receive.
مغرورتر از آن بود که بپذیرد از پا افتاده است.	too proud to admit she wasnt able to walk properly.
هوا آن قدرها روشن بود که تشخیص چیز سفیدی در قعر این جیب دهان باز ممکن باشد.	there was still lightenough to enable him to distinguish something white at the bottom ofthat yawning pocket.
از کناره تاریک کوچه پیش رود و مراقب کناره روشن باشد.	yet keep watch on the light side.
من جا خوردم ولی دخترها به همان سادگی رفته بودند و به جای آنان مخاطب جمله مصاحب من ماه زودرسی بود که آن هم بدون شک مثل شام از توی سبد خدمه پذیرایی بیرون آمده بود.	I started but the girls had moved casually on and her remark was addressed to the premature moon, produced like the supper, no doubt, out of a caterer's basket.
اما کیت تصمیم داشت رابطه اشن را در حدی غیر خودمانی و با فاصله نگه دارد	but she chose to keep their relationship on an impersonal, business level.
وقتی او را از پشت قاطر بر زمین افتاده دید از مرکب به زیر آمد	fall, leaped from his horse
بعد از اینکه بقیه به مدرسه رفته بودند به خانه رسیدم.	I got home just after the others had left for school.
سعی کردم چیزهای دیگر را فراموش کنم تا بتوانم تمرکز کنم.	I tried to forget everything else so I could concentrate.
بستن بازوبند قرمز رنگ به بازوان مردان مسن را به حال تعلیق درآورد	suspended the use of red armbands
ظاهرا دریافت که بالاشف برای عرض مطلب مهمی به این رفتار خارج از نزاکت متوسل شده است.	evidently understanding that he only acted thus because there were important reasons for so doing
اونوقت شاید بتونم یه روز هم با همدیگه اسب سواری کنیم.	we might go for a canter sometime.
پس از این فرمان خلعتی گران به او بخشید.	he followed up these words by bestowing a liberal bounty upon him.
تا زمانی که من اینجا را ترک نکرده باشم خیالش آسوده نخواهد شد.	she would never be happy until I had left it.
این کلاه فرنگی راپرونه معمار ساخته بود و دربان قبرستان در آن منزل داشت.	inhabited by the door keeper of the cemetery.
بگذار آرام و آسوده بخوابم و تازه و شاداب از خواب برخیزم!	lay me down as a stone and raise me up as a loaf
من دیوارها و کف آن را گل اندود کرده بودم	the sides and floors of which I plastered with clay
آن را کورکورانه به چپ و راست حواله کرد	he struck at them right and left in his blindness
اما خدمتگاران حق ندارند بیش از نصف این ساعات بچرند	but the servants are not allowed above half that time
تا با آزادی در مسیر مطمئن و آسان بس وی کمال مطلوب حرکت کند	so that without hindrance she may run her course freely to attain the desired perfection
این چهار وحشی از برگ عشقه و از الیافی که به رنگ سبز رنگ کرده بودند	all clad in ivy and hemp stained green
از این رو مستقیم پشت در اتاق رفتم و در زدم	so I go straight up to the door and knock.
اول کاری که دوک کرد دولا شد و زیر تخت را نگاه کرد.	the first thing the duke done was to get down and look under the bed.
آن هم با همان بی باکی و جسارت متعصبانه که برای وحشی های تشنه خون و عاری از رحم و شفقت انسانی یا هر نوع خدا یا موجود برتری وعظ کرده و آنها را به مسیحیت دعوت کرده بود.	with the same fanatical fearlessness with which he had gone preaching to bloodthirsty savages, devoid of human compassion or worship of any kind.
در پایین نامه اسمش را به خط بد امضا کرد	he scrawled his name at the bottom
انتظار داشت در وجود ایشان صفات انسانی را به حد کمال بیابد.	expected to discover in him the perfection of human qualities.
اندیشیدم که مبادا بین مادر و پسر اختلافی روی نموده باشد که او را این قدر منقلب ساخته است.	I feared that some difference between him and his mother might have led to his being in the frame of mind in which I had found him at the solitary fireside.
که به اتفاق او در مقابل خدا به سجده درآیند و برای همهٔ گنه کاران بدون استثنا طلب بخشش نمایند.	to fall down with her and pray for mercy on all without distinction.
پس از آن دوباره خودش را پشت ماشین اتوکشی دید	then he found himself before the mangle
دانستن این موضوع به هیچ وجه برای شما جالب نخواهد بود.	it is in no way interesting to you to know that.
بیایید ای شمایی که مریض و زخم و و محتضرید آمین	come, sick and sore! AMEN!
زنی که حجابی بر چهره داشت تا صورتش را مخفی کند.	wearing a veil to conceal her face.
قول شرف می دم که هرگز این قسمت رو فراموش نخواهم کرد!	I will not forget this, mother, upon my word.
دی گه خودشم نمی تو نه به مهمونی رقص بره	he can't go to the prom either.
اما از کیف و کلاه و روپوشش اثری نبود.	but there was no bag, and neither hat nor cloak.
بعد برگشت و دو چشم رام مادیان را دید که به او دوخته شده است.	then turned to find the bay mares gentle eyes fixed on him.
چنان رنگ و روغن مفصلی بر آن زدند تا او را حسابی عصبانی کنند	with such exaggerations as the ladies thought best calculated to rouse his ire
خیلی خوشحالم از این که صحیح و سالم می بی نمت.	I am frightfully glad to see you safe and sound.
نمی دونم از من میخ وای که چی به گم.	I don't know what you want me to say.
اکنون باید نیم دوم را نیز بدست آوری تا اینکه نجات یابی.	now you've only to try to do the second half and you are saved.
از ما خواسته بودند که شما را آزمایش کنیم.	I assure you the general actually asked me to put you through your paces, and examine you.
از آن بدتر اینکه با اثری از رحم نفرت بورزم.	worse yet, to hate with touch of pity!
یادم آمد که یک نفر در وصف او گفته بود زن زیبارویی است.	I remembered that I had heard someone describe her as being a beauty.
یکی از اولین چیزهایی که باید اصلاح بشود وضع زمین و کشاورزان خودمان است.	one of the first things to be made better is the state of the land and the laborers.
آری این را هم میدانم و بسیار هم خطرناک است	I've heard about that too, it's dangerous.
در آن وضعیت قادر نبود به هیچ موجودی علاقه نشان دهد.	for she was incapable of ever loving anyone else in this world
بوسیله مسافری که در این لحطه وارو کاروانسرا شد	by a traveller who at this moment entered the inn
من عاشق این هستم که شرح سفرهای اشخاص را بشنوم .	I love dearly to hear people describe their travels.
از صبح تا قبل از آمدنش بخاری را روشن نگه داشته بودند.	especially prepared for him by a fire all the morning
این اتاق از آن لحظه به بعد در نظرم کانون وحشت و ترس بود.	which became to me from that time forth a place of awe and dread
مادر شوهرش در عین تکاپوی کار نزدیک در اصطبل کهنه از پا درآمد.	the grand mother dropped dead by the stable door.
این یک ذره هم از دوست داشتنی بودنش نخواهد کاست.	that did not make her a bit less lovable.
زیرا فقیران نیز وقتی لیاقت و جوهر و فضیلت و تقوی داشته باشند همچون ثروتمندان که مردمی برای تملق و چاپلوسی به دور خود جمع دارند کسانی را خواهند یافت که به دنبالشان بروند و از ایشان حمایت و جان بداری کنند و به آنان احترام بگذارند.	for the poor, if they are persons of virtue and good sense, have those who follow, honour, and uphold them, just as the rich have those who flatter and dance attendance on them.
مردم ما پول زیادی برای او نا داده بودن	our folks had paid good solid money for it
آن را یک پارچه از مرمر سفید ساخته بودند	was an elaborately wrought marble tomb
مردان ما هم هم ون کاری رو می کنن که فکر می کنن درس ته	our men did what they felt they had to do.
که دوستش را به یک گورکن تبدیل کرده بود.	he had turned his friend into a badger.
زیرا او باعث شده بود که مادرش گریه کند.	because she made his mother cry.
حاصلی نداشت جز بیهوده در خطر افکندن سه یا چهار ژاندارم بدبخت.	it merely exposed three or four unfortunate gendarmes to no purpose.
ناشناس همان جا ایستاده همچنان چشم به او دوخته بود.	the stranger was standing in the same place, still watching him.
پس آنگاه چنان دلایلی بر تأخیر خود خواهم آورد که او نه تنها خشمگین نخواهد شد	to whom I shall make such excuses that she will be led to approve of my delay
به او گفتم یک بار در سال 1916 خونم بجوش آمد.	I went off the boil in 1916,' I told him.
آنگاه او را آزاد کرد و هر یک از دخترها را به پنج دلار جریمه محکوم کرد.	then he let him go, and proceeded to fine each of the girls five dollars
که ممکن است به علت بیفکری و بیاعتنایی باعث بدنامی خودت در اجتماع بشوی.	that through thoughtlessness and lack of caution you may cause yourself to be talked about in society.
با قارقار و هیاهوی هزاران پروبال خود در هوا بنای چرخیدن گذاشتند.	circled in the air, cawing and noisily flapping their wings.
من یاد دارم که یه سال او نقده سگ فراوون شد که مجبور شدن مطلب و تو روزنومه بنویسن.	I remember one year when there were so many dogs that it was necessary to put it in the newspapers.
برگی را که به با بدخلقی کنده بود دور انداخت	he threw away the leaf that he had picked so peevishly
پس حال خود را بدتر از آنچه بودم نمودم.	I pretended to be worse than I really was.
کاغذ را توی پاکت گذاشتم و بوسیله گارسون طبقه برایش فرستادم و به او دستور دادم که کاغذ را به دست شخص او برساند.	I sealed the letter, and dispatched it by the hand of a corridor lacquey, with orders to hand it to the addressee in person.
خیلی راحت حدس زدم که برای دیدن او رفته بودی	it was not difficult for me to guess that it was to see her that you had gone
شما به من گفتید که صبر کنم و امیدوار باشم	do you know what you did, unfortunate adviser?
بنا بود که در همین روزها وارد مسکو شود و او را به زنی بگیرد.	was to come one of these days and take her.
هر چند همین چند لحظه قبل نزدیک بود روی زنی مثل تو دست بلند کنم.	I'd almost as soon strike a woman as you.
در کالسکه هم خیلی راحت پشت سرشان بسته شد و اِما دید که خودش مانده توی کالسکه با آقای التن.	that the door was to be lawfully shut on them,and that they were to have a tete a tete drive.
فردای آن روز از صبح زود شروع به کار کردیم	THE next morning we fell early to work
شروع کرد به قدم زدن و کشیک دادن در سراسرا.	having some fear that the prisoner might bolt.
اما نه چندان بلند که متکبر به نظر برسد.	yet not so high as to appear haughty.
با این همه تدبیری بکار بردم و کوشیدم که روی دست و پا بخزم و به کناری از بوته سیسنبر که از تگرگ محفوظ بود پناه آورم.	however, I made a shift to creep on all fours, and shelter myself, by lying flat on my face, on the lee side of a border of lemon thyme
هر آن ممکن بود سر برسند و علت بازداشت او را بفهمند.	at anymoment might approach and so learn the meaning of his arrest.
به زودی نسیمی تندتر از نسیم معمولی از طرف دریا وزیدن خواهد گرفت.	the sea breeze had set in higher than usual.
ولی در هر حال اتفاقیه که افتاده و کاریش نمی شه کرد.	but all the same
من موافق نیستم بدون رضایت و موافقت کامل شما سرپرستی او را به عهده بگیرم.	I will not agree to take her without your full and willing consent.
همان طور که من آنجا روی زمین نشسته بودم.	as I sat there huddled on the floor.
تا خانه خود را پاکیزه و مرتب نگاه دارد.	to keep her house trim and spruce.
تا نگاهی به اطراف بیندازد و ببیند این حوالی برای زندگی کردن مناسب هست یا نه.	just to look about him and see whether the neighborhood would suit him to live in.
با لحنی که به کلی با آنچه از بدو ورود خود در پیش گرفته بود تفاوت داشت	in a much lower tone than he had taken since he came in.
تا بلکه بار دیگر او را به خود علاقمند کند	than a ruse or lovelorn device
ترسم از همین بود که او نارو دست کم بگیر ین!	I was afraid you'd take it like this!
هر یک از ایشان به کدام سر کرده بستگی داشت.	to what headsman each of them belonged.
اما فکر کنم برای اخطاری مثل این کمی دیر باشد.	but I guess it's a bit late for warnings like that.
وقتی رفتیم توی قلعه بهت می گم بیا بریم.	I'll explain inside
بنابراین لازم است به آنجا بروی و طوری با او سازش کنی.	so you must go at once and make a bargain with him.
که سرد و سخت مانند مرمری است و متکبر و مغرور است چون پدرش.	cold as marble and proud like his father
اکنون بازوان مهربان خود را گرد گردن لجوج او افکنده	now threw affectionate arms round his stubborn neck
نگاه کجی به من کردید و ابروها را درهم کشیدید	you looked through me, and frowned
واداشت قسمت آهنین آن را پهلوی یکی از پارو بهای قایقش در تابوت بگذارند.	then had the iron part placed in the coffin along with one of the paddles of his boat.
یعنی دردی است که از عشق و وجود آمده است	I mean from the love you bear
که صرفا به عنوان عالم وظایف الاعضاء صاحب حسی به سر وال سر زا و به خصوص وضع پیشانی آن در تمامی مجموع فشرده آن نگاه کنید.	as a sensible physiologist, simply particularly re mark its front aspect, in all its compacted collectedness.
اما فقط دو حباب بزرگ از دهانش بیرون آمد.	but only two large bubbles came out.
حالا باید آزاد باشم و به کار خوشایند خودم بپردازم.	I ought to be at liberty to attend to my own pleasure.
تا فهمید که آن را با آخرین نفس خود امضا کرده است.	to realize that he had signed his name with his last breath.
با رضایت کامل مطمئن شد که دخترک مست مست است.	saw, with great satisfaction, that she was very far gone indeed.
یا تا وقتی که از این وضع نجات پیدا نکرده پهلوش بمو نی و در همین نامه اضافه کرده که با این حال چاره دیگری نداری.	or until she is out of this thing, but thatit can't be helped.
به شما گفتم که نسبت به او محبت نداشتم.	I have told you he was not sympathetic to me
یا باید همچی زهر چشم گرفته با شن که دی گه جرئت نکنم دست به این کار بزنم.	or else punish me so I'll be afraid to do her again
قلب اسکار لت از این صمیمیت گرم و شاد شد.	while it surprised her, it warmed her heart and pleased her very much.
تا من بتوانم با غرور و خشم طوفان کنم.	so that I could storm away with my pride and indignation.
میل و اراده کنتس هر چیزی را که بخواهد	the countess has only to wish it
چون سر برگرداندم دیدم که آن بانگ همانا خر خر آن حیوانست.	turning my head, I found it proceeded from the purring of that animal
سنش از هفتاد و نه سال یک روز هم بیشتر نبود	not a dayover seventy nine years old
حتما موقع سواری در آن هوای مرطوب و نکبتی سرما خوردم.	I must have taken cold in that nasty damp ride.
که به کجا برود و در کجا زندگی کند.	where he had better go and try to live.
در حالی که از پله مخصوص که به عمارت زنش بالا رفت	as he ascended the stairs leading to his wife's room
اما اشتباه کرد و نخست از سمت راست رفت.	but he made a mistake and turned to the right first.
سعی کردم آرام بمانم و از کوره در نروم.	I tried to stay calm, to not panic.
فکر کردم که شاید او هم به همان خوبی مرا شناخته باشد.	I wondered if she would guess immediately who I was as well.
اگر یکی از این اراذل را به چنگ آورده بودیم	if we'd caught one of them rascals.
که بین این دو نفر وضع از چه قرار بود.	how this affair stood between the two men.
مگر اینکه بخواهد چون عاشقی چشم و گوش بسته با وی رفتار کند.	unless she were extremely and foolishly indulgent.
کار من سر ساعت شیش تم وم می شه.	I get off here at six.
که من به قدر کافی آزمایشش کرده خوب شناخته بودم	as I had ample reason to know
گفت مبادا اکنون شاعر من مختل شده باشد زیرا هر چند که او مرد شری ری مانند مرا بکشتی خود راه داده و از ای نرو باید پشیمان باشد	for although he should be sorry to have taken so ill a man into his ship
زیرا کسی که در پی حوادث روان است همیشه با حوادث نیکو و مطلوب روبرو نخواهد شد.	for those who seek adventures don't always find good ones.
فریاد کشیدند تا خادم قفل برنجی پلکان را بیاورد.	loudly called for the steward to bring the heavy brass padlock belonging to the companionway.
از روی گر تهٔ کسانی که در پیرامون وی بودند عمل کند و اندازهٔ معنوی ایشان را بپذیرد.	the minimum of risk, trying to copy the people about her and to take their moral measure.
روی دوایر بزرگ شونده از ساحل به جانب دریا پیش رفت.در پی دین بود.	swooped in ever increasing circles outward from the beach, searching.
به نظر من اگر یک سکه هم از مال دنیا داشت	I really believe, if she had only a shilling in the world
بعد ثابت ماند و در همان حال پنج پاروب قایق دیده شدند که عمود در هوا ماندند.	then remained fixed, while the boat's five oars were seen simultaneously peaked.
ضایعات مهر و محبت انباشته شده در قلب او را سوزانده و از بین برده بود.	had burned the dimming piles of nostalgic waste that life had accumulated in her heart
با این حساب تمام مصالح ساختمانی دم دستشان بود.	so that all the materials for building were at hand.
این بار بیش از هر زمان دیگری جسارت به خرج داد	here he showed more audacity than most
من هم همه را بخشیده و امیدوارم که در آن دنیا یکدیگر را ملاقات نماییم.	I forgive everyone, and trust we may all meet when the trump shall sound.
به جای آن وحشت و هراسی از دیدار حال غم ین و افسرده لینتون به وی دست داد و به جای اینکه از او پوزش ایام فراق را بخواهد مجبور شد با نگرانی از حالش جویا شود.	the congratulation on their long postponed meeting to an anxious inquiry, whether he were worse than usual?
یا چگونه ممکنست در امری چون و چرا کرد	or how a point could be disputable
که در نخستین روز ورود به این نقطه ناگزیر شد گروهبان خود را عوض کند	the first day of their arrival at that small town he changed his sergeant major
چون شب مهتاب بود موفق شدم که خود را به کاخ برسانم بی آنکه هیچ یک از مردم را لگد کرده باشم.	it being likewise a moonshine night, I made a shift to get to the palace without trampling on any of the people.
بنده ایشان را امروز بعدازظهر در خیابان ملاقات کردم	I met her in the street this afternoon,
نباید دست به شمشیر ببری و به دفاع از من برخیزی	thou must not put a hand to thy sword in my defence
کافی بود که آن را به تمامی در برابر چشمان کریستف ظاهر گرداند.	was enough to make it all come rushing mightily up before his gaze.
اما نتوانست و از فرط ذوق و هیجان هم گریه کرد و هم خندید.	cried and then laughed unnaturally.
وقتی کار به آنجا برسد که آدم بخواهد با مرد ناشناسی در مسافرخانه ناشناسی در شهر ناشناسی بخوابد	when it comes to sleeping with an unknown stranger, in a strange inn, in a strange town
خط طویل و کوتاهی از درختان در امتداد افق کشیده شده بود.	a long, low line of mangrove trees along the horizon.
باز نایستاد مگر آنگاه که ربع فرسنگی راه پیموده بود.	never stopped until he had run a mile or more.
بر اثر این علاقهٔ کودکان به من خیلی دیگر از اشخاص با من بد شدند	I had many enemies, and all because of the children.
برج کلیسا خود چون شبح غولی عظیم جثه شاهد صحنه بود.	while the church tower itself looked on like the ghost of a monstrous giant.
از آن هفته به این هفته و از این هفته به هفتة دیگر و از پریروز به دیورز و امروز و امشب!	at last, from the week after next to next week, this week, the day after tomorrow, tomorrow, today, tonight
من به اطاقم داخل شدم و روی بستر دراز کشیدم.	I ascended to my room, and lay down upon the bed.
پس یک سال اخیر بر او سی سال گذشته بود.	that year had counted for thirty.
اما بد تر از ان این بود که سعی کرده بود گناه را به گردن خواهرش بیندازد	but to try to put the blame on her sister!
دیوارهای اتاق پوشیده از اسباب و وسایل ماهیگیری بود.	all the fishing tackle hung.
تنها تو و بس! کسی غیر از تو مقصر نیست.	you and you, you and nobody else.
برای نگاه داری چنین دم و دستگاهی چه ثروت و تأمینی لازم است.	security which could sustain it.
که هر مردی آرزو دارد از زن شرعی خود چنان فرمان برداری و اطاعتی ببیند.	than a man has a right to expect of his own married wife, sir.
که چون من دست بر قضا به این جا آمده و پایش به جریان حوادثی کشیده شده که بدبینی اش مثل خود من باعث شده از کل این ماجراها بی اختیار متنفر باشد.	like me, has come casually here to be drawn into the events for which his scepticism as well as mine seems to entertain a sort of passive contempt.
مطمئنم که تو به آن به چشم یک مبارزه نگاه خواهی کرد.	I think you'll find it a real challenge.
من تقریباً مطمئنم که این آدرس در هتلی نوشته شده است.	I am almost certain that this address has been written in a hotel.
واقعاً باید با شوهرم حرف بزنم یک الاغ بخرد.	I really must talk to him about purchasing a donkey.
اما اگر چنین کنید خطر ان که جادوانه به توسط او ملطوم و غرقه شوید چندان کم نیست.	but by so doing, you run no small risk of being eternally stove and sunk by him.
نه از آن جهت است که او یکی از سه نفری بود	not becausehe was one of the three
300 لیرهٔ آن را برای کرایه و مخارج سفر فردا کنار گذاشت	put GBP300 on one side for the air fare and expenses the following day
یا چیزی جز بخار نیستند خود واقعا نکته جالبی است	or nothing but vapour this is surely a noteworthy thing.
در کتاب مقدس آمده است که و اجاره سفر را پرداخت. و آن قبل از حرکت کشتی بود.	that he paid the fare thereof ' ere the craft did sail.
حکایت کرد که چگونه هنگ 28 جبهه را ترک کرد	he told of the with drawal of the 28th regiment from the front
کمی پول که سال آخر جنگ کنار گذاشته بودم.	the bit of money I'd put aside during the last year of war
تا تکلیفم را بندانم و این گردش عالی و خوش را شروع کنم.	to ascertain if we could get leave to carry out this great idea.
سزاوار نیست که مردم شرافتمند بی آنکه نفعی برای خود تصور کنند جلاد مردم دیگر شوند.	it is not fitting that honest men should be the instruments of punishment to others, they being therein no way concerned.
هر یک از این پدران یک لحظه تصور کند که آن بچه که گفتم فرزند او است.	let each one of those fathers imagine that this child is his own.
لحظه بعد پارو جویده و به دو قسمت شد.	an instant later the paddle was bitten in two.
موتور لنجی به حرکت درآمد و سه ساعت بعد بازگشت.	a launch sped out, and three hours later returned.
دچار نوبه حادی شده بود که با هذیان و نیمه بیهوشی همراه بود.	he was in a feverish state, sometimes delirious, sometimes half conscious.
باور کنید از خوشحالی او بسیار مسرور بودم به خانهٔ اردینتف بازگشت	I was glad for the poor fellow, and went home.
بدون هیچ آسیبی برگردد و از مسیر دیگری به مرکز هزارتو برود.	get away from the sphinx unharmed
کودکی که از بطن او بود و از دیگر فرزندانش بیشتر دوستش داشت .	especially when that little girl was her favorite child.
نهایت این است که شش هزار فرانک تنزیل خواهید داد.	it will only cost you a discount of 5,000 or 6,000 francs.
راجع به خاطرات نیز معتقد بود که حالا دیگر باید هرچه زودتر کتاب را تمام کرد که موقع بسیار حساس است.	in relation to which document he had a notion that time was beginning to press now, and that it really must be got out of hand.
ولی درست موقعی که فکر کرده بود کار تمام شده ناگهان قضیه سر واکرد.	but it burst out again when she thought she had succeeded
اسمردیاکف در حالیکه لبخندی لبانش را منقبض ساخت با لحن مظنونی گفت	he faltered mistrustfully, looking with a forced smile into his eyes.
یا اصلا ممکنه کسانی پیدا به شن که قبلا تو هتلی که کار می کنه دیده با شنش.	or some one coming along who hasseen him there.
دریافت که میز و ابزار کفاشی به کناری نهاده شده است	he perceived that the shoemaker's bench and tools were put aside again
هر قهرمان فقط نقشی کوچک در این ماجرای بزرگ بازی کرده است.	that only a small part is played in great deeds by any hero.
اگه راهرویی خطرناک با شه حداقل به ما ارشدها باید به گن.	I do think he might have told us prefects, at least.
من پیرترین زن این نوا حتی هستم و هنوز میتونم بیسکوئیت های خودمو بپزم.	I'm the oldest woman in these parts, I guess, and I still make m'own biscuit.
آن قدر طولی نکشید تا من به آن زندگی عادت کردم و خوشم آمد	it warn't long after that till I was used to being where I was, and liked it
فرصتی که مدام همراه او روی آن صندلی که اکنون نشسته بود وجود داشت	it had always been with her there on the chair where she was sitting
در بالای آیینه هم کلی گردنبند آویزان کرده بودم.	the mirror with necklaces strung over the side
هیچ راه فراری برای من باقی نمانده بود ب	I have no way out of this.
بعد از این که پیام را برای جهان بیش و کم هوشیار بیرون مخابره کردم	after sending out the cable message for the information of a more or less attentive world.
از یک سو در نظرش سعادتی عظیم و باورناشدنی	presented itself to his mind
ممکن است دختر وضعی داشته باشد که زندگی در خانواده برایش حقارت آور باشد.	a girl may be so circumstanced that she cannot live in the family without humiliation,
حرف من صرفا این است که از دیدگاه عرف و قانون این پسر نامزد رسمی ربرتای فقید نبود.	I amsimply stating, as a matter of fact and of law, that this boy wasnot formally engaged to this dead girl.
بلکه مجبوریم یک یک برویم و هر یک به سویی بگریزیم	but only singly and separate, and each one his own way
دن کیشوت فقط توانست تشخیص بدهد که حریف او مردی است خوش اندام ولی قدش چندان بلند نیست.	he observed, however, that he was a sturdily built man, but not very tall in stature.
کلید را از دستش گرفتم و مات و مبهوت به آن نگاه کردم	I take the key from her and look at it in fascination
که قدحی به دست داشت و ظاهرا منتظر ورود فرمانده کل بود.	holding a dish and evidently awaiting the entrance of the commander in chief.
در هر حال زودتر از غروب مراجعت نخواهد کرد.	he would not be able to get back before evening.
طبعاً با اشتیاق چشم به راه پایان خوش این دوران بود.	naturally made him look forward the more eagerly to the happy termination of courtship.
این شخص بی آنکه جواب دهد سر را بلند نموده دوباره به مادر نگریست.	who did not answer but raised his head and again looked into the mother's face.
فریادی عظیم حضور او را در آنجا به دیگران که در جلوی خانه قرار داشتند اعلام کرد	a loud shout proclaimed the fact to those in front
اکنون با قلبی سنگین قدم به هوای مه گرفتهء خیابان گذاشت.	so he emerged into the heavy mist of the heavy streets, with a heavier heart.
نگاهشان بار دیگر به هم تلاقی کرد و لئون از نظر ناپدید شد.	their eyes met again, and he disappeared.
که بدو امر و دستکم تاکنون ظاهرا به نحو جدائی ناپذیر به یکدیگر نزدیکانش کرده بود.	which at first and up to now at least had seemed to be drawing them indivisibly together.
که موضوع نظام نامه قشون بزودی در اندیشه او جای اصلی خود را از دست داد.	that the question of the army regulations quickly receded to a secondary place in his consciousness.
یک خوراک کافی ماده مخدر به او دادم که چند ساعت بخوابد.	I gave him a sufficient dose of veronal to insure his unconsciousness for several hours.
همان کسی را که صاحب فرضیة لزوم انتخاب زن از میان بیچارگان است	who propounds the theory of the superiority of wives raised from destitution
شلیک چهارم و پنجم پیروزمندانه از محل نزدیکی در طرف راست شنیده شد.	then a fourth and a fifth boomed solemnly near by on the right.
گفت حالا اگر جرأت دارد از حق مرد صحبت کند	defied him to talk about his prerogative again, if he dared.
اما شاید برای اجتناب از یک دعوای دیگر از این کار منصرف شد	but perhaps he didn't want another row
به دنبال چنین هدفی به شهر رفته و دور دنیا راه افتاده بود که	it was in pursuit of this aim that she had gone to town and run about the world
تو می تونی برادرهای دی گه و بقیه خانواده تو به من نشون بدی.	you'll be able to show me your other brothers and everyone.
مطمئن باشید که د رآنجا خوب از شما پذیرائی خواهد شد.	you are quide sure of being well receifed.
بله گرم شده بود اما نه در اثر داستان بلکه در اثر مارتین.	but she was warmed, not by the story, but by him.
مداخله ندهم و خود را ناراحت نسازم و وظایف خود را با صداقت و وفاداری به انجام رسانم.	I shall try to perform them as faithfully as
در این نامه ربرتا به مادرش گفته بود که قرا ره بزودی ازدواج کنه.	in which she told her that she was about to be married.
به او فرمان دادند که اگر من در صدد رهائی خود برآمدم مرا آماج تیر کند و بکشد.	who was commanded to shoot me dead if I attempted my liberty.
ولی من هابیت پیری بیشتر نیستم و دلم لک زده است برای غذای ظهر.	but I am only an old hobbit, and I miss my meal at noon.
در این حال زنی لاغر و رنگ باخته که دستمالی به سر بسته بود و طفلی را در آغوش داشت	screamed a thin, pale woman who, with a baby in her arms and her kerchief torn from her head
کار دریانوردی را میان دو کشور بسیار آسان کرده است.	which affords frequent opportunities of sailing from one island to the other.
تنها موقعی که من نگاهی از پشت پنجره به درون کابین انداختم	until I got my eye above the window sill
او را از نادانی و حماقت درباره روابط شوهرش با دیگران بیرون آورد.	waking her from her previous stupidity and incurious self absorbed ignorance about her husband's relation to others.
اتکا دل پذیر روحی به انسان بسیار بالاتر اکنون به کوششی ناراحت کننده و آمیخته به بیمی مبهم تبدیل شده بود.	the delicious repose of the soul on a complete superior had been shaken into uneasy effort and alarmed with dim presentiment.
کلاه و شالش را برداشت و اندام لاغر و زیبایی را به نمایش گذاشت.	throwing back her wraps, and showing a thin but well built figure.
با نهایت خشم در تختخواب چرخی خوردم و به بالشم تکیه کردم	I angrily turned round in bed
بعضی از دریانوردان به دیگران گفتند که علت آن فقط این است که او هم در مالکیت کشتی سهمی دارد.	some of the seamen declared that it was only on account of his being a part owner in her.
پس نخواست که امر را طول داده و مطلب را پر دورتر براند.	, and not wishing to carry it too far
امکانش هست که این روزها مرا مجبور کند تا بار دیگر به زندگی با او تن بدهم.	every day I am faced by the possibility that he may force me to live with him.
هیچ وقت فرصتی برای یادگیری و تمرین شنا برایش پیش نیامده بود.	he'd never had much practice.
این سخنان را محکم ادا کرد و از اطاق خارج شد.	he concluded emphatically, and went out of the room.
آنکه پیدا کرده بودند هم قد با بام بود	they said this drownded man was just his size
آن حال که آن مردان خوش گذران از خشم او مات و متحیر مانده بودند	while the revellers stood aghast at the fury of the man
در طول مدتی که در آنجا هستم حداکثر تلاش خود را برای اصلاح و آبادی آن انجام خواهم داد.	while I do stay, I will exert myself to the utmost for its improvement.
بتوانم رعایای زنگی خود را به کشتی بار کنم	I may be able to ship off my black vassals
منظره از آن بالا خیلی زیباتر از برج فانوس دریایی بود.	better than from the lighthouse
همیشه دلواپس آن است که مبادا باز ذهن خود را از دست بدهد.	he may never feel certain of not losing himself again.
اما این لحظات درخشان و جا نبخش مقدمه و مرحله دومی قطعی بود	these moments were but presentiments, as it were, of the one final second
هیچ وقت قبلا از سرزمین خودمان بیرون نرفته بودم.	I have never been out of my own land before.
از بین خود یکی را به قید قرعه خواهیم گذاشت تا بزهای همه را نگاه دارد.	cast lots to see who must stay to mind the goats of all.
همه چیز را به جز انگشتان او روی پوستم از یاد بردم.	forgetting everything but her fingers on my skin.
فقط همین یه تیکه زمین و به رام باقی گذاشتند.	but this little piece o scratch that's here.
وی لفور این جمله را بی تمهید مقدمه با متانت تمام گفت	said the magistrate, without any introduction
من خواستم یک شاخه رز قرمزی را برای مادرم بخرم	I wanted to buy a red rose for my mother.
ولو اینکه به قدر سار نا عمر کرده باشید.	though you should live more years than sarna.
حالا دیگر ادامة گفت و گو دشوار شده بود.	I felt the difficulty of resuming the subject
هرگز این را به هیچ کس دیگری نگفته بودم.	I've never told this to a living soul before.
مجبور شد یک هفته با همین قیافه توی خیابان برود.	he had to go around like that for a week.
مگر اینکه خرید کمتر از ده درصد سهام کلی شرکت باشد	unless the purchase is less than 10 per cent of the company's stock
به دنبال این دود صدای شلیکی از دور شنیده شد و افراد قشون روس به سوی پل شتافتند.	our troops could be seen hurrying to the crossing.
باری مور ظاهراً تعجب کرد و چند لحظه به فکر فرو رفت.	considered for a little time.
منم احمق بودم که آواز مردم دریایی رو جدی گرفتم!	I was the only one who was thick enough to take that song seriously!
حالا در اینجا هم صحبتی دارم و این خیلی خوشحال کننده است.	it will be quite pleasant living here now with a companion.
به طرزی که او اسمم را گفت لبخند زدم	 I smiled at the way he said my name
چون تو نمی تونی اون و عشقش رو بفهمی.	because you can't understand him or his kind of love.
زیرا که اقلا نصف این اموال حق شما بود	half of it at least by right belonged to you
باید در انتظار آن بمانم و نه این که مثل یک ساتی برای مردن عجله کنم.	I should bide that time, and not be hurried away in a suttee.
موجودی که به نحوی جالب سترون و عقیم و بی اهمیت و پیش پا افتاده است.	interestingly barren and without importance.
به یاد اینجا معلوم می شه که ما هم مثل دوستانم ون برای کلاید ارزش قائلیم.	just to show that we don't think any less of him than our friends do.
اما صرفا به خاطر این خصلت خانم گولد نبود که به او توجه داشتند برای مثال مردان اردوی نقشه برداران از جوانت رین جوانان تا سرمهندس پخته و جاافتاده	but these were not exactly the reasons why, for instance, the whole surveying camp, from the youngest of the young men to their mature chief
چیزی نگذشت که باد و بوران را در موسیقی شعر از یاد بردم.	I soon forgot storm in music.
برای او نیز جایی در آن ستون باز کند.	put her in the new part
تمام اموال و دارایی خود را رها ساخته و از مسکو بیرون نرفته	that he had abandoned everything and not left the city
دستش را دراز کرد و او را به درون کشید.	but she put out a hand and drew him into the room.
دیدی که هشتاد فرانک از برای خودم خرج ملاحظه کردم.	do you not see that I reserve eighty francs for myself?
به او اطمینان داد که قصدش به هیچ وجه مقایسه نبوده.	assured her that he was not comparing.
ملوان پیش از آن که بتواند خنجرش را بیرون آورد خفه شده بود.	the sailor would have been stifled before he could draw his cutlass.
1 . با سکون و آرامش خیال و ضمیر بر خشم و غضب غالب شوم.	1 to conquer anger by calmness and deliberation
ناگهان خاطره جدید و غیر منتظری از جهان کودکی و عشق و صفا در نظرش مجسم شد	suddenly a new unexpected memory from that realm of pure and loving childhood presented itself to him.
که کلاید نتوانست تشخیص دهد که آن حروف از بی وتی تشکیل شده است یا از جی وتی.	, he could not decide which, so elaborately intertwined was the engraved penmanship.
تا اینکه در آن دنیا ما را به گناه این اعمال و این افکار مجازات نکنی.	so that you will not collect for this squandering in the other life.
اعصابش چنان برانگیخته شد که دستش به رعشه خفیفی افتاد.	growing decidedly nervous so much so that his hand trembled slightly.
من حاضرم هر کاری که لازم است انجام بدهم.	I'll do anything.
گویی چون زیاد به پوشیدن چکمه آن هم چکمه چرم گاو چروکیده که لابد سفارشی هم نبود	as if, not being much accustomed to boots, his pair of damp, wrinkled cowhide ones
چنین وانمود ساخت که گویی آنچه به وقوع پیوسته است	in a tone that seemed to imply that everything that took place
در همین لحظه به حمله پردازد وگرنه دگیر دیر خواهد شد.	at that very moment, or it would be too late.
در یک لحظه حال و هوای آشپز خانه را عوض کرد	instantly changing the mood in the kitchen.
در دست راست هم سوزنی داشت و گویی آماده	her needle in her right
ولی چندین سال بعد که این اجساد تازه کشف شد	but had yielded them up at last, after many years
من افتخار آن را یافتم که عالی جناب در جاده از من سبقت بگیرند.	I had the honour of being passed on the road.
چند بار قصد کردم تا از نگاههای او پرهیز کنم	I made several attempts to get out of their way
سر درد وحشتناکی داشتم .غصه دار و گرفته بودم	I have a throbbing headache, and I feel on the verge of tears.
آسوده خاطرم زیرا که میدانم که اگر بدبختی به او روی آور شود زندگی من نیز به پایان خواهد رسید.	I am at ease, because I know that if anything were to happen to him, it would be the end of me.
اما مطمئن بود که هرچه بیشتر اصرا کند همان جواب را خواهد شنید	convinced that say what she might she would still be told the same.
که چون خود طناب خوش بافتی بود و رنگ لاکی خوشی داشت	which, being itself nicely headed, and stained with a mahogany colour
که چه کس به نزد پزشک برود و به او چه بگوید.	who was to approach him and how.
اما بقیه به نظرم یک کم خسته کننده بودند.	but I thought others were fairly dull.
من خود را برای اتمام این کار تا گردن فروکردم.	I have been up to the eyes in this business.
چهره او چنان خوب درست شده بود که دربان وقتی در را گشود	presented such a rueful face to the aged pauper who opened it
پیشانی و تمام صورتش چروک خورده و از شدت درد کج و معوج شده بود.	the brow and the whole face were drawn and contorted convulsively.
بلند شدم و این طرف و آن طرف را با ترس نگاه کردم.	I set up and looked around, a little scared.
اما ناگهان دید که تمام آن علاقه چیزی جز توجه زودگذر و ناچیز نبوده است.	behold it was only a poor little evanescent partiality.
برعکس پشت به من کرد و چنان به شتاب گریخت	on the contrary, she turned her back on me and took to flight
من در مقابل گرو گذاشتن طپانچه های خود ده روبل وام گرفتم.	I pledged them for ten roubles.
در کار بریدن درختان جنگلی و ساختن پارو و دکل چندان رنج بردم که باور کردنی نیست.	I was at incredible pains in cutting down some of the largest timber trees, for oars and masts
اما برای من مثل آن است که سیخ چه از وسط دنیا در آمده.	but to me, the skewer seems loosening out of the middle of the world.
باید منتظر رقیب نامرئی خود باشد تا آن را به او برگرداند.	must wait for the unseen antagonist to return it to them.
این جماعت به قدری خودپسند بودند که دیگر حال و حوصله توجه به او را نداشتند.	were too much interested in themselves to pay much attention to him now.
زیرا دیگر ذرهای مهر تو در قلب من باقی نمانده است.	for all you had in me is gone.
از جا رهای بلورین پوشیده از بخار کدر اشعه کم رنگی ساطع بود.	bouquets were placed in a row the whole length of the table
اسب در گِل لیز خورد و به زمین سقوط کرد.	the horse slipped and fell in the mud.
او غمگین تر از آن بود که بتواند حرف بزند.	too miserable to speak.
او را در اطاق کارش بود و لباس خدمت بر تن داشت.	I found him in his study, apparently preparing to go out again
تنها راهش این است که ترتیبی بدهد تا همراهم بیاید.	the only way to work it was for her to arrange to go with me.
البته احتیاجی ندارم که بگویم این مطلب موضوعی محرمانه است	I needn't tell you to be secret.
گیج و مبهوت سر خود را به زیر افکند	hanging his head in confusion
تو در اولین فرصت باید با رفتارت نشان بدهی که عقلت سر جاست.	you must prove yourself to be in your senses as soon as you can by a different conduct
در دیدهٔ مردم نمونهٔ زن و شوهر شایسته بودند.	in the eyes of the world they were a model couple.
به خدا که تو دومین شخصیت مهم آن کتابی.	if you are not the second person in the history
لیوان شراب در دست داشت و حسابی شاد و شنگول بود.	who's standing by the door holding a glass of wine.
که انگار به فریادهای تمجید آمیز این جمعیت منتظر کمترین اعتنائی نداشت.	while he walked in the manner of one entirely oblivious of the meaning or compliment of this waiting throng.
جای زخم هری بلافاصله چنان تیر کشید که او از درد جیغ زد.	whose scar began to burn so fiercely that he almost screamed in agony.
هر لحظه انتظار دارم یکی حمله کند و به طرفم هجوم بیاورد.	fists clenched, anticipating an attack.
نگاهی به صفحات قبل انداخت و دوباره مدادش به رقص درآمد.	glanced back through the pages, and again started his pencil.
اما او ناشی بود و قدرت بستن در را نداشت.	but his efforts were weak and clumsy and the door
دیگری لباس سفید پوشیده و بر اسب سیاهی نشسته است	the other who was in a white uniform rode a black one.
روی تختخوابی از کاه خسته و گرسنه افتاده بود	as he lay, starving and weak, on a bed of straw.
در همین لحظه هم صدای حرکت کالسکه بر روی جاده سنگفرش شنیده شد.	at the same moment the carriage was heard rolling up the gravel walk.
قطر آن هفت هزار و صد و شصت و شش گز یا بیش از یک فرسنگ است	its diameter 7837 yards, or about four miles and a half
این بانوی زیبا و با فرهنگ هنوز ازدواج نکرده!	this beautiful and accomplished lady, she is not yet married?
چنان که وقتی از خواب پرید نه توانست تکان بخورد	so that, when he awoke startled, he was unable to move
یعنی قشون متجاوز نیز با آنکه تمام نیروی خود را در این تصادم از دست داد با این حال در نتیجه انرژی درونی خود که هنوز به کلی مصرف نشده بود باز جبرا اندکی پیش رفت.	with equal inevitability the ball of invasion that had advanced with such momentum rolled on for some distance, though the collision had deprived it of all its force.
تازه آن هم اگر نجات او امکان پذیر باشد	if, indeed, such salvation be possible
شاید جز همان مردی که چند لحظه پیش از او جدا شده بود.	but perhaps the man who had just gone away.
هم کسی ممکن نبود بیش از من جانش در خطر افتاده باشد.	could anyone be more entirely lost than I?
اگه دلت بخواد می تونم سر چند دقیقه یادت بدم.	I could teach you in a few minutes if you wanted me to.
از آن مرحله به بعد دیگر قادر نبود جلوی خودش را بگیرد.	from that point on he was going to lose control
بدون ایجاد ناراحتی و اوقات تلخی به آن پرداخت.	brought them off without any intermediate exasperation.
اون هیولا ادوارد رو در مورد این دوست داشتن قانع کرده بود.	that the monster had convinced him of this love.
چون شنید که پاسبان رفقای خود را صدا زده	for he heard the brigadier exclaim in a loud voice
این فرمان را که در آن حکم توقیف این دزد راهزن نوشته شده است بخوانید!	read this warrant which says this highwayman is to be arrested.
گرچه او حاضر بود بمیرد اما این واقعیت را نپذیرد.	though he would have died rather than admit it.
من این احساس را داشتم که سو الی خواهید کرد.	I felt that you were going to ask some question like that,
فقط گفت هرگز در زندگی حالش به هم نخورده.	said only that he had never been sick in his life.
از ژانینا واقعا مثل این است که شما اطلاع ندارید	really you appear to be totally ignorant
کلاه خود را از بس سراسیمه بودم هنگام پارو زدن با ریسمانی بر سر خود بسته بودم	my hat, which I had fastened with a string to my head while I was rowing
ولی آفتاب شدید بعدازظهر مستقیماً به چهره او تابید و مجبور شدند بار دیگر پنجره را ببندند.	but the afternoon sun hit him full in the face and she had to close it again.
که گویی دو نیروی متخاصم در او به نزاع پرداخته بودند	as if two antagonistic influences were struggling in her
در انتظارات واهی بمانیم و به او فرصت بدهیم که ما را بفریبد و از چنگمان بگریزد بسیار احمقیم.	or to trick us, now that we certainly have him in our hands!
به شرطی که او نم با من درست صحبت کنه.	if she does when she's talking to me.
اما یک مرتبه او را از نظر ترک کرده	but suddenly his glance was transferred
کتاب از آن آموزگار او بود که زنی بود محترم و موقر و نه پیر بود و نه جوان	belonged to her governess, a grave elderly gentlewoman
یا مده در اتاق من حرف خود را بزند	not come into my study?
اگر مواعظ و امثال حکیمانه آنان را درباره اصول اخلاقی و مملکت داری به کار بندیم موجب سعادت ما خواهد شد.	whose wise maxims in morality and government it would be our happiness to observe.
شما به ما خبر دادید که سی هزار لیور همراه دارد	who you said had 30,000 livres
از تالار بیرون رفت و در جاده ناپدید گشت.	skipped out of the parlour and into the road
درست نیست که من شرط شما را برای تحصیلات قبول کنم اما بعدش از تحصیلاتم روی گردان بشوم و از آن استفاده نکنم.	it would scarcely be fair to accept your education and then go off and not use it.
اکنون به سیلی از امواج خروشان و زرد رنگ بدل شده بود.	was now a race of turbulent yellow waters.
که با وجود این همه احتیاطی که او به کار برده است	that, notwithstanding her precautions
یک هیولای چشم قرمز که به قدری مردم را کشته بود که شمارش آن را از دستش رفته بود.	the red eyed monster that had killed so many people that I'd stop counting their numbers.
چند سال بود که من از از خو نه بیرون نرفته بودم.	I had not left the house for years.
انگار گریه کرده باشم یا یه هم چین چیزی.	like I'd been crying or something.
ولی هرگز در گذشته به این آسانی چنین رضایتی از جانب او ندیده بودند.	they had never before gained tokens of this favor so easily.
تو تنها نوزادی بود که جون سالم به در بردی.	you was only a baby, an' you lived.
بدون آنکه گناهی از او سر زده باشد و بی آنکه قبلاً مسبب بدبختی خود را بکشد خود را کشت.	who they say killed herself without having done anything wrong, and without having first killed him on whom the guilt of her misfortune lay.
خودم هم در حدود ده دلار پس انداز دارم.	I have about ten dollars myself.
ولی اگر موافق باشید که این وظیفه را سورچی انجام دهد	but if you would leave the postboy to say that
اما چون دسته آن کنار دستش نبود موفق نشد.	but failing now that he had reversed the handle.
اگه فقط می تونستم یه صدتایی ماشین جور کنم.	if I could only get a hundred jalopies.
تا وی را به سبب ارتکاب این عمل خودسرانه مجازات کند	for him to punish him for breach of discipline.
بنابراین گمان این که کسی را به انتخاب خود دوست بدارم بر خطا است.	to expect me to love by choice is idle.
مردم برای ماه عسل به جای دوری مسافرت کنند.	people going a long journey when they are married.
پسرک خیلی ضعیف بود و مثل شمعی خاموش شد.	there was nothing to the kid he went over like a candlepin.
که بیش از یک قرن مسکن آن خانواده بود.	which had been the family mansion for over a century
از پیاده رو خارج شد و درجوی افتاد و محکم به زمین نشست.	went off the sidewalk into the gutter, and sat down hard.
من حتی عرضه نداشتم یک برنامه ساده پیاده کنم.	I can't even organize one simple evening
من ساعت هشت و پانزده دقیقه به سراغ شما خواهم آمد.	I will pick you up at eight fifteen.
ولی باز تعجب کرد که اینهاچطور از اطاق خارج شدند و صدائی درنیامد.	but no sound of a door being opened or shut.
دیدم که دارای همان اثاثه ایست که در اطاق اول دیده بودم منتهی آن را به سبکی زیباتر از این آراسته بودند.	this was furnished like the first, only after a more elegant manner.
تا بتواند به برق طلایی رنگی نگاه کند که به سرعت از کنار گوش چپش گذشته بود.	too busy looking over his shoulder at the flash of gold that had passed his left ear.
از من پرسید که آیا عضو حزب ویگ هستم یا توری .	asked me, whether I was a whig or tory?
تا از ضعف روحی و جسمی خود لذت ببرد.	to enjoy his prostration.
خیلی ممنون می شن اگه شما یه خورده جلوتر برین.	he'd be mitch obleeged to us to gang on a bit further.
اما این احساس تنها آمیخته به نگرانی به خاطر او بود.	but it was only mingled with other causes in making her more conscious of that new alarm on his behalf
بیشتر از آن است که به طور طبیعی بتوانم تحملش کنم.	more than I could naturally bear.
او نا توی آتش نشانی زندونیش کردن و اجازه نمی دن حموم کنه.	they've been keeping him in the firehouse and not letting him bathe
یک لحظه از این حقیقت غافل نبودکه بهای نجات تارا را باید با تبعید دائمی خود بپردازد.	she had not given a thought to the fact that the price she was paying for the safety of home was permanent exile from it.
اما با این وجود حدود یک صد و پنجاه نفر را انتخاب کردیم که با تعداد زیادی از شترهای بارکش برای حمل نائم آماده کار شدند.	nevertheless, we started out with one hundred and fifty men and a huge train of empty pack camels for the spoils.
تو قصد داشتی از من خواستگاری کنی و پولت را نگاه داری!	I suppose you thought you'd keep the money, if I did!
که به زحمت بسیار توانست جلو اشکش را بگیرد	that he had to take great heed to keep his tears
برابر با مزد دو کارگر تمام وقت با کار شاق از بام تا شام در سرتاسر تابستان است.	that these liveries would cost the wages of two laborers for the summer,
چه طور یه نفر میتونه این همه چیزا رو به یاد بیاره.	how much a guy can remember.
ما با بادبان گشاده قایق راندیم و بیش از هشت میل در ساعت بدون هیچ هراسی طی طریق کردیم	under sail we ran more than eight miles an hour without any fear
استفاده از داروی مخصوصی را به آن جوان کارگر توصیه و کرده است	had already advised the young man of a temporary remedy.
کمی زیادی زرنگی کرده بودم و چوپش را خوردم.	I'd been a little bit too clever and put my foot in it.
تا دخترک بتواند به خود بقبولاند که آن مرد فقط قیم اوست و عاشقش نیست.	so that she could become accustomed to the idea that he was her guardian and no longer her lover.
تا قاشق کی که با آن گلویش را معاینه کرده بود به او هدیه کند.	to give her the tongue depressor he had used to examine her throat.
دلم برای برگشتن به دانشکده و شروع درس خیلی تنگ شده	I'm LONGING to go back and begin work.
مگر اینکه زن او حزم و دوراندیشی به کار برد و برای فرزندان آینده خود پدری تندرست از میان همسایگان یا خدمتگاران خویش برگزیند	unless the wife takes care to provide a healthy father, among her neighbours or domestics
تو که می دونی او مسافرخونه راست سرجاش وایستاده بود.	YOU know his tavern was all right
اما این حرکت او تشویش و اضطراب مو رل را بیشتر کرد	but his appearance manifested increasing uneasiness.
ما یک هیات مدیره خوب برای پشتیبانی از او تعیین خواهیم کرد.	we'll pick a lop management team to back him up.
من بیش از یک چهارم میل با ساحل فاصله نداشتم	I was scarce a quarter of a mile to seaward
با صدای یکنواختاش مانند صدای یک جاروبرقی کهنه شروع به خواندن کرد.	began to read in a flat drone like an old vacuum cleaner
او مجبور نبود که از خود معجزه نشان بدهد	for she was not bound to perform miracles
آن چهار سوار که سرو وضع آراسته و مجللی داشتند وقتی از اسب به زیر آمدند	the four that were on horseback, who were of highbred appearance and bearing, dismounted
همچنان غلیظ و به هم فشرده با یورتمه سریع	still compact and in close ranks, mounting ata full trot
دل و جرات نداشتم که به او بگویم بعد از یک جلسه از خیرش گذشتم.	I couldn't bring myself to admit I'd given up after only one session.
هر میرزا بنویسی در خود مختصر ذوق شاعرانه احساس کرده است.	every notary bears within him the debris of a poet.
من برای خاطر همه آنان به سیب ریه خواهم رفت.	 I go for all
این واقعه را بگویند که بر خلاف عادت و غیر طبیعی جاری و واقع شد.	let them now say that drama is unnatural!
اینک با دیدن او یقین کرد که خودش است.	then satisfying herself by her eyes that it was he
هم زوبین را او باید پرتاب کند هم نیزه را.	he should both dart the harpoon and the lance
گوئی افرادی دیگرند که به طبیعتی دیگر تعلق دارند.	they are different creatures, as it were, of a different species.
نسبت به خانم ادای احترام نمود و نسبت به آقا عرض ادب کرد	he offered his homages to madame and his respects to monsieur
اگر شما میل دارید روی بیماران بیمارستان متان آزمایش کند	if you like him to try experiments on your hospital patients
پیانو بنوازد و چیزهای زیبا و خوش آهنگ بنویسد	playing the piano and writing things which sounded beautiful
لازم نیست کسی اصیل زاده با شه تا بتونه موفق با شه.	yeh don' have ter be pure blood ter do it.
من تاکنون او را ندیده بودم درصورتیکه برای دیدن او بیش از حد تلاش کرده بودم.	I had never seen her before, though I had a great wish to do so.
هرچند که شاید یک لحظه بعد از گفتنش پشیمان بشوم.	though I may wish it unsaid the next moment.
معلوم شده بود که کلاید قصد ندارد او را به دست سرنوشت بسپارد.	than under the circumstances she feared he would be.
که به توسط سه گرگ خون آشام در مرتع مورد تعاقب قرار گرفته باشند	pursued over the pasture by three fierce wolves
آمد و پرده را بالا کرد و بی حرکت ایستاد	gown, threw aside the drapery and for a moment stood motionless
این را بیشتر به خودم گفتم تا به کولی.	I said this rather to myself than to the gipsy
آنان که وضعیتی بهتر و امکان مالی داشتند برای گرما و شادی به شهر رفته بودند.	the better sort, who could afford it, crowded for warmth and merriment to the city.
اما بالاخره باید به این کار سر و سامانی داد.	but it must be brought to a head.
نمی تونم به گم ترجیح می دم بمیرم تا این جوری باشم	I can't say that I'd rather die than be this way.
اما سخت از قدرت فهم نیازهای نوین عاری بود.	but utterly without any comprehension of the needs of modern days.
ولی به مرور زمان خوی تند آدلائید در مقابل درایت و مهر شاهزاده سچ ملایم خواهد شد.	but he thought that in time the impulsive young girl would let herself be guided by his reason and experience.
رفتار خشن چند لحظه پیش خود را تبدیل به ملایمت کرد	smoothed out what had been harsh in her manner a moment before
که پس از تأمل دقیق و پی بردن به نادرستی عقیده خود نتوانید نظر خود را تغییر دهید.	which will not yield if after careful deliberation youfind you are wrong.
انتظار نداشت اگر به دنبالش برود به فضای بازی برسد.	she should see any wide opening where she followed him.
با چشم به سراپای دشمن خود نگریست تا ببیند چه کسی را مغلوب ساخته است.	his eyes sought his foe to see whom he had vanquished.
تصمیم داشت طرح چند ساختمان را به پایان برساند	bent on finishing a plan for some buildings
ملبس به لباس سیاه و صورت خود را در زیر نقابی پنهان داشته	dressed in black and concealed in a long veil
اما می دونم که دلیل رفتار بلا ناراحت کردن تو نیست.	but I do know that she does not behave this way to hurt you.
اطمینان دارم که آن شب قادر به خوابیدن نخواهم بود.	I am sure I shall not be able to sleep.
در کوره راه پوشیده از علفی که از طریق آن به عمارت مری پیت رفته بودیم به راه افتادم.	taking the grass grown path by which we had come.
او چهارصد لیره به من و دخترش به رسم جهیز داد.	with whom I received four hundred pounds for a portion.
شاهزاده خانم سخت به خود ببالد و حتی شادی کند که به عبث دل در گرو محبت چنین شاه باز سد ره نشینی ننهاده است.	whereat the princess will be overjoyed and will esteem herself happy and fortunate in having fixed and placed her thoughts so high.
دیر یا زود فرصتی را که منتظرش بود به دست بیاورد.	he would sooner or later get the opportunity which he desired.
خو بیش همینه که آدم هر وقت دلش میخواد شوخی بک نه.	any time I want, it does a fella good to cuss if he wants to.
به امید آنکه این خبر مانند کشیدن دندانی دردناک او را تسکین بخشد.	hoping that such news would, like having a tooth out, completely cure him.
این همان آپارتمان طبقة دوم بود که کارگران در آن مشغول نقاشی بودند و اکنون گویی عمداً از آنجا رفته بودند.	the flat on the second floor where the painters had been at work, and which, as though for his benefit, they had just left.
هر چیز دیگری که بتوانند به طرز مرموز و نامعلومی بدزدند	such provision as he could steal in the most dark and mysterious way
که سروالترالیوت به کارهایی پست دست زده که ناشی از خون و نژاد حقیریست که وی بدان تعلق دارد	most slightingly and contemptuously of the very blood he belonged to and the honours which were hereafter to be his own
بلکه باید از نوک پا تا نصف ران این پیرمرد را بامشمع دا بپوشانیم.	we must put mustard poultices, as hot as they can be made, on his feet and legs.
به خاطر همین هم فرصت داشت به اطراف نگاه کند.	had therefore leisure to look around
متنفر بودم از اینکه به این صورت راجع به او فکر کنم.	I hated thinking of her that way
مادر دسته شلاقش را به علامت جواب تکان داد.	her mother answered with a wave of her whip.
بدین طریق که دو بچة کوچک را روی صندلی نشاندند	but the two little ones were sitting on a bench
به مردی که او را مخاطب قرار داده بود خیره شد.	stared at the person who had addressed him
فلهذا سه قطره هم در کار او کرد و او را نیز به دیگران لاحق ساخت.	he gave her the same dose as the others.
مرد را مصمم ساخت که مطابق میل او ترکش کنند.	seemed to determine the gentleman to leave her, as she requested.
اما حالا به دیدنش علاقه دارم چون انتظارم در این مدت طولانی تبدیل به بی صبری شده.	now I desire it, because expectation has been so long baffled that it is grown impatient.
آنچه هم که حاضر نباشد من برای شما خواهم فرستاد.	what is not ready I'll send after you.
به صورت آن ابر سیاه بود که تندر از آن آمده بود.	seemed the black cloud from which the thunder had come.
به چه سبب این کار برای او مطبوع است	why this would give him pleasure
هر بار به ناشیگری ضربتی به پهلونشینان خود زده و ایشان را به ستوه آورده بود.	from the seat to the rack, to the exasperation of his fellow passengers, against whom he knocked
جمعاً سی و یک دلار و هشتاد و پنج سنت	total, $31. 85.
چقدر با اهمیت است برای او تا هدفش را عملی سازد که قبل از اینکه از وجود ما با خبر شوند	how important it was for him to effect his purpose before we were heard
شرح داد که چگونه و چرا به بریجبرگ آمده است و چرا قبلا نتوانسته بود به این شهر بیاید.	telling how as well as why she came to behere, also why she had not come before.
اگر مادیان سرکار را در میان سینی هم بگذارند و جلو این اسب بیاورند دندان به آن نخواهد زد.	for if she was offered to him between two plates the horse would not hanker after her.
با اینکه خوشحالم حال مزاجی وی بهتر شده است از تغییر اخلاق و بی مه ریش بسیار رنجیده و آزرده خاطر شده ام.	though I'm glad he's better in health, I'm sorry he's so much less pleasant, and so much less affectionate to me.
مهم ای نه که چی از آب در میان!	but what they grow to be!
از تصور چین چیزی به کلی رنگش سفید شده بود	turning white at the mere suggestion.
چه نظر تند برادرانه ای نسبت به او داشت.	concerning whom he had a strong brotherly opinion.
بی درنگ برای خدمت گذاری به ارلاندو آماده بود.	she was to attend him instantly
از دست دادن این مقدار پول برای شما جزیی است	the loss of a sum of money becomes almost immaterial
به محض اینکه تو در زدی او ناپدید شد.	he disappeared when you arrived.
منتهی در مورد او زیبایی جای حقیقت را گرفته بود.	only beauty with him took the place of truth.
باید درون بریدگیش جمله غلیظی ریخته شود که بگزد و جای گیر شود.	there must be poured into the channel a concentrated prose which bites.
با این همه همیشه هم مثل گرگی گرسنه بود.	starved at that, by the powers!
اما این را هم دیدم که تو جواب رد به او دادی.	I seen you say no
که هایده به آهنگ جبروت و کبر ادا کرد	with such a haughty and dignified accent
چون به نظر من اوست که باید در این مورد تصمیم بگیرد.	because it seems to me that she is the one who has to decide.
اونوقت میخ وای بگی که می تونستی دویست متر تا ساحل شنا کنی ولی ازت بر نمیومد	do you mean to say that when you could swim five hundred feet to shore afterwards
بانوی جوان یک دست را گویی به نشانة اعتراض بلند کرد.	she raised one hand as if in protest.
هنوز نیم ساعت از معلوم شدن خبر هراسناک نگذشته بود	before the horror was half an hour old
تمام این ماجرا خودم را هم آن وقت گیج کرده بود.	it had all come upon me so suddenly.
کسی بیرون دست شویی نیست تا رون و هری بتوانند از آن خارج شوند	the coast was clear for them to leave the bathroom
دلالی بود با وضع آبرومند و یک زن و دو بچه.	a stockbroker with a position of respectability, a wife and two children.
ولی شکی نبودکه پیرزن آن را نشنیده و یا موضوع را درک نکرده بود.	but no doubt she had not heard him or had not grasped what he was saying.
مجبور بودم به خودم یادآوری کنم که باید احتیاط کرد.	I had to remind myself of the need for caution.
به سهولت کشتی را روی آب نگاه دارند ولو سوراخ دو برابر شود.	never mind if the leak should double on her.
شاید هیچ قوم و خویش آبرومندی هم نداشته باشد.	certainly no respectable relations.
حالا تو هم طبق رسم و سنت دیرین ما کاغذ را برگردان	just you turn it over, as in dooty bound
باید به کمک مرد جوانی که مقابلش نشسته بشتابد	to go to the help of the young man opposite so that he may expose
زیرا که هنوز خدمتی که به من کرده است تازه است.	for the service he rendered me is still fresh.
در جواب این سؤال که عقیده شما چیست گفت که او نیز همان عقیده را دارد.	when asked his opinion, replied that he thought so too.
همهٔ دیوهائی را که دردرون او باهم درستیز بودند و همه به یک اندازه حق زندگی داشتند.	all the daimons struggling within him, all of whom had an equal right to live.
اما باید شوهرش ارزش و لیاقت همسری او را داشته باشد.	but he must be worthy of her.
حتی من راجع به آن با مادرم تنها هنگامی صحبت کردم که جراحت التیام یافت.	I didn't even tell my mother till it had healed up.
اکنون که همه چیز بر وفق دلخواه تو شده	I should say that you were the happiest man alive at this instant
او عجولانه صفحات آن را گشت و ورق زد و گفت	he searched, hastily fluttering the pages, and said
باهاش طوری رفتار می کردن انگار وین کی آدم نیست!	it was like she wasn't even human!
مردد بود که در امتداد جاده حرکت کند یا از آن بگذرد و به طرف میدان سیاه دامنه تپه برود.	hesitating whether to ride along it or cross it and ride over the black field up the hillside.
آنچه از افکارش حالت نظم بیشتری داشت در روحم جایگزین شد.	what seemed better regulated feelings had become the inmates of my mind.
مطابق حساب زیانی که بر دشمن رسیده است اندکی بیش از زیان ماست.	the damage received by the enemy is reckoned to be somewhat greater than ours.
در صورت بروز خطر هر چه زودتر مراجعت نماید.	to come back as quickly as possible if there was danger.
که وجودش لبریز از خشم علیه دیگران شد و دست از نکوهش خود برداشت.	that she turned against other people and left off blaming herself.
عنکبوت دست و پایش را جمع کرد و مثل یک گلوله روی میز غلتید و غلتید.	as the spider balled itself up and began to roll over and over.
مردانشان از حق رای محروم بودند و زنانشان مورد اهانت قرار گرفته بودند.	their men disfranchised, their women insulted.
چشمم به شخصی افتاد که شب قبل مرا پذیرفته بود.	encountered the personage who had received me last night.
این است که دیگر کسی وجود ندارد تا به ما فرمان بدهد و امر و نهی بکند.	it is that there is no one left to give us orders.
من به طرف دیگر تختخواب بزرگی که آنجا بود رفتم.	I walked round to the other side of a large bed
درست بعد از این که وارد جنگل شدیم فهمیدم که چوب دستیم گم شده.	I missed it right after we got into the wood.
که آن مبلغ پولی که برای تجهیزات هنگ ضرورت دارد	that the money needed for the equipment of his regiment
گلگیر قر که به زور چکش صاف شده بود.	fenders battered and hammered back.
تا ایشان به ازای روزانه فلان مبلغ به همراه او تا ده بیایند.	that they should bear them company as far as his village, he paying them so much a day.
گفتم انشاء الله سفر به شما خوش گذشته باشد.	I hoped the voyage had been good
تا درباره مجرم خردسالی که خرگوش در دست گرفتار شده بود با پدرش صحبت کند.	to speak about the small delinquent who had been caught with the leveret.
بلکه تمامی کارگران به صورت کارگران پیمانی و موقت هستند.	because they were all hired on a temporary and occasional basis.
به نظرش رسید که انگار به یک باره نگاهی به درون قلب یک دشمن انداخته و در آنجا عشق و تفاهم دیده است.	it seemed to him that he looked suddenly into the heart of an enemy and saw there love and understanding.
صورت بلندبالایی از اشیای مورد لزوم را که به نسیه خریده بود برشمرد	gave him a long enumeration of all the indispensable things that had been got on credit.
دور تا به جاده دوردست ترحم و وفاداری صرف نسبت به شوهرش گام گذاشته است	she was travelling into the remoteness of pure pity and loyalty towards her husband.
اون وقت می تونیم فردا صبح یا بعد از ظهر حرکت کنیم.	maybe we could start out tomorrow or day after.
من خاک پای او را در عالم خیال بوسیدم.	 I kissed the dust at his feet in thought only
اما این دردی نیست که آدم و بک شه.	but you're not going to die about that.
واقعاً ناسپاس است کافی است خوب فکر کند ببیند کیست و چه کاره است.	very ungrateful, indeed, considering who and what she is.
احساسمی کنم که جانور در حال تغ یی ر کردن است.	I sense the creature changing.
چون هر یک فریب عرعر دیگری را خورده بود هر دو بت صور اینکه خر پیدا شده است به نزد هم بازگشتند.	each, deceived by the braying of the other, ran to look, fancying the ass had turned up at last.
ده مایل راه رفته بودم و هنوز خسته نبودیم.	I'd walked ten miles and I wasn't tired.
منتها دستور دارم که شما رو به هر ترتیبی که شده دستگیر کنم.	I'm told to getyou, whatever happens, that's all.
بعد سبوس و جو را با کمی آب قاطی کرد و جل وش گذاشت.	then mixed bran and oats with a little water for its food.
نیز خوابیدن در هوای آزاد چه چاشنی خوبی برای خوش خوراک شدن هر غذایی است.	they reflected little upon what a sauce open air sleeping make, too.
بهتر است که از تو بترسند تا دوستت داشته باشند	it is far better to be feared than loved
با سرعتی تمام و صدای زیاد به پایین افتاد.	he came into the room with more speed and noise than he intended.
وقتی که پدرم فهمید من رفیق دارم پانزده سالم نشده بود.	I was not fifteen when my father found that I had a lover,
عجالتا خواهی دید که درباره تو چه قسم رفتار خواهم کرد	what my own feeling is you already know
گرچه ترکیب بنا یکپارچه از طلا و الماس و یاقوت سرخ و زرد و در و مروارید و زمرد است	though the materials of which it is built are nothing less than diamonds, carbuncles, rubies, pearls, gold, and emeralds,
بلکه خود دلیل دیگری بود بر جرم و گناه دنیوی او.	were really further evidence of hisgeneral earthly sin and guilt.
سراسر این کوی را تا پایان آن شب جستجو کرد.	beat the quarter all that night.
او که از درد جانکاه دستش منگ شده بود	riddled with pain
به خصوص وقتی که ری تا مثل عروسکی که بی دقتی ساخته شده باشد از هم وارفت.	especially after she began to jitter apart like some indifferently made toy.
هر چه زودتر از اینجا برو بیرون و گورت را گم کن.	clear you too quite from my reach and hearing.
بارش باران هوا را سرد و مرطوب کرده بود	the irony of it was that the rain had brought a dank chill into the air
فقط با رفتار سخت ممکن بود جلو او را تا حدی گرفت.	it was only by severity that you could keep him within bounds.
سرم را بلند کردم و با چنان حرارتی بوسیدمش که امکان داشت جنگل آتش بگیرد.	I lifted my head and kissed him with a passion that might possibly set the forest on fire.
بنابراین هیچ کاری بهتر از این نیست که دممان را روی کول مان بگذاریم	we have nothing more to do but make good our retreat
این سؤال را با چنان خشم و خشونتی کرد	made this demand in such a dreadful tone of anger
با این حال وقتی با تو سر و کار پیدا کرد حتماً باید خیلی محتاط باشد.	but it's best to be on the safe side when one deals with you.
او این موقعیت را فرصت مناسبی برای مطرح کردن تقاضایش تلقی کرد.	which was his only chance to speak to her
شعله سوزان رشک و حسد به این سوگلی امپراطریس به همان شدت وحدت آن زمان او را به هیجان آورد.	a burning sense of jealousy of the favorite agitated him now as strongly as it had done then.
در ضمن این یکی امروز به صراف داده خواهد شد.	this one will be turned into cash to day.
دراز به دراز بر زمین افتاد و به خود پیچید و جان داد.	fell all his length upon his side, where he lay dead
اینکه من شما را پهلوان نامیدم و توانستم حدس بزنم که قطعاً باید حرفه پهلوانان سرگردان داشته باشید	for, that you are one, and of those that profess knight errantry
سانکو این تشویق را با ارباب خود در میان گذاشت	he said so to his master
با سکوت و سکون چشم در او دوخت تا وسایل کار آماده شود.	silently and composedly looked at him while they made ready
او لاغرتر و زیبا تر بود. تناسب بدنش مثل یک انسان بزرگ بود.	she was leaner and more graceful, her proportions were more even, like an adult's.
کاروانسرا دار کمال سعی و مراقبت خود را بکار برده بود تا شامی که از آن بهتر برای او ممکن نبود جهت مهمانان تهیه کند.	the landlord had taken care and pains to prepare for them the best supper that was in his power.
آخر شما به این ترتیب خودتان را دیوانه خواهید کرد.	you'll drive yourself out of your mind
عرض بنده را قبول کنید و به درون غار نروید و زنده زنده خود را مدفون نسازید	don't go burying yourself alive, or putting yourself where
از طرفی تسلیم شدن به نظر او هم اصلاً امکان نداشت.	to yield was out of the question.
در حالی که طول متوسط شاخ آن پنج قدم و در برخی ده قدم است	while its horn averages five feet, though some exceed ten
چشمانم را از صورت شما بر نخواهم گرفت تا اینکه دلتان به رحم آید و به من نگاه کنید!	I'll not take my eyes from your face till you look back at me!
مسافرت تمام شد و تو دیگر هیچ گونه ناراحتی نخواهی داشت.	the travelling is at an end, and you have nothing to do
هر سه منتظر شدند تا کشیش خم شد و دوقلوها را بغل کرد.	the three of them stood watching him expectantly until he bent and scooped the twins up, one on either hip.
اما سرش مو ندارد و خطوط سیمایش به کلی عوض شده است.	but that he had no hair on his head and his features were quite changed.
خود را با لباس بر بستر انداخته و همان دم به خواب رفته بود.	he dropped, all dressed as he was, upon the bed, where he immediately fell into a profound sleep.
وقتی خبردار شد که شوهر او را دستگیر کردند	when the fugitive husband was captured
شما مال خود را که از والانتین منع کرده بودید باز به او عنایت نمایید.	, but to restore your fortune to your granddaughter
بعد مقداری از راسته را توی تاوه برای شام پختند	then cooked some bacon in the frying pan for supper
با دلایل استوار ثابت کردند که ممکن نیست اورنگ امپراطوری متکی بر فساد نباشد	they showed, with great strength of reason, that the royal throne could not be supported without corruption
منتظر پسرها بود که برای شام به خانه بروند.	patiently waiting for the boys to go home to supper.
اما بقیه دارایی والدینش که به او رسیده بود	but the rest of the fortune his parents had left him
پانزده لوئی پول دارم و با پانزده فلورین شروع به قمار خواهم کرد!	I have got fifteen louis d'or in my possession, although I began with fifteen gulden.
حالا صبر کن تا فردا خودت متوجه خواهی شد که آنچه گفتم حقیقت دارد.	see if he won't.
این بود که خیلی زود به این فکر افتاد	so he presently found himself leaning to the impression
نه آن که آن را به خدمت یک حزب در آورم.	I have no right to enroll myself in the service of a party.
آنگاه به هرسو نگریست تا به امید اینکه شاید کاخی اعیانی و یا کوخی چوپانی بیابد	when, looking all around to see if he could discover any castle or shepherd's shanty
درست مانند این است که در این باب بحث و قضاوت کنیم که اگر ناگهان فصل پاییز به فصل بهار مبدل گردد	is like talking of what would happen if autumn became spring.
از اون به بعد در هم و قالب سگ مو ندم و در جنگل زندگی کردم.	I've been living in the forest ever since
بعدش هم دور از ادب است که به باشگاه نروم.	afterwards I cannot in decency fail attending the club.
دیگر همه کس از مشاهده ایشان سیر و بیزار شده است.	that everybody was heartily sick of them.
پس مدتی او را با یکی از پاروها سخت فرو کوفتم	I banged it a good while with one of my sculls
محل خود را ترک کرده و کلاه از سر برداشته و آمد به کنار کشتی و به دیوار تکیه داده ایستاد	he left his station by the pilot and hat in hand leaned over the ship's bulwarks
باز هم باید تصمیم بگیرم که با او چکار کنم.	I should still just as much have to decide what I ought to do with her.
یکی از شرکاء این شرکت بسیار محترم صورت گرفت.	one of the partners in the highly respectable firm.
به خدا هرچه باشد من همان قدر آزاده هستم که تو مذهبی هستی!	I'm as by golly liberal as you are religious, anyway!
به عقب نگاه کرد و بوی شادی بخش سوختن را استشمام کرد.	looking back, smelling the glad smell of burning.
برای اینکه هم دوش او راه بروم و سبب رنجش خاطرش نگردم. مجبور بودم که بدوم.	I had to run to keep pace with him, catching at my breath, tears very near the surface
تا کسی متوجه نشود که در واقعیت مدرکی است عاشقانه.	so that it would not be too obvious that it was really a document of love.
این حق را برای خود به دست آورد که خویشتن را مرد مجردی معرفی نماید.	in law, had arranged to be free to pass himself off as a bachelor.
قسم بخورد که پیش از تمام کردن کارها لب به غذا نزند.	with the promise he wouldn't eat again until he'd finished.
بی آنکه منتظر جواب بماند یا بیش از آن سخنی بگوید راه خانه خود را در پیش گرفت.	without another word or waiting for a reply he made off home.
تاجر پوست و خدمتکارانش سه مرد را در جاده دیده بودند که به طرز مشکوکی غافلگیر شده بودند.	the hide merchant and his servants had seen three men on the road arrested suspiciously, with their horses' heads together.
به اتاق برگشته روی نیمکت دراز کشید و فورا به خواب رفت.	returning to his room lay down on the sofa and immediately fell asleep.
ولی بعید است فعلاً چیزی دستش را گرفته باشد.	it is next to impossible that he should have realised any thing yet.
آقایان! در عین حال باید یادآور شوم که او برای احتراز و عقب انداختن لحظهٔ شوم و پرهیز از یک فاجعهٔ خونین مساعی فراوانی بکار برد.	I must confess, too, that he did a great deal to avoid the fatal catastrophe.
با این همه از اینکه او را الیاگاوی بخوانی احتیاط کن زیرا از این نام متنفر است.	but don't call him so, he will be offended.
شرکتی با ارزش تر از هر آنچه پدرش در زندگی به دست آورده بود در دسترسش قرار داشت.	within his reach was a company larger than anything his father had ever conceived of.
برای بقیه عمر یک بلیط درجه یک قطار به او اختصاص یافته.	had been allotted a free first class railway pass for life.
به مین منظور از بامداد هر دو در پی فرصت بودند که در خلوت یکدیگر را ملاقات کنند.	so they had been seeking an opportunity since morning to meet one another alone.
سبکی نظامی و در عین حال فاضل مآبانه و به دلیل بامبول پرسیدن سؤال و جواب گفتن فوری	a style at once military and pedantic, and, because of a trick of asking questions and then promptly answering them
یکی دو دقیقه با هم در سکوت و خاموشی قدم زدیم.	we walked up and down, for a minute or two, in silence.
اما خودم به هیچ وجه مطمئن نبودم که این مردک اجازه بدهد شما برگردید.	but I was not by any means certain that the fellow would have let you go.
در اینجا هم غیر از آرد و سیب زمینی چیز دیگر نداریم	you won't get anything else here. says the vagrant.
آقای کازوبن اندکی سرش را در برابر او خم کرد	bowed his head towards her
من مجدداً به جلو قدم برداشتم و او به عقب رفت.	 I stepped forward again, and he stepped back.
من وطن خود را بدرود گفتم تا بتوانم مالی به دست آورم	I left it to get riches
بعلاوه تحصیلات درخشان و قابل تمجیدش مانع از این کار است	nor his praiseworthy pursuits permit it
صدای آ روم تیغ روی شکم بلا رو شنیدم.	I heard the soft, wet sound of the scalpel across her stomach.
نکته اصلی را فراموش نکن که من در وضع تو نیستم.	don't forget the chief point, that I am not now in the same position as you.
من باعث دیر رسیدن تو به مدرسه میشم .	I'll make you late for school.
آنان مدتی به زبان خود با هم سخن گفتند و اندکی به ریش من خندیدند.	there was a good deal of talk among them in the language of the country, not without some laughter at my expense.
چنان در مقابل شمایل تعظیم کرد و با آهی عمیق سر سپید موی خود را فرود آورد که دستش به زمین رسید.	bent till he touched the ground with his hand, and bowed his white head with a deep sigh.
پدر و مادر نباید فرزندان خود را برخلاف میل خودشان به ازدواج مجبور کنند.	parents are not to settle children in life against their will.
این جا یه تکه شمع پیدا کردم باید خطر کنیم و اون شمع رو روشن کنیم تا شاید به شه با قطب نمای قایق به مسیر درست رفت.	I have discovered a bit of a candle here, and we must take the risk of a small light to make a course by the boat compass.
تا خود مانند او یا خلاف او بی اندیشد.	so that he can think the same thing or the opposite.
از بدخواهی که نسبت به همسایگان خود داشتند از این پیش آمد خوشنود گشتند.	it fed the malevolence with which they regarded their neighbors.
پس از مدتی به مرخصی رفتم و دیدم که وضع زندگی ایشان از سابق بهتر شده است.	I come home on leave and I'll tell you how it was, I look and see that they are living better than before.
لکن هرگاه از من سؤال کنید که این حس چگونه در من بو جود آمده است از تحلیل آن عاجز خواهم ماند.	but ask me why I think so, and I can tell you nothing.
جز اینکه کار ایشان ازدیاد نفوس است و لیاقت و شایستگی نام و آوازه ندارند	save that they merely serve to swell the number of those that live
جواهرات را در جعبه گذاشت و با خود برد.	she put back into the box and carried away.
من میرم این بچه رو به درمانگاه بر سونم.	I take this boy to the hospital wing!
منو توی یه کمد توی قلعه قایم کرده بود	hidden in a cupboard in the castle
ولی حضور او ممکن بود کارها را آسان کند .	but his presence would simplify matters.
حتی صورت ظاهرش وجه مشترکی با زندگی دیگران نخواهد داشت.	even the external forms, indeed, he fancied, must be utterly unlike the life of others in everything.
من نمی فهم دیم که چه طور اونجا می تو نه بهتر از اینجا با شه.	I didn't see where that was so much better.
در سراسر زندگیش هرگز این همه کار نکرده بود.	never had he worked so hard.
آنگاه تاریکی دیگر بار همه چیز را در خود فرو پوشید.	all was black again.
در حقیقت او را از انسانیت بیرون کرده بود	had succeeded in making him more or less than man.
انگار همان بوی نفس جمعیتی خشن و رنگین پوست و وحشی بود.	seemed the very breath of the strident multi coloured and barbaric population.
که باید این عواطف و احساسات رقیق را فراموش کرد.	that one must passer par dessus toutes ces finesses de sentiment.
چنان بیدار بود که گفتی هرگز در خواب نبوده است.	as wide awake as if he had never slept.
در باب ضرورت تلاش بی وقفه و مستمر برای دستیابی به رفاه و آسایش با دوام برای کشور پس از آخرین کشمکش و درگیری سخن میگفت.	as to the necessity of unremitting effort to secure the lasting welfare of the country emerging after this last struggle, he hoped, into a period of peace and material prosperity.
گودالهای متعفنی داشت که حتی تا آن اندازه که کسی را بتواند در خود غرق کند عمیق نبود.	smelling ditches that were not even deep enough to drown a man.
آری حق است که من خواستگایر او را رد کردم	u, I decidedly refused him
پدرم بی آنکه حرفی بر زبان بیاورد از غصه مرد.	our father's heart burst, he never spoke one of the words that filled it.
زیرا دو روز پس از ورود به آن شهر اجازه شرفیابی حاصل کردم	for, upon my admittance two days after my arrival
شاید نکات ظریف دیپلماسی وجود داشته باشد که عقل من قدرت ادراک آن را ندارد	perhaps there are diplomatic subtleties here beyond my feeble intelligence
زمانی که با خود فکر کردم آیا در اقیانوس افتاده یا نه لبخند ملایمی زدم.	I smiled gently as I wondered whether or not she had fallen in the ocean.
راجع به دنائت باطن خویش که تا آن موقع از وجود آن اطلاع نداشت	her own spiritual baseness, which she had not suspected
نورشان آن قدر است که فقط جلوی پایم را ببینم.	the glow just strong enough to see by.
ولی از شدت سنگینی و ضعف قادر به انجام این عمل نبود.	but could not do so on account of his weakness and weight.
از تمام آن حوالی جز خرابه و مقداری دود باقی نماند	only smoke and blackened ruins remained.
بر اثر سبک وزنی شدید خود با فشار قوی بالا آمده بود از درازا به هوا جست و باز به دریا افتاد و کنار من شناور شد.	rising with great force, the coffin life buoy shot lengthwise from the sea, fell over, and floated by my side.
تا به هم در خاموشی شب زیر نگاه ستارگان سرد بر جادهٔ پر برف قدم بزنند.	along the road, in the snow, the silence and the night, under the cold stars.
که در صورت دیدن دخترک در خیابان پا پیش گذارد و حرفش را به او بزند.	that if he should chance to meet her alone somewhere in the street, he would venture to speak to her.
زیرا چنان فرسوده شده که چیزی خوردنی از او باقی نمانده است.	she is so worn away.
با چشمانی از حدقه در آمده.در حالی که دستش را روی دهانش گذاشته	wide eyed, clasping a hand over her mouth.
بعد از صبحانه که شامل نان و مربا و قهوه و جگر کباب شده بود حالم بهتر شد.	after breakfast haddock, grilled kidneys, toast and marmalade, and a pot of coffee I felt better.
یکی از آثار اصیلی بود که خوشبختانه در دسترس مردم ثروتمند آن روزگار عصر طلایی ادبیات مدرن قرار داشت.	one of those genuine productions so often vouchsafed to the fortunate public of those days the golden age of modern literature.
کسی که با حرکت سر به او دل و جرأت داد	who nodded encouragingly
به دیدن زن کک و مکی که موی زرد و لباس زردی داشت	I was called from these reflections by the sight of a freckled woman with yellow hair and a yellow gown
بدانید که همان گونه که مرا به حال اول بازگردانید	for as he has restored me to my original condition
اعتماد کاملی نسبت به دختری ابراز داشت که هرگز پا به عرصه وجود نگذاشته بود.	confident in the character and behaviour of the girl who never was born.
یک جفت کفش برای سوار شدن و پیاده شدن از کشتی	a pair of shoes for embarking and disembarking
هنوز با شتاب مشغول آرایش خود و پوشیدن لباس بودند.	were still hurrying to get dressed.
لازم نیست این همه راهم ون رو دور کنیم.	I don't think we need to go that far.
بیم آن داشتم که او دچار مشکلاتی شده باشد.	I feared a reverse for him
از زمانی که دختر آن دکاندار را دیده ام به هیچ دختر دیگری فکر نکرده ام.	I haven't thought of other women since I met the merchant's daughter.
بالاخره از افسر فرانسوی خواهش کرد که او را عفو نماید و از گناهش بگذرد.	begged the officer to let the deed go unpunished.
با خود حرف میزند و این نشانی آشکارا است بر اینکه آن جوان عقل و هوش خود را از دست داده است.	talking to himself in a way that shows plainly he is out of his senses.
تحت رهبری او به سوی استحکامات حرکت کنند پیش برود	for whose movements no directions are given
آنگاه به میز تحریر تکیه داد و در رؤیای دردناکی فرورفت که تا غروب طول کشید.	then, leaning against the writing table, he stayed until the evening, buried in a sorrowful reverie.
از جایش برخاست و مجدداً تغییر طبیعت را تماشا کرد	he watched the appearance of nature again
گفتار و افکار فقط راجع به چیزهائی بود که با کار ارتباط داشت.	conversed and thought only of matters closely and manifestly connected with their work.
البته انتظار داشت من جریان را به تو بگویم.	he of course expected me to tell you of it.
ولی از لطف و مهربانی دایی عزیزش بسیار ممنون و سپاسگزار است	but his uncle's kind remembrance delighted him
چون ممکن است روزی در پیشامدهای مهمی تو را به دادگاه احضار کنند تا ذهن قضات را روشن کنی.	for under serious circumstances you may be called before the tribunals in order to enlighten the minds of the magistrates
بازار انواع طلسم و خرمهره و وسایل دفع بلا داغ بود.	a roaring trade in talismans, amulets, and other protective devices was sweeping the school.
من در هر حال در کنار تو خواهم بود.	I stand by you through thick and thin.
شانه را به دست خواهد گرفت و با طنازی و دلربایی مخصوص خود به شانه کردن گیسوان افشان خواهد پرداخت.	humming a tune, reach for her comb and run it through her hair.
رفتار ژنرال تمام مدت خوشایند بود و خیال کاترین هم از امیدها و آرزوهای ژنرال راحت بود.	so gratifying had been the tenor of his conduct throughout the whole visit, so well assured was her mind on the subject of his expectations, that
وقتی خود را در اوج قدرت و امنیتی دسترس ناپذیر برای توطئه گران فانی میدید ناگهان و به شکلی غیرمنطقی موجی از اعتماد به نفس در وجودش احساس میکرد.	had sudden accesses of unreasonable self confidence when he perceived himself elevated on a pinnacle of power and safety beyond the reach of mere mortal plotters.
او در ساعت دو بعدازظهر مشغول تمرین با کلاویکورد بود.	while she was playing the clavichord.
بی آن که اثری از خود بر جای بگذارد ناپدید شد.	they, too, sank without trace.
خرمگس با دیدگان یک حیوان شکنجه دیده چشم برداشت.	he looked up with the eyes of a tortured animal.
از فرط تشنگی و ترس زبان به کامش چسبیده بود.	his tongue cleaving to the roof of his mouth with all the intensity of thirst engendered by heat and fear.
اگرچه ممکن بود نظر پتراکوتس حس ترحّم توأم با عشق باشد.	perhaps because the pity that he inspired was mixed with love
اما من نسبت به او حس دوستی آمیخته با احترامی دارم.	but I hold him in a reverential respect.
که او را متقاعد سازد تا هر چه زودتر از با گوچاروف برود.	to persuade her to get away as quickly as possible
این راهزن خطرناک را من و اربابم از زنجیر سنت هرمان داد نجات بخشیده بودیم.	the great rogue and rascal that my master and I freed from the chain.
در تمام مدت با بهت و ترس رفتار غیرعادی این مرد را مد نظر داشت.	recalling with a great deal of astonishment and some fear, the extraordinary behaviour of the person from whom he had just parted.
با لحن رسمی خواهش کرد که پیغام به آقای وین سی رسانده شود.	beg her, almost formally, to deliver the message to her father.
اما بعد از ازدواجش با این زن دیگر حقی به گردن من ندارد.	but really the act of marrying this wife was a set off against the obligation.
کتابی راجع به پخت انواع کلوچه به دستش دادم .	 I handed her a book on cookies and bars.
مشروط بر اینکه باز از تلگراف خبر دروغی نشر نکند.	especially if the telegraph should not make any more mistakes
به جای آن همه خبرهای آدمکشی و طلاق خبرهای واقعا مفید و سازنده در اختیار مردم قرار دهند.	give the public some really helpful and constructive news instead of all these murders and divorces.
سر از ته و توی زندگی من و پدر و مادرم در بیارن.	should now investigate his parents andhis past?
معلوم است این کار را با جان و دل انجام داده.	it shews it to have been so thoroughly from the heart.
بلکه آن تشخص شامل است که هیچ پوشش و پوشاک ندارد.	but that abounding dignity which has no robed investiture.
امکان ندارد که به خاطر خوش بینی بیش از حد دچار اشتباه بشوم.	I am not likely to fall into mistakes from excess of optimism.
در ین مدت با کارد خود بعضی از درختان تناور باغ سلطنتی را که تا شهر نود و یک گز فاصله داشت بریدم.	which I spent in cutting down with my knife some of the largest trees in the royal park, about a hundred yards distant from the city.
من سعی کردم که صورت او را به خاطر بیاورم.	I tried to remember her face
کمان خود را به سوی دختر زیبایی که در جلو پنجره قصر ظاهر شده بود کشید	bent his bow against a damsel who stood between the turrets of the castle
با خود فکر کرد که این مرد با ذهن و اندیشه لطیف و محزونش در حالی که به لحاظ جسمانی تقریبا فلج به حساب می آمد	thought that this man of delicate and melancholy mind, physically almost a cripple,
که هر کودکی نیز به هنگام بزرگ شدن خواهی نخواهی دست به گناهی خواهد آلود.	that the child would have grown up and have sinned
قرار بود گراف از صاحب خانه هم امضا بگیرد و شب گذشته اجاره نامه را با پست برای من بفرستد.	he was to get the owner's signature and mail me the lease last night.
لباسا رو تک ون دادم و اونها رو به یه درخت زدم که مقداری از اون بوی بد ازش ون خارج به شه.	I shook the clothes out, snapping them against a tree to beat some of the smell from them.
از سویی دیگر آدمیرال بچه ندارد که خانه را به هم بریزد	as where there were many children
همچنان که رؤیای آب از آبی که برای خنک ساختن زبان سوزانمان به آن نیاز داریم.	as the vision of waters upon the earth is different from the delirious vision of the water which cannot be had to cool the burning tongue.
اعلام کرد که جسد را در زورق گاه دیده و آن را معاینه کرده بوده است.	now declared that he had seen and examined it there and that th ewounds
موقعی که من در خیابان به آرامی نام او را در گوش شما گفتم	the whisper of whose name in your ear when I came behind you in the street
خیلی عجیبه که تو حتی اسم او نم نمی دونی.	but it's incredible yeh don't know his name
بالاخره جسد را که تا رسیدن من به آن دست نزده بودند معاینه کردم.	finally I carefully examined the body, which had not been touched until my arrival.
ظاهرا بچه فکر می کرد که آن مرد از گلوله برفی مظنون شده است.	the boy evidently thinking that the other had suspicions of the snowball.
اما هنگامی که به دور تا نگریست چشمانش هنوز حالت اندوهگینی داشت.	but there was still an uneasy feeling in his eyes as he looked at her.
که پنهان از کنت به وی نوشته بود و این نامه او را متقاعد ساخت که باید به خانه مراجعت نماید.	written without his father's knowledge, and that letter persuaded him to return.
معلوم بود هیچ میلی به جواب دادن و بلند شدن از جایش ندارد.	he declared he had no ear for this appeal.
بین وال سر زا و وال گروئنلندی در مورد گوش این اختلاف مهم موجود است	this important difference is to be observed between the sperm whale and the right.
راستش من اول خیال کردم اون میخواد به نحوی سر صحبت رو باز کنه	I thought he was just, you know, making conversation.
شما آن قدر به من لطف کردید که ناچارم باز از شما کمک بخواهم.	you were so good that I can't help coming to you again.
تبر را برداشتم و او را داغ ون کردم	I took the axe and smashed in the door.
سپس با سحر و جادو سکوی بلندی در امتداد سمت چپ پدید آورد.	then he conjured a raised platform into existence along the right wall.
فقط تا چند روز دیگر همة مقدمات لازم فراهم شده است	in a very few days the necessary arrangements will have been made
به جای اینکه بمانند سابق مردها را وادار سازد که مخارج خانواده خود را تقبل کنند	instead of compelling a man to support his family, as they had theretofore done
در آنجا دیدم که بسیاری از کارگران با چندین نوع افزار در کشتزار سرگرم کارند	where I saw many labourers working with several sorts of tools in the ground
شما برای خودتان و او به حد کافی فکر دارید.	you would have sufficient thought for both yourself and her.
مازارین مشغول مطالعه کاغذی بود که جواب نوشته بود که ناگاه در به آهستگی کوبیده شده	when some one knocked gently at the door of communication with the queen's apartments.
حاضرم ریسک هر چیزی رو که ممکنه اتفاق بیفته رو به جون بخرم	I'd rather risk whatever could happen
آهسته دست چپش را بلند کرد تا دست مرا از خود دور کند.	softly raising up his right fore foot to remove my hand.
با وجود این ممکن است خیلی از عوام هم به همین اندازه دوست بدارند.	though there's many a common man would say better what he meant.
به گمان من که هر شب در خلنگ زار آزاد نیست.	I suppose that it does not always run loose upon the moor.
عشقی نیرومند برای پنهان کردن یا نشان دادن ندارد.	have no passion to hide or confess.
که اجزایش تکه تکه شده و از هم پاشیده بود	which he had torn to atoms.
راه مقابله با خطر را هم به او یاد بدهید.	show him how to avert the danger.
تا چه پایه قدرت تو در حق من نفوذ دارد و تا چه اندازه به مستولی و مسلط هستی	the power you have over me
از همین ملاقات کوتاه تصویر روشنی از اخلاق و صفات پفول را در خاطر مجسم ساخت.	was able to form a clear conception of the man.
آن هم نه فقط با پاروب زدن با قدرت و شدت باور نکردنی	he is expected to set an example of superhuman activity to the rest, not only by incredible rowing
در آغوش وی به خواب رفتم و راحت خوابیدم.	I fell asleep in her arms, after that, and slept soundly.
متوجه اشتباهش شد و از راهی که آمده بود بازگشت و جلوی او ایستاد.	realized what he had done, and retraced his steps, stopping in front of it.
شبی که هرگز هیچ شعلهٔ زندگی از آن بیرون نخواهد جست!	the sight of themselves from which no flame of life will ever leap!
دختر دست ناآرام خویش را از پنجرهء کالسکه به سوی ایشان تکان داد	her agitated hand waved to them from a chaise window
که اگر کاری را به خونسردی انجام بدهیم مثل آن است که با بزرگواری انجام داده باشیم.	that in most people's estimation, to do anything coolly is to do it genteelly.
چند صد نفری که یا پس از صرف شام به تالار گرم و دم کرده دادگاه هجوم آورده	at that the hundreds who had crowded into the hot stuffycourtroom after dinner though many
موج غول پیکری بلندش کرد و او را مانند تیری که از کمان شلیک شود به طرف ساحل برد.	a giant wave picked him up and shot him toward the beach at the speed of a catapult.
همه مطمئن بودند که دادگاه اقلا علل مخففه را رعایت خواهد کرد.	almost every one had reckoned upon a recommendation to mercy, at least.
اما افراد ارتش که شش ساعتی خوابیده بودند. به حرکت درآمدند.	but the army had slept six hours and was moving.
تازگی رفته بودم عقب یک نفر از اونها که تا خارجه مشایعتش کردم.	I just met one, and saw him off.
هیچ کس تا حالا تو رو درست درک نکرده.	no one had ever understood you properly
که بر اثر آن همه چیز در پیرامون او فرو ریخته است و عامل اساسی این سانحه نیز تنها او بوده است زیرا آن مقاله را به صدای بلند خوانده بود.	some sudden catastrophe had occurred, and that he was almost the cause of it, because he had read the article aloud.
بی درنگ چشمش بر چهره زن زیبا بی افتد.	in the hope of again looking on the face of the beautiful lady.
اون قدر گود بود که مجرای فاضلاب هم خراب شده بود.	so deep it had cracked the sewer below.
ما با وحشت دیدیم که سرتاسر جراحت و کبودی بودند.	we saw with horror that they were all mottled with bruises.
پس به زحمت زیاد همان جا که بود روی دو پا برخاست.	he struggled painfully to his feet
ابیاتی که با موضوع بحث ما مناسبت کامل دارند.	it seems to me they bear upon the point we are discussing
بینی یکی به طرف راست کج بود و بینی دیگری به سمت چپ.	one bent to the left and the other to the right.
حقیقتاً پا به پا رفتن برایشان سخت شده بود.	indeed it had become difficult for them to continue walking abreast.
اون وقت همین جوری یه ذکر و تم وم کردین	yellin' your head off.
این یک یافت نظری است که همه کس مانندش را آزموده است	an optical illusion which every one has experienced.
در این میان مادرش اورسولا بود که جرأت کرد خلوت او را درهم شکسته	rsula was the only one who dared disturb his, abstraction.
که کسی را بیابد تا هر چه زودتر نعمت آزادی را که با آن به دنیا آمده است به او تحویل دهد.	to find some one quickly to whom he can hand over that gift of freedom with which the ill fated creature is born.
اما عزم جزم کرده بود آن طور که خوش دارد زندگی کند.	but she meant to live as she pleased.
نصف دیگر حواسش را داد به فکرهایی که خودش داشت.	the other half she could give to her own view of the subject.
سپس مدتی در آب قدم زد و به فکر فرو رفت.	then he trod water for a while, thinking hard
رنگ باخته و لرزان از ترس و هیجان روی صندلی راحت نشست و اشکش سرازیر شد.	pale and trembling with fear and agitation, sat down in an armchair and burst into tears.
گرچه پدرش به ندرت وقت داشت به دیدن او بیاید	although he seldom had leisure for paying her a visit
من همون مردیم که از عصر گذشته حرف میزنه	I'm the man who speaks for the latter age
سخنانش چندان عاری از عقل سلیم بود که آن دو مستمع هاج و واج ماندند	with so little common sense that his two hearers were again filled with wonder
بر در اتاق پدر کوفت او را صدا زد.	tapped at his door, and softly called to him.
چون کشتی بسیار سریع و از همه حیث شریفی بود.	being a very fast sailer and a noble craft every way.
دیگر آنکه کارش بسی کم شد زیرا که کارهایش را با ژان وال ژان قسمت کرد	next, he had much lesswork, since it was shared.
چون مطمئن شد که نخواهد آمد خوابگاه را پس کرد	he removed his bed
نوشته بود که من به خوبی آن را خواندم.	I knew it, I could read it 'SUCCESS!
با سرقت یک نان به صورت مبدأ نکبت یک سرنوشت مواجه شده است.	the theft of a loaf of bread as the point of departure for the disaster of a destiny.
بدینجهت با فروتنی هرچه تمامتر به او نزدیک شد	so, going up to him,
با اینکه من در نظر او موجودی بسیار ناچیزم آرزومندم که روزی به اعلی حضرت خدمتی نمایان کنم.	as inconsiderable as he took me to be, I hoped I might live to do his majesty some signal service.
من به هیچ رو نتوانستم او را وادار به پذیرفتن چیزی کنم	I could force nothing on him
زیرا در آن لحظه به او پشت کرده بود.	who had his back towards her at the time.
دوباره به رختخواب رفتم.اما اصلاً به فکر خواب نبودم.	I regained my couch, but never thought of sleep.
باید گاهی بر سر قبر او نان خرد کرد.	we must often take some.
حتی چند نفر از دخترهای کلاسش بسیار خوب و مهربان نودند.	there were even a few girls in her classes who were reasonably nice.
او را به کناری کشید تا از علت فرارش جویا شود.	he drew him aside and asked the reason of his having come there.
با تأسف خودش را به عقب و جلو تکان داد.	rocked to and fro with sorrow.
از سرباز مجروحی پرسید که در کدام نبرد زخمی شده است.	asked a soldier in what action they had been wounded.
از ین گذشته ممکن نبود سبب آن کار را حدس بزنم تا اینکه آموزگار مخصوص من حقیقت مطلب را به من فهماند.	neither could I possibly guess the meaning, till my tutor informed me.
یا گمان کرد انسانی نوظهور است که نظیرش تا آن لحظه در جهان نبوده است.	or a human being of some new species or unearthly breed.
چنان خودمانی که افسوس خورد چقدر دیر شهامت به دست آورده است.	with a familiarity that cut him to the quick because his boldness came too late.
زمانی چندین مایل پیاده رفت تا به زنی که یک سنت از او اضافه گرفته بود پولش را بپردازد.	he walked several miles to return a couple of pennies that he had overcharged a woman.
ضم نا کرار از والتهام خواسته بود که در طی یک ملاقات حضوری به درد دل او گوش دهد.	because she herself had repeatedly appealed to him fora personal inter view in which
من تا موقعی که این را از او بیرون نکشم آسوده نخواهم شد .	I can't rest till I get hold of him.
خیالم راحت شد از برگشتن به مدرسه وحشت داشتم.	I'm relieved I was dreading the return to school.
این راه دیگر زحمت دور زدن و از راه شوسه رفتن را نداشت.	so save myself a considerable circuit by the high road.
تا وقتی آن موجود در نور مهتاب قرار گرفت آن را ببینند.	watched as it emerged into a patch of moonlight.
اگر چه شهریار در آن هنگام قصد کشتن او را نداشت.	although the king at that time had no design against his life.
ناگهان با ترس و لرز از خواب پریده یک پتو خواست.	he woke up in a fright, calling for a blanket.
اِما نگران بود که دیگر هیچ چیز نتواند درد هریت را درمان کند.	but nothing else, she feared, would cure her.
کاری کند که نوکرانش او را یک امروز با خود نبرند	arrange with his servants not to take him back that day
ناگهان چهار نفر از عرشه زیری بالا دویدند و گفتند حاضرند تسلیم شوند.	suddenly four men burst up from the forecastle, saying they were ready to turn to.
به همه اصرار کرد وارد خانه بشوند با پدرش چای بخورند.	pressed them all to go in and drink tea with him.
من به آرامی و با قدهای آهسته وارد اتاق شدم.	I ambled along at a slow walk.
وقتی برادرتون رفت توی اطاق به اون سر بز نه تقریباً تم وم کرده بود.	he wor a'most stark when your brother went into t' chamber and fand him.
برای تشخیص خوب و بد این دو نوع پهلوان که هر دو عنوان واحدی دارند	one has need of experience and discernment to distinguish these two kinds of gentlemen
به خود عطر زد و نوک سبیل سفیدش را چرب کرد.	he dabbed on cologne and waxed the ends of his white mustache
خودم تلافی کردم و تا صبح خواب اژدها دیدم.	I provided the best substitute I could by dreaming of dragons until morning.
پدرم پس از اتمام آموزشگاه نظام با درجهٔ ستوانی در ارتش خدمت کرده است.	my own father was a sublieutenant in the army.
به نظر من که صندلی دست گرفتن شرف دارد به چتر دست گرفتن.	I would much rather take a chair at any time.
اما دیدم که سردی هوا و تیرگی فضا بیش از آن نیست که بتوان در سایه کوهی حس کرد.	but I did not observe the air to be much colder, or the sky more darkened, than if I had stood under the shade of a mountain.
به علاوه اکنون تمام وسایل را از برای تبدیل صورت و هیئت خود به قسمی که احدی او را نتواند بشناسد در قبضه اقتدار داشت	moreover he had now the means of adopting any disguise he thought proper
نه به خاطر این که تنها سر میز نشسته بود	not because she felt alone, which in fact she was
بلافاصله مردم از همه طرف به جانب کلیسا آمدند تا در مراسم نماز صبح شرکت کنند.	presently the people began to gather for the morning sermon.
اما بیش از آنچه ناخدا در حق خود گفته بود به نفع وی سخن گفت	but with much more advantage to the captain
هر چی با شه تقصیر ماست که اون این جاست.	it's our fault he's here in the first place.
من وقار پیش رفتنش را تماشا کردم. با چشمان جدیدم تمامش را جذب کردم.	I watched the grace of his advance, absorbing it with my new eyes.
به بیرون ریختن اشیایی پرداخت که مورد لزوم حتمی بودند.	proceeding to cast out even articles of apparel that were imperative necessaries.
منهم در خود همان علاقه را یافتم که او را به حرکت آورده بود.	I realised in myself the same desire as animated him.
فقط چون شب در رسید به تاریکی نگاه کنید	you will only have to look at night
در وقت خود محصولی فراوان و خوب به دست دهد.	yielding in time a grateful harvest of good.
ناگهان بر اثر نکاتی شدید که از برگرفتن آن پدید آمد از خواب برخاستم	I found myself suddenly awaked with a violent pull upon the ring
خودش بارها به من گفته است و اولین حقوقش سه دلار در هفته بود.	I have heard him tell of it many times, and he got three dollars a week, at first.
اما زمانی که به پاهای او رسید به صدای بلند خندید.	but when she saw his legs she laughed out loud.
او نیز مانند دیگران با تواضعی ساختگی از سخن گفتن باز ایستاد.	she paused in semi mock modesty as did the others.
چند مبل و صندلی به صورت نیم دایره گذاشته بودند.	which was circled a number of divans and chairs.
به این بهانه که در دفتر خود کاری واجب دارد.	saying he was wanted at the counting house.
به نفع مشتی آدم بیکاره و دزد صفت نیست.	not for a pack of idle, thieving human beings.
الان پلیس به خاطر کشف عورت دستگیرم می کنه.	I'll get picked up for indecent exposure.
هنوز رنگ بر چهره نداشت اما حالا دیگر خون آلود و کثیف نبود.	he still looked pale, but he was no longer gory and sullied.
بعد با گوش کنجکاو و قلب پرتپش خود از اعماق روحم سه بار فریادی را شنیدم که نه مرا ترساند و نه از شنیدن آن برخود لرزیدم بلکه حس کردم برایم شعف آورست.	then vibrated thrice a cry on my startled ear, and in my quaking heart and through my spirit, which neither feared nor shook,
گویی گل رز زیبایی فقط در برابر دیدگان او شکفته باشد	as if some lovely rose had blossomed for her eyes only
به وی پیشنهاد کرد که همراه وی به خط جبهه برود.	proposed that he should ride with him along the line.
بی آن که به او دست بزنند رهایش کردند	they left him untouched
بین او دیگران فرق میذارید و ممکنه خیلی کارها برایش انجام بدید.	you'll do more for him than you would for someone else
حرکتی بود بسیار شرافتمندانه تا گذشته را محو کند.	but a very noble way of erasing the past.
مگر اینکه چون آن پهلوان در میان جادوگران دشمنان بی شماری دارد	unless indeed it be that, as he has many enemies who are enchanters
به نظرش دیر خوابیدن نوعی زندگی اشرافی و بیهوده تلف کردن وقت بود.	she'd have thought it vaguely wicked sort of decadent and foreign and aristocratic to keep later hours.
به شنیدن فریاد من آن موجود غول آسا گامی کوتاه برداشت.	whereupon the huge creature trod short.
حتی ترجیح داد این دعوت را حمل بر تشخص خودش بکند.	such a distinguishing compliment as she chose to consider it.
به باغ آمده بود تا دردم نزد شوهرش برود.	she had stepped into the garden, with the impulse to go at once to her husband.
وحشتش را بروز داد و بالمره خود را باخت.	showed a countenance of abject terror
من می تونم یک سکه رو از پنجاه یاردی بزنم.	I can drill a dime at fifty yards.
برای همین منظور بود که شروع به سخن گفتن کردم.	that's what I've been leading up to.
امشب همگی بی آنکه خود متوجه باشند از فرط خستگی از پا درآمدند و ساعت یازده و نیم متفرق شدند.	it now unanimously and unconsciously yielded to weariness and at eleven thirty, broke up.
که زنی دلی است و همچنانکه تنش از مفرغ ساخته شده قوی و نیرومند است	who is as mighty and strong as if made of brass
اما من با کمال سپاسگزاری همه را رد کردم.	however, I refused, with expressions of the highest acknowledgment.
زحماتی که اگر جسم جنابعالی را خسته نکرده باشد قطعاً روح شما را فرسوده است	for if they have not been of the body they have been of the spirit
البته در حقیقت وقتایی که اوضاع بر وفق مرادش بود.	when things went his way.
نیمی از آن در سایه میز قر ارداشت و نیمه دیگر بیرون بود.	half in the table's shadow and half out.
اما امروز جز طلب آمرزش و مغفرت برای مقتول چاره ندارم.	but I must pray for the dead.
نام آن پری پیکر که مرا به این بدبختی انداخته است چنین است	for that is the name of the rich damsel who has reduced me to misery
به این دلیل در تمام این مدت نتوانستم چیزی برایت بفرستم.	so that I've been unable to send you anything all this time.
در اینجا حرف خود را قطع کرد و به باز کردن بسته مشغول گردید	stopping to unpack his bundle
یک پنجره از در عقبی را با یک آجر شکستم	I shattered a window in the back door with a brick
از طرفی حدس اینکه از حالا تا صبح فاصله زیادی نیست خیلی راحت است.	besides, there is good reason to show that it now wants but little of day.
اصلا نمی تونم یک سیاه توی خو نهم بیارم.	I wouldn't have one in my house.
نه توان درک این اتفاق ناگهانی را در این رفاقت دلنشین داشت و نه نای تحملش را.	understand or endure this sudden rift in their wonderful friendship.
همة آنان در حالی که چشم به من دوخته بودند از اول تا آخر برجای خود ماندند.	but they kept their eyes upon my face from first to last.
با چشمانی سرشار از سپاسگزاری به آقای کازوبن نگریست.	looked up gratefully to the speaker.
تا این که آن را در تابوت مخصوص گداخانه محبوس کنند و در قبرستان گدایان به خاک بسپارند.	, than that they should be prisoned in a workhouse coffin and moulder in a pauper's grave.
صندوقش را باز کنی و آنچه را که در آن است برداری.	you empty her locker and split.
بعد ناگه طی سه ثانیه و نیم همه چیز تغییر کرد	then, in the space of three seconds and a half, everything had changed
چون در ذهنش تمام مدت مشغول برنامه ریزی و طرح نقشه فرار بود.	for her mind was busy planning.
چندین ماه بود در گوشه و کنار آنجا روی بستری از شوره افتاده و مانده بودند.	had been sleeping for several months in its bed of manure.
ابرها حالا در برابر باد به صورت صفوف دراز سیمفام در سمت مشرق متراکم شده بودند.	the clouds, now trooping before the wind, were filing off eastward in long, silvered columns.
آری از قراری که صندوقدارم گفت از جانب تومسون و فرانش	you are aware from whom I come at least so my cashier tells me
حتی به نظرم آمد که پشتش از شدت اندوه اندکی خم شده و روی هم رفته در هم شکسته شده بود.	beside me she had seemed tall and gaunt, but she looked shrunken now in size, more wizened
گویی چیزی خلاف آن از او انتظار داشتن عجیب بود.	as if it would be unreasonable to suppose anything else of him.
من حاضر بودم خیلی چیزها بدهم تا هنوز در شک و تردید باشم.	I would give a great deal for doubt to be still possible.
مطمئناً دیگر فکر نخواهید کرد که استعدادهایش ناشناخته خواهد ماند.	I have no idea that you will suppose her talents can be unknown.
به اِما خیلی خوش بگذرد و هم رقصش را هم ماهر بیابد.	she found herself well matched in a partner.
اما چون وی آمد دریافت که از فکرش به کلی رفته است.	but when she came and he realised that he had gone out of her thoughts entirely
داخل اتاق شد و سلامی مهرآمیز به او داد	came in and stole a kiss from her while she was busy
در چنین مواقعی نیز جوابش بسیار موجز و مختصر و خشک بود	then sharp and short and dry
برگشت و در حالی که از خشم برافروخته بود	he swung round with a deep flush
برای ما بجز ضربات مشت و چراغ چیزی نیاورد.	for us only the cuffs and lamp whacks
آب دهان را به سختی از گلوی خشک خود فرو داد.	swallowed with difficulty because his throat was dry.
قزاقان از این خطاب غیر عادی به تعجب افتاده	the cossacks,troubled by the unusual word comrade
من به تو می گم بگذار سرد به شه.	I tell you to cool it down.
چون هر دقیقه تو اینجا باشی برای عزیز من صد هزار سکه طلا ارزش دارد.	while every minute you are here is worth a hundred thousand guineas to my darling
زوجی که آن قدر همه چیز را از نظر هم مخفی نگاه داشته بودند که دیگر برایشان حرفی باقی نمانده بود تا به هم بزنند.	who had hidden so many things in this life that there was almost nothing left for them to say to each other.
خبردار بایستد اما با اشاره دست او دوباره به حرکت آرام و یکنواخت خود ادامه داد.	he stood at attention when the officer arrived, but at a sign resumed his measured, monotonous pacing.
خاله جان بطری دوا را دزدکی تحت نظر گرفته بود.	she watched the bottle clandestinely.
اما نتوانست صبحانه بخورد در کنار بخاری نشست و لرز کرد.	meaning to breakfast, but succeeded in nothing but in sitting and shivering by the fire.
شتاب و اضطراب بی جهت بر قشون چیره شد	an unreasoning hurry and alarm overcame them.
نام یکی از ایشان را که به حقی بت معلوم نبود روس بی است یا نه از قلم انداخت.	did not insert or name in it a certain lady of whom it was questionable whether she was one or not.
من که توضیح دادم دلیل اون دروغم چی بود.	I've explained why I said that.
هیچ چیز در حول حوش آنان تغییر نکرده بود.	nothing around them seemed changed
در همین حال کلاید به او خیره شده و حیران بود که عاقبت این کار به کجا خواهد کشید.	while he gazed at her wonderingabout the outcome of all this.
اما باید اعتراف کرد پیش از رسیدن به خانه تصمیمش را گرفته بود.	but it must be confessed that before he reached home he had taken his resolution.
هر وقت اومدی توی رختخواب چراغ را هم خاموش کن	turn out the light when you come back to bed
حتی آن لحظه هم از شلوار نظامیم غافل نبودم.	even then the whipcord breeches weren't altogether out of my mind.
تا جهت آغاز یک جنگ تمام عیار از او یاری بطلبد.	so that he would help him start the total war.
صدایش از چیزی که به خاطر دارم غمگین تر است.	his voice even sadder than I remembered.
آنگاه به گوش خود بشنود که دشمن مشغول حفر نقبی بط رف پاسگاه او است	knows that the enemy is pushing a mine towards the post where he is stationed
اما هنگامی که به سمت میزهای ویست به راه افتاد	but on moving towards the whist tables
امیدوارم که در مدتی کوتاه بتوانم با او از عجایب و غرایب جهان سخن گویم	hoped, in a short time, I should be able to tell him wonders.
برای اینکه هیچ گونه سوءتفاهم یا احساس ناراحت کننده شک و پرده پوشی میانشان به وجود نیاید.	in order that there might be no misunderstanding or painful sense of doubt and mystery between them.
این تغییر برنامه را طوری توضیح داد که گویا غفلتاً مسائل فراوانی را به یاد آورده که قبلاً به فکر آنها نبوده و حضور وی در پتزبورگ ضرورت دارد.	in law the change in her plans in a tone that suggested that she had to remember so many things that there was no enumerating them
تا شاید بتواند او را غافلگیر کند و جوابی از او بگیرد.	hoping to startle her into a response by asking it when she least expected it.
دستامو به سمت دست آزاد بلا دراز کردم و او نو تو هر دو دستم فشردم .	I reached out for her free hand, taking it in both of mine.
پس از آن چندین بار کلمه یاهو را تکرار کردند.	thereupon repeated several times the word _Yahoo_.
مسلماً اگر در مقررات پهلوانی خود محملی یافته بود که با آنکه پهلوان وقتی قول شرف داده باشد که به کار دیگری نپردازد	if he could have found in the ordinances of chivalry that it was lawful for a knight errant to undertake or engage in another enterprise
از روی غفلت و بی آنکه نیک بنگرد وزغی بزرگ از دلو در آب افکنده بود.	was so careless as to let a huge frog not perceiving it slip out of his pail.
اما در مقایسه با واقعیت تخت و ناقص بود.	but flat and inadequate in comparison to the real thing.
من تقاضا کردم که بازی چند دقیقه متوقف به شه.	I called for time out!
بلکه بر عکس خدمتی بود که به انسانیت نمودی	, but on the contrary have benefited mankind
من تو این شهر نمی تونم به میل خودم زندگی کنم.	I can't do just as I want to here.
مرهم هر جور زخمی از شکافتگی تن سگ تا پارگی پوست آدم همراهش بود.	capable of healing anything from a rent in the side of a work dog to an ulcer on a human shin.
ظاهرا علایق خاصی که به کلی از جنگ و سیاست دور بود	evidently had its own interests which had nothing to do with war or politics
گر برای او و از هیچ چیز نخواهد ترسید مگر به خاطر او.	he should fear nothing except for her.
یک خانم متشخص که حتماً خانم همان آخری بود.	a dignified lady who was doubtless the latter's wife.
اندکی بعد نیز بر اثر رفتار متانت آمیز این مرد آرزو کرد که ای کاش این حرف را نزده بود.	after wards something in the man heartening him, wishing that he hadnot.
فهم این مسایل احتیاج به یک فرهنگ علمی دارد	any glimmering of these can only come from a scientific culture
اگه اشکال ندا ره من سراغ ویسکی خودم برم	I'll stick to whisky if you don't mind.
آن هم برای یک بچه یتیم و شروری که در عالم هیچ کس دوستش ندارد!	all for a naughty orphan which nobody can't love.
دهکده را پشت سر و سراشیبی را که در آن زمان بسی تند بود پیش رو داشت.	having behind it the village, and in front of it theslope, which was tolerably steep then.
راستش یک بار خود من نزدیک بود جانم را از دست بدهم.	I am sure it almost killed me once.
چون که هم خیلی فقیر و هم مسن بود و ضمناً دوستی هم نداشت.	simply because she was old and poor and had few friends.
هواداران کاماش به علامت صلح و آشتی شمشیرهای خود را غلاف کردند	by their means he and his partisans were pacified and tranquillised
یا یک بشقاب نان و پنیر یا یک گیلاس نوشیدنی.	or a plate of bread and cheese and a glass of beer
دیدگان را به دوست خود که نزدیک من ایستاده دوخته است.	her eye glancing on her sweetheart, who is near me.
فردا شب را سر به بستر استراحت نهاده و خوابی به آسودگی نماید.	he slept soundly
در وحشت از عملی که به دنبال اعمال زشت و سابقعء ننگین خانه و خانواده او صورت گرفته بود	in his horror of the deed which had culminated the bad deeds and bad reputation of the old family house
من مطمئینم این کار اونطوره که تو انتظار داری	I'm sure I'm not doing this the way you expect.
مثل اینکه ناگهان وارد دنیای تازه و عجیبی شده که شکوه آن به وحشتش انداخته است.	like a sudden entrance into something new and strange, whose splendour terrified him.
همان موقع چند نفر فریاد کشیدند و به او گفتند که زنش بالای پشت بام است.	then they called out to him that she was on the roof
اما عملاً دل خودش را خوش کرده بود به این که با نگاه نافذش زود کشف کرد	consoling herself, however, with the discovery, which her keen eye soon made
معلوم شد که عزت نفس او بر حرص و آز تسلط دارد	so his self respect is greater than his thirst for money.
دیگران را نیز وادار کند به او محبت بکنند.	have others be nice to him, too.
یک مرتبه مثل نارنجک منفجر شد و بعد به همان سرعت تحلیل رفت.	uddenly blazed up like an exploding pine knot and then subsided just as quickly.
اگه یه وقت چیزی پیدا کردین به رام یه جغد بفرست ین.	send me an owl if you find anything.
دیگر آن دستخط بی قواره و کج و معوج قبلی نبود.	it was no longer the same cramped, awkward handwriting as before.
خاصه از آن جا که در نظر داشت برای هر کودک خوراک باب طبعش را تهیه کند	especially because she would order for the children their favorite puddings
که اسباب خجلت همه قبیله اوست و ایشان ناگزیر بایست زهر کزاز به جان او بیندازند.	a reproach to all his tribe, who must, no doubt, imprecate lock jaws upon him.
کنت نیز کلاه به سر نهاده و دستکش به دست کرده و پیش افتاد.	, the latter having previously resumed his hat and gloves
اما پسر این تفاوت را احساس کرد و به لبخند سرد پدر پاسخ نداد.	but the boy felt it, and did not respond with a smile to his father's chilly smile.
من تصمیم داشتم که حتما با اف. بی. آی تماس بگیرم و قضیه را اطلاع بدهم.	I was afraid I was going to have to go to the FBI about it.
ولی البته به هیچ وجه قصد چنین کاری نداشت.	which she never meant to send.
هر روز چشم به راه و منتظر تو هستم.	I shall expect you every day
یک گله چران معمولی او را روز روشن جلو چشمشان قاپیده!	an ordinary stockman, stealing her from under their noses!
قول داد بعد از اینکه اوضاع کمی بهتر شد مجدداً از کارگران سیاه استفاده کند .	promises that when times were better she would hire free darkies.
چون دلم نمی خواد تو ماه عسلم از درد به خودم بپیچم	I just didn't want to spend my honeymoon writhing in pain.
سپس بلافاصله به عزم گردش عادی خویش به بالای مهتابی برآمدم تا ببینم آیا عصای نبین ظاهر خواهد شد یا نه.	immediately repaired to the usual walk on the terrace to see if there were any sign of the reed
وقتی که قبل از رد شدن از جلوی من به ماشینش رسید نا امید شدم.	I was disappointed when she reached her car before she had to pass me.
میدانند جائی که پای دفاع از مال و آزادی در میان باشد باید تا کجا لجاج ورزند.	understand how far to carry their obstinacy, where their liberty or property is concerned.
هیچ فک زی به ذهنم نرسید جز این که سعی نم افسونی برای بستن در به آن بخوانم.	I could think of nothing to do but to try and put a shutting spell on the door.
با دشمن روبرو خواهد شد به تمام جهات اعزام شدند.	who had hitherto been inactive, would also soon have to meet the enemy.
آنچه را که تا آن زمان هزینه کرده بود دقیقا یادداشت کرد تا به شریکش اجحاف نشود.	made a careful note of what he had spent, so that his partner would not be cheated.
تا این که سرانجام بیمار سلامت خود را بازیافت و به سر کارش بازگشت.	until under his treatment she got quite well and went to work again.
اما تنها یک بار به این کار نیاز بود.	but then it had to be done only once.
وضع رویه مرفته همان بود که در آگهی نوشته شده بود یا بقول نماینده کمپانی در همین حدودها بود.	the thing was altogether as represented in the circular, or at any rate so the agent had said.
حالا نمی تونم راجع به این موضوع فکر کنم.	I won't think about it now.
دوباره بازمی گشت تا پشت سرش بایستد و نقاشی کشیدن او را تماشا کند.	then returned to stand behind him and watched him paint.
من تا این درجه هم او را اطلاع دادم از تفصیلی	I have even informed him of a circumstance
که در آن ساعت در تابوت دراز شده بود.	on view at that hour in his coffin
ولی دوشیزه جوان که عاقل بود و نام نیکی داشت	the young maiden, being discreet and of good repute
یک روز کنار بخاری دیواری دفترش به خواب رفت	he had fallen asleep in front of the staff room fire
