بر خشم خود فائق آمد و نگاه سردی به او انداخت.	she stiffened her spine and gave him a cold stare.
در حالی که به صورت ناشناس و برهنه در آغوش زنی خوابیده بود	he was naked with the women who had helped to entrap him.
از افتخاری که او به او و پسرهایش داده بود	for the honor she was doing himself and his sons
ولی در تشویش آن نیستید که آنان رادرک کنید.	but you never take the trouble to understand them.
زیرا او خودش هم قبل از مردن سخت بیمار بوده است	for she was very ill herself before she died.
چون از پیگیری در خور تحسین تو خبر داشتم	knowing your admirable tenacity
با بانگ بلند فریاد زدند بوراچ می ولا .	crying aloud, _Borach mevolah_.
چندان تقلا کرد تا موفق به گشودن در شد	exerting his strength he forced it open
از برای مدافعه با خصمی که خود را در خفا موضع گرفته	I could repel the attack made on me by enemies unknown to me
که دولت من عقیده دارد که گزارش مزبور نشان دهندهٔ واقعی چیزی نیست	that my government believes the report was not a true representation
تا من پول لازم و کنار بذارم بعدش هم برم پیشش باهاش حرف بزنم.	I could get money enough together to come up there and talkto her some more and
آن چیزی را که هیچ قمارباز قابلی تا به امروز نیافته.	what the most skilful players have never discovered that is, a roulette
در آن به جستجو پرداخت و یک نوع تبرزین جنگی و یک کیف پوست شیر ابی بیرون آورد که موی آن را هم نکنده بودند.	presently pulled out a sort of tomahawk, and a seal skin wallet with the hair on.
من دی گه فقط درد و رنجی هسم که روش پوست کشیده با شن	I'm jus' pain covered with skin.
بی آنکه به وی مجال دهند که کسی را به کمک بطلبد	carrying her off without giving her time to resist
از قیافه جمی ما به شک افتادم و حرفم را قطع کردم.	I tail off incredulously at her expression.
اگر پلکان و بخاری با هم جور دربیایند به نظر آرشی تک بزرگی باشم.	I shall think I am a great architect, if I have not got incompatible stairs and fireplaces.
به سمت ماشینی رفت که کنار خیابان پارک شده بود.	went to a car parked down the street.
اثاث و وسایل راحتی و چینی آلات در آن گذاشت.	had furniture put in, and china.
مادام موفق شد که راهش را به اتاقش پیدا کند	the poisoner succeeded in groping her way to the door
خانم پا مفری چنان محکم پتو را پیچید که هری احساس کرد لباس مخصوص دیوانگان را به تن کرده است.	wrapped him so tightly in a blanket that he felt as though he were in a straitjacket
زیرا دو ساعت پس از آنکه برخاستم سپیده دمید.	for I found the day broke in two hours after I awaked.
روحش خبر نداشت که مخاطبش یک مرد عاشق است.	not in the least suspecting that she was addressing a lover.
چه نفس راحتی کشیده بود وقتی دوباره پا به خیابان گذاشت!	what a relief to get out to the street again!
چنانکه برای حصول تأمین در قبال چنین خطری دوباره به ساختن کلاه خود همت گماشت	to guard against that danger he set to work again
من بیش از پنج متر دورتر از پنجره اتاق تو نخواهم ایستاد.	I won't stray five yards from your window.
منظور من از بار اول همان وقتی است که نامه حضرتعالی را برای او بردم	when I took her the letter that told of the follies
این حقیقت تنها پس از مرگ او هویدا شد.	a fact which only became known after his death.
با عینک و پالتوی گشاد در اتاق پذیرایی میان دخترانش نشسته بود	sat in the drawing room in a loose dress, surrounded by her daughters
یک رئال برای دو بار خون گرفتن از او در ایام بیماریش پرداخته است که باید به حساب منظور شود.	a real for two blood lettings when he was sick.
آنقدر اشک ریختم که فکرمی کردم هرگز تمومی نخواهد داشت.	I bawled until it seemed I'd never stop.
آنگاه خواهش کردم که نام آن سرزمین را به من بگویند	I desired them to tell me what country it was.
مخاطب من فقط کسانی هستند که ارزش پرداختن به این کار را دارند و شایسته به انجام رساندن آن هستند.	I address only such as are worthy of the work, and competent to accomplish it.
من هیچی بهش نمی گم دی گه نمی گم به هیچ کس	I shall say nothing never any more to anybody,
این دریچه برای این بود که روزی سه بار غذایش را به درون اتاق بفرستد.	so that small amounts of food could be pushed inside three times a day.
به او تکلیف کردند که از خانه و از اموال ایشان هرچه را که خوش دارد با خود ببرند	bade him furnish himself with all he wanted from their house and belongings
معذرت می خوام که شما رو جاسوس و دیوونه خطاب کردم.	I'm sorry I called you a spy and a fool.
به محض رویت او در پای او دوپای اضافه به عاریت گرفته فرار را بر قرار ترجیح داده بود.	no sooner beheld him in his terrors than he took to his noble heels.
در آن موقع است که تو باید فورا او را در پالتوی پوست بپیچی و به میان سورتمه ببری.	but you wrap the fur cloak round her first thing and carry her to the sleigh.
اثاثیه طوری خراب شده بود که دیگر قابل تعمیر نبود.	had caused irreparable damage to the furniture
من قبلاً اسم کوچک آقای راچستر را نشنیده بودم .	I had not before heard his prenomens
اما ان قدر گرسنه هستم که به راحتی و با خوشحالی بتوانم یک تکه مقوا هم بخورم.	but I'm so hungry I could happily eat cardboard.
الهی به مرض پلید متعفنی دچار شود و بپوسد.	I hope he'll rot with some loathsome disease.
از خدا طلبیدم که کمی شهامت و بردباری به من عنایت کند.	I prayed for courage in a blind despairing way
دکتر را از رفتاری که من با شما کردم آگاه کنید!	to let the doctor know the way I took it.
خوب است یکی از ما در جلو در بماند	let one of us stay at the gate
زیرا که باید من به آسودگی با او مکالمه نمایم	I must speak freely to her
چون همه چیز به دلخواه او درست خواهد شد.	for all would go well and turn out as he wished.
در آندم به یک طوفان شدید مبدل شده بود.	now it was a whirlwind.
در صورتی که علم قدرتی است که از حق حاصل شده است.	while science is authority rightly understood.
من نمی تونم برای مدت طولانی بیرون وای سم	I can't stand out there that long. 
به من گفت که برای این به این منطقه آمده که ثروت و مکنتی به هم بزند.	that he had come here to make his fortune.
به ویژه برای آنکه از دو یا سه تن از آنان سخت متنفر بود.	not to mention the fact that some of those present were particularly detestable in her eyes.
دوان دوان خود را به کوچه باغ رسانید و به انتظار ایستاد.	he ran into the road and waited.
ایشان را به پاس نیات و خدمات خود چشمداشتی جز این نباشد که آن بانو آنان را به شرف پهلوانی خود مفتخر گرداند.	who look for no other reward for their great and true devotion than that she should be willing to accept them as her knights.
چه خانه درست در بیرون شهر و در مجاورت باغ کوچک و اصطبلی قرار داشت.	because the house stood just at the end of the town, with a garden and stables attached,
با اکراهی که از دلش ریشه نگرفته بود گفت	he said with a disdain
فکر کنم اصل قضیه هم ون نشاط و سر زندگیه.	I think the whole essence of the concept is vitality, she says
البته نه از این جهت که پسرم بد است	not because he is a bad son
دوباره به غذا خوردن پرداخت بدون اینکه پاسخی دهد	without answering, went on with his dinner.
این موضوع شباهت بسیار به داستان یکی از شعرای نامدار و معاصر ما دارد	reminds me of what happened to a famous poet of our own day
جوانی بود درشت اندام و سی و پنج ساله	was a stoutly built fellow of about five and thirty
سپس ناخدا طول و عرض جغرافیایی آنجا را به دقت و صحت تمام شرح داد.	then he named the latitude and longitude exactly.
از حیاط به سوی بند رخت نیمه پر رفت.	she walked off across the backyard toward the flapping halffull clotheslines.
در آن وقت به نظرم موقع آن است که آن فرد را به کناری بکشم و مطلب را حالی او کنم.	then I think it high time to take that individual aside and argue the point with him.
آنان دیگر جرأت حمله و جنگیدن با ما را نخواهند داشت.	they had had more than enough of fighting.
شما غم و دردی رو میخ رین که گفتنی نیس	you're buying a sorrow that can't talk.
در این حال برای او ضرورت داشت که معشوق خود را در آغوش کشد	she wanted now, at once, to embrace the man she loved
هدیه کاترین را به نزد هیرتن بردم و پیغام وی را نیز ابلاغ کردم.	I carried it, and repeated the message
دو نفر شاهد بفرستم به نزد بشان که این فقره را منتشر ساخته.	, in whose journal this paragraph appears
چون مسلما برای اجرای نقشه من به پول نیاز هست.	for, clearly, money is required for my plan,
هر جا از این چراغ ای آبی دیدی برق بز نه	where you see one of them blue lights flickering around
با تمام وجود عاشق توست و تا روزی که بشود تصور کرد عاشق تو خواهد ماند.	he loves you with all his heart, and will love you as nearly for ever as possible.
مسیر حرکتش قوسی عجیبی به سمت پایین داشت و سرانجام روی میز فیلت و یک افتاد.	so that his cushion did an odd sort of belly flop off the desk.
چون مزدشان کم است از کجا که با بریدن سر افراد آن خانواده صد برابر مزد خود را به دست نیاورند.	who might get a hundred times more by cutting their throats.
این محبت و شور با دلبستگی وم اعتمادی در آمیخته است که نشانهء روزهای نخستیناز دست دادن شماست.	united to the trustfulness and attachment of the early days in which you were lost to her.
صدای جیز جیز روغن تفتیده ساکت شده و دود به سمت آسمان و نور خورشید بلند شده بود.	the noisy frizzling of fat had stopped, the fumes floated upwards in sunshine
اما خدا نخواست که پدرم خود را هلاک نماید.	but your father was not allowed to fall.
زیرا صدای تاپ تاپ چوب دستی کور را روی جادة یخ زده و خاموش شنیده بودم	for I had heard in the silent frosty air a sound the tap tapping of the blind man's stick upon the frozen road.
اما آنقدر نوبت به نوبت به یکدیگر تحویلش دهند تا مجلس به سر آید.	but was to be passed on most artfully from one to the other until evening should be over.
هرچند نمی تونم باور کنم خیلی سر این موضوع به هم ریخته با شه.	I can't believe she's so upset about it, though.
یک بلوز بافتنی دستباف و یک کیک آلو بود در آن یافت	found a new, hand knitted sweater and a large plum cake.
عالی جناب تقاضا دارم به شاهد بگوئید که ملزم نیست به چنین سؤال پاسخ دهد.	I ask the court to instruct the witness that he need not answer such a question
من هم شالی برای گردن و پشتم نداشته باشم.	I hadn't a shawl to cover me.
از حاکم خواهش کردم که ارواح یک عده یا یک دو تن از شاهان انگلیس را با هفت هشت پشتشان به ترتیب احضار کند.	I desired the governor would call up a dozen or two of kings, with their ancestors in order for eight or nine generations.
من خیلی تعجب کردم که شما رو اینجا دیدم.	I'm so surprised to see you.
زبان فرانسه را چون زبان مادری خویش بداند و به کار برد	might have known as much of their language as of her own,
من یقین دارم اگر به تو مجال بدهند تا سخنی را که در هر قدم شروع کردهای ادامه دهی	it is my belief, if thou wert allowed to continue all thou beginnest every instant
باید به شما به گم که من دی گه کشیش نیستم.	I got to tell you, I ain't a preacher no more.
راسکلنیکف کمی برخاست و نگاهی پر از تحیر به او دوخت.	he got up, looking at her almost bewildered.
اما نه حالا. هنوز زود بود که به او نزدیک شوم.	but not yet. I would not accost him yet.
بلکه ظاهرا توان این را نیز داشت که با یک نگاه هوشیارانه و اندیشمندانه به هر زن و دختر یا جوان رو به رشدی در قلمروی تحت نظارتش آنها را دسته بندی کند.	but he seemed able, with one attentive, thoughtful glance, to classify each woman, girl, or growing youth of his domain.
پاسخ روت چنین بود متأسفم که از او خوشت نیامد	I'm sorry you don't like him, was her reply.
چای و شیرینی قبلاً روی میز چیده شده و آماده بود.	where tea was laid ready.
هرگاه شوهرم از شما کرایهٔ اطاق را مطالبه کرد	if my husband applies to you for payment for board and lodging
حالا مرمت شده و به خانة جدیدی تبدیل شده بود.	now put into repair and turned into a modern dwelling.
وقت تنگ است و ما باید بسا چیزها که بکنیم و بگوییم و نشان بدهیم.	for it is growing late, and we have a great deal to do and to say and show.
این بازیگر لباس دیوانه یا دلقک درباری در تن داشت	dress with a great number of bells
کلاید بهت زده ایستاده و حیران بود که به این اتهامات چه پاسخی بدهد.	he gazing dumbly and wondering what else he was to sayin answer to all this
ولی سوگند خود را فراموش مکن وگرنه به کیفر موعود خواهی رسید.	keep in mind what you have promised and sworn under those penalties that have been already declared to you.
وی خودش این نکته را دیروز به من گفت.	he was explaining it to me again only yesterday.
به خصوص وقتی که به روشنی معلوم باشد این کار جنونی آشکار است.	which show from afar that it is plainly madness to attempt them.
نگران بودم که ممکنه مجبور به شم انتقام قتل تورو بگیرم.	I was concerned that I might have to avenge your murder.
بر حسب اتفاق یکی از انگشتان خود را بریده بوده.	happened to cut one of his fingers.
من متوجه این قضیه شدم و فهمیدم که مشکل از آنجاست که هیچ حس آسودگی ای به دنبال آن عمل نبود.	I considered, and realized the problem was that there was no relief tied to the action.
من هیچ چیزی از این جهان امروزی رو ندیدم.	I've seen nothing of this new world.
از موضوعی که مورد نظر همه ماست گزارش مبسوطی به من بدهید.	gave me a full account of what we are all driving at.
امشب تا بامداد خواب این حرکات را خواهم دید.	I shall dream of it all night now.
متوجه شد که بیش از اندازه به سمت شرق رفته است.	found that he was going too far east.
او با لحن مودت آمیزی گفت. بعدا به شما خواهم گفت.	I'll tell you afterwards, he said quietly.
بهتر است کاترین نظر لطف و مرحمت دوست و آشناهای قدیمی را حفظ کند.	while she could preserve the good opinion and affection of her earliest friends.
این نکته را نیز به عرایض خود اضافه کنید که در دنیا استعدادهای نهفته بسیار است	I say too,that there are rare gifts going to loss in the world
حس کردم دستی نیرومند مرا به طرفی پرتاب کرد	I felt as if an enormous hand made of air were sweeping me along.
هرگونه امیدی را از دل بیرون رانده و نومیدانه به زندگی خود ادامه داده و بدون آن که شتابی از خود نشان دهد در انتظار بود.	a woman whose nature prepared her to wait without despair
ولی استپلتن هرگز اجازه نداده ما با هم تنها باشیم.	he has never let us get together
به دقت اطراف را نگاه کردند و گوش سپردند تا ببینند صدایی هست یا نه	looking and listening eagerly
به نظر من تأثیر محیط خانوادگی به راش مفیده.	I think the home influence will be very good for her.
این کتاب در اینجا شهرت و موفقیت عظیمی کسب کرده است.	it has an enormous success here.
برادر شما اینک به اتهام قتل پدرش تحت تعقیب قرار دارد لکن همه کس از اینکه او پدرش را به قتل رسانیده است خرسند است.	your brother is being tried now for murdering his father and every one loves his having killed his father.
نامش را با حروف براق روی روبانی نوشته و به دور شمع کافوری محراب کلیسا پیچید.	engraved his name in gilt letters on the ribbon of the candle.
مادرت را از صدمه فقر و بدبختی نگهداری بکن.	but spare her the trial of poverty
در ده کوچک بیماری بود که احتیاج به فسد خون داشت	in it there was a sick man who required to be bled
این عمل چندان محسوس و دگرگونی حالت در چهره زندانی جندان آشکار بود که چشماهایی که به او دوخته شده بودند از او به آنم دو تن متوجه شدند.	so immediately, and so much to the changing of his aspect, that all the eyes that were tamed upon him, turned to them.
سپس بار دیگر سوگند عشق جاودانی خوردند و پیمان بستند که هر روز به هم نامه بنویسند	they renewed their eternal vows, and swore to write to each other every day
نمی دونم برای گفتن این حقیقت شایستگی لازم و دارم یا نه ولی بالاخره یکی باید بهت به گه.	I don' know if I'm the right person ter tell yeh ' but someone's gotta
من از وضع رفتار پسرک مردنی و موذی خیلی بدم آمده بود.	I felt disgusted at the little wretch's composure
نتیجه این شد که آن سگ پس از دو روز به علت سوء هاضمه مرد	but as things turned out, two days after this the bitch died of a surfeit
ولی این کار فقط اشتهای اورابیشتر کرد و گرسنگی دیوانه واربه او هجوم آورد.	but that only whetted his appetite, brought it raging up.
ولی آن قدر از آن خوشش آمد که یک بشقاب دیگر هم خورد.	but she liked it so much that she took another of the same size
حال معلوم شده بود که کلاید حقیقتا جذاب است.	he was so devoted to her.
گردن نوآموز یاغی خود را گرفت و از انبار بیرون آورد.	dragged his rebellious apprentice out, by the collar.
بلکه دو پیرزن مفلوک و ترسان و لرزانی را به همراه داشت.	for this time, he led in two palsied women, who shook and tottered as they walked.
کلماتی از شعر خود او خطاب به همسر سردبیر.	addressed to the wife of the editor of the
برداشت ما این بود که با نظر عموم دربارة این موضوع موافق است.	he left us with the impression that he shared the popular view upon the matter.
حتی اگر آن شب موفق به بازگشت به صومعه نشود.	even should he be unable to return to the monastery that night.
فکر کردم که آیا اوقات خوشی در گردش داشته.	I wondered if she'd had a pleasant time on the outing.
بلکه به زنی تعلق داشت که او را اسیر خود ساخته بود.	but the woman's to whom he had bound himself.
یک تشت مسی بزرگ آورد و جلوی رون انداخت	plunking a large copper basin in front of him.
اسب تنبل به راه افتاد و ما را هم با همان سرعت همیشگی با خود برد.	the lazy horse walked away with us all at his accustomed pace.
به هیچ قیمت هم به او اجازه نخواهم داد به دنبال تو بیاید.	as for him, I won't let him go on any account.
همکارانم دوست دارن توی این برنامه شرکت داشته باشند!	my colleagues will want to enter into the occasion!
عرق سردی که بر پیشانش نشسته بود از پشت عینکش سرازیر شد.	feeling cold sweat trickling down behind his glasses.
ربرتا که درست در همان لحظه نگاه اندوهناک خود را به رقص پرنشاط مردم دوخته بود	for at the very moment she had been looking at the happy dancers rather ruefully
شیاطین هم به عالم خودش ون کشیده می شن و روزگار به خوبی و خوشی سپری می شه.	the demons get sucked back to their own universe and all will be well with the world.
نخواهم فهمید که چه میگویید اما گوش خواهم داد.	I shall not understand you, but I shall listen to you.
وقتی به دهکده رسیدیم ما را با قایق به ساحل فرستادند	when we got to the village they yawled us ashore.
آن موقع همین جا از دست دزدها و تبهکارهایی که از سرتاسر استان آمده بودند.	here at that time by ladrones and matreros, thieves and murderers from the whole province.
شاید اونها هم ساعات سختی رو برای دادن اون لیوان بهش داشتند.	they were probably having a tough time not ripping the cup away from her.
پس در روی زمین کسی را به وجود من احتیاجی نیست	no one then longer needs my useless life
این زن بدبخت حتی نتوانسته بود جسد او را پس بگیرد .	she, the poorest of the poor, was unable to bring his body home.
جراثقالی در اسکله کالاهای انباشته در انبارها همه کارهای عضلانی و گوناگونی که به دقت نیاز داشتند	the piled up produce in warehouses, the precision and variety of muscular effort wherever exact work had to be turned out
این بود کشف و شهود موحشی که در جانش داشت.	this was the fearful vision which he bore within his soul.
درست همان موقع که پدرش از خانه بیرون رفت.	just after his father went out.
این عده تحت هدایت و رهبری جوان چابک و دلیری بودند	one of those on the mares asked an active youth
در نتیجه ما را به حرکت از آن منطقه وادار نکرد.	so he didn't bother about driving us through
قفسه ظروف شامل دو بشقاب و کاسه و یک دست وسایل چایخوری از جنس سفال لعابدار.	with two or three plates and dishes, and a set of tea things in delf.
اندیشه به صورت جریان یک توده سیاه و درهم به درونم وارد شد.	reflection came in as black and confused a flow.
انصافاً ثابت کرد که در خور حسن ظن تست.	therein justified the good thoughts you have of him.
به خصوص که تمام آن را به حساب خطای اسب خود گذاشت.	entirely, he considered, the fault of his horse.
حتی حالا هم قادر نیستم حقیقت و واقعیت آن را به طور کامل اظهار کنم.	I cannot even say of what it is expressive to me now
سرو صدای اهل منزل بلند شد و یک چراغ هم روشن شد.	I heard the people stirring around in the house now, and see a light.
لیکن در عیب رشک و حسد جز تلخ کامی و اندوه و خشم و غضب جانکاه چیزی نیست.	but envy brings nothing but irritation, bitterness, and rage.
تا مبدا جان سربازانش را فدای عدم هضم غذایش کند.	so as not to submit the troops to the risks of indigestion.
کمی خورد اما هیچ نخوابیده و این زندگانی را پرسخت ندید چه الآن اختیارش را به دست خود دید که چون لباس هروقت خواست از بر خواهد کند	ate little and slept less and found existence almost supportable because he felt that he could throw it off at pleasure like a worn out garment
مادرش را دیدم و دستش را بوسیدم گانیای عزیز من!	I saw his mother and kissed her hand, too.
به گمان برای شخص خجالتی ای مانند او جلب توجه چیز خوبی نبود.	I supposed, being shy as she seemed to be, attention would seem like a bad thing to her.
که این اوپرا نیست که محل توضیح خواستن باشد.	this the place for such a demand
از دقیق شدن به نواختن دست برداشت و شروع به خواندن کرد.	he let it walk off down the beach and then sang .
بلکه احساس ناخوشایند دیگری نیز با آن همراه بود.	but also there tinged her physical fatigue some faintly disagreeable sensation with another origin.
به من وعده داده است که هرگاه به گذرنامه نیاز داشته باشم آن را در اختیارم بگذارد.	she promised to lend it whenever I want one.
تا وقتی که چیزی به جز استخوان بندی و خال کوبی از او باقی نمانده بود.	till there seemed but little left of him but his frame and tattooing.
لبخند زنان جلو رفت تا دست خواهرش را در دست بگیرد.	he strode forward to take his sisters hands, beaming.
ولی وای به حال اون کسی که منو حاضر کرد بلایی به سرش بیارم که نفهمه از کد وم طرف بره.	but I lay I'd make that man climb the highest tree there was in the country.
اما در مقابل کاترین یک پایش را کاملاً عقب برد و نیمچه تعظیمی هم کرد.	on her he bestowed a whole scrape and half a short bow.
آن بزرگوار با کف نفس و خویشتن داری تمام و به رغم میل قلبی خویش اجازه فرمودند که در قفس را ببندم.	he very reluctantly, and altogether against his will, had allowed the door to be closed.
من از هر حیث به وضع شما علاقمند هستم.	I wish to know all about you, you interest me very much!
در این لحظه یک جفت شلوار ارغوانی از کنار او گذشت	here came by a pair of tight scarlet trousers
انگلیسی نیز در جواب این نظر تبسمی کرد که از این سیمای یخ کرده او خیلی غریب بود	to which he replied by a smile that an indifferent spectator would have been surprised to see on his stern features
کسی که قدرت آزاد کردن اون هیولا رو داشت	the one who had the power to release it
یکی از آنان که از صاحب منصبان محافظ من بود قسمت بیشتر از نوک زوبین خود را در سوراخ چپ بینی من فرو کرده بود	one of them, an officer in the guards, put the sharp end of his half pike a good way up into my left nostril.
زیرا خودم هم متهم کننده و هم مدافع متهم هستم.	I am here to accuse him, but to defend him also.
بارها و بارها این آرزو را کرد و بارها و بارها هم آن را به عقب انداخت.	that instant yearned for so many times and so many times postponed
اما صدای در کوچه که بسته شد شنیده گردید	they heard the street door close
اعلام کرد که مسئولان کارخانه آخر وقت آن روز گزارش پردردسری	that at the last moment at the factory a very troublesome report
بهتر است تو نزد آن وکیل بروی و همهٔ ما جری را برای او نقل کنی	couldn't you go to that counsel yourself and tell him the whole thing by yourself?
اما صدای ممتد بخاری صدای اصلی پس زمینه بود.	but the hum of the heater was the real soundtrack.
شاید در این بخش رازهایی ناگفتنی وجود دارد که زنان از درک آن ناتوانند.	here indeed there might be secrets not capable of explanation to a woman's reason.
این را هم گفت که هر چند شخصاً آدم فقیری است	though he was a poor man himself
تنها چیزی که ناخدا احتیاج دارد آفتاب خوب است و در سفر مناطق حاره که در پیش دارید آفتاب خوب فراوان است.	a pleasant sun is all he needs, and ye'll have plenty of them in the tropic voyage ye go.
من واقعاً اجازه ندارم در مورد جزئیات تحقیقات حرف بزنم	I'm not really authorized to talk about the details of any ongoing investigations.
تند تر به بسته حمله برد و کاغذش را قیقاج و دراز جرواجر کرد.	she attacked the paper faster, peeling it away in long, ragged strips.
به این ترتیب راه مرگ خودش را هموار ساخت.	so prepared the way for his own death.
من برآشفتم و در پاسخش با خشونت ناسزا گفتم.	I flared up and said much that was unpleasant and even rude to him.
ولی او قدرت اینکه آن را بردارد و روی خودش بکشد نداشت.	but she did not have the strength to get under it.
از ماندن وی در خانه و خودداری از عزیمت به مسکو شادمان است.	he was glad she was remaining at home and had not gone away.
وقتی هنوز چند قدم با در ورودی اتاق فاصله داشت تو آنست بخش باریکی از اتاق را که از لای در نمایان بود را ببیند.	he was able to see a narrow slice of the room beyond.
من با شتاب هر چه بیشتر به سوی کرانه دویدم	I made what haste I could to the shore
فرمانده تیپ سرتیپی بسیار شایسته که در پای تپه قرار داشت	, the brigade commander, an estimable and honest general
چون آن اهمیت ندادن در هم شکسته شده بود.	for the indifference was broken up.
در طی چند سال به درجه سروانی پیاده نظام رسید	he rose in a few years to be captain of infantry
الاّ جلیقه او مفقود شده و به دست نیامد.	excepting the waistcoat, which could not be found
آن را برای آن نقل کردم که به سخنم نفوذ بخشد.	I made it up to add piquancy.
اما ده بود محموله مرگ خود را در هوا خالی کند.	ready to unload its cargo of death.
با هم دست بر شانه او نهادند و در آرام کردن و نشانیدن او در برابر آتش کوشیدند	they each put a hand upon his shoulder, and soothed him to sit down before the fire,
کارگر راهدار هر روز سرگرم به چنگ آوردن لقمه نانی از خرد کردن سنگ بر شاهراه بود	the mender of roads went forth daily to hammer out of the stones on the highway such morsels of bread as might serve
از ای نرو بدین زبان سخنانی گفتم که شاید اندکی زائد بود	I could not forbear breaking out into expressions, perhaps a little too extravagant.
درست به همان نحویکه لیوان را پرتاب کرده بود.	as he had thrown the glass.
یا آن که خیلی به سادگی منظورش این بود که عادت از دست نرود.	or simply so as not to get out of practice.
با این وجود همه چنین پیشرفت سریعی را انتظار ندارند.	though not all of them expected to succeed as quickly as that.
اگر توانستی دوان دوان خود را به ما برسانی نیم پنی به تو خواهیم داد.	then let them see how far he could run for a halfpenny
زیرا در زیر باران به نشان کرنش زانو بر زمین نزده است.	because he had not kneeled down in the rain
چند خط یادداشت هم با همان پست آمده بود	a few lines at the same time by the post
املا به یاد ندارم چگونه موضوع را طرح کرد	I don't quite remember how he described him.
دوباره او پسندید و به قصر دعوت شد ولی او نیامد	found equally agreeable again encouraged invited and expected and again he did not come
گو اینکه ایشان شخص بسیار محترمی باشند و حتی گاهی هم رفیق بازی انسان شده باشند .	however respectable and pleasant a person he may be to play cards with at conweniency
ولی متوجه شدم وی عجله دارد تا هر چه زودتر ترتیب آماده کردن اتاق و وسایل راحتی مرا بدهد.	but it was impossible to delay her at such a crisis
در این اثنا بود که توتسکی بر حسب تصادف و با نهایت شگفتی و یک نوع عصبانیت دریافت که هر گاه از ناستازی خواستگاری کند جواب رد خواهد شنید.	he discovered that this was by no means the case, and that were he to offer himself he would be refused.
متنفرم از اینکه مجبور باشم چیزی رو دوباره تعریف کنم	I hate repeating myself.
توانست بوسیله مراقبت و دقت اعتماد فرماندهان مافوق خود را جلب کند	had gained the confidence of his superiors by his promptitude and accuracy
به آرامی مکتوب را در هم پیچیده و به فکر فرورفت.	he folded the letter and resumed his pensive attitude.
با وجود تمام احساسات مخالف افراد ارتش شرایط و اوضاع ایجاد کرد	despite the strength of the feeling that had arisen in all ranks
یا بنا به ملاحظاتی باید وانمود کند که ژنرال او را ندیده.	or that from some consideration of policy she should be allowed to suppose herself so.
با ملاطفت خاصی که زنان تنها به مرد محبوبشان دارند به او لبخند زدند.	smiling at him with the peculiar tenderness women save for the most beloved men in their lives.
چون تازه با سایر مهمانان شام خورده و تازه چای نوشیده بود.	because he had been dining with other guests, and had just taken tea.
وقتی به فرودگاه رسیدم هنوز یک ساعت به پروازم مانده بود.	I've arrived at the airport with an hour to go
درست همان طور که تا الان همیشه حفاظت کرده بود.	just like he'd always guarded me.
که بسیار بر من اثر دارد و در من نافذ است	which I consider quite beneath me.
اما چون دیدم که صفیر از تپة نزدیک دهکده برخاسته است	but I now found that it was a signal from the hillside towards the hamlet
لازم نیست من به تو بگویم چه کار باید کرد.	I need not tell you what is to be done.
وگرنه که تا به حال یک دزد حسابی از آب درآمده بود.	or he would have been a thief, long ago
وی گفت قادر نخواهد بود که حتی یک ساعت نیز در چنان جایی که برای من خوشایند و دل پذیر است به سر برد.	he said he could not breathe in mine
ممکن است همین امور مانع از ازدواج شخص بشود .	it might spoil many a match.
دور او چرخی زد و دوباره آن را گرفت.	looped her easily, and caught it again.
اما از خوشبختی پیش از آنکه آسیبی به من رساند شکمش را دریدم.	but I had the good fortune to rip up his belly before he could do me any mischief.
من البته افتخار خود دانستم که میل او را بجا آورم.	I, of course, was only too pleased to obey her wishes
اگر ولی نعمت این باشد قطعاً چیز ناخوشایندی است.	if so, a benefactress is a disagreeable thing.
تا مبادا زمانی از راه برسد که خاطره این وقایع بزرگ از یادها زدوده گردد.	lest a time come when the memory of these great matters shall grow dim.
مدت زیادی با او حرف زدی و او را سرگرم کردی.	you talked to her and amused her a long time.
من نتوانستم او را ببینم تا اینکه برپا خاست	but I could not see her till she arose
در این گونه مجامع شخصی هستی به غایت مناجور و بد برخورد.	you are a devilish ill conditioned fellow in that sort of society.
گیسوان خود را بالا زد و آهی کشید و با پای نازیبا و برهنه از راه باریک پیش رفت.	put up her plait, sighed, and went on her short, bare feet along the path.
به یکباره هرگونه هراسی را از دل بدر کرد و برای مواجهه با هر خطری آماده شد	casting fear aside and regardless of what might happen
به لحاظ نظامی آن قدر جلال و شکوه به هم زده که هر مرد تشنه پیروزی را سیراب میکند.	trying at the same time to put an air of gallantry into his attitude.
از حالا به بعد من در اختیار این خانم هستم	I'm in this lady's hands from now on.
در اطاق شخصی خود در برابر آتش گرم و نوازشگر نشست	sat herself down before a cheerful fire in her own little room
همان طور که برای شما گفتم آن را از زن و مردی که با سرقت توانسته بودند مدال را در اختیار خود بگیرند خریدم	I bought them from the man and woman I told you of, who stole them from the nurse, who stole them from the corpse
دو بار برای رفتن به اداره و دو بار برای مراجعت به خانه.	twice to go to the office, twice to return home
سرانجام پایش در طنابی که بالای تخته آخورش آویخته بودند گیر کرد و پایش لنگ شد.	had ended in laming himself severely by catching his leg in a rope that overhung the stable board.
حداکثر آرامش را حفظ کنند و و هر فرمانی به ایشان داده شود ببرند	they had resolved to maintain the strictest peacefulness, obey all orders to the last
که در قرن نوزدهم ممکن باشد چنین اسب پر داری را به جای حیوان دریایی واقعی به خوانندگان با بصیرت و جوانان مدرسه رو قالب زد.	that in this nineteenth century such a hippogriff could be palmed for genuine upon any intelligent public of schoolboys.
من صورت حساب خود را برایت خواهم فرستاد و امشب چیزی به تو خواهم داد که حتی بیشتر از یک گالن شراب قلبت را گرم خواهد کرد!	I'll send my bill, by and by, and tonight I'll give you some thing that will warm the cockles of your heart better than quarts of wine,
حتی این قدر از او ساخته بود که در موسیقی عقاید قالبی نداشته باشد و محیلانه ضرباتی بر شهرت غصبی مردان بزرگ روز وارد کند.	he was even capable of not having ready made opinions about music, and of having a sly fling at the forged reputations of the great men of the day.
باز هم دستکم تا حدی بازتابی بود از عقاید مذهبی و اخلاقی رایچ در آنجا	she was still, in part, at least, a reflection of the religious and moral notions there and then prevailing,
یک روز او به خاطر آنکه از رنج آوردن و بردن صندوق من برهد آن را در خانه نهاد	having left my box at home, to avoid the trouble of carrying it
من باید مردی را پیدا کنم که زبان کائنات را بلد است.	I have to find a man who knows that universal language.
حتما خیال کردند ما هم عاشق و معشوق هستیم.	I expect they took us for lovers too.
این آهنگیه که باید حتماً یاد بگیری جوانک من.	 'tis a song you should be knowing, me lad.
حالتی که اغلب مردها بعد از یک شب آنچنانی دارند.	the way most men did after what one knew was a good night in bed with a woman, thought the priest.
بعد تابلویی با مارک دولتی جمهوری به روی دیوار بیرونی نصب نموده	nailed up on the wall the shield of the republic that he had brought with him
امّا از زیبایی رسمی و عادی آن به وحشت افتاده بودند و اندیشمندانه و خود خواسته کوشیدند از آن بپر هیزند.	but they were frightened of its formal beauty, and set themselves deliberately to avoid it.
لکن معلوم نشد که سوار اسب را نگاه داشت یا اسب سوار را	but whether for his own pleasure or that of his rider would have been difficult to say
به بهانه اینکه این فقره راجع به عمل پلیس است	I feigned a criminal process
بعضا به سود دادستان گواهی دهند تا صبح روز بعد صبر کنند.	as wellas a few in rebuttal for the prosecution, he would prefer it if the work for the day ended here.
هرکس سزای نیکی را بدی بدهد قطعاً باید دشمن مشترک بقیه افراد نوع بشر باشد.	whoever makes ill returns to his benefactor, must needs be a common enemy to the rest of mankind.
اما به یاد داشت که آن ماجرا شامل رسوایی جنسی و مرگ بود.	but remembered that it had involved sex and death.
زیرا کسی نبود تا آنان را به حفظ نظم و انضباط بخواند.	for there was not one man aboard to mend another.
چون دیگر موقع آن شده که من درست تربیت بشوم.	for it's time my education began.
گویی در تمام شب مغزش سرگرم کار بر روی آن نقشه بودهاست.	as though his sleeping brain had been working on it all night.
بعد به شلوارک او و بعد دوباره به چهره فرانی رسید.	dropped to her shorts, and bounced to her face again.
من تقریباً شایسته آنم که یک اسب باری انقلابی باشم و کارهای پرزحمت حزب را انجام دهم.	I am about fit to be a revolutionary cab horse, and do the party's drudge work.
سگ آن اندازه قدرت درک داشت که این نوازش پوچ را رد کند.	had the insight to decline his hollow caresses.
متن تلگراف را از جیب خود درآورد و آن را به رقبای خود داد.	was beginning to sense, extracted the slip from his pocket and turned it over to the others
من بهش گفتم خفه به شه ولی اون حتی به من نگاه هم نکرد.	I told him to shut up and he never even looked at me.
کشیش نیز که همین ترس را داشت از خلیفه خواهش کرده بود قدری جلوتر براند	under the same apprehension the curate had asked the canon to ride on a little in advance
هری نیز برای چو دست تک آن داد و با این کار مقداری از آب داخل ظرف روی لباسش ریخت.	who slopped quite a lot of water down his front as he waved back.
آنجا را برای جشن آغاز سال تحصیلی آراسته بودند.	decorated for the start of term feast.
صدای آخرین الله اکبر او روحش را به پرواز در آورد و در جوار الهی به آرامش رسید	the last of his voice ascended his soul to his beloved almighty to earn the tranquility.
سرانجام بیرون آمد و با پدرش بر سر میز حاضر شدند. او در مقابل پدرش نشست.	went down with her father, and sat opposite to him at table.
هیچ کی نمیدونه کی اون تو هست و کی اون تو خواهد بود.	no oneknows who has been there or will be there.
قبل از همه به شاهزاده خانم ماریا تقدیم کرد	from habit began with the princess
آن را با آن لحظه در زمین تنیس مقایسه کرد	compared it with that moment on the tennis lawn
نانی را که برای شام خریده بودم صرف کردم.	eating bread that I had bought for supper.
من آن را با غلاف و هر چه داشت بیرون آوردم.	I took out, scabbard and all.
گویا کاماش عالمی را برای این رقص خبر کرده باشد.	for of them he has engaged a host.
انگار که آقای نای تلی به او گفته بود اسمی از دوستش برده نشده.	not at all checked by hearing that her friend was unmentioned.
هنوز ده قدم دور نشده بودم که آمد دنبالم.	I had not got three yards from the door, when he came after me
اصرار دارند که کلیدش ون مرتب گم می شه.	they'll insist they just keep losing it.
هزار بار به تو گفتم بین ما چیزی جز سلام و علیک و تعارفات معمولی وجود ندارد.	you cruel thing, that beyond the commonest civilities nothing has passed!
ضمن عبور به یکی از ملازمان دربار که مردی نیرومند و خوش قواره بود	looking at the powerfully built gentleman of the bedchamber with his well combed, perfumed whiskers
هیچ دلم نمی خواد کاری به کار من داشته با شه.	I'd hate to have him get anything on me.
کمی به سمت بالا نگاهی که خشمش فروکش کرده و حال بیشتر آکنده از سؤال و پرسش بود.	slightly upwards, mollified and questioning.
دیدم که رنگ چهره و خیسی چشمانم را بررسی کرد.	I saw her measuring the color in my face, the moisture in my eyes.
لی بیشتر اوقات شنلی با یک کلاه بزرگ به تن داره.	but more often he's in a robe with a cowl.
وقتی به دل رسیده بود مهر مرگ بر آن کوبیده شده بود.	when he was already stamped with the mark of death.
که در وقت مناسبی نامه را به او تقدیم کنی	beg you to choose a good moment to hand him the letter
به نظرم اون موقع دی گه نیشتون باز نمی شه	I don't think you'll be laughing then.
که احدی از این سلسله نمانده و بکلی منقرض شده	the family is extinct
برای معالجه هم سه روز استفاده از داروهنای خانگی کافی بود.	which was cured by three days of treatment at home.
زیرا آتش سخت دشمن به روی او باز شده بود	as a heavy fire had been opened on him
سپس نی و چند کتابی را که متعلق به او بود از کشوهای میز خود بیرون آورد	then taking his flute and a few books from his desk
بهتر است و گاهی گریزی به محیط مجردی بزند.	it does you good to get out of it sometimes into a bachelor atmosphere
فقط به شما می گم که وارد این خو نه نخواه ین شد	I tell you that you shan't enter this house
باسروصدا حرکت کرد و مقداری گردو غبار روی کف زیرزمین ریخت	giving way grudgingly and sifting dirt down onto the basement floor
این که دیگر به قدری عیان است که حاجت به بیان ندارد.	that is the plain truth.
کسی که دوست دارد در کار سایرین دخالت کند	wishing to interfere
اما او به شدت اعتراض کرد و گفت که یک دینار هم از من نخواهد گرفت.	but the captain protested he would not receive one farthing.
خواننده یک زن بود و صدای بسیار دلنشینی داشت.	it was a lady who sang, and very sweet her notes were.
از آن چیز پلید که بوزینه در دهانم فرو برده بود نزدیک بود خفه شوم.	I was almost choked with the filthy stuff the monkey had crammed down my throat.
پول در این خانه مثل میوه است در دکان میوه فروش.	money is as plentiful in that house as fruit in an orchard
با دست راست عصایش را که روی زمین بود برداشت.	with his right he picked up hiscudgel, which was lying on the ground.
من سوگند یادکردم و با شادی و خرسندی فراوان زیر آن پیمان را امضا کردم	I swore and subscribed to these articles with great cheerfulness and content
در همان اثنا ماهیتابه پر از مرغ و غاز را به ارباب خود نشان داد.	he showed him the bucketful of geese and hens
که آنچنان یکپارچه و کامل دوران کودکی و جوانی خود وی را جذب نموده بود	that had so completely absorbed his own childhood and youth
او را جز این چاره نبود که کشتی به پیش برد تا بر صخره بنشیند.	he must sail on, until he struck.
اما در روزهای دیگر هفته اصرار داشت که غذای خود را در فواصل نامشخص یا در طبقهء زیرین در اتاق آبی رنگ خود در طبقهء دوم صرف کند	but on other days persisted in taking her meals at unknown periods, either in the lower regions, or in her own room on the second floor'a blue chamber
به آن مرحله از آرامش رسید که بتواند گوش فرا دهد.	he attained that phase of composure where it is possible to listen.
این حال عمومی همهٔ اشخاص خودپسند و مغرور است.	it is often so with vain persons.
اما دلیل اینکه آن قبر کن موسیقی راه انداخته حتما این بوده که در بیل او هیچ موسیقی نبوده.	but the reason why the grave digger made music must have been because there was none in his spade, sir.
اما بلافاصله تعادلش را به دست آورد و تلوتلو خوران به حیاط بازی برگشت.	but after a minute or so she was on her feet again and tottering back towards the playground.
آنگاه آن را فقط با باروتی که در دبه نهاده و سر آن را محکم بسته بودم و بر حسب تصادف از رطوبت دریا محفوظ مانده بود پرکردم.	charging it only with powder, which, by the closeness of my pouch, happened to escape wetting in the sea.
یکی از نوکران جواب داد که قاطر حامل آذوقه و زاد راه که اکنون باید به آن کاروانسرا رسیده باشد چندان بار توشه و خواربار دارد	to which one of his servants replied that the sumpter mule, which by this time ought to have reached the inn, carried provisions enough
پیچیدم و راه خود را در مقابل توفان با تلاش پیمودم.	I fought my way against the stubborn storm.
نزدیک بود زن یک یارویی به شم که چند سال بود دنبالم بود.	I almost married a little kyke who'd been after me for years.
منتظر فرصتی هستم تا برای تشکر به ملاقاتتان آیم.	I intend to pay a solemn call of thanks upon you.
اکنون همه دارایی شما در صندوقی زیر کمد پنهان شده است.	now your whole fortune, in a chest concealed under that closet
اما در آن هنگام معتبر شمرده نشده بود تا حدی ایشان را برای این واقعه آماده ساخته بود.	though indeed not credited then, this had in some small measure prepared them for the event.
که تا آخر سفر دیگر مایل نبود مثل قبل حسرت آن سفر را بخورد.	that for the rest of the trip she took no pleasure in the memory of her earlier trip, as she had longed to do
فقط در فکر خزیدن و پنهان شدن و مرگ بودند.	only of hiding and of crawling, and of death.
به سوی او خم شد و بی درنگ شروع به صحبت کرد.	leaning over her at once began to purr.
امیدوارم او به من افتخار بدهد و با من ازدواج کند.	I hoped that she might honour me by becoming my wife.
هرچند در عین حال هم عجیب است و هم جدی.	though he is strange, and grim at times.
زیرا چند دقیقه پیش از آن آرزو داشت که بر شماره دشمنانش افزوده شود	but a few minutes before she had been wishing
که من هم هرگز تا به حال ان کلمات را نشنیده بودم	that I've never heard some of the words before.
من خیلی برای بازگشت عجله داشتم و عبور سرکار را از اینجا ندیدم.	I was in a great hurry to get home, and didn't see you were coming.
لباستون خیس خیس می شه چه رو و چه زیر.	you have your petticoats all damp above and below.
از آن طرف مسیو مورل به همین اکتفا نکرده و خود را مغلوب تصور ننموده	MMorrel had not readily given up the fight
قوت نیز به خودی خود یک ضعف بزرگ است.	force is a great weakness.
شاهزاده خانم ماریا دست در کیفش فرو برد و چیزی را به دست گرفت ولی آن را نشان نداد	putting her hand in her reticule but not yet taking out what she was holding inside it
در این فکر فرو رفت که حالا دخترش چه شکلی شده است.	wondered what his daughter looked like now.
بدین نحو بارهای زیادی ناگزیر به دور ریخته شد.	so it went, the inexorable elimination of the superfluous.
اما هلن با حرکت خشن و سریع سر لب او را گرفت	but with a rapid, almost brutal movement of her head
بی آن که حرف دیگری بزند شروع به صرف چای خود کرد.	he took his tea in silence.
در آن لحظه دانستند چرا ورود به آن راهرو ممنوع است.	now they knew why it was forbidden.
که ژاکت پشمی بلندی روی لباس خوابش پوشیده بود	who was pulling a cardigan on over her nightdress.
هردفتری در شماره خود و هرضمیمه در موقع مخصوص خود نهاده شده بود	each register had its number each file of papers its place
شلوارش را که به رنگ سبز تیره بود بالا کشید	then hitched up the trousers of his bottle green suit
به جای آن باد سبکی از جنوب و جنوب شرقی وزیدن گرفت	it had been succeeded by light, variable airs from the south and south east
بنابراین حالا هم میل ندارم جشنی به افتخار من داده شود.	I don't want any silly dance given in my honour.
چیزی که مخصوصا این تقصی را بزرگ کرد این بود که همه از این اشتباه خندیدند.	what rendered the faultenormous was the fact that the chapter had laughed.
چون آب خورد ریش سفید خود را معطر کرد	after which she anointed his white beard with perfumed oil
چون گویا آن حیوان بیچاره را هم از این نمد کلاهی بوده است .	for it seems to me that not the least share of this mishap has fallen to the lot of the poor beast.
توجهی بیش از خوشامد دیگران به او عرضه داشته است.	considerate than the welcome of the others.
چیزهای جو همیشه آن قدر خراب و فکسنی بودند که معمولاً به درد بخور نبودند.	but whose possessions were usually too dilapidated to be of much use.
ترس از دست دادن تنها موجود عزیزی که امید و آرزوی منست.	the fear of losing the one dear being on whom my every wish and hope are fixed.
تصمیم گیری در تمامی مسائل را به دوستانش واگذار کرده بود	he left its arrangement to others
دیدم که هر کدام به درازی یک بند انگشت و نصف آن و به تیزی سوزنست.	found them an inch and a half long, and as sharp as needles.
من فهمیدم که هنوز خیلی چیزها برملا نشده است	but I can tell lots of things are going on beneath the surface.
اما او خودش را عقب کشیده خواهش کرده بود که دیرک دست به او نزند.	but she had drawn away and begged him not to touch her.
از آنجایی که اردوگاه دشمن بود فریاد ممتد هزاران نفر را شنید.	where the enemy was, the long drawn shouts of thousands of voices.
برای خرسندی از اظهار حقیقت به شما نیز مبلغی علاوه بر آن خواهم پرداخت.	I am prepared to pay again for the pleasure of telling you the truth.
بعد من مجبور شدم برگردم اینجا و توی دست شویی خودم زندگی کنم.	so I had to come back here and live in my toilet.
اطلاعاتش درباره کشت و کار هم ون چیزاییه که تو کتاب خونده.	what he don't know about makin' things grow would fill a book.
من هیچ وقت نگفتم که می خوام گروه رو ترک کنم.	I never said I was leaving.
تراشش بده و هر جا که می ره جاش بند از	cut 'em out an' stick 'em inside a weak place.
درست با همان عشقی که از طریق آن سعات را به او عطا کرده بود.	as she had helped him to discover happiness.
فقط کافی است تزار لب به سخن بگشاید تا ما همه در راهش جان فدا کنیم.	need only say the word and we'll all die fo' him!
هنگامی که نوبت به روزاموند رسید لایدگیت باقی راه را به او اندیشید.	when her turn came, he dwelt on the image of her for the rest of his walk
بعد بی رغبت به رها کردن بحث با کنایه از خطرات سفرش گفت.	then, loth to give up, he would branch off into feeling allusion to the dangers of his journey.
باز هم زندگی برای من قابل تحمل است مشروط بر این که دیگران از این ماجرا وقوفی حاصل نکنند.	I believed I could bear it if I were certain that nobody knew of this but our two selves.
بدتر از هر کار بدی بود که تاکنون انجام داده بود .	anything else she had done.
چند قطره اشک شوق از چشم مستمعین جاری ساخت	drew more than one tear from some of the listeners
او همچنان فکر نخستین خویش را که رفتن به راه طویله بود دنبال کرد.	who followed out his first intention, which was to make straight for his own stable.
چون نخستین چیزی که بدان رغبت داشتم دیدن و لذت از مناظر پرشکوه و جلال بود	because my first inclination was to be entertained with scenes of pomp and magnificence
چمنزار کوچک پشت باغ را به حیوانات ازکارافتاده اختصاص دهند	to set aside the small paddock behind the orchard as a home of rest for animals who were past work,
سپس خود را به دست امواج محبّتی که قلبش از آن لبریز بود رها کرد	little by little he was carried away by the flood of tenderness that filled his heart
مردی بود کاردان که سرورش به او اعتماد فراوان داشت.	a person was well versed in affairs.
چند بار به قصد دخول به اتاق بیمار به جانب در رفت	several times went to the door and listened, wishing to enter
یک مهمانخانه و یک دکان آردفروشی در اسمولنسک به او تعلق داشت.	an inn, and a corn dealer's shop in that province.
روی فرمان دوچرخه خم شده بود تا جلوی مقاومت باد را بگیرد آنقدر سرعت گرفت که نزدیک بود پرو ازکند.	bending over the handlebars to cut down the wind resistance, picking up speed until he was nearly flying along.
البته این بار عقلش رسیده بود که آن یادداشت را امضاء نکند.	although on this occasion he had been prudent enough not to sign his name.
از سخن گفتن باز ایستاد و زارزار به گریستن پرداخت.	she broke off and burst into sobs.
آخه می دونی اژدها رو نمی شه رام کرد.	anyway, you can't tame dragons
اینک فراک و جلیقه سفید ببر کرده و کراوات سفید هم زده است.	had now put on a dress coat and white waistcoat and tie?
چنین لطفی در چنین موقعیتی و از طرف اشخاص محترمی مانند شما بسیار بزرگ است	which, on such an occasion and coming from persons of your appearance, is, it is plain to see, a very great one.
بالاخره گفتن این کلمات با صدای بلند مثل رهایی بود.پرسیدم	I asked it was a relief to say the words out loud at last.
گرد و غبار به شکل مهی قهوه ای رنگ بالای سطح زمین معلق بود و سربازان سواره که در این گوشه و آن گوشه آن ازدحام میان مردم گیر افتاده بودند از فراز اسبها همه سر برگردانده و به یک سو چشم دوخته بودند.	the dust hung in a brown haze, in which the horsemen, wedged in the throng here and there, towered from the hips upwards, gazing all one way over the heads.
با وجود تمامی آنچه انسان فانی از عهده آن برآمده بود دژ سفید و محکم پیشانی او چنان به طرف راست جلو کشتی خورد که همه افراد و الوارها به چرخ افتادند.	spite of all that mortal man could do, the solid white buttress of his forehead smote the ship's starboard bow, till men and timbers reeled.
اما باید بگویم که بر استی از آنجا نومید بازگشتم.	but I may truly say I came back disappointed.
زیرا که نیروی عمل در او ضعیف شده بود	so feeble had action become in him
او هم برایم دست تکان داد و اتوبوس در دل شب نعره زنان به حرکت درامد.	who waves back, and the bus rumbles off into the night.
اما صدای بی روح دوباره شروع به صحبت کرد	but the cold voice was speaking again
حتماً فقط برای هواخوری او نو بیرون میا ری	I suppose you just let it out for exercise
هنگام عبور ابرها را با طیف رنگ انگ عجیب خود رنگ زند.	struggled through, marbling the clouds with strange prismatic colours as it passed.
او فقط لبخندی زد و با تکان سر جواب مثبت داد.	he simply smiled at me and nodded!
باید بسیار امیدوار بود که نتیجه رصدها و مشاهدات نجومی خود را اعلام کنند	it is much to be wished, that their observations were made public
چنانکه من توانستم تشخیص بدهم در آن دستمال دلی بود مومیایی که کاملاً خشک شده بود.	in it, as well as I could make out, a heart that had been mummied, so parched and dried was it.
موجوداتی وحشی که خوی حیوانی در وجودشان بیدار شده بود.	elemental creatures whose emotions had atrophied to the subhuman.
به سیاره روشنی نگریست که تغییر مکان داده و به بالای شاخه درخت غانی رسیده بود.	, gazing at the bright planet which had shifted its position up to the topmost twig of the birch tree.
یک تکان ناگهانی از غرور و هم هوس احساس کردم.	I felt a sudden jolt of both pride and desire.
لیوانی شراب به وی نوشاندم تا حالش کمی سر جا بیاید.	I gave her a little wine.
تا آخر کلاس حتی یک کلمه هم با هم حرف نزدند.	didn't talk to each other for the whole class.
به من گزارش دهید که بین او و شما چه گذشته است	tell me what may have passed between you and her conditions which
یک دسته ترکه که از یک سر به هم بسته شده بودند با خود آورد.	carrying in her hand a bundle of twigs tied together at one end.
زیرا تو دیدی که من کاغذ را پاره کردم	besides you know very well that I tore the paper to pieces
ولی باید او را فریب داد اگر نه قهر خواهد کرد.	but I had to deceive him about it, or he would have been angry.
بک له برای آن که خود برمسندمراد مستقر گردند.	but in order to set themselves up and break away from all restraint.
ناگهان به گریه افتاد و از اتاق بیرون رفت.	suddenly she began to cry and was hurrying from the room.
چرا که به هر جهت چیزی برای از دست دادن ندارند	for he has not much to lose, after all
بعد هم با شور و شوق حساب کردند دقیقاً چه کسانی باید بیایند	the interesting employment had followed, of reckoning up exactly who there would be
بدین وسیله نشان داد که خود قصد هدایت این ستون را دارد	gave them the order to march, thereby indicating that he intended to lead that column himself.
دست دیگرش در کنارش آویزان بود و یک دستمال سفید و یک کیف ظریف توری هم به دست گرفته بود.	her other hand hanging down her side holding a white handkerchief and a reticule
من برای کالسکه سواری بیرون رفته بودم و به قدری لذت بخش بود که هوس ده به سرم زد.	I went out for a drive, and it was so fine I longed to be in the country.
روی صندلی نشستم و به عکس مات چشم دوختم.	I sit down on a nearby chair and peer at the blurry photograph
دو سوار را مشاهده کرد که رو به نهر ایستاده بودند.	two men on horseback facing the ditch.
من زیاد اهل تعارف و قلم به گویی نیستم.	I'm not much of a one for saying pretty things.
ولی معمولاً بعدش فرصت هست که از این حالت خارج بشوند.	but there is generally time to recover from it afterwards.
اگرچه او یک تن بیش نبود اما شش تفنگ در اختیار داشت.	one man, to be sure, but with half a dozen musket
این مرد دلی از آهن و فولاد و زهره شیر دارد.	his face was like marble, and his heart was like bronze
می خوام منو ببری ماشین چوب بری رو ببینم.	I want you to drive to the mill with me.
که در این ساعت از در این قلعه به درون آید	who entering the gate of this castle at this moment
یک روز حرکت دیرتر یا زودتر در نظرش بی تفاوت بود.	when he came in to see her earlier than usually, dressed to go out.
با اشتیاق انتظار فرا رسیدن آن دوران عالی و دوران زناشوئیش بود	she was looking forward to higher initiation in ideas
عاقبت آنچه را که کسان ما پیش بینی کرده بودند پیش آمد.	whereafter there befell what our party had foretold.
زیرا دوست نداشت کسی به کارهای او دخالت کند.	for he did not like any meddling with his affairs.
به خصوص وقتی که کاری از دستش ون ساخته نیست.	when you get down to rock bottom?
از ین گذشته جائی برای زورق رانی من آماده خواهد کرد.	she would provide a place for me to sail in.
ولی هیرتن جلو افتاد تا در را به رویم باز کند.	however, he moved off to open the door
زیر بار ناراحتی به کلی غیرقابل تحمل هدف توجه و تعریف همه شدن	in the entirely intolerable discomfort of being set up as a target for everybody's laudations.
که از فقرات ظهر غددی زیادتر از دیگران دارد	with a vertebra more than lizards usually have
احتیاج دارد شما برای خیاطی خوبید نه برای دریانوردی!	I reckon tailors is your trade.
تا با ایشان هستید از نخوردن و نخوابیدن خود انگشت حیرت به دندان بگزید!	what wonder is it, then, that you neither eat nor sleep while you are with them?
به همین دلیل اوتمام مدت باید تحت نظر باشد.	I'm afraid she has to be watched all the time.
دستم را دراز کردم تا پرده را بیندازم که ناگهان فریادی موی بر اندامم راست کرد.	stretched my arm to draw the curtain.
در را با فشار باز کردم و به اطراف اتاقش نگاه کردم.	I pushed open her door and looked around her room.
از بقیه هم چند نفری غیبشان زده و اکثریت پس از محاکمات علنی محیرالعقول و اقرار به جنایات از دم تیغ گذشته بودند.	of the others, a few had simply disappeared, while the majority had been executed after spectacular public trials at which they made confession of their crimes.
مثل این بود که شبحی از جوانی از دست رفته خود را به چشم دیده باشد.	he felt as if he had been visited by a ghost from his lost youth.
اسکار لت از ارابه بیرون پرید و تشکر کرد و منتظر ماند تا زن روستایی دور شود.	she made her thanks, climbed down from the wagon and watched the country woman drive off.
یکی به قصد آنکه مستقیم به آسمان برخیزد و دیگری به این نیت که خمیازه کشان به هدفی در کناره افق برسد.	one to mount direct to heaven, the other to drive yawingly to some horizontal goal.
من هرگز در عمر خود چندان وحشت نکرده بودم.	I was never in my life so terribly frightened.
برای این بود که نگذارد با کس دیگری ازدواج کند.	to prevent her from marrying anybody else.
زیرا در اطراف او هم کسی از آن نگرانی نداشت.	for none of her family bothered about it.
که از اتاق خود بیرون آمد و تمام اطلاعاتی که از وی بخواهید به شما خواهد داد	coming out of his cabin who will furnish you with every particular
راجع به طوطی هم باید گفت که در این چند هفته اخیر طوطیهائی در اینجا دیدیم	as for parrots we've seen quite a number ofthem around here in the last few weeks
کاروانسرا دار از صدای تراق و تروق از خواب پرید	at the mighty crash of this the innkeeper awoke
این خاطره تا واپسین دم به یادش خواهد ماند.	she would carry the memory of it all her life.
آنگاه بازوی او را گرفت و به زور در کنار خویش نشانید.	seizing him by the arm he forced him to sit down beside himself.
از آن نقطه تا صفه زیرین دکل طی کرد و ملوان را به دست رفقایش سپرد.	from there to the main top, where he left him in the handsof his comrades.
این جمله آخر را در حالی که زیر خنده زده بود گفت.	how I laughed and laughed!
زیرا چون همه کارهای طبیعت در آن کشور بر یک اندازه است.	because nature, in that country, observing the same proportion through all her operations.
به یک بوقلمون شباهت داشت که نیمی از بال و پرش ریخته بود.	that resembled a half plucked turkey.
من نیز بنای علی ته به لن پاشای ژانینا گریه گذاشتم.	I began to cry too
در واقع من دیگر باید شما را ترک گویم.	I must leave you now, indeed.
بیچاره به قدری که ممکن بود از برای دانتس سعی و کوشش خود را کرد	he had done all that was in his power
مگر این که مطمئن بشوم حالتان برای سوار شدن بر اسب مساعد است.	till I see you are fit to mount your horse.
ضمناً از قلعه بیگی و از حضرات وداع کنیم و هرچه زودتر از اینجا برویم!	let us take leave of the castellan and these gentlemen, and go hence this very instant.
که دفعتاً واحده چوب و ترکه ی سنتی را با وکلای مدافع و زندانهای نمونه عوض کرده ایم	that we have all of a sudden replaced the stick that served us for a thousand years by lawyers and model prisons,
از آن جا که خانه دربسته و تاریک بود	because the house was locked and dark
اما در خاطرت باشد که تا من نگفتم مزن.	but remember that you are not to strike till I give the signal.
که اگر این امر به میل شخصی من بستگی داشت	is that if the matter depended on my personal wishes
مؤدبانه سر را خم کرد و چشم را بست	he bowed his head respectfully, closed his eyes
جای شگفتی نبود زیرا دو روز بود که خویشتن را سبک بار نکرده بودم.	which was no wonder, it being almost two days since I had last disburdened myself.
من ماهی را با چنگال عوض خوردم ولی پیشخدمت با مهربانی بذون اینکه کسی بفهمد چنگال دیگری به دستم داد.	I ate my fish with the wrong fork, but the waiter very kindly gave me another so that nobody noticed.
اگر از قضا گراز ماهی هم در دریا دیدند از خبر کردن او مضایقه نکنند.	not omit reporting even a porpoise.
همه با هم چنان بینش او را نسبت به کشاورزی دگرگون ساخته بود	all this had so transformed his view of the farming of the land as he had managed it,
که او هم به نشان سلام کلاهش را با حالتی جدی از سر برداشته بود.	who, however, had raised his hat with mild gravity.
پس از مدتی موجب یأس و دل تنگی هری شد.	it did become a bit depressing after a while.
در نتیجه دو لهستانی هم در میان خندهٔ حضار تالار را ترک گفتند.	with damaged reputations, amidst laughter from the public.
مثل پیروزی در نبردی بر علیه دست آهنینی بود	was like a war won against the steely fist
او اینک بعد از دو بار تلاش ناموفق خود را به روی الوارها کشانده بود	after two unsuccessful attempts had managed to climb on the raft
با صدائی دگرگون گشته و خشمی کینه پرورد شروع به سخن کرد	spoke with a new tone of authority.
مارتین گفت دو سال مو نده بود که مدرسه را ول کردم.	I had two years to run, when I left, he answered.
برای خودم قابل قبول نبود که من نام او را به آسانی بر زبان جاری بسازم.	I could not believe that I had said the name at last.
برای یک مدت به حد کافی جنگ و جدال دیده بودم.	I'd had enough fighting to last me for a while.
اندیشه ای که وی در تنهایی روستایی خود آن روا ورزیده و از هر لحاظ سنجیده بود.	which he had brooded over in the solitude of his village, and had considered in every aspect.
آن وقت مردم شتابان بیرون ریختند تا در کنار در دادگاه بایستند	then the crowd surging out but only towait at the courtroom door in order to glimpse
من در پس ستونی در تاریکی خود را مخفی کرده	I was concealed by a column
چند دفعه قبل از ازدواجم به خاطر مستی افتادم تو هلفدونی ولی هیچ وقت به هم دستبند نزدند.	I was picked up and throwed in the drunk tank a couple of times before I was married, but never was I cuffed.
چکمه های بلند و براقش با مهمیزهای بسیار بزرگ	the high shining boots with enormous spurs
خالی که از سکنه و نه گمرکی دارد و نه قراولی	which being completely deserted and having neither soldiers nor revenue officers
اما در این لحظه حاضر بود به هر کسی متوسل بشود.	but at this moment she felt ready to take on anybody.
هم به خاطر حمل و هم به خاطر پخش.	transportation as well as delivery
هنوز ظهر نشده وال مرده را به کشتی کشیدند.	ere noon the dead whale was brought to the ship.
دو ستون نامشخص و مبهمی را دید که دو تا پا بودند.	watched two dim blurred pillars that were legs.
این که یک همچو باد و توفان و رعد و برقی راه بیفتند	the getting up such an expensive thunderstorm as this
از بالای یک بام خودم را پا ین انداختم و اکنون اینجا هستم.	I let myself drop from the top of a roof, and here I am.
که اگر نگویند محبت چشم مرا کور کرده بود	that unless my affection for her were deceiving me
به طوری که بعدها فهمیدم او را به اطاق بیماران تب دار به بالین یک مریض هذیانی خواسته بودند.	I knew afterwards that she had been called to a delirious patient in the fever room.
برای اینکه تا امروز در اتاق کار خانم هرگز چیزی نشکسته بود.	I don't think we have ever had any breakages in the morning room before.
سرانجام مرا نیز به تباهی و نیستی خواهد کشاند.	he'll be my ruin.
در حدود بیست نفر از صفوف مختلف پیش دویدند.	from the different ranks some twenty men ran to the front.
هنگامی که من دست بر پهلوهای ناهموار آن نهادم	when I laid my hand on its rough sides.
اما افسر فرانسوی حاضر نبود این سخن را بشنود.	but the officer would not hear of it.
کلاید به اکراه نشانی خود را داد چون از مقایسه مسکن خود با خانه سوندرا بیمناک بود.	an address which he gave reluctantly enough, since it was so different from the street in which she resided.
گفتم که او سلام رساند و گفت که برایش پیشرفتی حاصل شده است.	I informed her that he sent his compliments, and was getting on very well indeed.
در آن دو صندوق هرگز باز یا بی قفل دیده نشد	wherein the two black boxes were never seen open or known to be left unlocked
شرایط درهم کشور او را مجبور به استفاده از مست حفظ کرده و هزینهء این استحفاظ را نیز خود پرداخته است.	in charge of an escort which the disturbed state of the country had imposed upon him, and which he had paid for.
به خصوص وقتی که اجباری یا تعهدی در آن نباشد	more especially when they are things which we are not forced or compelled to attempt
ولو توجه به این مطلب نکنند که من مطیع و مجری فرمان کس دیگری هستم و به قول معروف بر رسولان پیام باشد و بس.	if they did not see that I am under orders, and that 'you are a messenger, my friend, no blame belongs to you.
چندین روزه که تو غار بالایی منتظرم و نمی تونم باها تون تماس بگیرم.	I have been waiting in the upper cave for many days, incapable of contacting you.
به دیری که او بد آن پناه برده بود رفت.	he arrived at the place where she was
هیچ داعیه به دست دادن وصف دقیق تشریح انواع مختلف یا دست کم در اینجا به دست دادن هر گونه وصفی را ندارم.	I shall not pretend to a minute anatomical description of the various species, or in this place at least to much of any description.
پس از چندی از دور لکه سیاهی را مشاهده کردم.	when I saw a figure, or large bush, or at least something black ahead of me.
چو ان امکان داشت که در یک لحظه غفلت چشمانش را از کاسه درآورند.	who in a careless moment might peck out her eyes
لبخندی که بیش از اندازه مهرآمیز بود بر لب داشت.	flushed and beaming with a more than cordial smile.
به فکر این بیفتد که مرا از میان بردارد.	make an end of me.
من به او گفتم بگذار دش توی انبار یخ.	I advised her to try putting him in the ice cellar.
من فقط کسی هستم که این ماموریت ناخوشایند بهش محول شده که اخبار رو به تو بده.	I'm just the one who has the unpleasant task of breaking the news to you.
پس از پایان سرود دامبلدور نیز مثل سایرین با شور و شوق به کف زدن پرداخت.	when they had finished, he was one of those who clapped loudest.
این پرونده اکنون به قدری برایم روشن شده است	the case has now been so entirely cleared up
او مناظر آن سرزمین را به من نشان دهد	show me the country
طوری افتادم که سرم به در خورد و شکست.	I fell, striking my head against the door and cutting it.
بلکه تماس بدنی لازم است که غیر از زن و شوهر برای افراد دیگر مجاز نیست.	some sort of physical contact absolutely forbidden between any but a married couple.
این بود از این همه اطعمه لذیذه که به ما خورانید خود به هیچ وجه چیزی نخورد.	of all the exquisite things he placed before us, he touched nothing
با دست دیگر یک سگ بولداگ پیر و بد اخلاق را بغل گرفته بود.	tucked under the other was an old and evil tempered bulldog.
ممکن نبود که از سیمای او ما فی الضمیر او را استنباط کرد.	it was difficult to read the expression of her face
بلکه رف خشن و چهار دیوار و کاغذ مقوایی که روی آن شکل مردی را در حال زدن وال کشیده بودند.	but a rude shelf, the four walls, and a papered fireboard representing a man striking a whale.
ولی هنوز بیشتر موهایش که تمیز و مرتب زیرروسری توری او بودند سیاه بود.	but there was still plenty of black left in that sensibly netted head of hair.
لازم نیست ادم نآبغه با شه تا بتونه اینو تشخیص بده.	you don't need to be a genius to tell which one's the better flier!
مایه هراس این بود که کنش آن مرد به احتمال زیاد ناآگاهانه بود.	what was frightening was that the action was quite possibly unconscious.
من که نتونستم پو له را به هیچ قیمت پس بگیرم.	I couldn' manage to k'leck dat money no way
چون به سبب جهل و حماقت این اشخاص موژیکها را نشان داد به وضع دشواری افتاده است	finding herself in difficulties owing to the boorishness of these people
شخصی به او نزدیک شده و کاغذی به او داد	a man approached and gave him a letter.
تا آنکه دختر عمویش با لحنی بسیار خودمانی با اعضای خانواده خود شروع به صحبت کرد.	until she proceeded most familiarly to address her family.
آنگاه با یک دست کمرش را گرفتم و از زمین بلند کردم.	then I went to take her up with one hand by the waist.
اما درباره آن دختر گفته بود نمونه زیبایی است.	but he had said of that particular woman
باعث خوشحالی من خواهد شد اگر اجازه بدهید یک نوشیدنی برای شما بگیرم.	I would feel much better if you would permit me to buy you a drink.
ببین این جادوگران چه کینه و عنادی با من دارند	thou seest how I am hated by enchanters!
ولی سرش به طور نامطبوعی مثل یک عروسک خیمه شب بازی آویزان بود.	head still lolling unpleasantly, like a grotesque puppet.
مرا از آنان دور کرده بود و رفاقت کردن و تفاهم داشتن بین ما بسیار دشوار بود.	I was much farther removed from my companions than in what I did not.
لازم است بین آقا و نوکر و ارباب و رعیت و پهلوان و مهتر فرق قایل شد.	there must be a difference between master and man, between lord and lackey
خونی را بر زمین ریختند که حق نداشتند بریزند.	they shed blood they had no right to shed.
برای نخستین بار در زندگی لحنش تفقد آمیز شده بود.	for the first time in his life alittle condescendingly.
پیش از بسته شدن در بزرگ قبرستون تابوت به قبرستون خواهد رسید.	before thegates of the cemetery are closed.
او همان لباسی را که دو روز پیش هنگام ملاقات پدرش در صومعه بتن داشت در بر کرده بود.	just as he had been three days before at the elder's, at the family meeting with his father and brothers.
جواب این است که نیستم و ابدا نخواهم بود.	I am obliged to you, count, for this pleasing intelligence!
اما از کمی مواد و مصالح موجود یعنی ذخیره خیار شکایت داشت	but he complained that his stock was low
چنان محکم که او را به دیوار مقابل کوبید.	with such force it knocked him into the wall opposite.
بی آنکه سرنشینان قایق را ببیند و منتظر است او را به سوی خود فراخوانند.	not discerning the forms, but expecting the summons.
غیر از آن سه نفر بقیه روی زمین افتاده بودند.	everybody else was on the ground.
خانوادهٔ ژنرال مرکب از همسرش و سه دختر بزرگش بود.	consisting of his wife and three grown up daughters.
فقط یک رایحه ضعیف مشک بار از بوی گرگ	just a faint, musky trace of wolf odor
در نتیجه آن شب در حدود هزار نفر در میتینگ شرکت کردند	with the result that about a thousand of them were on hand that evening.
جایی که دست کم او هرگز در قلمرو و نفوذ این مرد نباشد.	where, at least, she will never be HIS vassal.
لکن چون انگشتر را به او فرستادم فورا مرا به حضور طلبید	but I sent the ring I had received from the captain to him and was instantly admitted
این چپر بود که از پیشروی ما ممانعت کرد	that gate stopped the flow of the excitement.
به دنبال مستخدمه به راه افتاد و به ایوان حیاط خلوت رفتند.	when the maid led him through the darkness of the drawing room to the terrace in the patio
من دست کاترین را گرفتم و از اتاق بیرون بردم.	I led my young lady out
گیس من پیرزن را هم با غصه توی قبر بگذار.	ruin himself and bring her gray hairs with sorrow to the grave
وی متوجه شده بود که میان طبایع و تمایلات فطری ما و یاهوها مشابهتی وجود دارد.	he found as near a resemblance in the disposition of our minds.
تمام بدنم از جای کمربند الف داغ شده بود.	I was all over welts.
عیان بود که همسرش تمامی روابط خود را با شوهر قطع میکرد و سرنوشت خویش را با معشوقش پیوند میزد.	it was obvious that the wife broke off all relations with the husband and threw in her lot with the lover.
تا حالا هیچ وقت این قدر دوست نداشتم جایی بروم.	I've never wanted anything so much.
با خودم فکر کردم بهتر است تنهایش بگذارم تا خودش با آن مشکل کنار بیاید.	I thought it best to leave him alone for a bit to get over it.
میدانست که حتی یک گنجشک کوچک کجا از درخت خواهد افتاد.	where the smallest sparrow had fallen
پیمان عشقی که در اثر مهر و محبت به مرور زمان و مواجه شدن با شرایط غیرعادی تکراری بر استحکام آن افزوده شده بود.	with a passion that the passage of time and the more and more unusual circumstances deepened and enriched.
معادنی که در ایام طفولیت خود در سفری به گجرات و کلکته برایش دست داده بود مشاهده نموده بود	which he could just recollect having visited during a voyage made in his earliest youth
که زندانی را به جرم ارتکاب جنایتی که به آن متهم شده است محکوم کنید.	that you jurors must find the prisoner atthe bar guilty of the crime of which he stands indicted.
همین یک ماه پیش برای خودم نیز اتفاق عجیبی افتاد.	an odd thing happened to me about a month ago.
گویی تعریف رز ماری از او کاملاً رسمی بوده است.	as if the compliment were purely formal.
هرگز قبل از آن تاریخ آن را ندیده بودم.	I had never noticed before.
ای نبدبخت دیو سار جسد بچه مرا هم برد.	he carries away the body of my child!
سعی کردم این را به یاد آورم درد را به یاد آورم ولی نتوانستم.	I tried to remember thisto remember painbut I couldn't.
من پیش از ین در چند مورد به آن عالی جناب گفته بودم که بسیاری از ملاحان ما از بیماری در گذشته بودند.	having, upon some occasions, informed his honour that many of my crew had died of diseases.
تنها کاری که توانست بکند این بود که با انگشت به او اشاره کند و سرش را تکان دهد	she could only point a finger at him and laugh quietly
من برای محافظت از دنیا زیادی پیر و خرفت شدم.	I'm too old and senile to protect the world any longer.
مشروط بر اینکه این یکصد و پنجاه مجلد را از روی علم و قاعده انتخاب نماید	if not a complete summary of all human knowledge at least all that a man need really know
اگر به او اطلاع نداده بودم که صحیح و سالم هستم و خیالش را آسوده نکرده بودم	if I had not set his mind at rest about my safety.
با نام مستعار در شهر مانده است بیش از همه سروان را متعجب ساخت.	but remained there concealing his name and station.
حتی شاید به منظور دور نگه داشتن این شبح و در بستن به روی تصویر	if not even to keep him off and shut out the sight of him,
نه مسی و یک نفر گدایی را به شما تقدیم خواهم کرد.	I offer you a beggar, my lord.
چنان او را زد و کوبید که دیگر نایی برایش نماند.	had beaten and pounded him into exhaustion.
او به تجربه دریافته بود که انتخاب طبقه و اتاق و سوئیت دریک هتل به همان اندازه انتخاب خود هتل مهم است.	having learned that often the selection of the hotel accommodations was as important as the hotel itself.
فرصتی نبود تا آن همه طومارهای طویلی را بگسترد	there was no time for the smoothing out
اسم برخی هم بر روی بستة اشیا یادداشت شده بود.	other names are on the wrappers of the pledges
اما چون من قیافه جدی به خود گرفته بودم بالاخره راضی شد که اشگهایش را پاک کند.	but as I began to look very grave, she consented at last to wipe them.
که نایب اول او در اعماق روح خود از آرزوی ناخدای خود وحشت دارد	still he knew that for all this the chief mate, in his soul, abhorred his captain's quest
آخر من تنها چیزی هستم که او دارد .	for I am all he has.
پا را روی نیمکت قرار داد و روی میز نشست	got his feet upon the form close by, and sat upon the desk.
با خودم فکر کردم مشغول گرم کردن پشتم هستم.	I was making believe to warm my bum
اگر افسر شجاعی بود بی شک بدرد من خواهد خورد.	he'll be of use here if he's a brave officer
دهانشان به هنگام فریاد زدن از ریخت افتاده و چشمانشان بر اثر هیجان و کمبود خواب مات و خیره بود.	all awry with howling, and all staring and glaring with beastly excitement and want of sleep.
تازه مادر ابی گیل قابل مقایسه با مسیح نبود. به هیچ وجه.	she wasn't up to that snuff, no how, no way.
لکن اکنون مشار الیه کاپیتن شده و به کسی احتیاج نخواهد داشت	but now MDantes has no longer any occasion for assistance he is about to become a captain
اما به نظر من رویه مرفته این مبحث ناقص بود.	but, as I conceived, not altogether complete.
در هنگ همه او را دوست دارند و پاپاجانش هم از او راضی است.	how popular he was with everyone in the regiment, and how satisfied his father was with him.
من باید قبول کنم که چنین پیشامدهایی واقعاً ممکن است.	I must admit, that such cases certainly must arise.
من درست حدس زده بودم. پس داستان خود را برای ما شرح دهید.	I've guessed let's have the secret!
بلکه مرا به محکمه عدالت بکشند و گناه مرا مدلل سازند	but a verdict a trial sir I ask only for a trial
بلکه خودش هم در استمداد عاطفی و نیز در شگرد اولش ناکام مانده است.	but that her technical as well as emotional plea had failed
آن دو در این عقیده متحد بودند که دلائل عرضه شده روی هم رفته غیر کافی هستند.	both messmates of mine in a certain voyage, and they united in the opinion that the reasons set forth were altogether insufficient.
خود اِما هم تحت تأثیر احساس آقای نای تلی قرار گرفته بود.	she was herself struck by his warmth.
منظره ای واضح و روشن از قله های تاریک که دامنه های پرشیبشان بر ستونی از درختان جنگلی قامت بر افراشته از لبه ساحل استوار شدهاند.	a clear cut vision of dark peaks rearing their steep slopes on a lofty pedestal of forest rising from the very edge of the shore.
من تا وقتی سوار قطار تندرو نشدم تا برگردم نتوانستم نفس راحتی بکشم.	I didn't draw a deep breath until I was on an express train coming back.
هرگاه او تب دارد گناه آن بر من است.	I am responsible for his fever.
گاه گویی چند یارد بیشتر با ما فاصله نداشت.	sometimes it might have been within a few yards of us.
بخشی از من در این فکر بود که باید ساکت باشیم	part of me thinking we should be quiet
با سرعت دستم را گرفت و با همان سرعت هم آن را از دست خود رها کرد.	hastily took my hand, and as hastily threw it from him.
باید رمزی در این خانه یا نحوه ساختمان آن نهفته باشد	there must be something about the house, or the way it was built
لیکن با سکوتشان در برابر گرما آن دو گروهبان خیلی از مرز تحمل خود فراتر رفته بودند.	but by this silence the sergeants went far past their bond.
گویا تب مالیخولیایی شوهرش به او نیز سرایت کرده است.	as if she had contracted her husband's hallucinating fever
سپس پر کاهی ریز که به بزرگی چو بدست بود برگرفت	took a piece of a small straw, about the size of a walking staff
مخصوصاً مکتب شرعیات و اصول دین را به خوبی یاد گرفته بود	was a very dragon at his catechism
ولی در همان موقع وی دست از ناسزا گفتن و تهدید کردن برداشت و به من امر کرد وارد شوم. پس از اینکه به درون رفتم وی در را بست و چفت آن را انداخت.	but ere I could execute that intention, he ordered me in, and shut and re fastened the door.
چنین به نظرم رسید که مرا کام لا شناخت. برای آخرین بار دست او را فشردم.	I think she recognized me, for she pressed my hand.
تا نگهبان نیز آن را به مقامات بالاتر بانک برساند	who was to deliver it to greater authorities within
در فرمان دیگری افراد مسن را وادار کرد تا یک بازوبند به رنگ قرمز به بازوی چپ خود ببندند.	made men who were overage wear red armbands.
نو لو ینی یا سن تینتی لار ای النی	nu luini yassen tintilar i eleni
هیچ وقت ندیده بودم یا نشنیده بودم که بالاپوشی به این قشنگی وجود دارد.	I have never seen or heard tell of one so fair.
من لبخندی زدم و مثل روزهای کودکی از دستورش اطاعت کردم.	I smiled and obeyed her as in bygone days.
به کنار کیلسایی که در امتداد این دهکده آرام قرار دارد رسید.	turned down the hill by the church of the quiet village
پسر عمو نیز تقریباً همین دعاها را برای دن کیشوت کرد.	the cousin offered up almost the same prayers and supplications.
تا عذاب مرگ را به بهترین نحوی تحمل کند.	to endure the suffering as lovingly
بعد وسط کیف لوازم زائوها و لباس زیر بچه سر درآورد	next got among the accouchement sets, and baby linen
مرد آواره و سرگردان فرتوتی که تقریباً دویست سال عمر داشت	as ancient vagabond who was almost two hundred years old
با آجرهای تازه و خوش رنگ خود در میان آن محیط خراب درخششی خاص داشتند.	the fresh red of new brick glaring bright against the smut of the old walls.
به اتقاق جالب دیگری که اتفاق افتاده بود فکر کردم.	I considered another interesting phenomenon
که آن الفاظ را مردی بیگانه که سر راه ما ایستاده بود	when the above words were put to us by a stranger
حکم آن داشت که شصی سخت ناتوان را از اغما به درآوردند	was like recalling some very weak person from a swoon
فریادی کشید و از خشم پایش را بر زمین کوبید.	she cried again, losing her temper and stamping her foot.
سپس دو هفته بعد برای دومین بار از او دیدن کرد.	then he had visited him once more, a fortnight later.
که از صیاد وال برتر است پایش به هیچ پایگاه استواری بند نیست.	in that assertion the pirate has no solid basis to stand on.
ولی تا پدرش بیدار شد اِما فهمید که باید ظاهر شاد خود را حفظ کند.	till her father awoke, and made it necessary to be cheerful.
چون قیچی سانسور هرکجا که نام محل یا هنگی برده شده بود یک سوراخ مستطیل تمیز باقی گذاشته بود.	because the censors scissors had filled it with neat rectangular holes, once the names of places or regiments.
از کجا معلوم شاید همین سوندرا عاشقم به شه.	mayhap, who knows, even fall in love with him.
با چنان لذت و تحسینی هم خواند که همان اول کار به خاطر هیجان و احساسی که دچارش شده بود سرش را تکان داد و فکر کرد چه قدر احساسات خود را دست کم گرفته بود.	she read it with a degree of pleasure and admiration which made her at first shake her head over her own sensations, and think she had undervalued their strength.
آنجا کام لا درازافتاده و نیرویش را از دست داده بود.	there he had stretched himself out at full length, and there his strength had failed him.
بالاخره او در را پشت سرش بست و آهسته اهسته دور شد.	as he shuts the gate behind him and walks slowly along the street.
بر اثر درس دادن به کلی خسته و فرسوده شده است.	is wearing himself out giving ill paid lessons.
من تو را دوست دارم چنان که عمر و زندگانی خود را دوست دارم.	I love you as my life
با ورود او یک نفر به جمع آنان اضافه شد .	took up her residence with her brother, crowding the occupants of the little house.
چند عدد گل نارنج و چند نخ گلابتون در درشکه دید که معلوم بود عروس در درشکه سوار شده است.	a few stray petals of orange blossom and scraps of wire bore witness to its recent occupation by a wedding party.
متروک بود پس از آن زمان رو به دگرگون شدن نهاد.	was tending even then to transformation.
در حضور رئیسه محترم دیر یک خطابه روستایی بلند بالا و بسیار عمیق ایراد کرد.	entered into a rather diffuse and very deep rustic harangueto the reverend prioress.
برای بازگشت به میهن به کمک شما احتیاج خواهیم داشت!	we should want you to help work the vessel home.
پایم را از آستانه در به آن سو گذاشتم.	I stepped over the threshold.
که دین انسان یک چیز است و این دنیای عملی چیزی دیگر.	that a man's religion is one thing, and this practical world quite another.
این جریان به قدری آهسته اتفاق افتاد که مات یلدا به سختی آن را تشخیص داد.	then, very very slowly, so slowly she could hardly see it happening
پی نهاد کرد که پیش از ریزش باران به سرعت به خانه بازگردند.	that they had better be going home before it rained.
احساس کرد خداوند سعادتی به او مرحمت فرموده که از هر لحاظ با نیازهایش هم خوانی دارد.	feeling that heaven had vouchsafed him a blessing in every way suited to his peculiar wants.
یادم است که یک روز غرق در یأس و ناامیدی آمد پیش من.	one morning, I remember, he came to me quite in despair.
برعکس جناح چپ ما بر جناح راست دشمن تفوق دارد	while we, on the other hand, with our left wing by far outflank his right
برای مرتبه سوم در سکوت کامل شب باز به هوش آمد.	when he came to himself a third time it was in the complete stillness of the night.
اما این تابلوها حتماً بیشتر از کار شما برایم قابل درک است.	but I should learn to understand these pictures sooner than yours with the very wide meaning
پیراهن سیاه کوچولو و همه این چیزهای عزیز را نگاه کرد.	he gazed at the little black gown and all those beloved objects.
چون اسیر خواست آن دو قطعه شعر را بخواند	when he came to speak of the sonnets
سپس بقی کردن افتادم و حالم بسیار تسکین یافت.	then I fell a vomiting, which gave me great relief.
سرم را به سمت تابلوی آبی کج کردم .	I tilted my head toward the blue one.
با وجود بدن به پارچه پیچیده و درد شدید پهلو راست روی تختخواب خود نشست	sitting up in his bed in spite of his plasters and the pain of his ribs
هیرتن نیز بدون درنگ به دنبال کاترین از اتاق خارج شد.	her companion lingered very little behind her
در حینی که بانوان هم متحیر بودند و هم به دقت گوش فرا داده بودند	as they were all attention, wondering
آ ره. آنقدر هلش دادم تا یه چیز خوبی برای کشیدن پیدا کنم.	I wheeled it until I saw something I wanted to paint.
بفرمایید تا مرا به در خانه خودم فرود آورند	put me down at my door
ظروف نقره در آن نور کم چه تیره بودند !	noting how dully the massive silver gleamed in the dim light
دست در جیب و با چشمانی به تحقیر تنگ کرده	stood with his hands in the full curve of his pockets
گویی کام لا مطمئن است که هرچند با او آشنا نیست مورد پسند او واقع شده است.	to be so sure he admired her, and not to be acquainted with him.
ولی فعلا بهتر است که نظم و ترتیب گزارش مرا به هم نزنید و سخنان مرا تعقیب کنید.	but for the moment I would rather not anticipate.
رئیس رسیدگی به دو موضوع ساده را در این روز مقرر داشته است.	the president had appointed for the same day two short and simple cases.
تا حدی هم با نواختن ارگ در اقامهٔ نماز شرکت داشت	he served it in a sort of way, for he was an organist
آنگاه بدنش سوراخ سوراخ بود و دریای پیرامونش به رنگ صورتی درآمد	then he was full of holes and the sea round him turned pink
اما شکل آن خلاف انتظار و برای او ناگوار بود.	but the form of it was unexpected, and particularly disagreeable to him.
پای راست شلوارش از زانو تا قوزک دریده بود.	the right trouser leg was ripped from knee to ankle.
بعد دویدم آن طرف اتاق و پشت در قایم شدم.	then I run back across the room and in behind the door.
یا تا پایان عمر نگاه دلسوزانه دوستان خود را تحمل کنند!	or forever endure the eyes and sympathy of their friends!
سخنان آقای لاری در او همان تاثیر را بر جای می گداشت که در دیواری یا بر پشت نسیمی.	words fell on him as they would have fallen on an echoless wall, or on the air.
من هم تقریباً مایل بودم که یک معتقد بشوم.	I was almost willing to become a believer, too.
چون پیش از آن نیت خود را به اینکه آن غول آدمکش را شخصا شکار کند اعلام کرده بود.	for he had already revealed his intention to hunt that mortal monster in person.
آن چهار چوب موازی که پنج بند انگشت بلندتر از دستمال شده بود از هر طرف به شکل لبه و دیواره درآمد.	the four parallel sticks, rising about five inches higher than the handkerchief, served as ledges on each side.
ای مرد نیکوکار بداد من برس و مرا نجات بده!	father, save me, save me, let me have some camellias!
که از عالی جناب مطران یک روز مرخصی که با نظامات سخت این دیر محال بود خواهد گرفت.	that she would askfor a day's leave of absence an enormity in so austere a community.
150000سهم و جائی در هیئت مدیره را احراز کرد و قرار شد که تا پایان عمر مدیریت املاک لاستیک را بعهده داشته باشد.	received 150,000 shares, a place on the board, and managership during his lifetime of the rubber estates.
من اصلا دلم نمی خواد ار پیش شما برم. اصلا.	I I have no wish to leave you, none at all
کسی هم او را در فراموشی این اندوه یاری ننمود	no aid had been given in change of place
من نگهبان منافع شما خواهم بود. و تند تر در دهلیز به راه افتاد.	I will look after your interests, and went still faster along the passage.
به این امید که آنا دست خود را روی دست او بگذارد.	hoping she would lay hers in it.
به آن اتاق رفتم تا علت بازگشت خود را بگویم و شمع بگیرم.	I passed on there, to say what I wanted, and to get a candle.
که همان دوره قبل از دوره تشکل سطح زمین باشد.	which is the last preceding the superficial formations.
اون بیچاره احتمالاً الان توی آشپزخونه داره نفس نفس می زنه همم.	she's probably hyperventilating in the kitchen right now.
چون پی برد که با چه سفاهت غیر قابل بخششی رفتار کرده است	perceiving how foolishly he had acted
چاله بزرگی کند و آن را به همراه قفسش به خاک سپرد.	dug a deep hole, and buried it, still in its cage.
بیشتر آنان پیوسته در این فکر بودند که اگر بدین کار یکنواخت نیازی نداشتند	they were for the most part thinking of them selves always and what they would do
ما پزشک را به حال خود گذاشتیم تا سگ را با همان عمل دوباره زنده کند.	we left the doctor endeavouring to recover him, by the same operation.
اگر هم شخصاً بیاید شاید با دفت تمام از ملاقات من پرهیز نماید.	or he may come himself, and studiously abstain from meeting me
منهی چ وقت نشن ی ده بودم که شی ط انی با این راه فراخوانی به شه.	I never heard of a demon being summoned that way.
فقط باید راه بروم و امیدوار باشم که شانس بیاورم اقبالی کور و راه را پیدا کنم.	I just have to keep walking and hope that I eventually find my way out by blind luck.
با این شرط به آنجا برگشته بود که برایش نگهبان بگمارند.	had agreed to return to her job only on condition that she was given extra protection.
پس روی بر زمین افتاد و دوباره بلند شده	he murmured, and fell with his face to the ground.
چون در تن من دیگر آن تاب و توان نیست که شادی همسری ترا تحمل کنم	for I have not now the strength left either to bear the happiness thou givest me in accepting me as thine
زمین به برهوتی تیره و قاچ قاچ بدل شده بود	the ground a dark cracked waste lightened
مثل این که مادرش را از شیشه ریخته باشند.	as if she were cut glass.
بسیار خوشحالم که به مسکو آمدید و در خانه من اقامت کردید.	I'm heartily glad you have come and are staying with me.
اما چنان خواب آلود بود که بار دیگر فوراً به خواب رفت	he was so sleepy that he fell asleep at once.
اهالی آن نیز از همان شادابی و سرخوشی برخوردار بودند.	the same cheerful serenity prevailed among its inmates.
پس از آنکه چندین بار تعارف کرد دیدم که بهتر است آنچه گفته گوش کنم.	after offering it to him several times, I thought it best to do.
اقلا دیگری داشته باشیم چیزی که به کلی محتاج نگردیم.	the other would still have hers left.
نتونستم جلوی غرش کوچکی رو که از دهانم خارج شده بود رو بگیرم.	I couldn't hold back a small snarl of my own.
اتفاقی پیش او مد که فکر کردم برگشتنم قطعیه.	the means for my return seemed assured.
برای تأیید فرمانی که فلد مارشال صادر کرده است دستور کتبی داشته باشد.	to have written confirmation of the order the field marshal had given.
پسربچه که بودم یک دوره آن جا زندگی کردم	I lived there once, as a small boy
تا او راز مرد محبوس در قفس را با بسیار چیزهای دیگر که موجب سرگرمی او خواهد شد به وی بگوید.	so that he might tell him the mystery of this man in the cage, and other things that would amuse him.
لذا برای آنکه بداند با آن دست چه بکند فکری کرد	making up her mind what to do
آتش زیر خاکستر سرزندگی و آگاهی بر جاذبه ی خویش.	of the suppressed fire of vitality, and the consciousness of her own attractiveness.
آن طبیب حاذق بنابر علم و معرفتی که داشت ما را مطمئن کرد که این مطلب امریست بسیار ناچیز و در خور اعتنا نیست.	the doctor assured us, from his own knowledge, that it was a perfect trifle.
الساعه خواهم رفت و خودم هم یقین داشته باشید مزاحم شما نخواهم بود.	I'll go directly and you may be sure I won't be in your way.
اما خوشبختانه برادرش در مقایسه با بقیه واقعاً ممسک است.	the same happy conviction of her brother's comparative sobriety.
عقیده من آنقدر راسخ است که از اظهار آن به شما دری ندارم.	but I feel it so deeply that I'll tell you what I think.
از ما زه سمت راستش چند زوبین بیرون ایستاده بود.	harpoons sticking in near his starboard fin.
با سرعت از پشت سنگ قبر بیرون آمد و به دویدن ادامه داد.	he dashed out from behind the angel
دفتر راهنمای شهر را خواستم و در آن به فهرست نانواها نگاه کردم.	I called for a directory and looked out the bakers.
تنها ارتباطشان با دنیای خارج از طریق همین کلمات مکتوب بود.	their only contact with it was through the magic written word.
اگر چه محال بود که معنی آن را حدس بزنم.	although it was impossible for me to conjecture what it meant
که بسیار دیدن دارد یکی این است که این پیر زمین گیر عاجز	to witness this old man, apparently a mere useless burden
سپس هر دو در آن واحد شروع به عرعر کردند	it so fell out that they brayed almost at the same moment
این کلمه بر حسب تصادف به ذهن من آمد.	I said it accidentally, but let the word stand
از آن غم و اندوهی که به شاهزاده خانم روی آورده بود سخن گفت	speaking of the princess' sorrow and making herself a partner in it.
هر جا باشد از دل و جان خدمت گزار خواهد بود و پهلوان را ولی نعمت خود خواهد دانست.	that wherever she might be she would serve and esteem him as her lord.
سپس نگاه کردم و دیدم که آن جزیره سراسر از جزایر سنگیست	I found the island to be all rocky
گذشته از این با آنکه او تقریبا کودک است چندان بی معلومات نیست.	besides, he's a regular child, though he seems to be fairly educated.
در کیفش باز و پر از اشیاء مختلف بود.	was open and nearly full.
من نمی دونم کی یادش داده بود ولی چند دقیقه بعد یک بطری براندی خرید	I don't know where she got the notion but some time in the afternoon she got a bottle of brandy
به چه شکلی در آینده خود را به عقد او درآورد.	as well as marriage in the future.
متوجه شدم که ون کثیف بود پوشیده از گِل.	I noticed then that the van was filthy'thick with dirt.
من سعی کردم که خشم را به طور کامل از بدنم خارح کنم.	I tried to erase the anger from my system entirely
هم به زعم خودش دامن خویش را از این آلودگی دور نگاه دارد	hence by implication to clear his own skirts, as it were
شاید با بعض فرضیات دادستانی کل ناسازگار نباشد تا حدی به تفصیل شرح دهیم.	which is not lacking in coincidence with certainconjectures of the indictment.
خودتان از پنجرهٔ اطاق صدا بزنید او داخل اطاق خودش شد.	go and call to her yourself from the study.
اگر هم اشتهایشان را از دست داده باشند که چه بهتر!	if their appetite too, so much the better!
سعی کرد خوابی را که دیده بود به خاطر بیاورد.	tried to remember the dream he had been having.
ببین چه جوری از گریه کردن تو متأثر شده است.	see how sorry she is for you!
دویست فیل و ششصد شتر و بیشتر از دو هزار خر بندری که بارشان الماس است همراه دارند.	two hundred elephants, and six hundred camels, and over a thousand sumter mules, all loaded down with di'monds
قیافه زشت و ناپسندی پیدا کرده چون طفل شیرخواری شروع به گریستن کرد.	making her look quite ugly, and she began to wail like a baby
به قصد آب دادن به قاطرهای خود به چاه نزدیک شد	came with the same object of giving water to his mules
به همین خاطر نیرویی برایش نماند از خود بپرسد	left her no energy to spare for the question
اما درون قلعه سرشار از نور و شادی و شعف بود.	but inside all looked bright and cheerful.
مشروط بر اینکه قیمت مناسبی برای آن پرداخت شود.	if the price was right.
تا سرانجام نگبهانها بر سرش ریختند و او را به سلولی در بخش دیگری از زندان بردند تا بلکه در آنجا عقل خود را باز بیابد.	eventually he was overpowered and removed to a cell in adifferent part of the building to be observed as to his sanity.
که دو ساعت بیش نبود که از آنجا رفته بود	who had left him only two hours before
من بسیار مایلم که به چنین سرنوشتی دچار شود تا دیگر او را نبینم	I shall be glad to have him away from my eyes
آن چه او بر استی به آن نیاز داشت نه پیروزی بلکه جریان داشتن نبرد بود.	that what he really needed was the process of war more than the outcome of victory.
اما در دل از سرسختی وحشتناک این موجود مهربان در شگفت بود.	but he secretly wondered over the terrible tenacity of this mild creature.
در میان انبوه سربازان با عجله به راه خود ادامه داد.	still entangled in the crowds of soldiers.
اما ناگهان صاحب قهوه خانه بازویش را محکم گرفت و سیل کلمات خشمگینانه را بر سر و رویش بارید.	but the owner grabbed him and began to speak to him in an angry stream of words.
مادرم من نماز خواهم خواند و طی نمازم غم و تأثر تو را منعکس خواهم ساخت و همچنین برای سلامتی شوهر تو دعا خواهم خواند	I will remember him, mother, and your grief in my prayers, and I will pray for your husband's health.
من می دون ستم که شما تو جنگ بودین .	I knew you were in the war.
قبلا به شما خبر می دم که میخ وام حمله شدیدی به شما بکنم.	I warn you that I am going to make a scene for you.
باز با لحنی عادی شروع به توضیح دادن کرد.	he began to speak again in a tone of mere explanation.
چرا که من بسیار دوست داشتم دوباره با او سخن بگویم.	for I much desired to speak with him again.
کنیزکی مأمور پوشاندن لباس و دو خادم دیگر مأمور کارهای ناچیز او شدند.	a maid to dress her, and two other servants for menial offices.
پیش از آنکه چراغ خاموش شود آن سحر که دست و پای مرا بسته بود باز کنم.	before the light was put out, to break the spell in which I had so long been bound.
بسیار متأسفم که این موضوع برای شما چنین آشفتگی شدیدی ایجاد کرده است.	I am extremely sorry that the circumstance should have made such an unpleasant impression upon you!
سپس با نقشه قبلی و در کمال خونسردی آن را به اجراء در آورد.	then, with maliceaforethought and in cold blood, executed it.
که در نظر خود من مقدس و در نظر تو پدر عزیزم نابکاری است	which I feel to be as righteous as to thee, dear father, it seems wicked.
یا در فکر شاه بوده و آن را به زبان نیاورده است.	that is, present in the king's mind, but not uttered
انتظار داشتم از من دعوت کنی با تو در جای قشنگی زندگی کنم.	I expected an invite to stay with you at some pretty place.
از ساعت ورزشم در سالن زدم و بلافاصله بعد از ناهار چک را برایشان بردم.	I cut gymnasium and took it down to them right after luncheon
راستشو بخواین من زیاد از این جور چیزا نمی دونم.	I guess the real facts is that I don't know nothin' much about such things.
اما سرگی را در آن روزها به خاطر دارم.	I remember him then.
میان اینان و پیرمرد سپید موی تنها این بستگی وجود داشت	between them and the white haired man afar off, was the one small link
این قدری نگذشت که از رودخانه رد شدم و کرجی را نیم میل بالای شهر رساندم و بعد در آب راکد کنار افتادم.	I fetched the shore a half a mile above the village, and then went scooting along the bluff bank in the easy water.
اما مثل این که هنوز چنین سکویی ساخته نشده.	but they don't seem to have built it yet, do they?
احساس تنهایی مثل گردبادی بر او مستولی شد و وجودش را فرا گرفت.	an eddy of loneliness washed over him.
سپس گوشت سردی را که برایش آورده بودند خورد	then she ate her cold meat
در این صورت یک راهزن دریایی حق دارد آن را بدزدد.برای همین هم آن را دزدیده بود.	therefore legitimate prey for a pirate
آن شخص در میان تمامی افراد یک ملت یگانه خواهد بود	that man makes one in a whole nation's census
آنچه تو باید باور کنی و بفهمی این است که اگر این دو به قول تو به کشیش و دلاک ما شبی هند	what thou art to believe and think is that, if they look like them, as thou sayest
که اینجا ایستاده است و آنگاه از خانه بیرون بیاید.	that he was out here, and so cause her to come out.
سپس دستش را گرفت و به سفر خود ادامه دادند.	once again led him onward on his journey.
ولی عملکرد او واکنشی طبیعی در برابر پسرک بود.	his actions had been forced by the kid's.
با چنان سرعتی به دویدن پرداخت که برای دیگران رسیدن به او خالی از اشکال نبود.	darted off with a speed which rendered it matter of exceeding difficulty for the others to keep near him.
او را از اطاق پهلوی خوابگاه خود به اطاق دیگری در گوشه ساختمان منتقل کردند.	he was transferred from the room adjacent to their bedroom to one in a far corner of the house.
به مجرد آنکه صدای تیراندازی از جناح راست به گوش رسید	as soon as the guns of the right wing are heard
با سرعت غیر منتظری آن را برداشت و به طرف راهرو دوید.	it with unexpected rapidity and ran out into the corridor.
زیرا مردم مرا ناچیزتر از آن میدانند که دارای عزت نفس باشم.	I am much too insignificant for that.
من به آن شهر رسیدم و او را دیدم و مغلوبش ساختم و مجبورش کردم که بی حرکت بر جای خود بماند	I came, I saw, I conquered, and I made her stay quiet and behave herself
در آن لحظه هیچ فرصت فراری در دسترس ما نبود.	no possible chance of escape was at present afforded us.
نه اصلا و ابدا به ادمهای معروف زل نزدم	I'm not going to gawp at the celebrities.
من تا وقتی که زمان ادای سوگند رسید متوجه گریه خود نشدم.	I didn't realize I was crying until it was time to say the binding words.
به گستاخی بالاپوش رنگارنگ او را ازتن خارج کنند.	his fine coat of many colors ripped rudely from his back.
من تا وقتی که او نو نشنیدم متوجه نشدم.	I didn't understand until I heard that.
باز هم از هر پلنگی که در قفس باشد وحش تبارتر است.	he would be more hideous than a caged tiger, then.
که یک لحظه سکوت کرد تا بیشتر تأثیر کند.	who paused an impressive moment
فکر کنم تا آن موقع بتوانم تا حدی مقدمات کارمان را فراهم بکنم.	I think I could probably make some arrangements by then.
احساس کرد که پریشانیاش اندک اندک محو و شرم و ناخشنودی اش ذوب میشود.	he felt that little by little the confusion was clearing up, and the shame and self dissatisfaction were passing away.
دست کم با نخستین تندباد یا موج عظیم واژگون گردد.	at least overset by the first violent blast, or rising wave.
که نفسش موی مجعد تام را به حرکت در آورد	till her breath stirred his curls
که آواز او نیز مانند تمام رفتار و کردار دیگرش مورد پسند اوست.	he liked her singing as he liked everything she did.
من قسمت اول را با تمام قلبم بازگو خواهم کرد.	I'll say the first with all my heart
به محض اینکه وارد شد سرم را بالا کردم	I look up as he walks into the room
حساب کردم که عده پیروان هر فرقه مذهبی و هر حزب سیاسی در چه حدود است و از روی آن عده جمعیت کشور را برآوردم.	I computed the number of our people, by reckoning how many millions there might be of each religious sect, or political party among us.
تا آنجا که میسرم بود دندان به روی جگر گذاشتم.	I have forborne, and forborne, as long as it was in the nature of man to do it.
روزی از من پرسید که آیا هیچ از بادبان کشیدن و پارو زدن چیزی میدانم	asked me whether I understood how to handle a sail or an oar
منتظر راه حلی ماندن که هیچ وقت یدانمی شو دف نزدگی نیست.	I am not living, but waiting for an event, which is continually put off and put off.
هیچ کس سخنی که حاکی از عقل و شعور باشد از دهان او نشنید.	or heard to utter rational word
اما هنگامی که به عضویت در تیم اصلی مدرسه ابراز علاقه کرده بود	but when he had gone to try out for the school varsity team
او که از این پیش آمد بسیار متأسف است	he much regretted what had occurred
کسی هم در آنجا نبود که در ارتکاب رذائل سرمشق یا محرک من باشد.	where I could have no example or incitement to vice.
هزاران شمع بالای سرشان در فضا معلق و روشن بودند	lit by thousands of candles floating overhead.
بدون این که از آن قسمت غار که بلد بودند بیرون بروند	without going beyond the known ground.
همان وقت آن جمعیت خوش و خرم با سبدهای غذا توی خیابان صف کشیدند.	presently the gay throng filed up the main street laden with provision baskets.
سالنی با شکوه و کام لا عریان و خالی	a room magnificent and naked
اما در آن لحظه در آنجا فقط سکوت بود و باد.	but now there was only silence and the wind.
اصلا نگاهش نکنند و تا قوت در زانو دارند بگریزند.	not to lookat him, and to flee at the best speed of one's legs.
امیدوارم چون کارد در دلش فرو رفته و آتش به جانش زده باشد.	I hope went a little deeper than his missile.
بنابراین ناگزیرم از اینکه یکی از حروف اسم او را به تناسب اهمیت حذف کنم	nevertheless he would try to drop a letter as well as he could
بقچه های خوراک را باز کردند و در قمقمه های آبجو را برداشتند.	untied their sacks of bread, and uncovered the pitchers of rye beer.
حالا با عنصر طبیعی خودم تنها مانده بودم و احساس آشوب نده تأثرات گذشته در من سر برداشته بود.	now I was left in my natural element, and beginning to feel the stirring of old emotions.
یکی سلاطین را تا سطح گیوتین پایین آورد و دیگری ملت را تا محاذات تخت سلطنت بالا برد	one brings a king within reach of the guillotine the other elevates the people to a level with the throne
گستاخ و مبارز طلبانه که مبین بی باکی او بود به شاهزاده خانم نگریست	looked at the princess with a bold and defiant expression which said that she was not afraid of anybody.
به خود گفت به این جریان چنان که باید برخورد جدی نداشته است.	it seemed to him that he had not taken the affair seriously enough.
با توده عظیم و فشار نده روغن و پیه تقریبا چهارگوش شده است.	almost squared by the enormous superincumbent mass of the junk and sperm.
هیچ کس حق نزدیک شدن با و را ندارد!	keep their distance.
همچنین هنگام سوار شدن به کالسکه از تکان دادن و بالا و پائین انداختن من بکاهد.	to break the force of a jolt, when I went in a coach.
امیدوار نبودم که بتوانم کاری بیشتر از این بکنم.	I could not hope to do more.
چیزی مثل اشتیاق به تحقیر سرنوشت و به مبارزه طلبیدن	as of a wish to deal her a blow on the cheek, and to put out my tongue at her.
شک دارم حتی از مفهومش خبر داشته با شه.	I doubt it even understands the concept.
خجالت کشید که در مواردی هم به او حسودی کرده بود.	blushed for the envious feelings which had certainly been, in some measure, the cause.
نزدیک پنجره رفتم و از پنجره دزدکی داخل را نگاه کردم.	I slipped up and peeped in at the window.
هیچ شکایت و افسوی در کار نباشد جز شکایت و افسوس خودش.	be attacked by no regrets but her own.
معامله باطله و خو نه به صاحب اولیش برمی گرده	the sale won't be valid, and it 'll all go back to the estate.
کافی بود فقط چیزی برای خوردن و جایی برای خوابیدن داشته باشم .	it was enough that I had something to eat and a bed to lie on.
ولی اینک جراحت او موجب شده است که تا اوایل سال آینده برگشتنش به تعویق افتد.	which obliged him to defer his return till the beginning of the new year.
با این وجود باید به او گفت و بعد ما هم در مقابل اقدامات او دست به عمل میزنیم.	we absolutely must, anyway, tell him, and then be guided by the line he takes.
هر وقت دلتان خواست وقت مرا بگیرید و حرف بزنید.	you might take your own time to speak, or let me speak.
آن را با لحاف خود که در زیر بغل نهاده و با خود آورده بودم در کشتی نهادم	put my clothes together with my coverlet, which I carried under my arm into the vessel
بلکه آن را چون گوهری گران بها نگاه دارد و حفظ کند	but to keep and preserve it
به رغم کمی افزایش وزن تنش باد کرده بود.	in spite of her very slight weight gain she began to suffer badly from too much fluid in the tissues of her body
تا بار دیگر سوار بر جاروهایش آن ورزشگاه را دور بزنند	to perform another lap of honor on their brooms
لبخند اعتماد آمیز رفیقش او را بیشتر کوک کرد	it was rendered stronger by his friend's confident smile.
اما مدتی که جان تام به لبش رسید گذشت	but an age of anxious waiting passed
صبح روز بعد هم زود از رختخواب بیرون نیامد.	nor did he rise soon next morning.
مگر آنکه دخترک عقب بنشیند و با دادن امتیازی به او تسکینش دهد.	unless some concession on her part, such as would appease him, was made.
جدیدی وارد می شن و بعضی هاشون او میدونه که هرروز عده مشکل پزش کی دارن.	he knows there are more people coming in every day, and some of them have been banged around.
ظاهرا انتظار داشت که از مزاح او قدردانی کنند.	evidently hoping that his joke would be appreciated.
مثل مار درازی در هوا پیچ و تاب خورد و به شکل کلماتی در فضا معلق ماند.	rose high above the tables and twisted itself, snakelike, into words.
هیکل غول آسای او تمام صندلی را پوشانده بود.	her huge body overflowing the chair she sat in.
به همین دلیل شما را به اینجا خواندم تا در خلوت صحبت کنیم و مساله را خوب بسنجیم.	I asked you to come in order to discuss it alone with you and to consider it thoroughly.
کارم که تمام شد مسواک را به او برگرداندم.	I handed it to him when I was finished.
با مردی که اندکی شبیه تو بود ازدواج کردم.	then I married a man I thought looked a little bit like you
با چند بار زمین خوردن و زخمی شدن فرار کردند	fled, with many tumblings and bruises
تو حالت خو به و دی گه اسم شل بی از لیست مشکلاتم خط خورده.	you're all right, and for the moment, she's just one less thing for me to worry about.
مدتی پیش از من قول گرفت که در این باره با او حرفی نزنم.	a good while ago she made me promise not to speak to her about it again.
همین که در برابر پسرش قرار گرفت ناراحت و غریبه به نظر آمد.	once beside his son he seemed embarrassed and strange.
در این لحظه بود که تازه از تغییر سعادت آمیزی که روی داده باخبر گشت.	he seemed to awaken, all at once, to a full sense of the joyful change that had occurred
یا هنوز امید آشتی هست و آیا باید یک بار دیگر به دیدن او برود یا نه.	whether she should go away at once or see him once more.
او یک بشقاب پر از ماهی آزاد و خرچنگ و مایونز برداشت.	she heaped a plate high with salmon and lobster mayonnaise.
من این راز را در تصرف شما خواهم گذاشت زیرا خیلی میل دارم که افتخار خدمت گزاری و مفید بودن برای شما را داشته باشم.	I hold the secret at your disposal desiring to have the honor to be huseful to you.
گفتم که اکنون یک صد و نود و سه ساعت است که اینجا هستم.	I say we have been here eighty three hours.
هیجان و انتظار در هر یک از حرکاتش نمایان بود.	anxiety and expectation expressed in all his movements.
تعجب کرده بود که این حیوان این روزها پیدایش نیست.	she had wondered why this particular beast was not so much in evidence these days.
تا روح آن جوان با یأس و حرمان و کفر و بی دینی از این دنیا نرود وگرنه در آن دنیا جوابگوی گناهان او خواهد بود	so that his soul, quitting this life in despair, should not be lost
اما من او را در منازل وزرا ملاقات کردم.	I saw him at the ministers' houses.
تا اونجا که ممکن بود سعی کردم بهشون دست نزنم.	I tried to touch them as little as possible.
آیا ممکن است مرگ او هم موجب تأسف و گریه زاری تو شود.	would you have tears for him?
باری تا آنجا که از من ساخته بود به تکمیل آن کوشیدم	when it was as complete as I could possibly make it
سرانجام با یک دنیا تعجب و حیرت دیدم که	at last, to my wonder and confusion
الان دو روزه به شهر اومدم و هیچ حرفی در می ون نیست جز اینکه تو پولدار شدی	I've been in town two days, and I hain't heard nothing but about you bein' rich.
تا بتوانیم تمام چیزهای با ارزش باشگاه را در آن نگاه داری نماییم.	so it will hold all sorts of things, and save our valuable time.
الهی گور به گور به شم اگر به گم.	deed and deed and double deed won't.
من در ذهن لبخند قبیح او را تجسم کردم.	I could see his sardonic smile.
باید هر طور شده از این جا بیرون بروم.	I have to break out of here.
دقایقی به خواندن قرآن ادامه داد و بعد قرآن را بوسید و	in a moment ,he continued to recite and then kissed it
فقط هنگامی که پدر من و پدر او هر دو از خانه بیرون بودند	except when my father, and his too, were from home
که او از قلبش انتظار آن همه خلعت و نعمت داشته است.	of whom he expected such great favours.
از نزد او برخاستم تا بروم و در باغ گشتی بزنم.	when I left her, I sought the garden.
با قدرت و چالاکی بسیار از روی پرچین پرید	with great vigour and skill succeeded in surmounting the fence
دنیایی متعالی و نجیب که از قله های آن میتوانست گذشته ی خود را به آرامی داوری کند.	an exalted, noble world, from the height of which she could contemplate her past calmly.
هرگز درگذشته تا این اندازه ابراز کنجکاوی نکرده بودم.	interest that I had never felt before!
وقتی شب فرا رسید آن سه تن در ده کوچکی آرمیدند	that night they put up at a small hamlet whence
به زودی جملگی ما به درون آن پا خواهیم گذاشت.	that the passage to it is speedy.
بایست راجع به آن فکر نکنم و آن را مهم ندانم.	I must put it on one side, make myself independent of it.
پس مجددا تحسین نمایید که جدم باز به این خیال افتاده است.	you may approve again, for grandpapa is again thinking of it.
بگذار این دو عاشق شیفته در صفا و آرامش زندگی کنند	as to allow these two lovers to live in peace and quiet
وقنی در باز شد بکب در حال نوشتن و دیگری در حال ذکر گفتن بود	one was writing and the other praying when the door opened.
ولی توی راه گم شده و هیچ اثری ازش نیست.	she seems to have vanished without trace en route.
یک پاتیل از آلیاژ قلع و سرب اندازه شماره 2	1 cauldron pewter, standard size 2
به هنگام ادای این کلمات هوشمندانه او را بخاری از کدورت فرا گرفت.	with a slight sneer on his intellectual countenance.
می خوام همین جا بمو نم و یه فیلم تماشا کنم	I want to stay here and watch a movie.
دوستان زمان کودکی خودم رو دیدم که قطعه قطعه شدن.	I saw my boyhood friends blown to bits
لحنش حالتی داشت که گویی مانعی برای قبول پیشنهاد او نیست .	spoke with the outward assumption that no obstacle stood in the way of his agreement with her plan.
زنان و کودکان را نزدیک آتش به حال خود گذاشتند.	leaving the women and children at the fire.
زیرا تو هم مانند ثروتمندان و بزرگان حقوق داری.	for you have the same rights as the most rich and powerful.
کوزت اشغال کرده بود هر یک روی یک بسته کاه دراز شدند.	byCosette, each threw himself on a truss of straw.
ترجیح می دم منتظر بهتر از ایناش به مو نم.	I prefer to wait and hope for better things.
ولی من این مد عجیب روز را دوست ندارم.	I do not like the stupid fashions of today.
که پنداشتی انبار بزرگی بوده و خانه شده است.	which resembled a shed whichhad been converted into a house.
این قایق ذخیره بود و آن را روز پیش با شراع و طناب مجهعز کرده بودند.	a spare one, rigged the afternoon previous.
چهار تا سر را به ریسمان آویزان کرده بود مثل حلقه پیاز.	with four heads strung on a string, for all the airth like a string of inions.
اما همه کارگرها چند دقیقه زودتر میآن مثلا در حدود هفت و بیست دقیقه تا پیش از رفتن بر سر کار بتونن لباسهاشونو عوض کنن.	but they allring in a little earlier about seven twenty or so, so as to havetime to change their clothes and get to the machines.
اما تعدادشان در هر صد سال یکی دو مورد بیش نیست.	but only once or twice in a hundred years.
هر کسی که با او ملاقات کنید همین انتظار را از شما دارد.	each person you meet wants the same.
من برای اثبات عشق خود به او دستم را سوزاندم.	I burned this to prove my love for her.
اکنون که گرده نانی در خانه خود داریم دندان طمع از کلوچه مردم برکنیم.	as we have loaves let us not go looking for cakes
مگی با تعجب نتیجه گرفت که آدم خودنمایی است.	somewhat of a dandy, she decided, amused.
با دعا و استغفار نتوان آن را از میان برداشت.	by prayer and repentance it may be removed.
زیرا به دلم برات شده است که ما اکنون به پاهای خود بیش از دستهامان احتیاج داریم.	for my mother wit tells me we have more need of legs than hands just now.
از اوج مقام شامخ بازرسی تحضیض رسوایی عالم زناشویی سقوط کرده بود.	he had fallen from all the height and pomp of beadleship, to the lowest depth of the most snubbed hen peckery.
گفتم از کلبه بیرونم کشانند تا یک آخرین نگاه به اشیاء اندازم.	I had myself wheeled out here to take a last look at things.
توجه داشتند که صحبت نکنند و از پاهایشان صدایی برنخیزد.	they were careful not to speak or rustle their feet.
دهلیزی دراز و تنگ که چند پله و دریچه و زوایای بسیار داشت	a long, narrow corridor, broken by steps and gratings
نباید این همه او نا رو سرزنش کنیم .	I don't know that I blame them.
شهرهای بابل هم تا به این حد شریر و فاسد نبودند.	the cities of the plain were not more wicked.
آن گونه که چند سال پیش عقب نشستماین بار جا خالی نکردم.	I was not so easily abashed as I had been some years earlier.
ایمان هلاکت زده به صورت توده سیاه انبوه و پر قدرتی بالای سرم در نوسان بود.	my faith death struck, swayed full and mighty above me in one sullen mass.
آری یک بحران طولانی که ممکنست چندین ساعت یا حتی یک یا دو روز ادامه یابد.	lasting a long time several hours, or perhaps a day or two.
شما را زنده دارد و بهبودی و حیات بخشد	caused life to circulate in your veins.
اما من معتقدم که بهترین چیزها را باید آخر از همه بیان کرد.	I believe, however, in keeping the best to the last.
یعنی بهانه ای برای جنجال و خنده ی دستجمعی شد و قالی گرانبها و پیراهن بارونس را لکه دار کرد.	that is, providing much cause for much noise and laughter, and spoiling a costly rug and the baroness's gown.
پیدا رک دن راه درست در میان این دنیای بغرنج هیچ کار آسانی نیست	it is not an easy thing even to thread a path for principles in the intricacies of the world
گوشی تلفن را طوری سر جایش انداخت که انگار یک عنکبوت سمی است.	he threw the receiver back onto the telephone as if dropping a poisonous spider.
حتی در آنجا نیز تا بی گاه به عیاشی معمول خود سرگرم بودند.	even there they prolonged their usual orgies late into the night
به طوری که بالاخره ما همه در طرف چپ کالسکه جمع شدیم.	so that at last we were all crowded together in the left hand corner of the cart
سر جیمز یک راست به اتاق کار او رفت.	his visitor was shown into the study
از وقتی که یازده سالم بود تا این فاصله به عمق جنگل نیامده بودم.	I hadn't been this far into these woods since I was eleven
فردا همه چیز را تحمل خواهم کرد فقط امشب نه!	I will bear anything to morrow only not to night!
اما نه آن طور که شوهرش با هزار امید و آرزو به دنبالش رفته بود.	but she could not give him the repose he had dreamed about
امیدوارم کار پسرم به جایی نر سه که دزد و راهزن به شه.	I hope my son will amount to more than a thief or a plunderer
پس پیرمرد کوتاه قامتی را با چهره گلگون که نیم تنه آبی تمیزی در برداشت	he asked, indicating a short old man in a clean blue peasant overcoat
گرچه هیچ وقت با او هم صحبت نشده بود	though hehad never spoken to her
که تا حدی به حکم مهر و محبت بر آن شد که مرا تا محل زورق بدرقه کند	partly out of kindness, was determined to see me in my canoe
حال بیشتر از یک ماه است که بایستی اینجا رسیده باشد	she ought to have been here a month ago
یک روسری هم سرم کردم و زیر گلویم گره زدم.	I put on the sun bonnet and tied it under my chin
به عنوان یک پسر روی هم رفته چیز جالبی است.	for a boy, and altogether jolly.
که عدم اشغال ارتفاعات مشرف بر تمام این ناحیه و نگه داشتن قشون در پای آن دیوانگی محض است.	that it was madness to leave a height which commanded the country around unoccupied and to place troops below it.
من او را به سویی انداختم و به سرعت از روی صندلی بلند شدم تا میز را بین خود و آن حیوان وحشی حائل قرار دهم.	I flung her back, and hastened to interpose the table between us.
سپس گوشی تلفن را برداشت و با ان صحبت کرد.	then reached for a telephone and spoke into it.
به نحوی که همه نماش شاد به تمامی برابر او قرار داشت و گویی فقط به خاطر حظ فردی او درست شده است.	so that the whole rejoicing drama was full before him, and seemed merely contrived for his own individual diversion.
بعد چوب پرش را آرام روی همان قسمت کشید	he gave his brush another gentle sweep
اما او آدمی نیست که دیگر هیچ حرفش را باور کنم.	but he is the last man whose word I would take.
لازم است که سعی نماید تا انانیت او را من دک نکند.	you must avoid even the appearance of wishing to wound it
بر عصبانیت خود مسلط شد و قبول کرد که قسم بخورد.	he suppressed his feelings and submitted to be sworn at once.
تمام کفاشان کنجکاو و شتا بزده به جمعیت متحرک پیوستند.	with eager curiosity all the bootmakers joined the moving crowd.
هر کس به مقتضای طبیعت خویش آن را عاقلانه و یا اصرافکارانه به کار انداخت.	used it wisely or foolishly, according to our natures.
تو همچنان دوست خانواده ما و دست کم من هستی.	you shall always remain the friend of the family mine, at all events.
مانند گیاه تازه کوچکی همراه با حشرات مخصوصش روی فسیل بزرگی درآمده است.	grew like a small fresh vegetation with its population of insects on huge fossils.
دیگر تکان نخورد تا اینکه دوباره توجهش به صدای همسرش جلب گردید.	nor did he rouse himself until his attention was again awakened by the voice of his partner.
بسان بیابانی بی آب و علف که دست ساحری آن را برای زمانی کوتاه به باغی تبدیل کرده بود.	as a wilderness that a magician's spells had turned for a little while into a garden.
من صبر کردم تا پاسخی به آواز آدمی بشنوم	I waited to hear some answers in a human voice
در نتیجه همین عمل نیز مقام و منزلش در نظر آن رجال بالاتر رفت.	by this means he rose higher in their estimation.
سر در اتومبیل کردم و به آرامی او را بوسیدم.	I stepped up into the car and kissed him gently.
من هم نسبت به او نظر خیلی نامساعدی داشتم.	I used to have a very poor opinion of him too
با شتاب سه چهار چل یک بزرگ را پشت چرخ بادبانکش ردیف کردند	hastily slewing about three or four large casks in a line with the windlass
پیش از رفتن به رختخواب چیزی توجهش را جلب کرد.	was about to turn back to his bed when something caught his eye.
در میان سکوت که همه جا را فرا گرفته بود به خاموشی گرایید.	died away in the prevailing silence.
که نظامی آن گونه متکی بر دژخیمان فرخورده موی و پودر زده	that a system rooted in a frizzled hangman, powdered,
بالاپوش خود را تن به درآورد و به زمین انداخت.	he took his coat off, and let it drop on the floor.
دور از چشم اغیار بازهم با او حرف بزند و قرار ملاقات بگذارد	when he could, as to where they could meet when no one was along
حتی گاه به گاه برای دخت رهائی که ظاهر نجیب و متینی داشتند.	in connection with the most respectable looking girls at times.
لکن آنقدر لطف دارید که آن را نادیده بگیرید.	but you will perhaps be so good as to overlook that.
که در آنجا دختری سه ساله با پیراهن گلی زیر نیمکت دراز کشیده بود.	graveled space where a three year old girl in a pink dress was lying under a seat.
عیان بود که اطلاع دارد همسایه و مارشال او احتمالاً چه نوع سودی به دست میآورد.	obviously aware how much gain his neighbor and marshal was likely to be making.
تا سرانجام لحظهای فرارسید که دیگر رمقی برایش نماند.	the moment came when he felt he had no strength left,
که مردی هوشمند بشود و توان به کار گرفتن ذهن خود و توش تقلای جسمانی بسیار به دست آورد	as to be a highly intelligent man, capable of close application of mind, and great exertion of body
پس من هم بروم و کلید آن اتاق را بیاورم.	I have forgotten the other key.
دست و پای مرا به دقت نگاه کرد و چندین بار دور من راه رفت.	he viewed my hands and feet, walking round me several times.
چیزی که هیچ گاه در زمان حاضر وجود ندارد	something which is always absent from the present
من چنان نعره زدم که آن آتش پاره ترسید	I roared so loud that the urchin was frighted
اما چون ترس تن نتوانست سوگند بخورد که آن دوربین همین دوربین بوده است و گواهی او را از پرونده حذف کردند.	but failing to identify it as the particular one, his testimony being stricken out.
بلکه بیشتر از این جهت که حتی حالا هم مرا مستحق سرزنش دانستی که سکه و خانه ندارم.	as because you just now made it a species of reproach that I had no brass' and no house.
سراسر یک خاندان نابود گشته و اثری از آن به جا نمانده بود.	a whole family disappeared from the face of the earth, leaving no trace.
پس از آن که ما گنج را به کشتی بار کردیم	once the treasure shipped
این امر مانع میل من برای آشنائی با شما نبود.	that hasn't put me off.
صدای هلهله و شادی میز مجاورش آن چنان بلند بود که صدای رون در آن گم شد.	the uproar from the next table was too great.
حکایاتی از مردانی که دنبال گنج خود رفتند و هرگز موفق نشدند.	stories of men who sought to find their treasure and never succeeded.
کاری کرد که آن دوست رسماً او را دعوت کند	he so arranged it that the friend should send him a very pressing invitation.
در حقیقت بیست و سه دقیقه به شش بود	it was indeed twenty three minutes to six
فردا بعد از آنکه مازارین را آوردید امضا خواهم کرد.	I will sign it to morrow.
در این مدت اسکار لت سعی کرده بود بخشی از اوقات فراغتش را با آنان بگذراند .	she tried to fill in some of her empty hours with them.
که در سوط زمستان در حالی که تازه از سفری چهار ساله و خطرناک بازگشته بود	who in mid winter just landed from a four years' dangerous voyage
کار روزانه او عبارت بود از سرکشی به بیماران و فقیران نقاط مختلف آن منطقه.	he found daily business in visiting the sick and poor in its different districts.
از در عظیم ورودی که از جنس چوب بلوط بود گذشتند	through the giant oak front doors
بعد شارلوت از در جنوبی فوری خود را به میان آشپزخانه انداخت	the former of whom rushed into the kitchen by a side door
زیرا خداوندان ذوق و شعر نه چندان با من دشمن نیستند	for the muses are not such enemies of mine
برای راه برگشت هم مانیوک سرخ شده و چاکا و لایچاتو با خود داشتند.	tapioca chips and chakka velaichathu for the way back.
آدم جل وش زیر شیر می شوره و پشت سرش توی حوضچه آب میکشه.	you wash at the faucet in front of you, and rinse in a basin behind you.
تأثیری که این سخنانم بر اربابم داشت موجب وحشت و حیرت خودم نیز گردید.	I trembled at the first effects of this intelligence
حتی گروهی او را از بعضی جهات بر آن دو ترجیح دادند.	there were even those who were inclined to give it somewhat the preference.
اما مسؤلیتهای سنگینی را به عهده شما خواهد گذاشت. شما باید مرد و قویدل باشید.	but it imposes duties on you, and you must be a man.
تا او را بکشم و افتخاری برای خود کسب کنم.	that I might destroy him, and cover myself with glory.
به راستی که از بابت او هزار جور نگرانی داشت.	he had indeed a thousand anxieties
رنچ از قرار شریک زندگی خوبی انتخاب نکرده بود.	he must have altogether begun with an ill chosen domestic apparatus.
طنین پوچ آن به روشنی در آشپزخانه به گوش رسید.	made a hollow resonance perfectly audible in the kitchen.
از این روی تصمیم گرفتند که آرام درجای خود بمانند	decided to sit quietly where they were
من یک تکه از آن را برای این که جرأت پیدا کنی برایت خواهم خواند.	I'll read a bit to encourage you.
دردم از چشمه لایزال عشق و حیات لبریز شدند.	were as instantly flooded with this rich upwelling force of life and love.
دور و بر من پر از اشیا عتیقه و تابلوهای نقاشی نفیس بود.	surrounded by beautiful paintings and antiques.
مجبورش کند که از رو به رو به وی نگاه کند.	to force her to look up at him.
معنی آن را از تنها پزشک فرانسوی موجود در ماکو ندو جویا شود.	ask what a pessary was
با پشتکار هر چه بیشتر به بافتن سرگرم شد.	knitting away assiduously.
من وقت ندارم تورو از این ور مملکت به اون ور مملکت ببرم.	I haven't got time to go dropping you off all over the country.
باد دری را باز کند و آن را برای همیشه ببندد	open a door which, should the wind blow it to, would shut upon one for ever
این کار برای مردی با عادات و خلق و خوی او به هیچ وجه کار کوچکی نبود.	it was no trifle for a man of his habits.
بر اینکه روزی میانه من و او در امری تصادف شده باشد.	that in no period, in no case, in no circumstance, could there have been any contact between him and me
دست او را که به سویش دراز شده بود فشرد.	pressed the hand held out to him.
باد بسیار بسیار ملایم و آسمان بسیار ملایمی است!	it is a mild, mild wind, and a mild looking sky.
اعتبارات مالی مؤسسه در اختیار مدیریتی متشکل از یک کمیته قرار گرفت.	the funds of the school were intrusted to the management of a committee.
با هنرمندی خود را در وقت خاص به محل معین برساند	by his art, so place and time himself on his way
پسرک سرش را بلند کرد و اولیور از میان چهره رنگ پریده او قیافه یکی از دوستان قدیم را به خاطر آورد.	as he stopped, he raised his pale face and disclosed the features of one of his former companions.
در حالی که با خوشحالی او را تا دم در مشایعت کرد.	as in an almost joyful manner he conducted her to the door.
ولی زنش آن اوراق تاشده را نخواند و در کشوی میز توالت گذاشت	but she put the folded sheets in her dressing table without reading them
دیگر متوجه آبجوسازی نبودم که آیا هنوز پابرجاست یا نه.	I hadn't even looked to see whether the brewery chimney was still standing.
طی این مدت به جلب دوستی این بانو قانع باشم و عشق او را طلب نکنم.	to be content with cultivating the lady's friendship during that time without claiming her love.
