اما در عین حال این لذت غریب و تازه در او میل به قهقهه زدن برمی انگیخت.	but at the same time she wanted to laugh with a strange new joy.
به خصوص وقتی که از پشت میز بخاستم. سرپیشخدمت هتل جلو دوید و صندلی مرا با نهایت ادب عقب برد.	for as we got up from the table the little mattre d'hotel rushed forward to pull away my chair.
از چشمان دهقان اجتناب کرد و به آتش خیره شد.	avoiding the farmer's eye and staring at the fire.
تمام لوازم و از جمله ملاحانش تکمیل شده باشند.	supplied with all her needs, including crew.
یک استخر داشت که پر از پرندگان قشنگ بود.	a pond with beautiful birds in it
مقصودم ای نه که یک چنین حدس غلطی از طرف من یه جور بی مبالاتی بود.	I mean it was careless of me to make such a wrong guess.
کسی که حالا تبدیل به یک جنگجوی بی شاخ و دم شده بود	with that of the mythical warrior
شنل و نشان شوالیه گری روی صندلی انباشته شده بود.	his cloak and garter being flung all of a heap on a chair.
من می دونم که روح چه کار می کنه.	I know the ways of ghosts
دستان و چهره تب آلود خود را در هم فرو برد.	wiped his hot face and hands.
زیرا ناودان کله اژدری جان نگرفت و کنار نرفت.	for the stone gargoyle did not spring to life and jump aside
تا رسیدن تند باد هنوز فرصت کشتن ماهی هست.	there is time to kill a fish yet before the squall comes.
زیرا معامله بین نویسنده و روح زمانه یکی از ظرایف است	as, indeed, well she might, for the transaction between a writer and the spirit of the age is one of infinite delicacy
تا اگر خواست بار دوم کتابش را به طبع برساند	if he prints it again
آنچه را که سن از او ربوده بود با طبع خوش و کدبانوگری جبران کرده بود.	but what she had been deprived of by age she more than made up for in character and diligence.
مانند تاری نازک و چسبنده در تار ضخیم تفکراتش تنیده شده بود.	like slight clinging hairs into the more substantial web of his thoughts.
تو به تدریج می تونی کارگاه رو از من بخری و مال خودت با شه و	you could gradually buy the mill from me and it would be your own and then
تو گوش پیرزن فریاد خواهم زد که این برادرزاده منه	I will shout in the fruit seller's ear, that she is aniece of mine
مرد کوچکی که چهار زانو در هوا معلق بود و در دست راستش عصایی داشت پدیدار شد.	a little man with wicked, dark eyes and a wide mouth appeared, floating cross legged in the air, clutching the walking sticks.
از آن همه شرابی که نوشیده بودم چیزی به شکل ادرار دفع نکرده بودم.	I had not discharged myself of any part of it.
لکن یقین دارم او پس از ده دقیقه از من پوزش خواهد خواست و به مین جهت به فکر افتادم بهتر است کاری با کار او نداشته باشم.	but I knew that if I did, he would begin to apologize in a minute or two, so I decided to let him alone.
سخنان دیگری که به من آموخته بودند بر زبان راندم.	used some other speeches I had been taught.
که برای دادن امتحانی که مطمئن است با رتبه ممتاز قبول خواهد شد در برابر تماشاگران بسیار فراخوانده شده است.	called up before a large audience for an examination in which he feels sure he will distinguish himself.
مرا کمک کن تا از این تخت کثیف پائین بیایم.	let me get off this thundering bed anyhow.
او زمرد را برگرداند و پشت آن را هم بررسی کرد.	turning it around, studying its facets.
گیریم که حاضر نبودند اسباب تفریحش را در محافل خود فراهم بیاورند.	whether they troubled to entertain him socially or not.
که ناگهان چیزی دیدم که مرا از جایم پراند.	I saw something that almost made me jump out of my skin.
موی انبوه او را با چنان غروری مرتب کرد	smoothing her rich hair with as much pride
من حساب کرده بودم که چرا با {هار هزار فرانکی که از این سفر برایشان آورده بودم و با آنچه که خودشان توانسته بودند قرض کنند باید الان تا هشت هزار فرانک داشته باشند	I calculated that, with the 4000 francs which I had brought with me, added to what my patrons seemed already to have acquired, the party must be in possession of at least 7000 or 8000 francs
همچنین چگونه به طریق نیمه روشن و دورتر از تصوری شاید در نظر ایشان شیطان بزرگ و روان دریاهای زندگی شده بود	also, in some dim, unsuspected way, he might have seemed the gliding great demon of the seas of life
دستش را درون پیراهن مرد برد و بر سینه او قرار داد.	laid her hand inside his shirt, against his chest.
لوتر بعد از پشیمانی دیروقت خود به آنجا رفته بود کشته شده است.	whither her too late repentant lover had repaired.
او تاکنون هزاران روبل برای این زن افسونگر به در داده است	though he has wasted thousands on this enchantress already.
خونی از تبار شاهی هر چند بدبختانه به واسطه تمایل به آدمی خواری که در دوران صبا وت عاری از تعلیم خود بدان خود کرده بود خون او فاسد شده بود.	though sadly vitiated, I fear, by the cannibal propensity he nourished in his untutored youth.
فقط یک سرایدار و مردی عامی در آنجا ایستاده بودند.	only a house porter and a peasant.
او را به اتاق زیر شیروانی بفرست تا شام تمام شود.	send him into the garret till dinner is over.
به نحوی که حتی فکر از دست دادن او برایش واقعاً وحشتناک بوده	so that the thought of losing her was really terrible to him
اون بیش از اونچی که من می تونم نمی تو نه وارد سرت به شه	he can't get inside your head any more than I can.
ولی در ته دل از آن غمگین و آشفته شد.	but inwardly he grieved and was furious.
پدرش در راست و پدربزرگش در چپ او بود.	his father on his right, his grandfather on his left
این را که آیا لباس بود یا شمد یا کفن نتوانستم تشخیص بدهم.	but whether gown, sheet, or shroud, I cannot tell.
بدان که تا من در این جهان هستم تو بدون دوست و یار و یاور نخواهی بود.	you shall not be friendless while I live.
سپس مانند شناگرانی که برای رسیدن به ساحل بشتابند خودشان را درون روشنایی زردرنگ انداختند.	then they plunged into the yellow sunlight like two swimmers hastening to get to shore.
سپس خودش یک صندلی برداشت و در فاصله دوری از هر دوی ما روی آن نشست.	she got a chair for herself, and placed it at a distance from both of us.
ناگهان به یاد آورد که وکلا گفته بودند او تمام روز در دادگاه درگیر خواهد بود.	but then he remembered that the lawyer had said he was going to be tied up in court all day.
او زن کوتاه قامت و چاقی و مهربانی بود	for a short, plump, kind faced woman
در عین حال بیم داشت که مبادا با حضور خود مزاحم ایشان باشد.	afraid of being in the way when she was with them.
بلکه راه حل برخی از مسائل را نیز ارائه میدهد.	but the solution of some question connected with them.
اما تیر با برخورد به زره پنهان او دفع شد و به کناری افتاد.	but the arrow fell back foiled by his hidden coat of mail.
برای خود یک ماشین تحریر و یک بسته کاغذ خریداری نمود و صبح را به نوشتن گزارش خود پرداخت.	bought himself a typewriter and a pad of paper, and spent the morning writing his re port.
همان طور هم آرزوی حرکت برای شخصی که در وضع من قرار داشت کاملاً به صلاح بود.	just as natural was the wish to stir, under my circumstances, as it would be under his.
با این همه چنان موجه بود که آدم را از وحشت بیاکند که افراد دیگری با شعور کمتر ممکن است تحت تأثیر آن قرار گیرند.	yet just plausible enough to fill one with an alarmed feeling that other people, less level headed than oneself, might be taken in by it.
یک سکهٔ بیست کو پکی را از جیب درآوردم و با و دادم و آنگاه صلیب را بگرد نم آویختم.	I fished out fourpence, and put his cross on my own neck
برادر شوهر خود را شناخت و به پیش بار شتافت.	recognized her brother in law, and ran down to meet him.
باید به عرضتان برسانم که او بسیار از مرحله پرت است	, I may tell you he did not know and does not know half the mass
که بتونه تو این کار به جائی بر سه.	who would ever make much of a stir in this game.
همان آهنگ که عموی کشیشت برای آن شعر ساخته و به مذاق مردم ده بسیار خوش آمده است.	thy uncle the prebendary made thee, and that was so much liked in the town.
اما شما حال که خود را از دشمنان من قرار دادید	 but you have constituted yourself my enemy
همین جور که او از جا بلند شد و به طرف صندلی شهادت رفت	as he rose and took his place upon the stand
شاید راهش همین باشه ولی حیف تو این شهر تا دلت بخواد دشمن و بد خواه دارم.	if only he were not as treacherously surrounded as he was here.
نوعی آبی سیر مثل آسمان صاف عصرگاهی که از درون اتاقی با چراغ روشن دیده شود.	a deep blue like clear evening sky seen from a lamp lit room.
بین اوقات فواره وال و اوقات معمول تنفس توافق بدون انحرافی موجود است.	between the periods of his jets and the ordinary periods of respiration.
بلکه برای جلب همفکری او و گاه همچون یک آموزگار.	but with an appeal to her understanding, and sometimes with instructive correction.
فرصت رو به راه کردن یک قسمت کوچک از این استان	have the chance of getting a bit of the country into good fettle, as they say
مشاهدات خویش را به زبانی همه فهم بر ننوشته بودند.	had not in plain words recorded what they saw.
شاید ما در حدود چهار هزار نفر تلفات داده باشیم.	perhaps about four thousand
آن نیز نه به سبب خطا یا گناهان خود او	not from any fault or sins of his
که برای خیساندن یک تکه نان در ظرف شیر هیچ حاجت به قاشق و جنگال نیست حتی به قاشق و چنگال چوبین	that one really does not need either fork or spoon, even of wood, in order to dip a bit of bread in a cup of milk.
آزادانه اختیار زندگی خود را به دست کسی بسپرد که از لحاظ دیگر طرف اطمینان او نباشد.	freely giving his whole life into such an otherwise distrusted person's hands.
تنها برای تو بود که به چنین خطری تن دادم.	I ran some risk for you, you see.
چون آشکار بود که اگر جسد را به طور ساختگی بالا نگاه ندارند فوری به ته دریا رسوب خواهد کرد.	for it was plain that unless artificially upheld, the body would at once sink to the bottom.
این تغییر رنگ مو در یک ساعت صورت گرفته بود.	it had turned white during the hour he had sat there.
این کاغذ اون پیرمرده که واسه قداس به کلیسا می ره.	said she, this is for that old fellow who goes to mass.
من وقتی چهارده سالم بود از منزل فرار کردم و به یک کارناوال رفتم.	I ran away from home when I was fourteen and joined a carnival.
که در گوشه سردی از اتاق چمباتمه و لرزان نشسته بود	as he sat shivering on the box in the coldest corner of the room
فقط مثل مرگ تیز و شیطان جهنده پیش بروید!	only start her like grim death and grinning devils
از این جهت برای اجتناب از وسوسه نفس آهسته و آرام به پشت ستون رفت.	so to be out of temptation she slipped quietly behind one of the columns.
چنان با شدت این را گفت که دیدم مادرم دستهارا با الحاح و ندبه پیش آورد تا میانجیگری کند .	that I saw my mother involuntarily put out her trembling hand as if to interpose between us.
یا به کارهای دیگری از این قبیل مشغول شده	various other pursuits of a similar kind
استنباطم این بود که در این موقع از گستاخی من نه عصبانی و نه حیرت زده است.	I discerned he was now neither angry nor shocked at my audacity.
قبل از آن که جناب آقا خواب سرکار خانم را دیده باشد.	before the gentleman is first known to have dreamt of her.
بلکه تنها خاکریزی استحکامات هم که روز بیست و پنجم شروع شد	that those begun on the twenty fifth
که مردی دیگر در پالتو نظامی به او نزدیک شد و جلوی نورلرزان چراغ را گرفت.	when another man in a military overcoat, quite close beside her, stepped between her and the flickering light of the lamp post.
نفرت علیه ماست حتی بدتر ازنفرت پوچیه که ما رو تهدید می کنه.	t's hate against us, worse, it's emptiness.
آن شب او نیز مانند کریستف نتوانسته بودبه خواب رود.	she had not slept any more than he during the night.
که در وجود خود آنچه دیگران همه داشتند جمع کرده باشد ندیده بود.	whom all the characteristics of those others were united to such an extent.
هزاران سؤال جدید ذهن هری را مشعول کرده بود ولی جلوی خود را گرفت و چیزی نپرسید.	he swallowed a lot of new questions that had just occurred to him
کاش من یک خو نه داشتم و او نو در اختیار شما می ذاشتم.	I only wish I had a home to offer you shelter in.
دستم را به سوی دستگیره در اتومبیل دراز کردم اما مردی اونیفورم پوش با عجله در را برایم باز کرد	I reach for the door handle, but a man in a peaked cap rushes forward to open it for me.
چندان عظیم است که برای من قابل تحسین است	are such that they fill me with admiration
بدون ملازمت اندک شدتی نسبت به شخص او نبود.	had not been unattended with some small violence to his own person.
آن قدر آن را چکش و سیخ زده بود تا بتواند صف آن را بکند.	but she hammered and poked till it was unshelled and its meager proportions concealed in a grove of lettuce leaves.
صریحاً قید کردم که باید مرا در خوشی اندکی به خاطر شخص خود آزاد گذارند.	that I should be allowed a l l little chuckle all to myself now.
در آخر درست قبل از اینکه در درختان انبوه آن طرف رودخانه ناپدید شود معلق زد.	finally turning a somersault just before he disappeared into the thick trees on the other side of the river.
سپس با حالتی پر طمطراق به قرائت روزنامه مشغول شد.	read the paper with great show of pomp and circumstance.
توصیه من به شما اینست که در صدد دانستن آن برنیائید.	I would recommend you not to ask for it.
من مفتخر شدم که این رو برات ون ترتیب بدم.	I have taken the liberty of arranging this little
از روی کاپوت یک دم توی مهمانخانه را تماشا کرد.	looked over the cowl of the truck and watched the restaurant for a moment.
بدون آن که هیچ خطری در کار باشد که مثلاً علامه یا نابغه برگردند.	without any danger of coming back prodigies.
ازش خواهش کنم که دست از سرم ورد اره.	beg her tolet me go.
که بجز دو گوش و دو بازو در این لحظات بحرانی هیچ نداشته باشند.	but ears, and no limbs but arms, in these critical moments.
من دیگر اهل در افتادن با وال سفید نیستم.	I've lowered for him once, and that has satisfied me.
اما هنوز همان معلم سر خانه محدود فکر و تربیت یافته و پرهیزگار و ملانقطی بود.	but was still the same narrowly intelligent, conscientious, and pedantic preceptor.
چه قدر پرتحرک و از نظر ذهنی تم پرور و بزدل.	how slothful and timid in mind.
دیروز که خبر چارلز کوچولو را دادند من شوکه شدم ولی وضعیت امروز فرق داره	I was dreadfully alarmed yesterday but the case is very different to day
شهری که چهار قرن بود اتفاقی در آن رخ نداده بود.	where nothing had happened for four centuries
باز هم آن فواره سیمین در آن شب دگر دیده نشد.	yet the silvery jet was no more seen that night.
ابتدا با یک زیگزاگ خسته کننده تا نوک یک شیب تند بالا رفت و سپس کم کم آماده شد تا برای آخرین بار پایین بیاید.	it climbed to the top of a steep bank in a weary zig zagging sort of way, and then prepared to go down for the last time.
دستی روی بازوی سروان گذاشت و سعی کرد به چشمان او دقیق شود.	she put a hand on the captain's arm and, with difficulty, focused his eyes.
کشف این سرّ مکتوم امروز به واسطه وقوع امری اتفاق افتاده	the discovery of this secret has been occasioned by a great event
اگر این طورست پس بقیه بدن او هم باید اینجا باشد!	her small, slight fingers!
خراش تیغ بوته هار و روی پوستم احساس کردم اما اهمیتی ندادم.	I felt the little tears as the thorns cut into my skin, but I ignored them.
مردها که هنوز پشت میز صبحانه بودند با حیرت سربرگرداندند.	made the menfolk still seated at the breakfast table turn their heads curiously.
وقتی که او با زبان متعهد شده است تا خودش را در کار دیگری در گیر نکند	when he had plighted his word and faith not to involve himself in any
پس از این قرار من در عمارت خودم محبوسم.	I am a prisoner, then?
نزدیک یک ربعی ادامه داشت و دیگر فرصت بگومگو به کسی نداد.	which went on for nearly a quarter of an hour and put an end to any chance of discussion.
تا آنجا که اقدام به یک عمل خیر از هر قبیل را برای او واجب ساخته بود.	had ended by rendering a goodaction of some kind absolutely necessary to him.
بنابراین طبیعی بود که این موضوع ضمن صحبت مطرح شود.	so that it was natural that the subject should come up for discussion.
بلکه به بهانه بیماری در اطاق ماندم و از جای خود نجنبیدم.	but, pretending I was sick, kept close in my cabin.
چنین بود بخشی از دعای او. گرگ و میش شامگاهی در تابستان.	SOUVENIRDusk, of a summer night.
من می خوام که روی پای خودم بایستم و هرچی که لیاقتم با شه بگیرم	I want to stand on my own feet for what I'm worth.
با ناراحتی تعظیمی کرد و از این جهت نسبت به خود بسیار عصبانی شد.	bowed awkwardly and was at once furious with himself for it.
که چندین بار فکر کرد همه چیز از دست رفته	that he more than once gave the matter up for lost
ولی خیلی باعس تفریح دختراس. بنابراین من اجازه می دم که ورجه و ورجه کنند.	but he heartens the girls, so I let em hev full swing.
پس آن را برداشتم و دوباره بر سر گذاشتم	better by taking it off and settling it again
آن را برای اینکه از هرگونه آسیبی مصون باشد در دهانم قرار دادم	I put it in my mouth for safety
که متعلق به یک جادوگر با سبیل چنگیزی بود.	which contained a wizard with a walrus mustache.
واهمه داشت از اینکه فکر کند با او تا کجا پیش خواهد رفت.	if anything, she proposed to permit herself to do in regard to him.
یک یادگاری بنابراین برای کمک کردن به او در پوشیدن دیر جنبیدم.	a token so I was too slow to offer her my help.
من سر سوزنی قصد آن ندارم که به زندگی معمول برش گردانم.	I have absolutely no enticements powerful enough to sway him from his present way of life.
مثل نشان دادن یک شیء براق به یک کودک.	like flashing a shiny object at a child.
پیوند خودم را با حقیقتی که نسل کنونی از آن نفرت دارد نخواهم برید.	or cease to identify myself with that truth which an evil generation hates.
آن دستور عجیبی که ناتاشا حامل آن بود باور کنند.	but could not believe the strange order
به خاطر دارم یک بار هنگام یکه او تنها بود نزد او رفتم.	I remember I went once into his room when there was no one else there.
صدای استریو را کم کردم و به موسیقی داخل سرم گوش سپردم.	I turned down the stereo and listened to the music in my head
او به دیدن ایشان شگفت زده بر جای خود خشک شد.	at sight of which he fell back in amazement.
همیشه در نظر او به صورت ظلم دادگستری و جنایت قانون جلوه کرده بود.	always appeared to him the iniquity ofjustice, and the crime of the law.
همه نصف ناهاشان را خورده بودند که هرمیون آمد	halfway through lunch
چون قدرت تشخیص همواره معادل مبلغ نامعینی پول نقد است.	judgment being always equivalent to an unspecified sum in hard cash.
قبلاً به او هشدار دادم که مراقب اعمال خود باشد	telling him beforehand and warning him to mind what he was about
من یکی از آخرین نفراتی بودم که بیرون آمدند.	I was one of the last to go out
سعی کردم بهش زنگ بزنم و مادرش گفت که مریضه.	I tried calling her and her mom said she was sick.
آنگاه دستمال خود را به عصائی که معمولاً همراه داشتم بستم و از آن روزن بیرون کردم.	I then fastened my handkerchief to a stick I usually carried, and thrusting it up the hole.
سخن خود را تمام کرده ابروها را فرو انداخت.	his brow became smooth again.
هنگامی که شاه سخت بر سرخشم است و قصد دارد که شهری را با خاک یکسان کند	the king, when he is highest provoked, and most determined to press a city to rubbish
به مادر اطمینان داد که کتاب مقدس را دارد و از خواندنش غافل نیست.	assured her that he had and didread it.
انگار امیدوار بود جواب نه باشد و برادر بزرگش بتواند از این قتل عام در شرف وقوع به دور باشد.	as if he hoped the answer was no, and his old brother could be spared from the coming carnage.
چنین به نظرش رسید که حتماً هیئت مدیره با توجه به سوابق بد او این تصمیم را گرفته است.	taken it into their heads that this extraneous circumstance ought to influence their proceedings.
لحن افرادی که هیچ وقت تامین معاش برایشان مسئله نبود.	the casual manner, he reflected with some resentment, of a person for whom anything so simple as a living had never been a problem.
من حق خواهم داشت که از نو ولی برای آخرین بار در این زمینه با شما حرف بزنم.	I may speak to you again on this subject, for the last time.
تا اینکه به جای بدن او قالب بدن مرا به خود گرفت.	until it had my shape instead of his.
او توانسته بود کشتزار وسیع تارا را بدون مرد اداره کند	yet she had managed the plantation without men to help her
آرزوی توأم با اضطرابی داشت که تقویم را به عقب برگرداند.	an anguished wish to turn back the calendar.
روی زمین دو نفر دیگر دکتر و خدمتکار خوابیده بودند.	two others the doctor and a valet lay on the floor.
یک ماهی کوچک طلایی هم با زنجیر طلایی به گردن وی آویزان بود.	on his neck a chain with a small gold fish.
چرا به هزار نیرنگ در پی آنی که در پایان مرا خوشبخت نکنی	why dost thou by such subterfuges put off making me as happy at last
به این ترتیب فرصتی را که در انتظارش بود به دست آورد.	so had the chance for which he had waited.
طوری بار آمده و رفته رفته مردی شده که تا دلتان بخواهد پادوی شما و پیام رسانی شما و خدمت گزاری کوچک و بزرگ شما را خواهد کرد.	brought up and growed up to be a man, wot will errand you, message you, general light job you
بوی خون و باروت را استشمام کرد و وحشت و ترس از مرگ بر وی چیره گشت.	smelled blood and powder, and a feeling of horror and dread of death seized him.
امیدوارم که شما او را موافق و آرزومند به همکاری در تمام امور معقول و منطقی بیابید.	I hope you will find him sympathetic and ready to co operate in promoting all that is reasonable.
حالتش طوری انگار خیال داشت در صورت شنیدن جواب منفی هری را لت و پار کند.	looked as though she might knock him out if he refused.
چون در این مورد ظرافتی دارد که فقط با لطافت خرطوم فیل هم مرتبه است.	for in this respect there is a delicacy in it only equalled by the daintiness of the elephant's trunk.
گناهکار یا بی گناه فقط در لغت مفهوم داره.	guilt or innocence merely an academic question.
من اطمینان دارم که شما خودتان بیشتر شبیه یک برونی هستید.	I am sure, you are more like a brownie.
در پیروزی ما نباید تردید و تزلزل وجود داشته باشد.	there must be no doubt of victory
من هیچ مایل نیستم که امور من مایه رنج و ملال خاطر او شود.	therefore I should be sorry that any affairs of mine should worry him.
گروهی به التماس و دعا و گروهی به گریه و زاری	some with prayers, and others with tears
اما چنان زندگی کن که برای همه چیز آماده باشی!	but live so that thou mayest be ready for anything.
ولی امکان داشت که شخص شش هزار فرانک در بازی ویست ببازد.	, but where it is possible to lose six thousand francs at whist in the course of a night.
یک دستش را روی لبه زورق به درون آب فروکرده بود.	one hand over the side of the canoe in the water
که روی هم رفته به حکم وراثت خوب رسیده و خوش ترکیبند.	that upon the whole they are hereditarily entitled to embonpoint.
باهاشون موافقت کردم و خودم او نارو تا خلیج همراهی کردم.	I granted them that and escorted them to the coast myself.
من تا آن موقع باید او را از اینجا دور کرده باشم.	I must have him off.
به آن پنج نفر سرباز تحت امرش دستور داد تا به خیابان مقابل آنجا رفته و مشغول نبرد بشوند.	ordered his men to go out and fight in the street.
تمام دید مرا پر کرد و سراسر ذهن مرا در بر گرفت.	it filled my vision and overwhelmed my mind.
سرم رو تک ون دادم و پاهام رو به آ رومی بلند کردم.	I shook my head, rising slowly to my feet.
اما با تقلایی سرسختانه وضع خود را درست کرد و با خنده به سرسره کردن پرداخت.	with a violent effort recovered himself, and skated off, laughing.
پس بیگمان گدار دور دست دیگری در همین اواخر با منظر ناآشنای ایشان به جنبش درآمده است.	then, be sure, some other and remoter strand has been very recently startled by the unfamiliar spectacle.
توی مدارس می شه یه دستگاه پلی کپی دستی پیداکرد.	I'd just go down to the high school and find the biggest hand crank mimeograph I could lay my hands on.
مطمئن نیستم که او تمایلی به دیدن من داشته باشد.	I'm not sure if he'll wish to see me.
شرحی از رفتار من درباره آن شش تن مقصری که از آنان یاد کردم بیان کرده بودند.	gave an account of my behaviour to the six criminals above mentioned.
شاید منظور این بوده که بگذارند مقداری هوای تازه به محل دم گرفته و خفه بیمار وارد شود.	probably to admit some fresh air into the close abode of sickness.
به تماشای ردیف لژهای روشن و درخشان مقابل پرداخت.	scanning the brilliant tiers of boxes opposite.
او پنجاه سال پیش برای خدمات ویژه به مدرسه جایزه گرفته.	he got an award for special services to the school fifty years ago.
تقاضا خواهم کرد به من رخصت آن داده شود که از این مزیت برخوردار باشم.	I should ask that I might be permitted to come
یا اینکه چطور از قهوه و نان شیرینی ابا کرد	how he eschewed coffee and hot rolls
گرچه آسمان غرب و شمال چون همیشه روشن بود.	though the sky to the west and north stayed clear as ever.
همان جا در کنار صندوق چون کنده هیزمی به خواب رفت.	went to sleep where he fell.
سرنوشت لطف کرده و ما را رسانده به دو نفر که خیلی از ما برترند.	the destiny which bids fair to connect us with two characters so much superior to our own.
این دارو مؤثر از آب درآمد دیگر به جز در موارد بسیار تصادفی تماسی با ربرتا نداشته باشد.	it must be the last of any save the most accidental and casual contacts.
از زاد راهی که در خورجین داشت بیرون کشید	taking out of the alforjas what he had stowed away in them
موهای صاف و بلند خود را با استفاده از سنجاق مو به شکل دم چلچله در پشت سرش جمع کرده بود.	with her straight hair in a smooth bun held behind her ears by swallow tail brooches.
به همین دلیل ناخودآگاه دستش را به سوی برآمدگی خیالی روی کراواتش رفت	whereupon his hand rose spasmodically toward a phantom bulge in his necktie.
گرهی درخت را فشار داد و شنل را پوشید و ناپدید شد.	vanished from view as he put on the cloak.
من به ابریشم کم رنگی که پوستم را پوشانده بود چنگ زدم. دوباره به وحشت افتادم.	I clutched at the pale silk that covered my skin, panicking again
بیم آن دارم شما را دچار کسالت کنم و شما تاب نیاورید و راه گریز پیش گیرید.	I am afraid you are so bored you will jump up and run away, and that will be all I shall see of you.
اما او جوابی نگفت ولی روی خوش به من نشان داد و سپس یک مرتبه من خود و او را در تختخواب طویلش که جایگاه دو نفر است یافتم.	but he did not reply, gave me a kind look, and then we suddenly found ourselves in my bedroom where there is a double bed.
چون اگر گوش نکنی به خشونت متوسل خواهم شد.	because, if you won't, I'll try violence.
ولی چون بجز آن سه زن دهاتی کسی را ندید نگران شد	as he could see nobody except the three peasant girls, he was completely puzzled
قبل از کشته شدنش در لحظاتی که طبق شهادت خودت ربرتا خیلی غمگین بود.	before she was murdered out there at a time when, asyou have testified, she was very sad.
طاقت نیاورده بود که آن را در گرد و خاک باقی بگذارد	he could not leave it there in the dust
همگی حاکی از آن آرامی عجیب چیزها بودند که مقدمه صحنه طغیان و شدت هستند.	all these seemed the strange calm things preluding some riotous and desperate scene.
مدتی روی زمین ماند تا این که بالاخره هیجان او اندکی کاهش یافت	where he lay at full length until his laugh was over
بی آن که چیزی بگوید منتظر بود که او به سخن درآید.	without a word, waiting for him to speak.
دو برگ کاغذ که رویشان قصه ام را نوشته بودم در دست داشتم.	in my hands the two sheets of paper on which I had scribbled the story.
یک هفته ده روز شد و او هنوز نیامده بود.	ten days, and still he did not come.
مراقب آن حول وحوش باشد تا او نتواند از روی دیوارهای حیاط فرار کند.	lest he should escape over the wall of the yard.
بعد از کالسکه سواری مطبوعی که تقریباً بیست مایل طول کشید	after an agreeable drive of almost twenty miles
به توبره اشاره کرد صد تا سنگ چخماق است.	he showed a bag a hundred flints.
آن موجودات نباید یلنهنیامشی یا موجودات غیر بومی باشند	that those creatures could not be _yinhniamshy_ or _aborigines_ of the land
اما گفتم که قبل از اینکه حالت کام لا خوب شه باید تغییراتی کنی.	it was just that you'd had to change a little bit in the process of getting better.
البته اگر بتوان بر احساسی چنین پلید نامی چنین زیبا نهاد.	if, indeed, so dark a passion may be known under so bright a name.
که به خاطر خودش هم که شده باید خونگرم و مؤدب و خوش بین به نظر رسد.	that for the good of his own cause he must try toappear genial and civil and optimistic?
برآمدگی دیگری در دومین مهره از پایین بود که به سردی یخ بود.	another about second from the bottom which was cold as ice.
ولی آ نیت نداشت و از نمک لطف و شادی خالی بود.	but it lacked just that something which is the salt of mirth
گرچه دوستان زیادی داشت که مایل بودند به دیدنش بروند	though he had many friends who would willingly have done so
آن صدای فلزی که از همان بعدازظهر دوردست به اعماق قلب او فرو رفته بود.	the husky voice he had carried in his soul ever since the afternoon
چقدر نگاه کردن من او را عذاب داده بود	how it rankled inside her, my staring
حداقل به اون اندازه باقی موند که بچه بالغ به شه و بتونه بچه خودش رو به دنیا بی اره.	at least long enough for the child to mature and bear children of its own.
باور کنید که من مانند جن زدگان علام صلیب کشیدم و تعجب کردم از اینکه مو لف آن کتاب این مطالب را از کجا دانسته است.	so that I crossed myself in my wonder how the historian who wrote them down could have known them.
اِما بعد از این آشنایی فهمید که رابرت مارتین جوان عاقل و لایقی است که کاملاً برای دوست عزیزش شوهر مناسبی خواهد بود.	she fully acknowledged in him all the appearance of sense and worth which could bid fairest for her little friend.
اظهار تأسف کرد که به علت غیر عمد بودن قتل و مستی متهم مجازات اعدام در مورد او روا نیست.	regretted that the drunken unpremeditated nature of the crime precluded hanging
به اشخاصی که کاغذی به آب طلا نوشت در دست داشتند	to some people who were holding a paper inscribed with characters of gold
اما ذائقه من نتوانست دریابد که از کدام حیواناتست.	but could not distinguish them by the taste.
هرگز فرصتی پیش نیامد تا یکدیگر را به تنهایی ملاقات کنند یا از عشق خود سخن یگویند.	they never had the opportunity to be alone or to talk of their love.
هرکدام احساس کردند که سخت میل دارند بروند و از نزدیک این چیزهایی را که جو گفته بود ببینند.	the family felt inclined to go visiting in a body,
زیرا که چنین خواب تعبیری غیر از هفت سال فراوانی و هفت سال گرانی ندارد	for that would only betoken for us seven years of plenty and seven years of scarcity
خب من دی گه تا اون حدش نمی دونم	well, I wouldn't go as far as that.
زیرا درازی تیغ او تقریباً دو برابر داس دسته بلند معمولی ما بود.	for the razor was almost twice as long as an ordinary scythe.
او را با رنگی مهتابی و حالتی حاکی از ضعف آوردند و به روی دیوان نشان یدند.	so they brought her in, looking very white and weak, I thought, and sat her on a sofa.
بگو آن دو ماهی دیگر یعنی استرلت و لامپ روا را بیاورند	have the other fish brought in the sterlet and the lamprey
پس از آن هر دو ارتش به صف شدند	after which the armies fell into line
پدر که صورتش از قبل هم تیره تر شده بود گفت	the father said, greyer than ever now.
اما از خوشبختی من مشارالیه در پیش دانکلار محتاج به حمایت نیست.	but, happily for me, he can dispense with it
منظورم ای نه که حتی جاهایی هم که کسی زندونی نیس بوی شاش میده.	I mean, even the places where no guys are locked up, it smells pissy.
نخواهم شناخت و در راه عشق و محبت این مردم فدا کنم.	of love from men I don't know and never shall know, for the love of these men here
من امروز صبح رفته بودم بالا وقتی که دیدم کف اطاق چه جوری ترک برداشته فوری دویدم پائین!	I was up the belfry smorning, and I tell you I come down faster I went up, when I saw how that there floor's a busting underneath them.
مثلا من ابلهی هستم که قلب دارم ولی هوش ندارم.تو برعکس احمقی هستی که هوش داری ولی قلب نداری	I am one and you are the other
او کسی را ندیده بود که به چنین طرز درخشانی از هنرهایش قدردانی کند.	she had never seen anybody so splendidly do justice to her talent.
چطور که بایست در این دنیای دون تنها بمونن.	to be left alone in the cold world so.
نمی تونی به هم بگی که نمی خو ای از این جا بزنی بیرون .	I sort of belonged here.
حس کردم یکی دو قطره خون از سرم روی گردنم غلتید	I felt a drop or two of blood from my head trickle down my neck
اما به هر حال از ماشین پیاده شد و به سمت در ورودی خانه	but she got out of the car and bolted for the front door.
تنها دردسرشان این است که آن را مصرف نمایند.	their only care is to dispose of it.
عجب است مسی و مگر شخص در خانه خود مختار نیست	am I no longer at liberty
تا شاید دبرای با او به لحن دیگر صحبت نماید	awaited one kind word of consolation.
آخر آنجا آدم باید تربیت و اصل و نسب خوبی داشته باشد تا شوهر ثروتمندی نصیبش شود.	where a woman has to have breeding and background to catch a rich husband.
قضا و قدر او را از کنار معشوقه دور کرد	one of those caprices deprived him of his mistress, of the future of which he had dreamed
اما من نیم ساعت زد تر دفتر را ترک کردم	but I leave work half an hour early.
به هر حال نسبت به او کنجکاو شده بود.	had awakened in her a curiosity that was difficult to resist
ولی از نوک درخت تکان نخورد و میخکوب سر جای ماند.	but he did not move from his treetop.
مثلاً قامت بلندترین اسبان و گاوان میان چهار و پنج بند انگشت است.	for instance, the tallest horses and oxen are between four and five inches in height
قبل از اینکه من بیرون رفته و در کنار ساحل تفرج کرده بود به قول خودش با نصف ملاحان آن منطقه طرح دوستی ریخته بود.	had been strolling about the beach before I was up, and had made acquaintance, he said, with half the boatmen in the place.
بلکه حتی از اندیشیدن در این باره هم بیم داشت.	but was afraid even to think about it.
در واقع این ویژگی بین اهل سینما کم شایع نیست.	not so rare a thing in the theatrical profession
به سمت آن تپة سنگی که پسرک روی آن ناپدید شده بود به راه افتادم.	made for the stony hill over which the boy had disappeared.
تا آنکه پنج قدم آب در داخل کشتی بالا آمد	not much only two inches an hour but still it rose
فقط چند چوب پرده با شکلی حزن آور و رقت انگیز بر جای مانده بود.	only the remnants of the lace curtains remained, clean but obviously mended.
فضای دخمه دوباره تار شد و بعد دوباره روشن و واضح به نظر رسید.	the dungeon dissolved again.
که در آنجا به دنیا آمده و ایام کودکی را به سر برده بود رفت.	estate where he had been born and spent his childhood.
اما او مردی بود که جوانی را پشت سر گذاشته بود.	but he was a man whose youth was past
آن عده توانستند خود را به عرشه زیرین برسانند	they succeeded in gaining the forecastle deck, where
این حوادث صرفاً به این دلیل روی میداد که روستاییان میخواستند با خیال راحت و بدون مسؤولیت کار کنند	but it happened simply because all they wanted was to work merrily and carelessly,
پهلوان بی آنکه بداند چگونه چنین اتفاقی افتاده است	without his knowing how or in what way it happened
خود را بروی کشیش انداخت و به کندن ردا و باش لق او پرداخت.	dismounting briskly from his ass, rushed towards him and began to strip off his gown.
با اولین پسری که به چنگش آمد دعوا راه انداخت.	started a quarrel with the first boy that came handy.
پیرمردی سپیدمو با لباس ملیله دورزی زرین به ندیمه بلندبالای زیبایی	 said a gray headed, little old man in a gold embroidered uniform
آدم هرگز نبایس واسه هیچ و پوچ ناله کنه.	you must never bawl again over anything.
مدتی با احساس واقعی از خوشحالی و سپاس خود حرف زد.	continued some time to speak with serious feeling of his gratitude and happiness.
در نظر اول شکل و قامت مرا چنانکه باید ندید	not well observing my shape at first view
باز تعظیم کرد و گفت اگر نمایش او باعث تفریح حضار شده استدعا دارد که منت گذارند و رفقایشان را دعوت کنند که شب بعد برای دیدن نمایش حاضر شوند.	then he makes them another bow, and says if he has succeeded in pleasing them and instructing them, he will be deeply obleeged if they will mention it to their friends and get them to come and see it.
من از این لحاظ با اونها فرق دارم چون خودم هم زیاد خوشگل نیستم.	I'm different because I'm not so good looking myself.
نماینده شرکت کش تیرانی سوار اتومبیلش شده به شهر رفت	the shipping agent to return to his car and drive away into town
اما سقف میانه چشم او و آسمان حایل بود.	there was a stone veil between him and the firmament.
نه فقط نشستن و زل زدن به صفحه تلویزیون.	not just to sit there like couch potatoes staring at the screen.
که این لولا ناگهان به حرکت آمده و حیاتی هولناک گرفته	that that hinge had just become animated, and had suddenly assumed a terrible life
این طور با قیافه ابلهانه به من نگاه نکن.	don't look so silly, now!
چندان که حسن و جمالش آوازه جهانگیر داشت به وقاحت و بی شرمی نیز شهره دهر بود.	she left the world as full of her vagaries as of the fame of her beauty.
قلبش در اثر رویدادهای زندگی تبدیل به خاکستر گردیده بود	with her heart turned to ash
وقتی پدرم وارد شد علت جیغ کشیدن مرا جویا گردید.	papa asked what was the matter
دو ژاکت از جنس پرم بز به رنگ آبی مرغ ماهی خوار	two chamois leather jackets of kingfisher blue
گفت من میل دارم میگساری کنم و کام لا مست شوم مانند بار گذشته	I want to drink. I want to be quite drunk, as we were before.
پس این بار حد خلاصی خود را به سه ماه قرار گذاشت	he therefore fixed three months
من شام مفصلی خوردم زیرا مثل باز شکاری گرسنه بودم.	I was as hungry as a hawk
او را در نظر بیاور که در بیچارگی خود تا چه حد ناتوان است.	how weak he is in his misery!
می خوان اگه ممکن با شه بهشون غذایی بدیم.	they wonder if we could spare a bite.
این کار جز تلف کردن وقت چیز دیگری نیست.	he was wasting his time.
فردای آن روز به کلیسا رفتم و در مراسم تدفینش حضور یافتم	but two days after, I went to her funeral
قول دادند که یکدیگر را از حال هم با خبر سازند.	promised to let each other know how things went with them
حالا پای راستش را بلند کرد و بعد پای چپش را	he lifted his right foot and then his left
صدای بامب بلندی از سقف دفترش به گوش رسید	there was a great BANG! on the ceiling of the office
چیزی که پهلوان را بیشتر در پندار خود صائب گردانید	he was all the more confirmed in this notion
تقاضای او هم حتما مورد قبول قرار خواهد گرفت	the petition will certainly be granted.
ترجمان گفتن آغاز کرد و چیزها گفت که هرکس فصل بعد را بخواند یا بشنود آن سخنان را خواهد خواند یا خواهد شنید.	the interpreter began to say what he will hear or see who reads or hears the next chapter.
اما ترق تروق در اتومبیل و صدایی به گوششان خورد.	but they heard a car door slam and they heard voices.
روزی را که قرار بود او خوشحال تربن مرد عالم بشود تعیین کنند.	the day would be fixed that was to make him the happiest of men.
او اشتباهاً نوضوع را فهمید و در را کمی باز کرد که ما داخل شویم.	she misunderstood him and opened the door a bit wider to let us in.
در آنجا با افرادم به پیش تاختم تا از موقعیت آگاه شویم و قبل از این که بقیه برسند امنیت آنجا را بررسی کنیم.	I trotted forward with my men, to be sure against accident in the place, and to feel again its remoteness before the others came.
مسی و آ به که نه خصوصیت و دوستی شخصی و نه ملاحظات دیگر	no ties of friendship or humane consideration
به لب برد تا بنوشد لیکن از صدای فریاد اربابش دست نگاه داشت.	as he was raising it to his mouth he was stopped by the cries of his master exclaiming
در مورد گذشته هم دی گه کاری نمی تونم بکنم.	I can't help what's past.
مثل اینکه فراموش کردی داروهات را بخوری پسر دیوونه	I think maybe you forgot your medication today mental boy
شک دارم که توی آن مدرسه عریض و طویل حتی یک بچه هم پیدا بشود که این کتاب را خوانده باشد.	I doubt there is a single child in the entire school who has read that book
زیرا او که چندین ساعت در این وحشت به سر برده بود که مبادا یکی از همنوعان خود را زخمی کرده باشد	who, after labouring, for some hours, under the fear of having mortally wounded a fellow creature
آقای التن از درِ باغ سبز صحبت کرده بود.	that he should talk of encouragement
آنگاه هر دو به طرف در ورودی عمارت آمدند	he generously returned.
او چند چیز پیدا کرد که قبلاً فراموش کرده بودند .	she discovered overlooked articles which could abide nowhere else
من تأثیرات اینکه یه پیرزن توی بیابون گم وگوربشه و از سرماو گرسنگی بمیره رو نمیتونم درک کنم	I don't see no implications in leaving an old woman to wander around day n night until she dies of exposure
که در قفسه تاریکی در اطاق ناخدا نگاه داری شده بود.	in consequence of being kept in a dark locker of the cabin.
کاری نکن که کفرم در به یاد و دسم بالا بره	I'd like to take a sock at you.
یادآوری آن همه حدس و گمان باطل آن قدر ناخوشایند بود	the remembrance of all her former fanciful and unfair conjectures was so little pleasing
در ظاهر درست همان کس بود که بایست آهن خود را پرتاب کند	would seem the very man to dart his iron
تا روپوش تور او که مبل هنگفتی برای آن پرداخته بود خراب نشود و میان لبش را بوسید.	he had paid a good price, kissing her straight on the lips.
هرچند که تا مرحله سوء ظن بردن به مافوق تجاوز کند.	although suspicion directed above ourselves is an abuse.
امکان نداشت از دست این مرتیکه الدنگ شکایت بک نه.	never have sued thatguy, you bet, unless she had to.
چنانکه در حین سخن گفتن زارزار به گریه در افتاد.	bursting at the same time into a flood of tears
اگر چه نزد خود اقرار نمیکرد زنش را کیفر دهد.	though this he did not admit to himself to punish her.
دقیقا مانند صفحه موسیقی که شامل نت است و نباید از آن تخطی کرد	like our music paper.
تا اینکه آن را سر بکشند و دل درد بگیرند.	till they have swallowed it and got the colic.
بگذار من هم بیایم و چند تا آهنگ با تو بزنم.	let me come and play some airs with you.
او مکرر گوش خود را بدو قدمی من نزدیک کرد.	he often laid his ear within two yards of me.
آن را به جهت ستر عورت مانند کمر بند به کمر بستم.	fastening it like a girdle about my middle, to hide my nakedness.
ما هم می تونیم هم ون روز برای خرید بریم.	we can go and get all your things then, too
از آنجا مهمانان را به دفتر کارش که نیمکتی مندرس و قالی رنگ و رو رفته داشت	finally into his private room where there was a tattered sofa, a worn carpet
منظور نظرم دلیل و علتی است که نزد آن دختر خانم جایی و اهمیتی داشته باشد.	I speak of causes and reasons that will tell as such with the young lady.
اگرچه مبلغ نهصد هزار فرانک مبلغی است که قابل آن هست که شخص را دلخور دارد.	though, after all, 900,000 francs are worth regretting
ولی قطر آن از یک سکه طلا بیشتر است.	but thicker than a half crown.
کاری که در مقابل درس و مشق مدرسه حکم بازی را داشت.	play compared to the horrors of school.
شما به عنوان یک وطن پرست واقعی حتما با کمال میل آن فداکاری را خواهید کرد.	without doubt you as a good patriot will be happy to make them.
یعنی به اصطلاح به نگاه اول وقتی که هنوز نفسم درست جا نیامده بود و او هم آن طور غیرمنتظره نشسته بود ترسیدم	that is, after the first jolt, as you may say, when my breath sort of hitched, he being so unexpected
بلکه یمل دارد سر گفتگو با او باز کند	but to getting into conversation with her.
در آنجا مشاهده کردم که او مرا دنبال نکرده است.	where, finding I was not pursued
یا یک گیلاس آب سرد با شکر میل کنید.	or else a glass of fresh water with a little moist sugar.
با این حال در شورای فرماندهان گردانها تصمیم گرفته شد که هنگ را در حال توقف برای سان آماده سازند.	it was decided at a consultation between the battalion commanders to present the regiment in parade order
استیک و سیب زمینی سرخ کرده و برای دسر قهوه فوری و کیک توت فرنگی خوردند.	the steak, the french fries, the instant coffee, the strawberry rhubarb pie.
تا آنکه یا دستور محاکمه مجددش صادر شود و یا زمان اعدامش فرا رسد.	he was to be restrained untilordered retried or executed.
با دقت کامل همه چیز را زیر نظر داشت.	was watching things very closely.
دوست من! امیدوارم که شما آرزوی پدرتان را به جای آورید.	I hope, my dear friend, you will carry out your father's wish?
بر چهره پیرمرد نیز اکنون غمی اضافه بر آنچه بود آشکار شد.	so over the old man's face there now stole some such added gloom as this.
چشمان خود را کام لا بسته است تا صدایش را بهتر بشنود.	he has closed his eyes to hear it better.
دخترک که بر آستانه در خانه ایستاده بود به سرا چترش رفت و آن را باز کرد.	she stood on the threshold, and went to fetch her sunshade and opened it.
اگر تا دو ساعت دیگر به آنجا باز نگردم از لقب نر دک محروم خواهم شد و به همه اعلام خواهند کرد که من خائنم.	if I did not return in two hours, I should be deprived of my title of _nardac_, and declared a traitor.
ولی زندگی آن خانه خیلی پرزورتر از صفات نیک او بود.	but life in that house proved stronger than her virtue.
تمام توجهم به این بود که چطور ضربه بعد از این فحش را تحمل کنم.	my care was how to endure the blow which would certainly follow the insult.
ضمناً در این اواخر اشتهایش را نیز از دست داده	although in the last days he lost his appetite
با ادای این حرف به بریدن چوب خود پرداخت.	went on sawing his wood.
به جهت بعضی مصالح لازمه و مه مه تجارتی	on account of certain commercial speculations
ناگهان شاهزاده آندره پایان عشق خود را به یاد آورد.	suddenly he remembered how his love had ended.
به طرف پنجره برگشتم و کتاب را از آنجا آوردم.	I returned to the window and fetched it thence.
به فکرش نرسیده بود که از نظر رین مشکل اصلی نامش بود.	her name was indeed the crux of the matter.
اما جغد خشمگین با عصبآنیت منقارهایش را باز و بسته کرد و پروازکنآن به جایی دور از دسترس هری رفت.	but she clicked her beak furiously and soared up into the rafters out of reach.
به نظرم پنج دقیقه بدون مکث و نفس تازه کردن برایشان حرف زدم	I declaimed for five minutes without drawing breath
مگر این سخن معروف را که ملل مختلف هرکدام آداب و عادات مختلف دارند.	farther than the common answer, that different nations had different customs.
بی آن که دیگران چیزی از آن بدانند و یا خود غالبا بتوانند در دل بدان اعتراف کنند!	unknown to others, often unconfessed to herself!
دهان مردی که داستان عرعر خر را گفته بود از حیرت باز ماند	the landlord in perplexity, and, in short
چون هنوز این مسئله مشکل لاینحل مانده است و این عقدة سرسخت هنوز بازنشده	as this knotty point is still unsettled,
تا روزی برسد که دختران بتوانند خود پیراهن خود را به برکنند	till they come to dress themselves
تا اینکه بالاخره پروندهٔ کلفتی در نهایت کار با مهر تأیید بیرون آمد.	until the final dossier emerged with the stamp of approval.
سه مسافری که تصادفاً تازه به کاروانسرا وارد شده	to three other travellers who had by chance come to the inn
به صورتی بی سابقه در چنگ آن اسیر شد.	she fell into its hands as she had never done before.
آن عبارت بود از پنجاه کشتی جنگی وعده فراوانی کشتی باری	consisting of about fifty men of war, and a great number of transports
موقعی که آن دو پرتره مورد پذیرش قرار گرفت احساس غرور کرد.	he was not less contemptuous when the two heads were accepted.
درختان میوه را حصیر پیچ کرده بودند و درخت مو چون افعی بیماری روی داربست در طول دیوار باغ افتاده بود.	the espalier covered with straw, and the vine, like a great sick serpent under the coping of the wall
خود را وقف کار و فعالیت در لابراتوار عکاسی بنماید.	dedicated to the operation of a daguerreotype laboratory.
اینست که او در آن روز راه خود را یکراست در پیش گرفت	is that he was on the road all day,
که به سرعت از موضعی که مکشوف و بی درخت بود بگذرد	pass as quickly as possible through the flower garden
این مسلم است که پیروزی بر پهلوانان آراگون به مثابه پیروزی بر تمام پهلوانان جهان خواهد بود.	would be winning it above all the knights of the world.
او را کام لا آزاد گذاشت که در موقع نبرد به میل خود یا در کنار او بماند	giving him full liberty to remain with him during the battle or to join the rearguard
صدایم بلندتر از حد معمول خارج شد زیرا کلمات او مرا متحیر کرده بودند.	my voice came out higher than usual because the word took me so by surprise.
خاصه هیچ از خاطرش نگذشته بود که بتوان این اثر را روی صحنه آورد.	it had certainly never occurred to him that it might be produced on the stage.
آگلائه جلو بیا و مرا در آغوش گیر.فعلا ابراز محبت بس است.	come and kiss me there that's enough
که ذهن شما متوجه آن گردد ناگزیر آن دیگری از است شعار موقت شما به کلی بیرون خواهد شد.	in such a manner as to bring your mind to bear on it, the other will be utterly excluded from your contemporary consciousness.
من برای این کار زمین زیادی در اختیار ندارم.	I ain't got a big enough place for that.
به واسطه هذیان او تشدید یافته بوده که نایبان او مجبور شده بودند دست و پایش را محکم ببندند تا باقی سفر را در ننوی کشتی عربده بکشد.	was moreover intensified by his delirium, that his mates were forced to lace him fast, even there, as he sailed, raving in his hammock.
اما اینک دیگر میل نداشت به خانه او برود.	but now he felt disinclined to go to it.
این حادثه آنقدر برای همهٔ حضار غیر مترقبه بود و آنقدر با امیدواری عمومی تضاد داشت	something so unexpected by all of us and so contrary to the general hope
فرانک چرچیل به رلی آن که کمی از دست دختر خلاص بشود	to escape a little from the latter
آنان از او پرسیدند که گنج را در کجا پنهان کرده است	they asked him where the treasure was.
متوجه شد که چگونه به اوج بدبختی رسیده است.	because it permitted her to realize the extreme of unhappiness she had reached.
ولی در واقع به امید این که یک عشق دیگر بتواند جانشین عشقی بشود که برای پسرش جای زندگی باقی نگذاشته بود.	but actually in the hope that another love would cure him of the one that did not allow him to live.
یک قهوهی بزرگ و یک پرس سوسیس سفارش دادم.	I ordered a large coffee and a couple of frankfurters.
جز صدای چک چک آب از فیلتر به تنگ سفالی بزرگ زیر آن	except the drip of the water from the filter into the vast earthenware jar under the wooden stand.
اما مطمئن باش که من هم عن قریب همین قسم خدمت به تو خواهم کرد	be assured I will return the favor hereafter
بالاخره گیسوان او را رو به بالا شانه کردند بطوریکه قیافه وی را یکباره تغییر داد	just as her hair had been arranged on the top of her head
هیچ کدامشان شعرهایی را که بایست حفظ کرده باشند کاملاً بلد نبودند.	not one of them knew his verses perfectly
بنابراین راه افتادیم رفتیم طرف آلونک آن را ببینیم.	so we went on down to the hut by the ash hopper for to examine it.
من اطلاعاتی در مورد این شهر تیره و سیاه می خوام.	I want to get some information about this benighted town.
که شاگردی برای کسب و کار یا پادوئی احتیاج داشت.	who wanted an apprentice to any trade, business, or calling.
همان جا ایستادم تا به موضوع بحث پی ببرم.	waiting to hear what the argument was about.
آن چنان که یک ساعت میزان تا به آن حد هماهنگی ندارد.	so perfect that the best regulated clock could not surpass it.
که خواهر کوچک سه ساله او را هم با خود آورده بود.	who was accompanied by a little sister threeyears of age.
گفت که ناخدا فرمان داده است که مرا در ساحل فرود آورد.	said, he had orders from the captain to set me ashore.
نکنه قبل از اوم دن لوئیز دکم ون کن ین.	I hope you wont make us go before she comes.
به علاوه این بچه هم آن قدرها شکمو نیست که آن را دوست ندارد.	I dare say the boy isn't too dainty to eat 'em
فریاد زد نه به را پول نه به را مزد!	not for money, not for wages! he shouted.
ولی ترسیدم که مجاورت مادیان من اسب شما را ناراحت کند.	but for fear that horse might turn restive in the company of my mare.
از کنار ناودان کله اژدری وارد راهروی تاریک شدند.	emerging next to the gargoyle in the darkening corridor.
بعد از آن همه عمرمان را زن و شوهر هستیم.	we shall be married all our lives after.
اما همراه پسر بچه دنبال دکتر تا خانه رفته بود.	but with the boy followed him to the house.
قصدم نخست این بود که به منظور انجام خدمتی نامه را بدست خود شما بسپارم	I confess I thought of doing you the service of handing the letter over to yourself
بدتر از هر تصویری که تا به حال در سرم نگه داشته بودم.	worse than any image I'd ever held inside my head.
به مرض جلدی تمارض کردم و قدری گوگرد خواستم به من دادند و از او کبریت ساختم	I pretended that I had a disorder of the skin and asked for a little sulphur which was readily supplied
می تونستم صدای تپش بی نظم قلبش رو بشنوم.	I could hear her heart, thumping unevenly.
تو نباید مرا در این حالت ترک کنی و از اینجا بروی.	you shall not leave me in that temper.
ولی یک پارکینگ داشت و او کامیونش را در آنجا پارک نموده و آن را قفل کرده بود و سپس تلگرافش را ارسال داشته بود.	but it had a parking lot, and here he had parked and locked the truck, then sent his cable.
تا در آن هنگام که بزرگ شدند عصای پیری ایشان گردند	so that when grown up they may be the staff of their parents' old age
سپس گروهی از مردان به خوبی مجهز شده را جمع کرده و جهت یافتن اورسولا در مسیر ناپیدایی به حرکت درآمد.	was lost on invisible paths in pursuit of 'rsula.
فکر کنم وقت شه که با او نا آشنا به شی .	I think it's time for you to meet them.
این بود که خیلی زودتر از موقعی که باید برسم رسیدم.	so I got home a heap too quick for that length of a trip.
که به ترتیب آهن اول و آهن دوم نام دارد.	respectively called the first and second irons.
به قدری تند دوید که تا نزدیک خانه به او نرسیدم و آنجا او را گرفتم.	she ran so fast that we were very near the cottage before I caught her.
بعد خواب پیرزن را دید که روی تراس نشسته بود.	then of the old black woman sitting on her porch.
اینست محیط طلسم شده و زندان یأس آوری که رهایی از آن برای من میسر نیست.	these are the enchanted circle I cannot escape from.
من مایل بودم که حداقل یکی دو هفته بیشتر دقت داشته باشم.	I'd like at least a couple of weeks longer.
در برابر هرگونه جدایی غیرمنطقی بین دانش پزشکی و جراحی ایستادگی بورزد تا هم بتواند تحقیقات علمی خود را دنبال کند	resist the irrational severance between medical and surgical knowledge in the interest of his own scientific pursuits
هر آن منتظر بودم که سرش پایین بیفتد و در پشت پیش خان دکان ناپدید شود	that I fully expected to see his head go down behind the counter
امیدوارم میل شما برای دیدن من به علت بازگشت علائم بیماری نباشد.	I hope your wish to see me is not due to the return of unpleasant symptoms
که حال و هوای پنهانی حاکم بر رویکرد عمیقا حسی و کم و بیش خاموش و بی صدای این مرد را نسبت به جهان اشیاء مادی درک کرد	to detect this secret mood which governed the profoundly sensible, almost voiceless attitude of this man towards the world of material things.
واقعاً استحقاقش را هم داشت چون زن خیلی خوبی بود.	she deserved it she was a very good woman.
آنگاه چون بیش از نصف جثه تو تحلیل رفته است گند لاشه تو چندان خطرناک نخواهند بود.	neither would the stench of your carcass be then so dangerous, when it should become more than half diminished.
هر چیزی که فکر تو را پریشان کرده به من بگو تا راحت بشوی.	your mind of any weight that oppresses it, by imparting it to me.
امر کرد فوراً بیرون برود وگرنه محتوی ظرف کذائی بر سرش خالی خواهد شد.	ordered him instantly to depart, on pain of receiving the contents upon his portly person.
اما از این چیزها هم با عشق لازم است.	but there must be something else to go with it.
آن هم در سن و سالی که ظاهراً همه چیز به حد تکامل خود رسیده بود.	at an age when everything had seemed complete.
قتلی که اخیرا در شرایط عجیبی صورت گرفته و در شهر جارو جنجال بزرگی به راه انداخته است.	about a recently committed murder which the whole town was discussing, and as he thought of it something strange came over him.
در حالی که نفر سوم بین دوپای من قرار گرفته و بر من سوار است.	while a third man rode me astride.
با ارز خارجی معتبر به بانک مناسبی واریز شده است.	had been received into the appropriate bank in hard currency.
خود را در خانه خویش و در لنگرگاه آرامی یافت.	he felt himself at home in a quiet haven.
قرار است که من فردا در همان ساعت تلفن کنم.	I'm due to try again tomorrow at the same time.
که شما باید زن بگیرید. چاره ی دگیری ندارید.	that you ought to get married, that's what I say.
تا ردپایی از خود برجای نگذارند و به هیچ فرد آشنایی برخورد نکنند.	so that they would not leave any trace or meet any people they knew.
باز هم او علاقه خاصی به زوبین خودش دارد	yet he had a particular affection for his own harpoon
ولی اظهار داشتند که همه چیز بر وفق مراد است.	but protested that all was well.
یا معتقدم که چون شما جوان هست ین من نباید چنین واقعیتی را به شما به گم.	or because they think I should not tell you so, young as you are.
اما پیش از آن هرگز از تلفن استفاده نکرده بودند.	but had never used a telephone before.
نجیب زادگان فقیر را به سفره مجلل و شاهانه خویش دعوت کند	let him entertain poor gentlemen with the sumptuous fare of his table
زیرا من در آنجا دیدم که شب شد و روز آمد و باز روز شد	because night overtook me while I was there, and day came
در دل خود عشق سابق را نسبت به او نیافت.	did not find in his heart his former love for her.
اکنون از ترس اینکه مبادا پدرش از گناه او آگاه شود و آتش خشمش زبانه بکشد	was waiting for an opportunity of making it known with safety to himself
ولی ظهر روز بیستم متقاعد شد که این طور نخواهد شد.	but by noon of the twentieth, she admitted it wasn't happening.
سر بگردان و به آن سو نگاه کن تا ببینی که پهلوانی سرگردان بر زمین دراز کشیده است	turn thine eyes and look, and thou wilt see stretched there a knight errant
تنها از رنگ چهره او به این نتیجه رسید که چندان تندرست نیست	he simply formed an unfavorable opinion of the banker's constitution
فر کردم بیایم ببینم بعد از دیشب در چه حالی هستی.	I thought I'd come and see how you were after last night.
این چیزی نیست که مرا از کوره در ببرد.	it is not a little matter that puts me out of temper.
در عین حال متعجب بودم که چرا او این قدر مضطرب و معذب شده.	I wondered why he was making such a fuss.
خروس نحیفی که در مقابل دو خروس جنگی مخاصم ایستاده باشد.	or a little shuttlecock against two battledores,
اما در همین اوضاع و احوال بود که تصمیم مهمی گرفت	in this position he took an important resolution.
چون متوجه شد از این کار نیز دردی دوا نخواهد شد	finding that mode of treatment wholly ineffectual
روی هم رفته از بعضی جهات خدمتکار مطلوبی نیست اما کارش خوب است.	not altogether unobjectionable in some points, but she does well enough.
زیرا بخت بد مرا به آن دیار افکنده بود	because I had been thrown into his kingdom by my misfortunes
زیرا من ناچارم تکرار کنم که او وقتی پدرش مجبورش کرد که به این ازدواج تن دردهد فقط یک پسربچه بود	for he was, I repeat, a boy, when his father ordered him to marry.
بعد از آن دانتس صدای خراب شدن و ریختن چیزی از خاک و سنگ به زمین شنید	he then heard a noise of something falling
متأسفانه نبوغ من حتی آن اندازه نیست که مرا به پای نقاشان بزرگ برساند.	I am afraid mine would not carry me even to the pitch of doing well what has been done already
لکن دیروز دو بار با چنان نگاههائی به من خیره شد که پشتم بلر زه افتاد.	but yesterday he looked at me in such a way that a shiver went all down my back.
که او دمی چند به جرگه آن جماعت خوش گذران درآید.	he was just beginning to be a part when that terrible accident had occurred.
درد او ساکت شد و در عوض تحمل این وضع نامطبوع موقت مکانی را روی سکوی توپ به دست آورد	the pain had passed, and at the cost of that temporary unpleasantness he had obtained a place by the cannon
ازدواج بین یک زن اسرار انگیز و جوانی که ممکن است ندیم شاه گردد.	a marriage between a questionable woman and a young fellow who might be a flunkey.
با طبیعت لجباز این خطاکار پیر آن قدر آشنا بودم	I had seen enough of the contrary nature of the old sinner
که نسبت به همسرش سپاس و مهری دو چندان احساس کرد.	that he experienced towards her at the moment a great increase of gratitude and tenderness.
بر ما زیردستان است که آنان را در خور مقام ارجمندی که دارند تکریم کنیم.	who ought to be treated with the utmost respect due to their sublime dignity, by us their inferiors.
به زندگی سابق ادامه داد و با مجاهدت خاص به ساختمان ابنیه	resumed his former way of life, devoting himself with special activity to building operations
خود را به زور به جلو حرکت داد تا اینکه قسمت جلو شکمش دوباره به دست سرباز خورد.	he forced himself forward until the toe of his shoe struck the soldier's hand again.
پس از آن راجع به حاضر کردن کره اسب با او صحبت کردم.	I negotiated with him about the pony.
آن وقت مجبور است تغییر وضعم را به حساب بیاورد.	she must recognize the change in his position.
هر چه که در این جا نادرست باشد من تغییرش خواهم داد.	I'll change everything here that's not right.
درست مانند روی من در آن روزی که به زندان آمدم و دیوارهایش را دیدم.	they remind me of prison walls when I was first brought here.
حالا روش رو بپوشونین و بذارین به کار خودش بر سه	now cover 'im up and let 'im get to his work.
مرا به اتاق خواب راحتی بردند که روی در آن نام دال فین نوشته شده بود.	I was shown up to a nice little bedroom, with DOLPHIN painted on the door.
به زندگی عادی خود بازگردد و در اتاق خود آرام و آسوده در بستر بخوابد.	return to ordinary conditions of life and sleep quietly in a room in his own bed.
خود نیز بی آنکه کسی را از غیبت خویش آگاه کند راه خارج شهر را در پیش گرفت و رفت.	then himself quitted the city without letting anyone know of his departure.
بالاخره هومه میانجی شد و توانستند کشیش را برگردانند.	they succeeded in making the priest sit down again
که تو را خشمگین سازم و به چشم خود دیدم که دیدگان تو از فرط غضب برق زد.	to tease you and I saw your eyes glow.
تا این که به طور کلی در روشنایی شدید دم ظهری ناپدید گردید.	fading away in the radiant light of noon.
نمی تواسنت برای توصیف چگونگی حال شوهرش کلمات دیگری بیابد.	that was the only way she could define his condition to herself.
انگار تازه متوجه شده بود که اون این جاست.	as though he'd only just realized he was there.
تصمیم دارم به آن دو مرد جوان هم بگویم.	I'm going to invite the two young men.
با لحنی کم و بیش خشک و تند به پیرمرد گفت	he said with some asperity to the old man.
قبل از اینکه از خانه خارج شوم شروع به دویدن کرده بودم.	I was running before I was out of the house.
لوسی حتی به همین احتمال نیز آماده بود در هفته هفت روز هر روز تمام روز را آنجا بگذراند.	on that possibility she would have waited out the day, seven days a week.
هر دو به راه افتادیم و از تپه بالا رفتیم و به نزدیک لینتون رسیدیم.	so we climbed the slope of heath together.
کنت همین دستور را نیز به پیشکار و خدمتکاران خود داد.	the count gave a similar order to the major domo and the servants.
اما او درست بر سر راه من ایستاده بود	but he placed himself directly in the way
همچون پیشانی کسی که عمیق و با حضور ذهن در اندیشه است.	as with one thinking deeply and intensely.
ما به خوبی دریافته بودیم که امید این نیست	it was plain from the first
که در جای خود از آن دشمن خواهم گفت.	as I shall relate in its proper place.
در این موقع نگاه حق به جانبی به بسته انداخت.	said she, with a conscious look.
چیزی هرچند مختصر از مضمون رؤیاها و قدرت تخیلاتش خواهد فهمید.	she would come to understand something, a little something, of the stuff of his dreams and the strength of his power.
با کارتی که خودش برای هری درست کرده بود وارد اتاق شد.	turned up with a get well card she had made herself
زیرا فاقد آن قریحه و استعدادی هستند که خود دارند.	because they want the same endowments.
مینشست تا آسمان روی خود را به سیاهی آلاید.	before he showed himself.
برای آنکه کاغذ لک نشود آن را کنار گذاشت.	moved them before they could be blotched.
من میگویمسلطانک چون که سلاطین کوچک بیش از سلاطین بزرگ خوش گذرانند.	I said 'fisher,' because kingfishers see a good deal more fun than kings.
نگاه خیره و ناگهانی خود را در تاریکی زمستان به تختخواب و دیوار دوخت	sent its sudden stare over bed and wall in the darkness of winter,
نتیجه کار او زندگی را بر دانشجویان سخت دل پذیر و پر بار کرده بود	whose attainments made the student's way unusually pleasant and profitable
ولی عقیده داشت که این عشق نباید مانع آن شود که مردان دیگر با او آشنا نشوند و پیشنهاد ازدواج ندهند.	but that did not prevent her from inveigling other men into asking to marry her.
با این سخن روی کف چوبی اتاق لغزیده از در تالار بیرون رفت و به باغ دوید	glided over the parquet to the door opening into the garden, where
درست مثل اینکه زمین را به او داده و پس گرفته باشد.	it was like giving him the land
صورتش در نور مهتاب مثل گچ سفید شده بود	his face white in the moonlight
قصد برگشتن و پرداختن کرایه قایق را هم نداشتی.	you did not expect to have to come backand pay for it anyway.
شاید عشق ارلاندو به شعر را باید شماتت کرد	it may have been her love of poetry that was to blame
زیرا من به چشم خود دیدم که او خود را از پشت زین بر زمین انداخت و با غم و اندوهی فراوان دراز شد	for I saw him fling himself off his horse and throw himself on the ground with a certain air of dejection
که بتواند در این تردیدی به دل راه دهد	who could possibly doubt,
دست دراز کرد و قرص نانی را که در دسترس خود یافت برداشت	he caught up a loaf that was near him
آن دو ماجراجو در تاریکی رو به مسافرخانه راه افتادند.	the two adventurers crept in the gloom toward the tavern.
وی پاکتی که در کاغذی پیچیده شده بود به دست	with a paper parcel under his arm.
حتی موجب شده بود که رئیس جمهور با گروه ملازمانش به آن دیار سفر کند	had certainly helped so greatly in bringing about the presidential tour
وی که نه نام خانوادگی داشت و نه سال تولدش معلوم بود	as he had no surname, and we could not tell his age
سپس مهمیزی به کره اسبش زد و به سرعت از من پیش افتاد و مرا ناراحت و نگران به جای گذاشت.	she set off at a gallop, leaving me to toil in the rear.
زیرا به علت درد شدید پیشانیش قادر به شرکت در کلاس نبوده است.	claiming that his scar was hurting too badly to continue studying.
برای خدا دستور بدهید ایشان را بیرون کنند و نزدشان نروید.	have them sent away and don't go out to them.
لذا همه به سمت مکانی که جوان هنوز با نوکر خود به گفتگو و جر و بحث مشغول بود به راه افتادند.	so they hastened to where he was still talking and arguing with his servant.
زیرا اتفاقا قاضی دیگری ریاست دادگاه را بعهده داشت.	because a different magistrate had chanced to be on the bench
سیل آب بقایای شهید فقید را شست و سیراب کرد.	a deluge of water drenched the prone martyr's remains!
تاکنون نیز بی آنکه حاکم بوده باشی زندگی کردهای	you have lived until now without a government
مومیایی با صورت روی زمین افتاد و روی زمین غلتید.	it became entangled, fell face forward, and
که آرزوی درک همه چیز جز کبر و غرور چیزی نیست	that it is impossible to understand all
تا راه زودتر باز شود و او دچار یک ربع تأخیر ورود نگردد.	had endangered his arriving at the office, a quarter of a minute after his time.
شاید اصلا دلش نخواد که من باهاش حرف بزنم.	might not even wish him to address him in any way.
هری به هیچ وجه مایل نبود بار دیگر چنین اتفاقی پیش بیاید.	had no desire to repeat the experience.
به سرعت و کاملاً خود را از میان بازوانش بیرون کشیدم.	extricating myself from restraint rapidly and completely.
که فریادهای نومیدانه زنی که در ارابه نشسته بود توجهش را جلب کرد.	when his attention was diverted by the desperate shrieks of the woman in the vehicle.
که در حدود شش صندلی کاهی و دو میز قمار آن را فراگرفته بود نشده بودند	furnished with half a dozen cane chairs, and two small card tables
که اکنون به رغم هر هوسی که به سر داشته باشی	that now, even though thou repentest
آ نق در سریع این کار را انجام داده بود که پیرزن غافلگیر شد.	ah, but it had come so sudden, and she hadn't been ready for it!
این همان بچه نوانخانه است که با شما درباره او صحبت کردم	this is the boy from the workhouse that I told you of.
قفس از چهار گوشه درون زمین پیچ شده است.	bolted to the floor in all four corners.
اما از وسط آن گذرگاهی باز کرده بودند که همانند یک پل دارای فراز و نشیب بود.	but through the middle a passage had been beaten, rising and falling like a bridge.
یا شاید درون خود رازی را مخفی کرده بود	or did she lock up within her some secret
اما این کارت هیچ به ملکه شدن شباهت ندارد.	but this is not at all being like a queen.
قول دادم که اگر روزی بخت یاری کرد و من توانستم به وطن خود بازگردم	promised, if ever I had the good fortune to return to my native country
در همان حال با تمام قوت پاروب زدند تا از کشتی جلو بیفتند.	at the same time pulled with all their might so as to get ahead of the ship.
من تصمیم دارم ترتیبی بدم که این ماجرا پرخطرترین ماجرای سر تا سر زندگیم با شه.	I am resolved to make this the most desperate affair I was ever engaged on in my whole life.
مدی شروع خواهد شد که تا به توفان سخت و غیرقابل مقاومتی تبدیل نگردد فرو نخواهد نشس	the tide that will never turn till it has reached its flood that will be irresistible, overwhelming
یعنی در واقع منازعه ست مکش با ستمگر نیستند	which are no longer the conflict of the oppressed and the oppressor
از طرفی من خواهان نص صریحی هستم که بگوید مهتران نیز در حینی که اربابانشان به نبرد مشغولند مکلفند با هم درآویزند و چنین نص صریحی وجود ندارد	but granting it true that there is an express law that squires are to fight while their masters are fighting
اما ضم نا قسمت ویژه غیرفنی و کوچکی نیز زیر نظر اوست	but who had under him one small and very special, though by no means technical
چون متوجه خواهند شد که این میهمان آدم وحشی جالبی است.	because they would find him an interesting wild man.
قصد نداشتم همان جا بایستم و با آن بدبخت بحث کنم.	I wasn't going to stand around arguing with the wretch.
من دستور می دم با مال برادرت بفرستند اون وقت معلوم می شه که درس ته.	I'll take the order and send it, along with your brother's, and then they'll know it's all right.
من باید از پدر خودم اطاعت کنم و هر چه زودتر از اینجا بروم	I must obey my own,' she replied,
بلکه اصلا چوب گلف هیچ تماسی با توپ پیدا نکرد	I literally could not make contact with the ball.
به اصرار خودشان برای رستگاری در ته زیرترین انبارها جایشان دادند.	so at their own instance they were put down in the ship's run for salvation.
میل به گفتن ندارید کسی به شما زور ندارد	either to speak or be silent just as you please
آنجا کلاه از سر برگرفت و آن را در آب انداخت.	where he took off his hat and flung it into the water.
مکثی کرد تا قضیه را تجزیه و تحلیل کند.	paused to scrutinize it.
امیدوارم تا فردا شب دیگر بر او غلبه کرده باشم.	I hope before the day is past to have the upper hand at last.
زیرا آدااسرار داشت که خود را همراه کریستف به مردم نشان دهد.	for she insisted on being seen with him.
وقتی پا پا از اتاق بیرون رفت کاترین مرا به کنار پنجره برد	when papa was gone, she made me come to the window
یا آنکه رنگ آن تغییر یافته به طور محسوس چیزی از جثه آن نکاسته است.	though changed in hue, it has not perceptibly lost anything in bulk.
اون قدر پنبه بکارم که در عمرت ندیده باشی.	more cotton than you ever saw.
تا اجازه ندهد او را زنده به گور کنند.	in order to make sure that they would bury him dead.
اعتقاد پیدا کرده بود که در قلب او نفرتی تولید کرده است	she had been convinced that she had left behind a seed of hatred in him
او خواهش کرد که با شکیبائی به سخنانی که به آبرو و جان من پیوسته است گوش فرا دهم.	he desired I would hear him with patience, in a matter that highly concerned my honour and my life.
او را تا سرحد مرگ رنج خواهم داد ولی بعدا	I'll torment this man nearly into his grave, and then, oh!
بالاخره خود را رسانید به در خانه که پدرش در آنجا منزل داشت	he found himself at the door of the house in which his father had lived
به طمع گوهرهای حسن و جمالی که آن شب در قلعه بودند	covetous of the great treasure of beauty the castle contained.
دقت کردم که هیچ کس از وجود او در آنجا یا تحت آن نام اطلاع پیدا نکند.	I took care that none should hear of it or of her under that name.
از ساربان پرسیده بود که چرا این قدر به دانستن آینده علاقه دارد.	had asked why the camel driver was so interested in the future.
از هزار اسم من یکی برای تو کافی است که چون صاعقه بر سرت فرود آمد	of my hundred names I need only tell you one, to overwhelm you!
طبال که سربازی لاغر و چهل ساله و در عین حال زیبا بود	a lean, hand some soldier of forty
من تقصیر ندارم که کار و بار شما خوب نیس	I can't help what happens to you.
که به خواهر شوهر آینده دخترش فرصت بدهد تا آزادانه با زن برادر آینده خویش گفتگو کند.	to give the future sisters in law an opportunity to talk to one another freely
بالاخره چشم یکی به دیگری افتاده و همدیگر را چون دو مقتول به یک شمشیر دیده و به آغوش همدیگر پناه بردند	but at length the two poor victims of the same blow raised their eyes and with a simultaneous burst of feeling rushed into each other's arms
پس سه روز نخواهد کشید که تو دیوانه زنجیری خواهری شد	in three days you will be like him mad enough to tie up
اما ناشناس سخن آغاز کرد و او فوراً به خود بازآمد.	but the unknown began to speak and he recovered himself at once.
با صدایی بلند و لرزان داستان عجیب و قدیمی زیر را خواند.	read in a high, cracking voice the following curious, old world narrative
وقتی که او در همان وضع سابق باقیمانده بود	while he, the old one, remained stationary in the muffin cap and leathers.
آن بود که علنا و بی درنگ به همگان نشان دهند	would serve to make plain to all and at once that
یک پیرزن و یک پیرمرد که پای هر دوشان لب گور بود.	two old people, ambushed by death
اشاره کرد که از دنبال او به اطاق سوم داخل شوم.	made me a sign to follow him into the third room
من از وضع خاصی که به خود گرفته بود مبهوت شدم.	I was struck with the singular posture he maintained.
این تویی که باید جلوی پیشرفتشونو بگیری و نگذاری به قدرتی که سیزده سال پیش داشتین به رسن!	you will be hard pressed to stop him regaining the sort of power he had thirteen years ago!
با یک حرکت غریزی به جلو پرید و وی را در میان هوا گرفت و سالم بر روی زمین نهاد و پس از آن سرش را بالا کرد تا مرتکب آن بی مبالاتی و غفلت خطرناک را بشناسد.	by a natural impulse he arrested his descent, and setting him on his feet, looked up to discover the author of the accident.
از این گذشته با علاقه در انتظار فردا و دیدن مجدد او هم هستید!	you are looking forward with so much pleasure to seeing him once more to morrow!
کلاه گیس خود را به دو دست روی سر مرتب نمود	flattened his flaxen wig upon his head with both hands
بعضی از این لوازم قشنگ و بعضی زشت بود	besides a few more or less handsome pieces of plate
نزدیک شهرست و بسیار بزرگ است و پنج فرسنگ و نیم مساحت دارد.	in a great field near the city of twenty miles square.
از توقعاتی که والدینش در قلمرو تحصیل و مذهب از او داشتند به تنگ آمده و کوشیده بود کاری برای خود پیدا کند.	he had browsed about trying to find something to do while still resenting the combination of school and religious work expected of him.
اشتباه دوم تون ای نه که نه شب اوم دین و نه ماسکاتونو آوردین.	the other is that you didn't come in the dark and fetch your masks.
با زحمت فراوان چند کلمه نوشت و امضا کرد.	sputtered the pen across the paper painfully
یک شعاع باریک و درخشان نور خورشید به شکل عمودی قاب را به دو نیم تقسیم کرده بود.	a thread of strong sunshine cut it perpendicularly.
اگر هم این کار و درست بلد نباشی خیلی خطرناکه چون ممکنه درست از آب درنیاد.	it can go badly wrong if you don't know what you're doing
تو هم هرچی از وسایل این اتاق لازم داری بردار	you grab anything you need from your room
به او قول داده بودم که روز بعد حتماً به دیدارش بروم.	I had engaged to call again next day
با دوپای دیگر جلوی بدنش او را گرفته بود	the front two clutching him tightly
تیرکمانش را در دست ضعیف و لرزان او گذاشت.	gave his bow into his feeble hands
اما پاسخی نشنیدم مگر هلهله همان اسب راهنما و صدای اسب دیگری که اندکی ریزتر بود.	but I heard no other returns than in the same dialect, only one or two a little shriller than his.
به طوری که حتی بعد از مردنم فراموش نشود.	that won't be forgotten after I'm dead.
بعد با شدت تمام هردو دست او را گرفت و دخترک را بس وی اطاق کوچک مجاور کشانید.	suddenly pinioning her hands dragged her, into a small room adjoining
وقتی به فروشنده گفتیم دو تا از او نا بهمون بده	when we said we wanted two.
برای چهل سال روحاً و جسماً گل سرسبد آن بهشت اجتماعی محسوب شده بود	had been the soul and body of her social paradise for almost forty years.
تصمیم گرفتیم که یک قرص نان خوش شکل و قهوه ای بخریم که قیمتش را سه پنی پرداختم.	we decided in favour of a nice little loaf of brown bread, which cost me threepence.
به محض ورود به اتاق دیدم که وی در پای تختخواب زانو زده و مشغول گریه کردن است.	I found her crying, on her knees by the bedside.
دست برد به قبضه کاردی که در کمر داشت	wiping his large knife on his apron
اگر آن عالی جناب پا توی کفش ما نکرده بودید	if it had not been for your worship
امّا هنوز بیش از ده یارد پیش ندویده بودند	not ten yards further
حتی حاضر بود مردها را برای ساعتی کرایه کند.	even if he were hired by the hour
به درون اتاق دوید و بی درنگ معمای جدا ساختن او از دختر جوان را به این ترتیب فیصله داد	came running into the room in advance of the inn servants, and soon settled the question of his detachment from the poor young lady
گرچه او دستخطش را از کتاب خودآموز خط انتخاب کرده بود	although he had chosen his because it was the one he liked best of the many he saw in a manual.
باز به جای اول باز آمد که نزدیک من بود و آن را به حام نشان داد.	came back to where he had retired near me, and showed it to him.
بدبخت جیکوب به لک آن طور که انتظار داشتم از دست منبع افشا کننده عصبانی نبودم.	I wasn't as angry with the source of my exposure as I would have expected to feel.
یک در فرعی را باز کردم و داخل شدم.	opened a side door, and went in.
به حکم طبیعت چنان گرسنگی بر من غلبه کرده بود که ناگزیر بی قراری نمودم	I found the demands of nature so strong upon me, that I could not forbear showing my impatience
یک ساعت بود که بارش باران شروع شده بود.	which had been falling for almost an hour now.
قو یا و کرارتا منکر داشتن سه پایه شده است.	vehemently and repeatedly denied that he had.
سراسر روز بعد را در حال سرپا به رؤیا فرو رفته	spent the whole day dreaming on their feet.
فراموش کردم شما دوستش دار ین و معذرت می خوام اگه حرفی زدم.	I forgot how you liked her and I'm sorry for what I said.
به سرعت دنبال کتابی گشت تا زیر بغل گذارد.	mechanically sought for a book to place under his arm
هرگاه او از ین پس یک خط دیگر به من بنویسد به پدرم شکایت خواهم کرد تا او را بدار التأدیب بفرستد.	if she dares so much as write me one word again, tell her I shall tell my father, and that she shall be taken to a lunatic asylum.
به بازرس کارخونه می گم پانسیون خوبی برات پیدا کنه.	I'll have oursuperintendent see that you're directed to a good boarding house.
چنانکه از گفتگو با خود او نیز این نکته روشن خواهد شد.	as might be easily tested by talking to him.
در دل گفت چقدر از نخوت کل این قضایا بیزارم	I detest the smugness of the whole affair, he thought
البته ممکن است که گاهی لباس من پاره باشد	ragged I may be
من را سی نمی دونم داریم به کجا میریم	I jus' don't know what the country's comin' to.
لحنش جدی و حاکی از ندامت بود و بعد شروع به خندیدن کرد.	with grave repentance, and then began to giggle again
بهتر است آدمی گاهی با بینی آویزان جائی را ترک کند تا اینکه اساسا بینی نداشته باشد	it's better to get off with your nose pulled than without a nose at all.
من نمی دونم چه طور از سرد خو نه فرار کرده.	I don't know how he escaped from the morgue.
که دوباره به رنگ آبی مایل به سفید درآمده بودند آن را بخواند.	so that he could read it by the light of the flames, which had turned back to blue white.
چون انان جرات کرده بودند که خودسرانه دست به اقدام بزنند و سیاهان را مجازات کنند.	because they had dared take the punishment of crime into their own hands at a time when the ordinary processes of law and order had been overthrown by the invaders.
منتظر ایستاد تا مردک صبحانهء خود را به آخر برد.	stood waiting until the countryman had made his breakfast.
من از کالسکه پایین آمدم و وارد عمارت شدم.	I alighted and went in.
اما این دعوت پذیرفته نشد وطرفین با نهایت ادب و نزاکت از هم خداحافظی کردند.	but this was declined, and they parted on each side with utmost politeness.
یه تغییر صدا یه تغییر حرکت باعث می شه که یه هفته اینجا به مو نیم	for a change of tone, a variation of rhythm may mean'a week here?
گویی ذهنش آبی روان شده که همه چیز در آن شناور بود و همه چیز را به تمامی در خود گرفته بود.	as if her mind had become a fluid that flowed round things and enclosed them completely.
هر چند این اقدام در زهن خود او تازگی نداشت	though by no means new to his own mind
به مبل پس از اینکه نگاه لبخند آمیزی بر کلاه خود افکند	who, repressing a complacent smile by looking sternly at his cocked hat
در صورتی که در اینجا مکثی کرد و روی این کلمه تأکید ورزید .	in case andhere he paused and rested on the phrase
من هم آن را این طور تلقی کردم و پذیرفتم.	I regarded and accepted it as such.
من در بالای تپه یک خانه خیلی خصوصی دارم.	I have a house up in the hills that's very private.
چهارسال و یازده ماه و دو روز تمام بدون وقفه باران بارید.	IT RAINED FOR four years, eleven months, and two days.
اما چیزی که باید به یاد داشت این است	but the thing to remember was that the very fact
کارت سوار شدن را به راننده دادم و او سرش را تکان داد	I show my travelcard to the driver and he nods.
مرا اندرز داد که اندکی بیاسایم زیرا به آسایش بسیار نیازمند بودم.	advising me to take a little rest, of which I had great need.
اما هنگام یکه بزرگ و نیرومند شد شروع به دزدیدن کرد.	till he grew up and was strong enough to go away and be a thief.
این را در خاطر داشته باش ای شقی نابکار.	remember that, wretch,
او از اینکه همیشه ناگزیر بود سرش را بالا بگیرد تا صورتشان را ببیند خسته شده بود.	he was so weary of forever having to tilt his head up to see their faces.
به نظر ما کام لا از گناهان صغیره بوده است.	is a perfectly venial offence in our sight.
یگانه آرزوی من این است که همه شما چون من خوشبخت باشید.	I only wish you were all as happy as I am.
از اینجا که حتما خیلی بهتره چون تو این هوا کار خو نه چنگی به دل نمیزنه.	where it must be much nicer than in thefactory here in this weather.
برخاستم و آهسته به طرف بیشه به راه افتادم.	I got up and went down the hill to the cove.
از ارتفاعات سرد و یخ زده عبور کردند و در برف و باران شدید شب را در کلبه ای سنگی که زیر برفها گم شده بود گذراندند.	burying in a drift of snow the little shelter hut of stones in which they had spent the night.
یک پاکت نامه قهوه ای رنگ بود که به قبض شباهت داشت	a brown envelope that looked like a bill
حتی شالی که دور سرش پیچیده بود کمکی نکرد	the tartan scarf didn't help.
مجبور بود آن را روی زانوهایش بگذارد و برای خواندن روی آن خم شود.	which meant she had to sit leaning forward in order to read.
این شراب ناب رفیق و مصاحب او در مدت اشتغال بکار است.	with which she solaces herself at her work.
بالاخره اسیر از این مطلب نیز آگاه شده بود که دختر جوان هم سفر دیوان بیگی دختر خود او است	he had learned, likewise, that the young lady was his daughter
بهار جوانی شما حالا مثل بهار جوانی آن زمان من نیست.	not a more vernal tint freshens you now than once freshened me.
مثل مردم دی گه مدادش رو روی زبونش میز نه.	an' lick his pencil.
با خشم و ملال دستش را از روی نیمکت برداشت و روی شکم گذاشت	lifting his hands with a gesture of annoyance, folded them across his stomach
می تونم با هر یک از او نا زندگی کنم	I can survive on either.
آنجا بی شک ارواحی بسیار قدیمی وجود دارند که هرگز چنین کاردینال شریفی را ندیده باشند.	there are p p probably many old established ghosts who have never seen such a thing as an honest cardinal.
قرار شد که هر دو را دریک برنامه بگنجانند.	it was arranged to include them both in one program.
بدلیل داشتن گذرنامه زردم که به شهرداری نشان داده بودم.	because of my yellow passport, which I had shown at the town hall.
او برای ضعفی که از خود نشان داده بودم هر چه از دهانش درآمد نثارم کرد.	he calling me all sorts of names for the base spirit I evinced.
با و گفته بود که از جان و دل او را دوستدارد	he told her he loved her devotedly
ازقضا به راه بندانی برخوردند که امکان گذشتن از آن نبود.	did indeed come upon a blockage from one side of the northbound lanes to the other.
برای بیرون رفتن از اینجا و گم شدن در بیابان و مُردن در دنیای خود.	to get out of here, lose myself in the desert and die on my own world.
می تونستم تصور کنم که در چند سال آینده منم از همین جنبه به قضیه نگاه خواهم کرد.	I could imagine that maybe I would be able to see it that way, too, in a few years.
اما وقتی تفکراتم به پایان رسید و به بیرون نگاه کردم و دیدم بعدازظهر گذشته	but when my reflections were concluded, and I looked up and found that the afternoon was gone
تجربه به تو نشان خواهد داد که شجاعت من تا به چه پایه است.	for experience will tell thee what mine is.
سپس نزدیک رفت و ارنج او را بر هر دو دست گرفت.	then she went up and took him by the elbow with both hands.
حالا هم کاری به من ارجاع شده است که باید به انجام برسانم.	I have a business charge to acquit myself of.
تازه با چیزهای مختلفی که دزدیده بود ناشتایی کرده بود	he had just breakfasted upon some stolen odds and ends of food
مری صبر کرد تا کشیش با کلیدی که به او داده بود در را باز کند	she waited while he used the key she handed him
هر طور شده باید خودمو از این وضع نجات بدم!	I HAVE to get out of this in some way!
به این ترتیب شما در یک ساعت دو بار از او خبر خواهید داشت	so that you'll get two reports in the hour
بعد هم که دیگر یقین حاصل کرد واقعاً شهر برایش بمانند سابق نیست	then, finding that the place really no longer was, to him, what it had been
پنج سالی که در آنجا به سر برده بودم	of my five years residence there.
چنان با لطافت غریبی اگر آن را لطافت بخوانیم در این امر مقید شده بودند ک	by such a strange delicacy, to call it so, were they governed in this matter
نخ زنگ را گسیخت و با تمام قوا کلفت را صدا زد.	broke the bell rope, called for the servant with all her might
اما به عکس. وس ساکت و متفکر. به دود کردن سیگار خود پرداخت.	but he went on smoking his cigarette.
او نا جرئت نمی کردن ما رو ویل ون و سرگردون کنن.	they wouldn't hunt nobody down
اما هرگز موفق نشدم که شبیه یک جنتلمن واقعی بشوم.	I never, then or at any other time, succeeded in looking like a gentleman
که خشن و خام زمخت و حیوانی بودند در یک آن مجسم کرد.	scenes that were rough and raw, gross and bestial.
از زبان آوری بهره داشت و در نوآوری از ناپلئون سرتر بود ولی به نظر دیگران عمق منش ناپلئون را نداشت.	quicker in speech and more inventive, but was not considered to have the same depth of character.
قسمت شخم نشده بیش از ده پا پهنا نداشت	the uncut space was ten feet wide.
میمونی را بر جای فرمانداری مستبد یا فرمانداری را بر جای میمونی گذاشت	you might put a monkey for a margrave, and vice versa
چون شوهر او چند سال پیش تبخیر شده بود.	since her own husband had been vaporized a couple of years earlier.
زیر لبه کشتی دور زد و در آن پنج ناشناس دیده شدند	coming from the windward side, pulled round under the stern
مگر در مورد کاری که محتاج به یک دوره علم آموزی باشد.	except where a course of study is required.
گویی صرفاً یک نظر قربانی بود که از سنگی معدنی ساخته شده باشد.	but rather a mineral good luck charm
دم و بازدمش این نوبرهای سفید فزرتی را به خش انداخت.	the flimsy white things stirred and rustled in his breath.
خیلی خوشحال بودم که او این فکر را کرده است.	I was glad he'd thought of it.
بلافاصله پیشنهاد خود را پس گرفت چون ابدا میل نداشت مایه رنجش یا ترس دخترک شود.	withdrew the suggestion because he did not care to offend or frighten her in any way.
پیوسته به خاطر ایشان خود را نیز از یاد برده است.	had uniformly forgotten himself for their joint sakes.
اما یک هفته پیش در اینجا نمایان شد و شروع به اظهار این عقیده کرد	then he suddenly came a week ago and he began about it straight away.
که هفت نفر مرد به زور موفق شدند او را کشان کشان به داخل اطاق خواب برده و روی تختخوابش بخوابانند.	to such a degree that seven men were unable to lift him and they had to drag him to the bed.
البته متوجهم که شما خودتون این کار و لازم می دونید.	I understand, of course, that you consider it necessary.
مثل اینکه خوشوقت شد از اینکه هنوز غروری دارد.	he seemed to be glad to think that he was still proud.
چون بیم داشتم مبادا پرستار که تمام شب را بیدار بود صدای حرکت مرا بشنود.	fearful lest the nurse who sat up all night should hear me.
سپس ناگهان یک ردیف طویل از بازوان افراشته با شمشیرهای کشیده ب	then, all at once,a long file of uplifted arms, brandishing sabres
از آن پس صرفا در شهر کوچکی طبابت کرده بود.	had practised ina small town ever since.
چنان بود که گویی نیمی نامطمئن بودند که آیا واقعا موجود میرنده	as it seemed, whether indeed he were a mortal substance
دوم اینکه غذاهایی که رستوران دانشگاهتون می ده اسپرم تولید میکنه.	or two, they are feeding you boys something in the UNH messhall that builds up sperm
عواقب وخیم این شوخی مضحک به همه جا سرایت کرده	the unlucky joke has gone so far
این بار همه ی آثار هنری را بر سقفها و دیوارها تماشا کرد.	this time observing all of the works of art on the ceilings and the walls.
احتمال داردکه نشوم زیرا که میل ندارم یادگاری از خود باقی بگذارم	which will probably be the case, for I have no anxiety to raise slips of myself here
از قرار مذکور بعد از دیدن مرگ ناگهانی شوهر خللی نیز در هوش و عقل او به هم رسیده بود.	which affected her very deeply, she has not completely recovered her reason
قبلاً از تو خواسته بودم در انظار عموم طوری رفتار کنی که زبان بدخواهان بسته باشد و نتوانند علیه تو حرفی بزنند.	I have already begged you so to conduct yourself in society that even malicious tongues can find nothing to say against you.
پنداری برای توان و قدرت نظامی که ماهیت مرموزش به دلیل مستقل بودنش از قوای عقلانی و شعور خود را بر تخیل او تحمیل میکرد اهمیتی بیش از حد قائل بود.	seemed to have an exaggerated respect for military ability, whose mysteriousness since it appeared to be altogether independent of intellect imposed upon his imagination.
چنان بود که از لحاظ تازگی و جذابیت دست کمی از خود آن ماجراها نداشت.	has been such as befitted the novelty and strangeness of the matter.
چون دانست که در راه رسیدن به هدفش کشتی بزرگ شدن است	because he knew he was on his way to becoming a mighty ship.
در همان جا من پرچم به دست پیش خواهم شتافت و هرچه سر راه من باشد در هم خواهم شکست.	I shall be sent with a brigade or division, and there, standard in hand, I shall go forward and break whatever is in front of me.
ولی البته این روزها ان حلقه چندان معنایی نداشت.	but these days, of course, that meant nothing.
نقاط مستحکم و ضعیف خانه و تسهیلاتی را که ممکن بود برای اجرای توطئهمان از آن استفاده کنم	the fastenings of the house and everything that could be taken advantage of to make our task easy.
دانش آموزان اجازه نداشتند به تنهایی در قلعه پرسه بزنند	they weren't allowed to wander off on their own
شکاری بگریزد به وی نشان داد و از بالای دره به طرف جنگل تاخت.	a spot where nothing could possibly run out went round above the ravine.
من همیشه دل دارم ولی کارامازوف بر استی وحشتناک است!	I am always manly, but this is awful.
تنها دو ماه نزد زن و فرزند خود ماندم.	I stayed but two months with my wife and family.
با یک قوری قهوه توی اتاق آمد تا به ماجرا خاتمه داده باشد.	she came to the rescue, armed with a coffeepot.
زمانی که به این فکر کردم که او چقدر به حقیقت نزدیک شده است ترس عمیقی در درونم حس کردم.	I felt a deep sense of dread as I wondered how close she'd come to the truth.
اشتیاق زیادی به نشان دادن خودم به گرگی تازه و عصبانی نداشتم.	I wasn't exactly eager to reveal myself to a new wolf with an anger management problem
به او رخصت داد به دنبال دادرس خود برود تا بیاید و حکم صادره را اجرا کند.	gave him leave to go look for his judge in order to put the sentence pronounced into execution.
سپس من راهی در پیش گرفتم و دویست گز دور شدم	I went on one side about two hundred yards
اما آمادگی رویارویی با آن گرداب خشمگین و در جوشش امواج را اصلا نداشت.	but he was totally unprepared for the fury of the seething maelstrom they faced.
که مثلاً با صراحت بگویند ژنرال باید قدم پیش بگذارد و خواستگاری کند	or that he should even very heartily approve it
که با همه ابلهی خود تصمیم به فرار گرفتم	I was a little fool then, I know
سرعت پیش روی آنان نسبت سرعت اشان در منزل اول بیشتر شده بود.	they went forward quicker than they had done on their first march.
مطمئنم دخترای زیادی هستن که به موقعیت تو غبطه می خورن!	I'm sure many girls would be very envious of your career.
گو اینکه وی هنگام سرکشی به انبوه تبعیدشدگان بندرت وسیله داشت که بهر یک از آنان بیش از بیست کو پک اعانه بدهد.	though, in point of fact, he could never, of course, have distributed more than a few pence to each member of a party.
زیرا که او را مأمور نموده برای گفتگو با سلطان که راجع بوده و بر موت و حیات او.	since he had interested him with a negotiation of life and death with the emperor
زیرا مصمم بود به هر قیمتی که شده از سرنوشت شومی که ظاهرا گریبانش را گرفته بود رهائی بیابد.	eager at any cost to escape the fate which seemingly had overtaken her.
هر چند در بین آنان کسی نبود که سن او از یک دو قرن تجاوز کرده باشد.	although there was not above a century or two between them.
سپس به میان قایق آویخته خود جست و زوبینی به دست گرفت و اعلام داشت که آماده قتال است	yawned a little bit, and then springing into the head of his hoisted boat, and poising a harpoon, pronounced himself fit for a fight.
هیپولیت جمله اخیر را به طور معنی داری تأکید کرد.	he added, accentuating the fact that he had waited.
اگر در اینجا اقامت کنند ما به نوایی خواهیم رسید.	if they stop here we may say gaudeamus
کس دیگری هم نبود که من با او برقصم.	when there was no other partner in the room.
اما ضروری دانست که در آن محفل او را با القاب رسمی بخواند حضرت اجل!	but thought it necessary on this occasion to address him formally
معنای این حرف او این بود که تکیه کردن به آن بستگی به نوع نیاز موکلش دارد.	meant to be bent to suit the needs of his clients.
صرف نظر از این که چه حزب و گروهی در منطقه قدرت را در دست داشته باشد	no matter what party was in power
جمع خاص خود را داشتند و او را به عنوان عضوی در آن جمع پذیرفتند.	had a society of their own of which they now elected her a member.
به طور روشنی نگران این بود که احساسات من جریهه دار شده باشد.	clearly worried about having hurt me.
لیکن مرا با کلمات عاری از لطافت و قراردادها از سر خود وانکنید	but do not put me off with platitudes and conventions
در این صورت تو مانع انجام خدمت او نخواهی شد.	then it's all right to let him serve.
از فراز اطاق آشکارا صدائی مانند صحرای زنجیر به گوشم رسید	I plainly heard a noise upon the cover of my closet, like that of a cable
از ملکه با سردی پرسید که از کی او شیفته سپلک ناک شده است.	asked the queen after a cold manner how long it was since she grew fond of a _splacnuck_?
چون ممکن بود که او زودتر آمده و اطاقی گرفته باشد.	it might be he had arrived early and taken a room.
ولی در باغ مانند دفعه گذشته که بدان جا رفته بودم بسته بود.	but the jealous gate was fastened, as at my last visit
او فرو نشستن آرام امواج را در مهتاب دید.	she saw the waves rippling peacefully in the moonlight.
نه به واسطه دشواری کار بلکه به مناسبت عدم تناسب آن با طبیعت خویش ناراحت بود.	for them not because of its difficulty but because of its incompatibility with their natures
تا مسئله بی گناهی یا مجرمیت متهم بدرستی حل شود.	for the purpose of truly solving the question of the defendant's guilt or in nocence.
سیمای جذاب و دلنشین او هم برای من بیگانه نبود.	I knew her face too,small and oval
خرسند و مسرور از لباس و نقابشان تمجید کرد	admired their cleverly contrived costumes, and particularly how they suited the young ladies
قدرتی به او داده شده که چهل و دو ماه ادامه دارد.	power was given unto him to continue forty and two months.
آن قدر تو این فکر غرق شدم که نفهمیدم چقدر وقت گذشت تا اینکه با بام داد زد که خوابت برده یا غرق شدی.	I got so full of it I didn't notice how long I was staying till the old man hollered and asked me whether I was asleep or drownded.
بعد ناگهان سرش روی میز افتاد و در میان بازوانش پنهان شد.	with the words fell forward and lay face down on the table, his head buried in his arms.
در صورتی که او بالعکس مردی است متین و موقر و جدی.	that he is a firm, grave, serious man.
باید بفهمم که منظور او از گفتن این جمله چه بوده است.	I have to find out what he meant by that.
می تونم مثل یک گرگ بی آزار توی دفترم کز کنم و منتظر افول ماه به مو نم.	I'm able to curl up in my office, a harmless wolf, and wait for the moon to wane again.
از آن گذشته هر گونه ناباوری را که جهل عمیق درباره تمامی موضوع ممکن است	moreover to take away any incredulity which a profound ignorance of the entire subject may induce in some minds
اما در عین حال بیم آن داشت که پیوستن دیرهنگامش به فاتحان نبرد چندان پاداش قابل توجهی در پی نداشته باشد.	but he feared that such a late adhesion would earn but scant gratitude from the victors.
نیز قول داد که او را با وسایل لازم و با عزت و احترامی که درخور شخصیت او است به ولایت خود بازگرداند.	on his own part to provide him with the means of making his appearance in his own country
به رام مهم نیست اسم خونوادگی شما چیه .	I don't care what your last name is!
آن اینکه یک پهلوان سرگردان تمام عیار هرگز نباید بیم داشته باشد	that the true knight errant must not on any account be dismayed by them.
زیرا بالاترین قیمت پنج روبل و نیم برای هر کیل است و راه دیگری هم برای به دست آوردن پول وجود ندارد.	that it was fetching only five and a half roubles, and that more than that could not be got for it.
اما بر روی هم ذهنش را به حرکت در آوردند و صدایش در آمد.	but that nevertheless stimulated his mind and set it tingling.
آهسته و آرام سوار بر اسب به سوی لنگرگاه رفت.	rode slowly towards the harbour.
من در برابر آنان به زانو در افتادم تا آزادی خود را حفظ کنم	I fell on my knees to preserve my liberty
در زیر درخت شاه بلوط به حال خودش رها شده بود	had been forgotten under the chestnut tree.
پیدا بود که مادرش از او به تنگ آمده	it was plain that she was tired of him
پیش از آنکه بتوانم دست و پایم را جمع کنم	I accepted the offer before I was able to collect myself.
من صدات کردم تا بهت به گم که درستش کردم.	 'I called you to tell you I fixed it.
زیرا جامه بومیان آن سامان را به تن کرده بودم و زبانشان را آنقدر که بتوانم با آنان گفتگو کنم آموخته بودم.	being clad like one of the natives, and sufficiently instructed to converse with them.
یأسی چنان عمیق که حتی از گفتن آن به شوهرش نیز ابا داشت.	dismay too deep to be uttered in words even to her husband.
اگر شما نیز قدری از این هنر برخوردار باشید یقین بدانید که مشکل حل شده است.	if you can ever so little, the thing's as good as done.
صدای باران اوج گرفته بود. رنگ غوغایی و به باور نیامدنی بر شیروانی.	their voices had risen to shouting pitch to be audible above the incredible din on the iron roof.
میرم و تو رو با باقیمانده وجدانت تنها می ذارم.	I leave you to what remains of your conscience.
که تختخواب و میز و دو صندلی نهاده بودند	it contained a few poor articles of household furniture a bed, a table, two chairs, a stone pitcher
تا بدین وسیله بقیه را تحت تأثیر قرار دهند و به دیگران بقبول انند که به دارو دسته عوام تعلق ندارند.	that was meant to impress the rest of us and show that they didn't belong to the common herd.
شاید هم روی اون دریاچه پرت و خلوت عمدا با دوربین به صورت اون دختر زده بود.	might have even struck her on that lone, secret lake!
کسی نبود که به ریش من بخندد یا از من عیب بجوید یا غیبت کند.	here were no gibers, censurers, backbiters
در حالی که مرغ را از دست جوان گرفته	taking the fowl from the young bandit
همان مردم پس از این سبعیت با قیافه دردناک و متأثر به جسم بی جان	looking with pained distress at the dead body with its long
وقتی که شما به اینجا رسیدید من در شرف مردن بودم.	I was on the verge of dying when you came.
قلبش شک داشت که چنین جوابی از هریت بشنود.	had she deemed it possible enough for wishing.
باید افکار و عقاید شو رهش را دربست قبول کند و از خودش رای و فکری نداشته باشد.	should accept his opinions in full and have none of her own.
پهلوان در آنجا به حضور ملکه و شاهزاده خانم دخترش بار یابد	where the knight will find her with the princess her daughter,
فقط لازم بود چند مدتی صبر کند تا یک کار پردرآمد طراحی لباس و کشیدن تابلوهای آگهی به دست بیاورد.	it was only a matter of waiting a little and he was bound to get a well paid job to design costumes and draw posters.
که بعد از اطلاع از من بازخواست هم نمایند.	r, which is that he should disapprove of what I have done
زیراکسی را یارای آن نبود تا به دوستان این آفتاب درخشان یا هرکس که در سُلک مصاحبت او باشد نگاه چپ کند.	since nobody dared to annoy one whom he honoured with his countenance.
با حرکت منظم و موزون به جلو و عقب حرکت کرد.	forwards beneath him as if it were breathing heavily and jolting.
نگاهی به بازوهای لاغر کوچکش و پوست نازک کبودش انداخت	then he looked at the thin blue skin, the wasting of her little arms
در خط سیری مثل راه موش کور که شعبش شناخته نا شده است.	a mole's track, whose branchings are untraceable.
اما فقط اگر این واقعیت رو بپذیریم و سریع وارد عمل بشیم.	but only if we accept this and act fast.
این که به آثار چوب و چماق بیشتر شبیه است تا به آثار افتادن از بلندی.	remarked that this had more the look of blows than of a fall.
تو هم می تونی خوب فکر اتو بکنی و بری پایین پشت داخل وایستی.	an' you can make up your mind to it to be down below waitin' on the counter.
که آمده در یک مجلس پنج میلیون از من خواست.	he came to demand five millions at once
اما اگر بر خلاف از عروس خود راضی نشد	if he disliked his choice
سر راهش برخورده بود به نامه و به خودش اجازه داده بود آن را باز کند.	he had met with it in his way, and had taken the liberty of opening it.
خواست بداند که آیا ما در میان خود هویهنم داریم یا نه	he desired to know, whether we had _Houyhnhnms_ among us?
من حتی نمی تونم بفهمم این چه معنی ای می ده.	I can't even grasp what that would mean.
جک مالدون هم روی او خم شده بود تا دفتر نُت را ورق زند.	he was leaning over her to turn the leaves.
گربه در حدود یک وجب از سر مشغول آقا معلم بالاتر بود.	the cat was within six inches of the absorbed teacher's head
یکی شو نم که وفادارترین خادم منه و داره انجام وظیفه می کنه.	one, who remains my most faithful servant, and who has already reentered my service.
در این زمان به زن تبدیل شد و تا پایان زن باقی ماند.	when he became a woman and has remained so ever since.
عمداً مسیر فکرهایم را عوض کردم تا بتوانم احساساتم را کنترل کنم.	I deliberately redirected my thoughts in order to control my emotions.
اون موقع دی گه واقعا حاضر بودم با ربرتا ازدواج کنم.	I had decided that I was willing to marry her.
این طور که پیداست باید از نزد او بروم.	I must leave him, it appears.
شاید موقعی که بیرون دفترم منتظر بودی خودت شنیده باشی.	as you may have heard, while waiting outside my office.
من وقتی شهر در محاصره بود دعوای مفصلی باهاش کردم.	I had a quarrel with him during the siege
که با تجیری مسدود شده و آن طرفش آشپزخانه بود.	which was partitioned off from the tiny kitchen.
باز هم در مواردی که از حمایت اجتماعی و مالی هنگفت دیگران برخوردار نبود	still he was opposed to aiding, either by his own countenance or skill
این که بعد از بیدار شدن از یک رویای بسیار پرشکوه	that I have wakened out of most glorious dreams,
این جنگی که برخلاف میل و اراده من شروع شده هر چه زودتر پایان یابد.	that the war begun by no wish of mine may finish as quickly as possible!
از ای نرو نتوانستم مانند سایر هنرمندان اصوات زیروبم را با هم به صدا در آورم	nor consequently play the bass and treble together, as other artists do
اما فهم ما ابلهان از درک این دلیری که از شما ظاهر شد قاصر است.	but every simpleton would not be able to understand your heroism
چوب بیرق را ندید و پایش به آن گیر کرد و سکندری خورد.	he did not notice the staff of the banner and stumbled over it.
عادت کرده بود که هر چند وقت یک بار از او کتک بخورد.	was used to being beaten from time to time.
مرا ببخش اگر با سؤالات پیاپی تو را ناراحت کردم.	forgive me if I've asked you a lot of rude questions, my dear
موقع خروج به او تبریک گفته و به پیشوازش آمد	greeted her when she came out again.
برای مقابله با هجوم آشوب هیچ سدّی نمانده بود.	no barrier to keep back chaos.
در این رابطه از نکات مثبت تئوری هر دو حزب بهره بگیرند.	setting up a humanitarian regime that would take the best from each doctrine.
بدون تظاهر و مشورت با دیگران و تحمل رنج و زحمت و کوشش بسیار انجام دهد.	without display and without perceptible difficulty.
البته کتک زدن دیگران برای او نوعی ورزش بود.	unless of course it involved punching somebody.
پس دشمن قدیمی ما یک بار دیگه در میدان نبرد همدیگر را دیدیم	my old foe we meet on the battlefield once again
یکی از کسانی که عدهٔ آنان در آن زمان بسیار نادر بود	one of those men somewhat exceptional
او را دزدانه از نزدیک زیر نظر گرفته بودند.	slylyand silently remained as near as possible to watch.
اما در سیمای او غیر از اثر مستی چیزی دیگر ندید	but he read nothing but envy in a countenance already rendered brutal and stupid by drunkenness
ولی از آمدن به درون اتاق جداً امتناع کرد	but resolutely refused to meddle with him.
اما به شرافتم قسم هیچ قصد آن را نداشتم که این اشیاء ناقابل را کسی ببیند.	though, upon my honour, I had no intention of rendering those trifling articles of remembrance invisible to any one.
آدرس گیرنده را با جوهر سبز رنگ نوشته بودند	the address was written in emerald green ink.
فی الحقیقه مدتی طولانی بود که در این سیاهچال که چون قبری بود منزل کرده و حق داشت که خود را در شمار مردگان به حساب آورد	but he had so long ceased to have any intercourse with the world that he looked upon himself as dead
خودم هم از قلة مضرس آن به آن تپه ماهور دلگیر نگاه کردم.	from its craggy summit I looked out myself across the melancholy downs.
ولی نا دین حالا به مقصود خود رسیده بود.	but her purpose down here was already completed.
بالاخره با وجود همه این تداعی انباشته همراه هر چیز شیرین و افتخارآمیز و عالی چیز گریزانی در مفهوم دور از ذهن این رنگ نهفته است	yet for all these accumulated associations, with whatever is sweet, and honourable, and sublime, there yet lurks an elusive something in the innermost idea of this hue
چندان علامت صلیب کشیدند که گفتی خود شیطان سر در عقبشان نهاده است.	they pursued their journey making more crosses than if they had the devil after them.
باید بقیه عمرم را هم صرف بزرگ کردن یک مشت بچه بی تربیت و فقیر کنم.	while the children are growing up unhappy, badly educated, and penniless.
تیر راهنما را به یک دست گرفت و تازیانه را به دست دیگر تاب داد.	taking hold of the gee pole with one hand and swinging his whip from the other.
زیرا تنها یک نگاه به این شخص عجیب و غریب کافی بود که نگرانی او را کام لا مرتفع سازد.	it only needed one glance at the prince to see that in that quarter there was nothing to fear.
به جایی که دهکده زیر آفتاب به خواب رفته بود	to where the village lay drowsing in the sun.
از دیدن منظره صندلی خالی و بخاری بدون آتش احساس سردی و افسردگی کردم.	the sight of the empty chair and fireless hearth chilled me.
او هم دلایل زیادی در آن پشتکار زیادی نشان داد.	there was every reason to make him assiduous.
بنابراین با یک تصمیم قاطع آن را برای همیشه کنار گذاشت.	she cut it off with one stroke.
حیوانات بعد از اینکه او را پیدا کردند برگشتند	when the others came back from looking for her,
به طریقهٔ خودم زندگی کنم و به طریقهٔ خودم بمیرم.	live my way and die my way.
من حتی در آن موقع گفتم که نتیجه چنین خواهد شد!	I said then that it would be so,
ویرانگی گذشت زمان در آن تالارهای وسیع بدون پنجره.	the squandering of time in the enormous, windowless rooms.
توی بالکن ایستادم و در هوای خنک تابستانی نفس کشیدم.	I stood on the balcony and breathed in the cool summer air.
بلندیش به اندازه سه طبقه عمارت و پهنایش هفتصد پا بود.	it was three stories high, and seven hundred feet wide.
که بسیار مایه حیرت او شد و درستی سخنان من آشکار گشت و وی را خرسند کرد.	which, after great astonishment, clearly convinced him of my veracity.
ناگهان رودرروی کسانی که در جست جوشان بود آشکار شد.	presented himself abruptly to the eyes of those whom he was insearch of.
امکان داشت که نگاهشان به جهان نیز یکسان باشد.	it is possible that their outlook might have been the same.
زنی که چراغ کوچکی بدست داشت آمد در را گشود.	a woman with a little lamp in her hand opened the door.
من از حال او نگرانم ولی در عین حال خرسندم	I am anxious about him and glad
چه به اشتباه به دست یاران خود کشته شدن	to get shot down by my own party in mistake.
تا زمانی که رشد کرده و آنقدر بزرگ بشوند که رنگ پوست و مسایل آن را یاد بگیرند.	until he grows too old and learns what skin color is all about.
من حاضرم تمام زندگی خود را برای شما حکایت کنم.	I'm ready to tell the whole story of my life
به نظرم رسید که تا حدی وضع غیر عادی داشت.	I thought he had a rather singular air.
بلافاصله آن را با کلاهی که بر سر داشت عوض کرد.	swapped it for his wizard's hat at once.
ساعت چهار بود و هنوز دو ساعت تا غروب خورشید فرصت بود.	at four o'clock, the sun was now two hours above the horizon
زمرد را روی میز گذاشت و شماره تلفن را گرفت	set the emerald on the desk in front of him, and dialed a number.
بریم تا بدم قیروپر به تنش ون بمالند و بی اندازند تو رودخانه.	we'll have them tarred and feathered, and flung in the river!
می دونی که این اتفاق هرگز نمی افته .	you know that isn't so!
دقت کردم و دیدم که کیف وسایل بافتنی من جابجا شده بود.	I noticed that my bag of knitting had been moved.
نتوانست به موقع خود را به آن نقطه برساند.	could not gallop up to the spot before the party in smock frocks
این بود که بعد از شام با احتیاط با هم تمرین کردند.	they practised cautiously,after supper
فقط یک حادثة دیگر هست که باید در مورد این روز پرهیجان و گرفته ثبت کنم.	I have only one other incident to record upon this tempestuous and melancholy day.
دوباره صدای شکستن استخوان درمحلی دیگر بگو شش رسید.	heard it break someplace else
از تکرار یک کار در روز های متوالی خسته شده بودم.	I was tired of doing much the same thing every day.
همه اسلحه بر زمین گذارید و آرام بگیرید و به سخنان من گوش فرا دهید!	let all be calm and attend to me as they value their lives!
بعلاوه اتهاماتی هم از لحاظ شیادی و جادوگری داشته است.	for having besides a certain touch of the sorcerer about him.
دوک این را گفت و جست به طرف ولیعهد.	the duke went for him.
مقتضی این است که کمتر و نادرست با او از امور مه مه صحبت داشت	prevents our speaking to him on any subjects
کاری بکنی که آبروی آدم را به خطر بیندازد اما	that would put a decent position on the fritz but
زیرا که این شیطان همان نیروی بدوی بود که پیش از کشف مفهوم بد و خوب نیز موجود بوده است.	for it was a primitive force that existed before good and ill.
تا روزی که سر این سگ ناگهان بزرگ شود و مبهما در تاریکی جلو شیر ظاهر گردد.	until such day as the head of the dog, suddenly enlarged, is outlined vaguely in the gloom face to face with the lion.
برعکس مملو از همان وقایع حقیر مورد تحقیرش بود.	it was, on the contrary, entirely made up of the pettiest details
ولی هنگام بازگشت جاروی بخاری را برداشت و پس از گذشت از خاکستر ردپای خود را به دقت از روی آن محو کرد.	but when she returned she took the stove brush and carefully effaced every trace of her footsteps in the ashes, after she had crossed over them.
او هم فریاد زنان در گذرگاه سرخ دار پا به فرار گذاشت.	fled screaming down the yew alley.
چند استخوان پرنده هم که گوشتش کاملاً خورده شده بود	the well gnawed bones of two or three fowls.
ولی نه چندان که کاملاً متوجه موقعیت خود شود.	but not so completely as to understand what was the matter.
اما این آزاد از نوع آزادی روزهای قبل از ازدواج نبود.	but she was never again to know the careless freedom of her unmarried days.
امیدوارم حالت کاملاً خوب باشد و در دانشکده هم پیشرفت رضایت بخشی داشته باشی.	I hope you are quite well and have made satisfactory progress at college.
تمام سرها بس وی در برگشت و همه نفس را در سینه حبس کردند.	a breathless look from all towards the door.
در آن را کاملاً باز کرد و سمندر را توی پارچ سر داد.	pulled the lid fully open and tipped the newt in.
لیکن اکنون در برابر تیر آنان قرار گرفته بودیم	now it was we who lay uncovered
برای همین تصمیم گرفت که به سمت من برگرده.	decided to return to his master.
به خاطر فرونشاندن عطش آزمندانه آنان بود که آن خون ریخته شد.	for their sake was it shed, to quench their ravening thirst.
میدانی که من همه شما را چون فرزندان خود دوست دارم.	I love you all, like children of my own, as you know.
تا مرا یاری کند و از من مراقبت نماید.	to assist and take care of me.
سرش را با دستمال بزرگ آبی رنگی بسته بود.	his head done up in a blue scarf.
که تصویر پلنگ سیاه در حال پرش روی آن نقش بسته بود	each with a granite panther jumping across it
چنان اهمیت عظیمی کسب کرده بود که ناچیز انگاشتنشان امکان نداشت	will of his own, had gained an extraordinary importance that it was useless to contend against.
احتیاج به شراب نیست پیر از برای این بگفت	I do not want it said the old man
که کسی نتواند از اتاق مجاور او را ببیند	which enabled him to see into the adjoining rooM
اونوقت باید ببینم که هم چین کاری صلاحه یا نه.	ornot well who could tell.
چند مسافر با وجود طوفان خواسته بودند هرچه زودتر پای به خشکی بگذارند.	that carried ashore the few passengers who had decided to disembark despite the storm.
تا شاید ملتفت شوم بیمار چقدر بهتر شده است.	so that I might notice in how much better form the patient was.
یعنی هرکس یک بار آواز بخواند در تمام مدت عمرش گریه خواهد کرد.	for he who sings once weeps all his life.
دوستی بسیار نزدیکی بین او و خانم معلم برقرار شده بود.	a very close friendship began to develop between the teacher and the small child.
هرگاه واقعاٌ خواستار چیزی باشی تمام کائنات دست به دست هم میدهند تا تو به خواسته ات برسی	when you really want something, the universe always conspires in your favor.
باز هم همه تصویر بیهوده است مگر آنکه چشمان شبان به نهر جادویی که پیش رویش روان است دوخته شده باشد.	yet all were vain, unless the shepherd's eye were fixed upon the magic stream before him.
روی سر شکیل و کوچکش انبوهی از موهای پر پشت و سنگین و طلایی آشفته بودند و او هیچ توجهی به آنها نداشت دور گردن ربدوشامبر ململش نیز پر از توری بود.	fair hair twisted up negligently on her little head, and a lot of lace about the neck of her muslin wrapper.
اصرار داشت دومین سکه پز وی طلا را به خاطر حق ویزیت قبول کند.	trying to force him to accept a gold peso for the second visit
اما بلافاصله شروع به آزار او کرد تا به او در منتقل شدنش کمک کند.	but immediately began to badger her about helping with his transfer.
از دختر یک روستایی فقیر بیش از این هم نباید انتظار داشت.	it is as much as you can expect of a poor man's daughter.
برای او شرح داد که یکی از چیزهایی که فلاسفه این است	observed that one of the things wherein the ancient philosophers
بهت گفته بودم که خون دن فکر بیشتر مردم به رام آسونه.	I told you, most people are easy to read.
یک پارچ سرامیک شکم دار آبی رنگ پیدا کرد.	found a large bulging thing made of blueglazed pottery.
کسی که دفاع از شخص خود را یکباره به کف با کفایت شما سپرده	for she who has once entrusted to you the defence of her person
معلوم بود که خیلی هم از سر و وضع خودش راضی است.	he was clearly very pleased with himself this evening.
بهتر حرف بزنیم و راه خود در پیش گیریم و بیش از این سخن یاوه نگوییم.	now let us march on, for we have had quite enough of this entertainment.
به آنان فرمان دهم که به سؤالاتی که مناسب میدانم جواب دهند	command them to answer any questions I should think fit to ask
که ما بامداد همان روز در پیش گرفته بودیم	which we had entered in the morning.
من باید این گزارش را هرچه زودتر برای مقامات مربوطه بفرستم.	I've got to report that body.
شما باید زندگی توأم با انضباط خشکی در آنجا گذرانده باشید.	you must be tenacious of life.
باید بدانید که حدس درست خیلی با حدس معمولی فرق دارد.	for, depend upon it a lucky guess is never merely luck.
تا جایی که یک سال قبل تصمیم گرفت که به کلیسا رفته و تارک دنیا شود	since it is only about a year ago that she herself proposed entering a convent
اما راستش ای نه که تا حالا هیچ کس و ندیدم که تمامشو به جمع کردن و چپ و کردن گذرونده با شه و آخر ناکام نباشه	but I never seen nobody that's busy as a prairie dog collectin' stuff that wasn't disappointed.
از قدرتی که ارواح نیرومند در مواجهه با مشکلات دارند خبری نداشت.	did not know what strong minds are capable of, under trying circumstances.
من چگونه داستان تلخ و مشقت بار زندگی ایشان را هرگز مشنیدم و ندانستم.	how I never knew their hard, hard history.
به این ترتیب در آغاز قیمت پشم نامحسوس و بعد به تندی روبه افزایش گذارد.	the price of wool began to creep up, then skyrocketed.
نمی خوام که دوباره درگ ی راین ماجرا به شم.	I didn't want to get sucked into it again.
این خنده چون به هنگام خوردن قهوه بر او عارض شد سرفه سختی را ایجاد کرد	which laugh, meeting the coffee he was drinking, and carrying it down some wrong channel
میدانست عادت کردن به تجمل چه عادت ریشه گیری است	knowing too well how easily the heart accustoms itself to comforts
همین که توتون در چپق تمام شد پیشانیش را به پیشانی من فشرد و دست به کمرم انداخت و گفت	when our smoke was over, he pressed his forehead against mine, clasped me round the waist, and said
به همین مشاهده این درست قولی شما از این وصلت سر نپیچد	which he will not do
کلاید در این لحظه پیش خود حساب کرد که عجالتا باید همه چیز را انکار کند تا بلکه بعدا حرف دیگری برای گفتن بیابد.	recalling now butone thing that he must deny all until he should think or know what else to do or say.
باید اقرار کنم که چیزی مانند منظره پستان کوه پیکر او مرا متنفر نکرد.	I must confess no object ever disgusted me so much as the sight of her monstrous breast.
هرگز مردمی را تا این حد خوشحال ندیده بودم.	I never saw people so happy.
در حالی که آرامشش را از دست داده و صدایش آشفته بود	changing his expression of calmness for one of violence
خواسته بود که منتظر بماند تا توپخانه بتواند به آسانی حرکت کند	it hadbeen his wish to wait until the horse batteries could move and gallopfreely.
اما من هرگز مگر در صورت اجبار مایل به چنین کاری نبودم.	but I wanted to avoid it except as a last necessity.
اکر هم وقتی ناگزیر شوم این کار را بکنم به آن بستگی دارد که آن زوبین انداز چگونه کسی باشد	that if I should ever do so, it would depend upon who the harpooneer might be
هشیاری یکی از دو برادر و تجدید خاطرات برادر دیگر نگذاشت این دلخوری عود کند.	the immediate alertness of one brother, and better recollections of the other, prevented any renewal of it.
بذار بزرگ شن و آن وقت چنان روی زانوش زد که کمرش تقی صدا کرد و رگ به رگ شد.	wait till a growed up one goes over and then he whacked himself and throwed his hip out.
آن دو نیز بی درنگ از پیام خانم گریفیث رونوشت برداشتند.	who thereand then proceeded to copy it.
کیت آنقدر غضبناک و رنجیده خاطر بود که با دیوید حتی خداحافظی هم نکرد.	kate was so furious and hurt she refused to say good bye to him.
من ابداً قصد نداشتم تو رو اذیت کنم .	I didn't mean to hurt you.
بی آن که پلک بزند بر او دوخته بود.	out of her dumb, fear distorted face.
من میخ وام با شما بهتر رفتار کنم فقط همین.	I'd like to do better by you that's all.
دوباره تبدیل به همان سگ سیاه و بزرگ شد.	transformed again into the black dog
باز هرگز به یکی از آن مردان یا اطفال نگفتم که حتی از این وضع هم ملولم.	I never said, to man or boy, how it was that I came to be there, or gave the least indication of being sorry that I was there.
وحشیانه واکنش نشون دادم و چیزایی گفتم که واقعاً از ته دل نبود.	I reacted savagely and said things I didn't mean.
در اثنایی که من دست از دوختن برداشته بودم	while I paused from my sewing
با حرکت سریع بعدی تیرک شراع بدان گونه گرفتار شد و خطر از میان رفت.	at the next jerk, the spar was that way trapped, and all was safe.
هر سه با شور و شوق سرگرم خوردن بستنی شدند	which they slurped happily
باز هم خود را به همین پیکر شکنجه دیده باز خواهد ساخت.	it will twist itself into the same tortured forms.
اگر به طور دست و پا شکسته عملی باشد امری نبود که ملاحان خرافی بدون بدخیالی و وحشت از آن بگذرند.	though clumsily practicable, was not a thing to be passed over by superstitious sailors, without some shudderings and evil portents.
به ریاست یکی از شعب کمیسیون وضع قوانین منصوب گردید	was chairman of a section of the committee for the revision of the laws.
چهار نفر هستیم و زوجه من هم مریض است.	four persons and my spouse ill.
امیدوار بودم در آینده تو را بالغ و کامل ببینم.	I was looking forward to watching you mature.
شاید همه دنیا را به تصرف او در می آورد.	would, perhaps, have given him the world likewise.
چون میل نداشت پیش از این وصف این صحنه را بشنود	not wishing to hear more
اما در هر حال هنوز از خواب خود به طور کامل بیدار نشده بود	but, be that as it may, he had not been long at his perch
لیکن فرصت اینکه این خطا به آسانی جبران شود دست خواهد داد	but a time may come when this omission can be remedied
زیرا آنان هرگز قادر به استفاده از آزادی خود نیستند	that they will never be capable of using their freedom
تنها از طریق چاپلوسی و تملق ممکن است و بس.	only to be obtained now by interest and importunity.
تا با شمشیر خود در خاک سخت گودالی بکنند.	to dig hollows in the earth with their swords.
با نگاهی سرشار از ستایش چشم به دخترش دوخت.	she looked admiringly at her daughter.
به جای این که به این همه تعارفات صمیمانه پاسخ گوید	so, instead of responding to this open hearted salutation in a kindred spirit
سپس آمدیم بر سر منظور من از آن ملاقات.	then we came to the object of my visit.
مطمئنم توی رختخواب راجع به این موضوع چیزی بهت نگفته.	I bet she never told you that in bed.
بغض گلویش را گرفت و پرده اشک چشمش را تیره ساخت.	a tickling in his nose, and tears dimmed his eyes.
گوشت را بررسی کردم. همه جای آن سفید بود. اما ممکن بود کامل نپخته باشد.	I checked the meat, and it was white all the way through, but I wondered if it was completely done.
تا اگر چند دیوانه از تیمارستان گریختند و به میان آنان آمدند به اسانی شناخته شوند.	so that if any lunatics were at large, one might know and avoid them.
شهامتش در رها کردن گله اش و سعی اش در تحقق بخشیدن به افسانه ی شخصی اش و شور و شوقش آن زمان که در بلورفروشی کار میکرد.	his courage in having given up his sheep and in trying to live out his destiny, and his enthusiasm during the time he had worked at the crystal shop.
اِما حاضر بود هر اسم بدی روی این رفتار بگذارد.	she was ready to give it every bad name in the world.
هر چند وقتی بار اول آن را شنیدم برایم مثل کوبیدن چیزی روی یک صفحه برنجین بود و هیچ معنایی نداشت.	though, when I first heard it, it was only like a stroke on sounding brass to me conveying no meaning.
با چشمانی از حدقه در امده به او نگاه کردم.	I gaze at him, wide eyed.
من ترا تحویل دادگاه خواهم داد و ترا به دار خواهند آویخت.	I'll have you tried, and you'll be hanged!
تا اگر توانست برای خود لقمهء نانی پیدا کند و بخورد	to feed'if he could find food
چه احمق بودم که وقتی جو پار ادایش از جا نپرید و بغلم نکرد دلخور شدم.	I was a fool to get sore because JoeParadise didn't jump up and hug me.
به خواهر شوهرش وعده کرد که بعدا در این باب به تفصیل با او گفتگو خواهد کرد.	a real one, but that they would talk of that later.
تا ایشان را دوست داشته باشد و برایشان دعا کند.	she had more of them that she might pray for them.
لباسش را پوشیده بود و وسایلش را هم بسته بود.	she was almost dressed, and her packing almost finished.
پردة موسلن که وسط آن کمی باز بود نمایان بود.	where a muslin curtain partly undrawn in the middle
با این همه این ضعف بر وجودم مستولی بوده	yet I have had the weakness
تا نشان دهد تا دستکم جسمش در خور توجهات او هست.	show him that physically at least she was worth his time.
آنگاه شمشیر را در ابرها کرده بازوی بلند خود را از سوراخ به پیش و به بالا برده بود	then dropping his sword, had thrust his long arm far inwards and upwards
اما در آن دورها هنوز همان ظلمت مه آلوده فضا را پر کرده بود.	but in the distance was still the same misty darkness.
ه این قدر تخلف از میعاد شود و والانتین این قدر تأخیر نماید.	that the signing of a contract should occupy so long a time
پیرمردها در محبت و علاقه اشان خیلی خودخواه هستند	old men are always so selfish in their affection
اما لهوین چنان به او نگریست که گفتی زندگیاش یکسره به فهم این حرف از جانب کیتی بستگی دارد.	but he looked at her as though his life depended on her understanding the words.
بعضی دیگر آن را به زور در کیف تنگی جا داده بودند	others had crammed them inside tight bags
زیرا آمدن پدر برای او مترادف با شوهرکردن بود.	for to her the father brought a husband,
فقط زنای بد از این آشغالا استفاده می کنن.	doan nobody but bad womens use dat stuff.
این بود که مثل یک قاطر جم وش بود.	was her mulish character.
من شکی ندارم که داستان شما چنین خواهد بود.	as I feel quite sure your story will do.
اورسولا نیز کلون پشت در را انداخت و تصمیم گرفت تا پایان عمرش آن را باز نکند	rsula put the bar on the door, having decided not to take it down for the rest of her life.
حلقه تماشاچیان باز به جا ماند و منتظر به تماشا ایستاد.	the circle sank down again and waited.
پس از سالیان سال که از زندگی خود حذفش کرده بود	because for many years she had erased him from her life
مبادا پیرمرد سرک کشیدن او را به خیابان پیش از بیرون رفتن از مغازه ببیند.	so as not to let the old man see him reconnoitring the street before stepping out of the door.
او از ساعت یازده شب بستر را ترک کرده و تا آن ساعت هنوز برنگشته بود.	had not been in bed since eleven o'clock
مگر اینکه زن به خصوصی آدم را دوست داشته باشد.	unless he has some one woman to love him dearly.
که در نخستین فرصت رقصیدن را یاد خواهند گرفت.	were already declaring that when the opportunity offered, they were going to learn.
تنها و دورافتاده و مهجور و فراموش شده بودم.	I fell at once into a solitary condition, apart from all friendly notice,
مار به دود سیاه رنگی تبدیل و ناپدید شد.	the snake vanished in a small puff of black smoke.
اما تعجبش تنها چند لحظه سکوت در پی داشت که در طی آن چندشی را روی میزش جا به جا کرد	but his surprise only issued in a few moments' silence, during which he pushed about various objects on his writing table
بلکه به جهت این بود که چیزی را بهتر به خاطر بسپارد.	it was to pin down some thought more exactly.
که هرچند در دوران زندگیش بسی منظره شوم دیده است	that, although many funerealspectres had crossed his path in life
که فقط در تحول کوتاهی به زحمت قابل تحمل است.	a thing barely tolerable only in some one brief vicissitude.
تا ببینی که ایشان همین که قدری از ما دور شدند از صورت گوسفندی بیرون خواهند آمد و به شکل طبیعی خود	thou shalt see that when they have gone some little distance from this they will return to their original shape and ceasing to be sheep
با خود گفت حتماً آدمی با چنین ذهن عالی باید از همه جهت با ما تفاوت داشته باشد.	she thought, stooping down to look, a great mind like his must be different in every way from ours.
جز آنکه جدا از ژنرال و رفتار کنونیش ناراضی است.	excepting that he was highly dissatisfied with the general and his present condition of mind and behaviour.
این فکر که دیگر بار میخانهء او را بیابد و در آن موقعیت آشفته و با صاحب آن در مورد جایی امن مشورت کند.	he thought of finding out the wine shop again and taking counsel with its master in reference to the safest dwelling place in the distracted state of the city.
بن ابر این با دقت تمام شروع به فراهم کردن مقدمات آن نمود.	went on perfecting the details
سنجاق بزرگی که آن بانوی نازنین به نیم تنه خود زده بود مانع از افتادن من شد.	I had not been stopped by a corking pin that stuck in the good gentlewoman's stomacher.
خود را به بستن یک چمدان سفری با وسایلی که لازمه یک سفر چند روزه بود سرگرم کرد.	packed in a traveling bag the things needed for a few days.
هرگز زیاد وقت پرداختن به علوم طبیعی را نداشتم.	I have never had time to give myself much to natural history.
