هر کسی که آن نامه را آورده بود بدون شک متلفت شده بود که فقط سه هفته پس از مرگ شوهرش	for whoever had delivered it must have noticed that only three weeks after the death of her husband
ولی امیدوارم وضعیت ما رو به هم نریزه شاید فکر میکنه ما اونو قبول نداریم	I just hope he doesn't try to fuck up what we're doing now
اما مثل آن بود که دستی مافوق طبیعت در دست من گذارده شده بود.	but a supernatural hand seemed placed in mine.
چشمانش را ببندد و دردها و نقاط ضعف گوناگونش را تحلیل کند	where he was content to lie with closed eyes and analyze his various pains and weaknesses.
اقلا نگذارد که همدیگر را هلاک سازیم و به هم احترام از همدیگر نماییم.	at least to make us esteem each other.
رو زا در خود نیروئی نیافت که از آن جا در برود.	she could not escape.
با خود گفت باید به خدمتکار بگوید اینجا را باز مثل معمول نظافت کند	thinking that she must order the servant to attend to it as usual
مشتی بر صورتش نواخت و به پشت برزمینش انداخت.	sent him sprawling on his back with a great slash across the face.
تنها به آن نوع قمار سبک علاقه داشت که خاصیت الکلی ندارد	he had only the tendency to that diffusive form of gambling which has no alcoholic intensity
کلاید را در گوشه نیمه تاریک اتاق ایستاده بود نگاه کرد	looking up at him in the shadow, her desire to obtain some slight satisfaction
در طی سه هفته پیشرفت شایانی در آموختن زبان آن مردم یافتم.	in about three weeks I made a great progress in learning their language.
فکر کردم اگه دقت کنم میتونم ببینمش ولی سعی نکردم چون احساس کردم اون فلگه.	I felt like I could almost see it, that if I squinted my eyes the right way, I would see it.
از اینکه ببینند من از شدت اندوه و ناراحتی	when you think of the grief I ought to be in
ولی اگه دیگران جای من با شن حتما همین کار و میکنن	if not himself would to deny that he had held any such relationship with her and so escape.
از مطبش بیرون دویدم و یک راست به اینجا امدم	I ran out of his office and came straight here.
به پیشخدمت نگاه کردم و منتظر شدم تا به حالت عادی بازگردد.	I looked up at the waitress, waiting for her to recover herself.
شما باید یک حساب در این جا باز کنید.	you should open your own account here.
دو حرف اول یک اسم قابل پرستش که وی بی درنگ پایه تصوراتش را بر آن بنا نهاد.	these two letters were the first thing of her that he had gained possession of, adorable initials, upon which he immediately began to construct his scaffolding.
با یک سوم دیگرشان هم خودمانی بود و بقیه نیز دوستان خوب او بودند.	another third were his intimate chums, and the remainder were friendly acquaintances.
مینی گفت که پدرش عقب درشکه رفته است و جرام هم باید زودتر حاضر شود.	said her father was gone for the chaise, and he must make haste and get himself ready.
زیرا روی هم رفته مردی آرام بود و احساسات نیکی داشت.	because he was really a man of peaceful and kindly disposition.
اعم از اینکه به شاه تعلق داشته باشند یا به افراد عادی	as well those that are the king's as those belonging to private individuals
به سوی سربازانی که مقابل در ایستاده بودند برگشت	turned round to the soldiers standing at the entrance
فقط دو تا سرباز پابرهنه به دنبال وی بوده	preceded by two barefoot orderlies
شرحی از مشاهدات من در کشتی و کسانی که با من هم سفر بودند.	trying to amuse, describing my fellow passengers.
او را به جای خلوتی در میدان کریکت برد.	took his sister away into a secluded corner of the cricket pitch.
از سرنوشت خود خبردار باشد و راه گریزی نباشد.	knowing her fate and powerless to avoid it.
شهر را جمله به زیر پا گرفت تا آنکه به نقطهء مورد ذکر رسید.	overflowed the city to that point.
در واقع از قبل همه چی رو برنامه ریزی کرده بودم	I honestly had it all planned.
به خدا من اگر شروع به پرسیدن و جواب دادن بکنم از حالا تا فردا تمام نخواهد شد.	faith, if I take to asking questions and answering, I'll go on from this till to morrow morning.
پیش از این که من اوقاتم تلخ به شه	before I get my dander up
پس از خواندن نامه برای نخستین بار به مفهوم و اهمیت آن پی برد.	did he grasp its meaning for a moment.
قصد ندارم بدون دردسر و مقاومت مورد تحقیر و توهین قرار بگیرم و اموالم را هم بدزدند.	I don't mean to submit tamely to insult and robbery.
زیرا عشق حقیقی به مراتب دشوارتر و جانکاه تر از عشق رویائی است.	for love in action is a harsh and dreadful thing compared with love in dreams.
پشتم رو به دیوار تکیه دادم و روی زمین سر خوردم.	I leaned back against the wall and then slid to the ground.
می دونم که این روزها توی کارم اون طور که باید احتیاط به خرج ندادم.	I know I'm not as scrupulous as I should be these days.
از ترس یا از خستگی از پا درآمده بود.	she had fallen dead of fear and of fatigue.
شمشیر کشیدم و دوباره آن را در نیام کردم.	drew my hanger, put it up again.
باور کنید هنوز نمرده بود که من آن چیز را از او دزدیدم	I tell you she wasn't cold, when I stole it!
از نظری که در این حالت به فرانز افکند	casting one glance towards the young man
یا حتی سلاح سنگین رزم از تن بدر آورد خود را که در پیش دارد بنظر آرد یا حتی سلاح سنگین رزم از تن بدر آورد	without even relieving himself of the weight of his massive armour,
درست مرا برای ارج ای این نقش سفر وال گیری معین کردند	put me down for this shabby part of a whaling voyage
او یک سر و گردن از دیگران بالاتر بود.	he stood head and shoulders above the rest.
سرش را پائین انداخت و به پاهایش خیره شد.	only looked down at her feet.
باید یک جایی را پیدا کنم که بتوانم کتابم را آنجا تمام بکنم.	I might find somewhere where I can finish my book.
به دریا جست و شناکنان به نزد رفقای خود بازگشت.	leaping into the sea, he swam back to his comrades.
در سال 1948 شرکت معدنی خودش را بنیاد نهاد.	in 1948 had founded his own mining company.
نامه را روی آن نشاند و کارد را با نامه به طرف کشتی پرتاب کرد.	impaling the letter on it, sent it thus loaded back into the ship.
پس از پرداخت وجه دنبال زین کردن اسب و تدارک وسایل سفر رفتند	after it was ready, and paid, a horse had to be saddled, and a man to be dressed
من به مجرد آنکه از این قضیه واقف شدم عدم رضایت خود را از رفتار شاهزاده کوراکین ابلاغ کردم	as soon as I was informed of it I let him know how much
شروع به تمایز قائل شدن بین خوب و بد کردم.	I began to distinguish between tripe and not tripe.
هری چند بار در طول استخر شنا کرد و سرانجام به کنار استخر رفت	he actually did a couple of lengths before swimming back to the side and treading water
من کنار او ایستاده بودم و بعد او را از سر راه کنار کشیدم تا وقتی که شنوندگان مشتاقش خسته شدند و دیگر دنبال جزئیات بیشتر نرفتند.	I'd been standing with her and then pulled her out of the way till her eager listeners got bored and stopped looking for more details.
بلکه برای تمامی مردان حاضر در آنجا یک شانس بزرگ به حساب آمد که اقبال دیدن جمال او را پیدا کردند چهره و لبخند زیبایی که تا ابد در ذهنشان ماندگار شد.	but for all the men who had the unfortunate privilege of seeing her, that was an eternal instant.
در جواب سخنانش گفت که برعکس او را خوب به خاطر دارد.	answered his question by saying that, on the contrary, she remembered him quite well.
باید اعتراف کنم که هیچ علاقه و تمایلی به این خدمت ندارم.	I confess I do not want to.
در نتیجه مرگ آخرین برادرش در این اوقات ثروتمندتر شده بود.	who had now become a wealthy heiress through the death of the last of her brothers.
بنابراین بروی مسلم شد که اربابش عقل و شعور صحیحی ندارد و کاملاً دیوانه است	beyond all doubt, his master was out of his wits and stark mad
ولی من و هیرتن ماندیم تا گورکن روی تابوت را بپوشاند.	we stayed to see it covered.
یقین دارم که در اعماق دوزخ مزد این اختراع شیطانی خود را باز خواهد گرفت.	whose inventor I am persuaded is in hell receiving the reward of his diabolical invention
البته اضافه کند که تا یک شب دیگر هم سپری نشده این جوان نباید خیلی خیالش راحت باشد.	which, however, he could not allow him to feel quite assured of himself till after another night.
صاحب اسب را گذاشتم که همه شب را با چراغی روشن در اتاق کار بماند.	I left the owner of the horse to sit in the study all the evening with the lamp lighted.
به من یادآوری کرد که تابستان رسماً به اتمام رسیده.	reminding me that summer was officially over.
یک چند با دستمال شوار خود را که سر دو زانو ازشیره گیاهان سبز شده بود پاک کرد.	with his handkerchief rubbed his trouser knees,green with juicy grass.
چیزی گرو گذاشت و دخل و تصرفاتی در اموال خود کرد مبلغی کافی فراهم آورد.	making a bad bargain in every case, he got together a fair sum.
چندین بار به پیرمرد التماس کرد که بگذارد او نیز به همراه رفقایش دنبال کار برود.	took many occasions of earnestly entreating the old gentleman to allow him to go out to work with his two companions.
کشتگان به خاک سپرده نشده مدفون کردند و مهمات ناقص تکمیل شود	the wounded gathered in, the supplies of ammunition replenished
نیازی نیست به شما بگویم که این موضوع برای این منطقه روستایی اهمیت خیلی زیادی دارد.	I need not tell you that it means a very great deal to the countryside.
من به طور حتم او نو مقصر می دونم!	I most certainly can blame him!
افسران و سربازان و موژیکهای نیروی دفاع محلی به خیابان دویدند.	officers, soldiers, and militiamen began running forward along the road.
حتی یک بار به طور تلویحی گفت که کار من تجارت است	he had a slip of the tongue and said 'in trade
از ای نرو امیدوارم که با من مانند دشمن رفتار نکنند	I therefore hoped they would not treat me as an enemy
در همان روز یعنی روز طرح سه سوال صورت گرفته است	it took place on that day, on the day of the three temptations.
که وقتی کشتی بار دیگر آماده سفر دریا شد وضع ایشان چندان ضعیف بود	that upon the vessel being ready again for sea, they were in such a weakened condition
که من با آرزوی او به طور کامل موافقم	consented to comply with his wishes
که زمین لرزه باعث شکاف برداشتن کناره شده است.	when earthquakes caused the beach to gape.
زیرا هنوز دل و جرات نداشتند که بیش از این به عقب بازگردند.	for they had not yet the heart to look further back.
خدایا من یک نفس کلی حرف چرت و پرت به یک ادم غریبه زده بودم.	I've been blabbering non stop for an hour to this complete stranger.
ای پهلوان شجاعی که مردی و مران گیت مافوق هر حد و وصفی است!	high mettled past extolling!
در راه برگشت یک کلاویکورد با خود به خانه آوردند که جای پیانو سابق را پر کرد.	came back with a clavichord, which took the place of the pianola.
اگر تو بگذاری بروم حتم دارم از سرم خواهد پرید.	I'm sure I shall get over it if you'll only do that.
صدای تغییر خط قطار را نشنیده و زیر آن له شده بود.	had not heard the train moving back, and had been crushed.
چون به انتهای آن رسید یک سر طناب را که با خود آورده بود	arriving at the point, he fastenedthe rope which
در این صورت حتما باید ملیت او نیز همراه نامش ذکر شود.	his nationality would also be given in the answer.
بلکه به طور موقت در قسمتی از دهان او جای گرفته است.	but as temporarily lodged in some part of his mouth.
زیرا این بار نوبت او بود که پس از مراسم کشتن یکی از بزرگان دیگران را خبر کند تا بیایند و زمین را بشویند.	whose turn it was to give notice about washing the floor after an execution
نمی دونم راجع به پیشنهاد تو چی به گم.	I don'tknow about that idea.
به شکم خوابید و روی دیوار تا بالای بدنه بین دو دیوار خزید.	lay down flat on his stomach and crawled alongon top of the wall as far as the cant.
فریاد زدم و مادرم را به کمک خود خواندم	calling to my mother.
ضجه گریه آلود و نافذی سر داد و به حالت غش از روی صندلی به جلو افتاد.	uttering a whimpering yet clear cry and then falling forward in a faint.
که تو از آن آگاه نبودی و به تو نیرو خواهد بخشید.	which will give you fresh courage
زهر این سحر و جادو تنها متوجه من بود و تنها به چشم من ریخت.	against me alone and against my eyes is the strength of its venom directed.
حتی یک تن از آنان هم دیگر حال و احوالی از او نپرسیده بود.	no one of whom had troubled to communicate with him in any way
موقتاً پیش خود تصور کردم که روزگار سابق تجدید شده است.	I felt, for the time, as if the old days were come back.
اولین شبی که از شما دعوت کردم به انی جا بیایید مرا متعجب کردید.	you puzzled me the first evening I invited you down here.
ولی کشیش از ترس اینکه مبادا بیرون کشیدن شمشیر و جان دادن محتضر در یک دم صورت گیرد	as the instant of its withdrawal would be that of this death.
اعتراف کرد که چون در کتب پهلوانی خویش نظیر حادثه غار بسیار خوانده بود به جعل آن درباره خود نیز پرداخته است.	said he had invented it, thinking it matched and tallied with the adventures he had read of in his histories.
به سوی او آمده و شاد و شرمگین خود را یکسر ده به او وانهاده بود.	she had run up to him and given herself up entirely, shy and happy.
هر جادوگری باید اطلاعات کاملی از جوامع غیر جادویی داشته با شه	wizards should have a thorough understanding of the non magical community
در هر حرکت مهره هر قدر میل داشته باشد فکر کند	you may think over each move as long as you please
دیگر نتوانست این واقعیت را از خود پنهان بدارد که وضع وخیم است.	he could not conceal from himself that the aspect of affairs was very alarming.
من می تونم به گم که اون در باره وی فر چه نظری داره	I could maybe ask him what he thinks 
در گل و لای سر در پی گوساله های دیوانه از نشاط بهاری گذاشتند تا آنها را به داخل محوطه برانند.	waving brush wood in their hands, chasing the calves that frolicked in the mirth of spring.
زیر سایه کلاهی لطیف و نرم با آن چشمان مشکی که ثابت و بی تزلزل به بیرون دوخته شده بود گویا عاری از حیات بود.	shaded by a soft felt hat, the dark eyes looking out fixedly.
که اگر مرا دعوت کند دعوتش را بپذیرم یا رد کنم.	in case he invited me, I would comply or otherwise.
به این شوق بود که به دختر بفهماند او یک کلوخ سراپا نادان نیست.	desirous of showing her that he was not wholly a stupid clod.
در حالی که هیچ نیازی به این کار نداشت.	when he didn't need to.
زیرا که مقدمتاً باید در بعضی امور توضیحاتی بخواهد و مشورت کند.	because she had something which it was very, very necessary to talk over beforehand.
در صورتی که با این کار موافقت نکرد و یا اصولاً نتوانست چنین اطلاعاتی به ما بدهد	or, if she will not, or cannot do that
که هرگز چنان قدرتی را در خود ندیده بود.	he had never known before
دوباره راه را بر او بست و کیف را چنان محکم گرفت که معلوم بود بزودی آن را رها نخواهد کرد.	seizing the portfolio so firmly that it was plain she would not let go easily.
کسی که اکنون از این نقطه محو تماشای او بود.	where she now stood looking at him
امیدوارم اجازه بدی خودم شخصا تو کارهای خودم تصمیم بگیرم .	I wish you'd let me mind my own business.
این هم از برادرش که مثلاً از تو خوشش آمده بود!	then the brother, he, who had appeared so attached to you!
کتاب را تا نزدیکی بینی بالا آوردم تا مطمئن شوم همان نسخه است.	I lifted it to my nose to see if it was the same copy.
از واقعیت امر تنها به عنوان عمل از پیش رفته رو در رو شود و در کشمکش انتظار و تردید گرفتار نیاید.	should come to the knowledge of the step, as a step taken, and not in the balance of suspense and doubt.
از این تاریخ موضوع لباس من جزء اسرار خواهد ماند تا آن شب مهمانی که تو مرا با لباس ببینی.	I'll keep my costume a secret to the last minute, and you won't know anything about it.
به هر حال درست به خاطر ندارم که این مبلغ شش بود یا هفت.	I am not clear whether it was six or seven.
یک جاسوس و یک اسیر و یک ژنرال که از مأموریت اکتشاف مراجعت کرده بودند	a spy, a prisoner, and a general who has been on reconnaissance
همه چی به نظم و ترتیبی وافی نهاده شده.	all were arranged in the drawers
گوش ندادم که بفهمم این باعث شده بود چه فکری بکند	I didn't listen to whatever this made her think
زیرا غرض عمده من از نوشتن این کتاب آگاه کردن بود نه سرگرم کردن.	because my principal design was to inform, and not to amuse thee.
اما طول شمشیر او تقریباً سه بند انگشت بود.	it was almost three inches long.
قادر نبود هضم نماید که برادرش این همه ثروت را از کجا و چگونه به دست آورده است	was unable to understand his brother's passion.
زیرا او دین خود را به آنان ادا نکرده	from whom he has received no obligation
همین الان خودم دیدم که باهاش رفتی بالای رودخونه.	I saw you going up the creek there with him a while ago.
درشان را بدهید خوب کیپ کنند تا آب تویشان نشت نکند.	seal their lids shut so they cant possibly leak or slip off.
در اثر طوفان مقداری آب در آن جمع شده بود.	with a lot of water in the bottom after the storm.
چشم به سوراخ کلید که به اندازه کافی وسیع بود چسباند	applied his eye to the keyhole, which wastolerably large
موهای پرپشت بورش چنان خوب آراسته بود که گفتی طبیعتاً به همان شکل روی سر کوچکش روییده است.	the thick rolls of fair chignon kept up on her head as if they were her own hair.
بلکه تنها از یک حس تنفری بو جود آمده است.	it was simply a matter of disgust.
اصلاً حق ندارم از تو بخواهم صرفاً برای خوش آمدن برادرم خوشبختی خودت را فدا کنی.	I do not think anything would justify me in wishing you to sacrifice all your happiness merely to oblige my brother
در تمام این مدت به قدر این سگ برای من ارزش قائل نشدید	take no more notice of me, all this mortal time, than if I was that 'ere dog.
من در تلاش بودم تا برای او خوب باشم.	I was trying to be good enough for her.
به طوری که من نفهمیدم مرده است تا وقتی که خواهر پرستار به من گفت.	so that I didn't know she was dead till the sister told me.
شاید متوجه شد که سپیده دم نزدیک است چون شمع را برداشت و به راه افتاد تا به طرف در برود.	perhaps it saw dawn approaching, for, taking the candle, it retreated to the door.
به این سبب بود که به هول و بلا افتاده بود.	this was why he threw her off balance.
که جوانک در سر راه خود به آنان برخورده بود	whom he had met by the way
در زمانی بس کوتاه دگرگونی مشهودی بر میخانه دار مسلط شده بود.	a very remarkable transformation had come over him in a few seconds.
بلافاصه پای بلند و پشمالوی جانوری از آن بیرون آمد و همه جیغ و فریاد کشیدند.	the people around him shrieked and yelled as something inside poked out a long, hairy leg.
بی صدا خندیدم امیدوار بودم صدای آن به قدری آرام بوده باشد که نشنود.	I chuckled hopefully it was too quiet for her to hear.
اون وقت یکی دو هفته که توی غار موندن	after they've been in the cave a week or two weeks
آن اطاق تا الان ده سال است که لانه آن حیوان و خانه آن روح پلید شده.	she has now for ten years made a wild beast's den a goblin's cell.
به شرط آنکه هر یک از سپاهیان به اندازه آدمیانی باشند که دیده بودم.	if they were all of the same size with him that I saw.
لرزش سردی که بر تنش افتاده بود از چشم دیگران پنهان نماند.	an anguished chill at the thought of it affecting him almostobservably.
خواهی دید حرف آخر را من خواهم زد نه او.	I shall catch HIM tripping yet, and not he me.
یعنی به حدی که شنیده و دیده نشده است.	incredibly and phenomenally so.
همراه با آن از همه آرزوهایم برای تأسیس مطب خصوصی هم گذشتم.	with it all hopes of a consulting practice.
نخواست که با این جانور دماغ گنده تنها بماند	did not like to be left alone with the nosy man
که خودش از ترس مثل مرده کف اتاق نشست.	that he sank down almost dead with fright.
از راه دری که حالا دیگر باز شده بود تا او را به درون بپذیرد	through the door which was now open to receive him
که بیم و ترس این مرد کوچک اندام و ضعیف و در عین حال مغرور را در زیر تپانچه خویش با خرسندی بسیار مشاهده خواهد کرد	that small and frail but proud man when covered by his pistol
این کار را از فراهم کردن غذاهای بهتری که در وطن برایشان مهیاست برتر میشمارند.	than much better food provided for them at home.
منم با و گفتم که روی ظرف شیر سرپوش بگذارد.	I told him to stop and lay the table.
من بهش گفتم که تو مریض بودی اما حالا حالت خو به.	I told him that you had been sick, but you were fine now
صدایی که بلا انقطاع از روز گذشته همچنان ادامه داشت.	which had been ringing without pause since the previous day.
چه اینان هم روزی شکوفایی خود را از دست خواهند داد	for these too will get faded
اما نگفت که چطور با او نا زندگی کنم	but it didn't teach me how to live with them.
ولی همان اندازه هم که با مردم آنجا سر و کار داشتم در من این تصور را به وجود آورد که آنان به یک تجاوز غیرارادی خو گرفته یا در شرف خو گرفتن هستند.	but what little I have seen of the people has given me the impression that they have got, or are getting, into a mechanical habit of violence.
خواهش من این است که الان رای گیری نکنیم و امشب را بخوابیم و درباره آن فکر کنیم.	I beg that there should be no vote, until we have slept on it.
بدگمان شده بود که نکند ربرتا موذیانه این تدبیر را به کار بسته است	he was almost ready now to assume that this might be little more
همین که ایستاد گدایان که در پی فرصت بودند در اطراف کالسکه ازدحام کردند.	where the beggars, watching their opportunity, crowded to the sides of the coach.
بسیار بخشنده است بی آنکه اسرافگر باشد یا زیاده روی کند	he is generous ,without prodigality and wasting
بایست این قضیه را به خاطر بسپارم و سر فرصت باز فکر کنم خیلی عجیب و غریب است	I must lay it by in my mind, and think it over some time or other, it's so kind of strange and unregular.
من هرگز نمی دون ستم مست کردن تو عزب خو نه غیر قانونیه.	I never knew before that it was illegal to get drunk in a sporting house.
اما با این حال در انفجار دومی که به وقوع پیوست تا حدی موفق شدند.	but at the second try did it some hurt.
شرط عقل اینست که هر کس خشم و غضب خود را خود بخواباند	though the surer way would be to let everyone's anger sleep
فردا صبح زود قرار است یک بابایی باید مرا ببیند.	I've got a fellow coming to see me early to morrow.
هر یک به سوی وال تنهایی در دامنه رمه رو نهاد.	each making for some one lone whale on the outskirts of the shoal.
لذا چند بار به او تذکر دادم تا محکم نشسته و ناله نکند.	until at each step of the camel he bumped down on her hinder quarters with a crash
در دل کلبه ای دراز که دیواره هایش از الوار و سقفش از آهن کرکره ساخته و زیر سایه درختان غول آسای سرو واقع شده بود این کلبه مقر مهندسان مسئول بخش پیشرفته پروژه بود.	in a long hut of planks with a corrugated iron roof overshadowed by gigantic cedar trees the quarters of the engineer in charge of the advance section.
ولی مقامات پلیس کشف کردند که آن گنجه در همان جا بوده	but the police proved that it had been there
که من حق موت و حیات درباره او داشته باشم.	whom one has the power of life and death
خلاصه من که چیز به این قشنگی در عمرم ندیدم.	I never see anything so lovely.
درودگر به دستور من روزنی به بزرگی یک ثلث گز مربع احداث کرده بود.	I ordered the joiner to cut out a hole of a foot square.
بنابراین شرابش را به یک جرعه نوشید و بدون هدف به اتاق دیگر رفت.	for he drank his wine at a gulp and sauntered into the outer room.
در رأس موعد پرداخت این مبلغ برای شارل میسر نشود	that the bills would not be paid
معهذا راسکلنیکف یقین داشت که در مورد او و کار او چنین تحولات بیمارانه غیرممکن است	he decided that in his own case there could not be such a morbid reaction,
من هرگز به هیچ کس حتی به خودش نگفته بودم	I have never till today told even him
مخصوصاً یادت باشد مواظبت کنی تا گورکن سفارشی را که راجع به برداشتن تخته تابوت من و کاترین به او کرده بودم حتماً عملی کند.	mind, particularly, to notice that the sexton obeys my directions concerning the two coffins!
هرکدوم از پس راش یه تیکه برداشتن. ۶۰ جریب هم به شوهرم رسید. زیاد نبود.	his sons with a piece for my first husband, sixty acres, not much.
به همین دلیل است که من ای نا هستم.	so here I am.
اما در این کار به قدری پیش رفته بود که بازگشت از برایش ممکن نبود	but he had gone too far to draw back
شکی ندارم که این موجود در حقیقت مرد است.	I really think this must be a man!
او بی آنکه سخنی بگوید شمشیر از نیام کشید.	for drawing his sword without another word he made a rush at the stand.
ولی وی به محض اینکه چشمش به من افتاد از اطاق بیرون رفت.	but he quitted the room directly.
همین قدر مسلم است که هنگام رسیدن او در باز بود.	but it is certain that he found the door open when he reached it.
فریاد خاموش شد و صدای گریه کودکی به گوش رسید.	the scream ceased and he heard the wail of an infant.
پرسیدم قصد فوری او که مربوط به حرکت بعدی او باشد چیست.	I asked him what might be his immediate purpose, touching his future movements.
دلیلی نداشت که نتواند به فوریت استعدادهای درخشان خود را نشان دهد و سودهای سرشار را به دست نیاورد .	there was no reason at all why he should not make a brilliant success and lots of money.
آن را چنان کج و معوج کرد که ناچار شدم کلاه را بهتر بر سر بگذارم.	discomposed it so much that I was forced to adjust it
حتی اگر این مهلت محاکمه را تا پس از انقضای دوره دادستانی من به تعویق بیندازد.	even if it throws the trial over until I am out of office.
چون که من حالا تقریباً گیج و دیوانه هستم.	for I'm half bewildered.
یا از کسی بوده که مرتکب جرم عظیمی در اینجا شده	where a horrible crime had been committed
این حیوان فرومایه چون دیده بود گنج خود را از دست داده است به بانگ بلند نالیده و همه یاهوها را به آنجا کشانده بود	whereupon the sordid animal, missing his treasure, by his loud lamenting brought the whole herd to the place
ما نباید این طور رفتار کنیم این وظیفه من است که صحبت کنم.	I beg you'll allow me to speak.
دستمالی را که بر روی چهره انداخته بود برداشت	pulling his pocket handkerchief from over his head.
مسؤول آنجا خانم مسنی بود که عینکی روی بینی و یک جفت دستکش مشکی به دست داشت.	it was kept by an old dame, who wore horn spectacles on her nose, and black mittens on her hands.
باید بگویم که من نه تنها از هر گونه ظاهر سازی بدورم	I agree that I have none, nor yet any dignity I will tell you why.
زیرا او که این همه مدت را در بیرون به انتظار گذرانی ده خون در عروقش منجمد شده است.	for his blood was chilled with standing about so long, and the wind blew through him.
ویلفور کالسکه گرفته و شماره منزل خود را گفته و سوار شد	he gave his address to the driver and springing in threw himself on the seat
تا ورود موجودی را به درون خود تسهیل کند.	to afford an aperture wide enough for the passage of a human body.
بعد هم مثل این بود که از بیماری حصبه بلند شده باشد.	then she looked as if she had passed through a wasting illness.
به شما اجازه نخواهم داد بیش از این بازی کنید	I won't let you go on playing.
اما رایحه ی بیابان و زنان روبنده زده را هم با خود آورده بود	but it had also brought the smell of the desert and of veiled women.
اما تا وقتی زهر تلخ آن و شمار قربانیانش توجه عامه را به وضع آن مدرسه جلب نکرده بود همچنان در آنجا حضور داشت.	but not till its virulence and the number of its victims had drawn public attention on the school.
تو تا چند روز دیگر غیر از من پدری نخواهی داشت	all the father you'll have in a few days
تا چنانچه بچه پسر باشد از پشم آبی و اگر دختر باشد از پشم صورتی برایش بلوز کلاه ببافند.	in blue wool if it was to be a boy and in pink wool in case it was a girl.
پیدا بود که حاضر نیست به هیچ قیمت او را از دست بدهد.	obviously not at all wishing to let him go.
خیلی هم اصرار داشت که زود جواب مثبت بشنود.	was very urgent for a favourable answer.
باهاش بیرون برم. بعدش هم. ممکنه خیلی بد به شه.	go places and then well, gee
اما او در سیر و سیاحتش به زحمت این وعده را شنیده بود.	but, in his contemplation, it is doubtful whether he had heard this.
با او جنگیده بودم تا تو جن سید را ببینم!	than to have seen thee, thou white ghost!
ممکن بود این سه هزار روبل را از صندوق خودتان بردارید.	you may simply have taken it out of your cash box and brought it to the court.
طفلک معصوم! من از کوچکی او را بزرگ کردم.	I nursed her, poor thing!
ساختمان را دور بزنم و در این کوچه توقف کنم.	I'll have the back door of the car open.
اینست که فردا صبح مرا به آیین خاص به مقام پهلوانی مفتخر سازی.	is that you shall dub me knight to morrow morning
من فقط اینجا منتظرم که مبادا اون یارو بخواد برای جریان نامطبوع بعدازظهر اذیتش بک نه.	I'm just going to wait here and see if he tries to bother her about that unpleasantness this afternoon.
من متأثرم که چرا نزد او رفتم و ناتاشا را به آنجا بردم.	I am sorry I went to see him and took her, said the old count.
آن را برداشته و به یک نفس تمام آن را نوشید.	he swallowed its contents at one draught.
از نفس خود منفعل شده دو کلمه تعارفات رسمی را به عمل آورده	he muttered a few words of general civility
کمی برو مور به او داد تا خوابش ببرد.	gave her a bromide whereupon she fell comfortably asleep on the bed.
اما سر رفت و به همه پاشیده شد و درست کاری را که لازم بود انجام داد	but spluttered over every one, and boiled away, doing just what was required of it
تا آمدن شما حتی خبر نداشتم که به پاریس آمده است.	I had no suspicion even of his being in this fatal place.
در سراپای وی آثار نشاط و جوانی و سلامت نمودار بود.	her whole aspect sparkling with health and spirits.
کیک کوچکی برایم آورد که در بالای تنور پخته شده بود.	brought me a little cake, baked on the top of the oven.
بلافاصله همان رفتاری را در پیش گرفت که از چندین روز پیش در کارخانه پیشه کرده بود.	he fell back upon the attitude that for days past had characterized him at the factory.
من به یک بارکش کوچک با پروندهءتمیزی نیار دارم.	I need a small freighter with a clean record.
نخستین فکرش این بود که شب باید خوب بخوابد تا روز بعد برای انجام وظایف خود سرحال و تر دماغ باشد.	his first thought being that he must sleep well and so be fit for his duties in the morning.
شاید تو را به یک روان پزشک معرفی کنم.	I may want to send you to a psychiatrist.
تقاضاهایش از دخترک در صورت مرگ خود این بود که خاطرات خودشان را به لعن و دشنام نیالاید	if he died, not to curse his memory
تا دستی به سر و روی خود بکشد و آماده بشود.	while she tidied herself before seeing him.
از آن شب اسکار لت دیگر به پرده دست نزد.	a curtain that she felt hopelessly would never be lowered again.
اون روز صبح دی گه تصمیم گرفته بودم به هر قیمتی که شده باید عادلانه رفتار کنم.	I had made up my mind that morning that whatever else happened that day, I was going to straighten the whole thing out.
ایشان فقط باید خوب بخورند و بنوشند ولی تهیه غذا و چیدن میز کارشان نیست.	all they have to do is to eat a good dinner, but providing it and serving it all up, that's not their business!
اینو بدون که پدر و مادرت هم مثل خودت بودن.	as for all this about your parents
باید این قدر از خشکی دوری کنیم که ضعیف بشیم	we must keep away from the land till we grow weak
وقتی که ناچار شد توقف کند تا نفسی تازه نماید	being at length compelled to pause for breath
از راهرو باریک و تاریکی وارد اتاق جلویی شد.	down the dark little tunnel into the room at the front.
باید به مأموران خود فرمان دهد که مرا فرار دهند	his officers should be commanded to let me pass
نیز روایت معین و معروف همگان که با واقعیت به کلی مغایر است وجود دارد.	there also exists a definite and well known, but quite false, conception.
ولی دیگر حاضر نبودم حتی یک شب باجانوران موذی آشنا به سر برم.	but I refused to spend a single superfluous night with my familiar vermin.
زیرا پس از آن هرگز در ملأ عام راه نرفت	for she never walked again in public.
چون چیزی را به من گفته بودند که در روحم وجود داشت.	for they told me what was already in my soul.
دارای پنجهزار و سیصد و بیست و هشت تو از اگو بود.	five thousand three hundred fathoms.
دستش را زیر بالشش لغزانده و یک کتاب جلد قرمز را از زیر آن بیرون کشید.	slipping her hand under her pillow, drew out a little crimson covered book.
گویی از پایین بودن کیفیت پس مانده غذای خانه افسرده بودند	as if in low spirits from feeding on a too meagre quality of rinsings
هیچ گاه از حرکات وی بدان اندازه متوحش نشده بودم.	but, for my part, I was never much afraid of his vagaries.
با پیراهن و شلوار کوتاه کنار پنجره به تماشا ایستاد.	stood there in shirt and breeches looking out of the window.
در مقابل درهای عظیم ورودی از جنس چوب بلوط جمع شدند.	crowded around the huge, oak front door.
بدان که هر یک از ما در مقابل دیگران مقصر است.	believe me, every one is really responsible to all men for all men and for everything.
او را از حیث زیبائی و کام بخشی و ملاحت صفات و محاسنی که آدمی برای هر موجود غریزی قائل است	as delightful, precious, exceedingly worthwhile from the point of view of beauty, pleasure, sweetness
سر چاه آمدم تا بپرسم کیمیاگر کجا زندگی میکند.	I went to the well, seeking the alchemist.
پیش از سپیده دم برخاستم و به دن بل آنا رفتم.	I got up before dawn and went after them.
طناب جا سپر را کشیدم و آهسته آهسته به راه افتادم.	I went across the shingle
به او گفت که چون تاکنون در قوانین پهلوانی به خلاف این اصل بر نخورده است	he assured him he might complain whenever and however he chose, just as he liked
اما ناگهان به خاطرش خطور کرد که از شرطی سخن به میان آورده بود.	until he remembered having spoken of a condition.
شاید بیشتر خوشایند مورخین باشد که بگوییم ارلاندو چیزی ندید.	perhaps, accounts for his seeing nothing more likely to be of use to a historian.
به جای آنکه تعظیم کند چنان چرخی زد و جستنی کرد که دو نیزه به هوا پرید.	instead of making me a curtsey she cut a caper, springing two full yards into the air.
آن وقت شعاع سعادت بر راه زندگی منفرد من خواهد تابید و آن را روشن و منور خواهد ساخت.	it will shed a gleam of happiness upon my lonely way, and light the path before me.
با ملتزمین رکاب که بیش از نصف آن تقلیل یافته بود	with his suite diminished by more than half
اگرچه این جستجو بیش از یک سال هم طول بکشد!	if I search a year.
اما تا وقتی کنار هم بودند هنوز به سنی نرسیده بودند که معنی خجالت کشیدن را بدانند.	but they had never been old enough together to know what shyness was.
با شنیدن نغمه سرایی آن دوباره به گریه افتادم.	in listening to it, I again wept.
شلوار او نیز از قدک آبی رنگ و شب کلاه او از سر همان پارچه بود.	his breeches were also of blue cloth, and his cap of the same colour
دو سال پیش در کلوپ دوئل هاگوارتز شرکت کرده بود.	he had attended briefly two years ago
فقط چنان قرار گرفته بود که سایه بر عروسک که در آغوشش بود افتد.	only turned so as to cast a shadow on the doll which she held in herarms.
که به مادران صاحب رأی موسومند زیرا که حق رأی در شورای راهبات دارند.	who are calledmeres vocales because they have a voice in the chapter.
مته مه یک جور تو خالی طنین درداد که من که می گژارم کنار.	I do leave it alone, affirmed the accused hollowly.
این زن تقاضا کرد که کمیته بخش طبیب خود را برای معاینه زنی که حالش سخت است بفرستد.	made an application to the porochial committee for them to send the porochial surgeon to see a woman as was very bad.
هنوز روی آن دختر تمرکز کرده بودم و در تلاش بودم چیزی بشنوم.	I was still concentrating on the girl, trying to hear something.
هنگام راحت باش در کنار سد استخر کوچکی به هنگ خود رسید.	overtook his regiment at its halting place by the dam of a small pond.
این اندیشه را به خود راه ندهند که ممکنست ایشان را به اقتباس و تقلید از نویسندگان پیشین نسبت دهد.	without deserving the censure of having borrowed or transcribed from those who wrote before them.
خواهش کرد که وی را از هر پیشامد نیک یا بدی که برای او اتفاق بیفتد آگاه سازد	entreated him to let him hear of his good or evil fortunes
که زمین و زمان را به هم دوختند تا آشکارا همه چیز به نفع او تمام شود	who moved heaven and earth in his interest publicly
شامل همکاران و زیردستان او بود که از نظر شرایط اجتماعی به انحاء گوناگون و رنگارنگ مرتبط و یا مجزا میشدند.	consisting of his colleagues and subordinates, brought together in the most various and capricious manner, and belonging to different social strata.
تا این صورت به کلی محو شد یا مبدل به صورت دیگر گردد.	for the man to disappear or assume some other forM
چندین بار خود را از مراسم اعتراف معاف کرده بود.	he had been refused absolution in the confessional several times
که سرشان به طور کامل از بدنشان جدا شده	whose heads have parted company with their bodies.
دیگر چرا خریدی بکنم که احتیاجی به آن ندارم.	I need not burden myself with a purchase that I did not need.
راضی بود از سهم و نصیبی که از گوشه چشم دیگران برده بود.	perfectly satisfied with her share of public attention.
همین چیزاس که باعث می شه که همه بهش احترام بذارن.	all tha' respectable.
گرچه در نظر نداشت که با او ملاقات نماید.	although he had not planned on meeting him, anyway.
امیدم بدان بود که شاید بتوانم از پنجره یا از دریچه زیر سقف از آن اتاق خارج شویم.	perhaps we might contrive to get through the window there, or into a garret, and out by its skylight.
من می دونم که تا ابد نمی تونم نگهش دارم.	I know I can't keep him forever
فرصت داشت جهیدن آن را رو به بالا پیش از دو نیم شدن خودش تماشا کند.	have time to see it leap upward out of the sand before it blew him in half.
من متوجه شدم که مردم به خصوص مردها وقتی گرسنه هستن بداخلاق تر می شن	I've noticed that people men in particular are crabbier when they're hungry.
بدون اخذ نتیجه قطعی میدان کارزار را ترک گویند.	but unthinkable to keep an army even from complete disintegration and flight.
من چندان آزاد شدم که توانستم سر را به طرف راست برگردانم.	which gave me the liberty of turning it to the right.
نباید تا آن حد سقوط کنم که برای کار انجام نداده حقوق بگیرم.	I must not at least sink into the degradation of being pensioned for work that I never achieved.
او بی آنکه توجه دیگران را به خود جلب کند از آنجا رفت و من دیگر او را ندیدم تا وقتی که در دریا رفیق من شد.	this man slipped away unobserved, and I saw no more of him till he became my comrade on the sea.
وحشیانه و کور سیاسی در مقایسه با گذشته کمتر شده بود.	there was more fatuous imbecility, plenty of cruelty and suffering still, but much less of the old time fierce and blindly ferocious political fanaticism.
به اولین گیاه خودرویی رسیدیم که در میان یک ردیف تخته سنگ روییده و گذرگاهی را در پناه گرفته بودند.	as we reached the first stragglers of a battalion of rocks, guarding a sort of pass
دخترت را به کسی شوهر بده که هم شأن و هم پایه خود او باشد	marry her to her equal
نگاهی به ساعت خود افکند و با دست جلوی صورت خود حرکتی کرد به علامت نوازش همسر و فرزندانش و چابکانه در پیاده رو به راه افتاد.	glancing at his watch, he made a motion of his hand before his face, indicating a caress to his wife and children, and walked jauntily along the pavement.
هر دو چشم تاریک شده بود کف سیاه هر دو را کور و خفه کرده بود	both eyes out all befogged and bedeadened with black foam
ما سه تن هنوز جوانیم و قادریم که زندگی خود را بدست آوریم	for we were young men able to gain our living
از حالت عبوسی که به خودش گرفته است متنفرم.	I hate when she pulls a face like this.
امّا با کمال تعجّب دختر را بسیار گستاخ و دلیر یافت	but to her amazement the girl adopted a brazen attitude
نیم پا وند چای سبز قیمت آن هم در حدود هفت شیلینگ شد	half a pound of seven and six penny green
اکنون با کمال میل حاضر بود کمر بر این خدمت بر بندد.	he would willingly have had that service of exhortation in prospect now.
اما در همین لحظه چشمش به صندوق بلند و بزرگی افتاد که در فرورفتگی یک طرف بخاری بود.	when her eye suddenly fell on a large high chest, standing back in a deep recess on one side of the fireplace.
دخترک در آینده هم میل به دیدار او کند.	lead to some faint desire on her part to contact him again at some time or other.
ناگهان خانم مو بور که حدس زده بودم باید بیوه باشد وارد شد.	presently the fair haired dame, the one I thought might be a widow, came in.
اما تا به حال این کارها را نکرده بود	but he had never done this to any woman
در عمرش فکرش را هرگز روی چیزی سخت تر از بستنی و نوشابه متمرکز نکرده.	she has never in her life concentrated on anything more difficult than ice cream soda water.
من به شما پند نخواهم داد که پنین یا چنان کنید.	I will not give you counsel, saying do this, or do that.
منظورم این بود که حرف اول را من بزنم.	I meant to get my say in first
که یک دیوارش تختخواب و دیوار دیگرش میز بود	one bank of which was the bed, the other the table.
من به همراه گواهی آن را هم به تو اطلاع خواهم داد.	I'll let you have it with the certificate.
اما از موضوعی که تمام فکر و ذکر مرا مشغول داشته بود خبری نبود.	but no new allusion was made to the subject over which I brooded.
آن روز نه یک ذره گوشت و نه یک جرعه نوشیدنی از گلویم پایین رفته بود چون صبحانه نخورده بودم.	neither meat nor drink had passed my lips that day, for I had taken no breakfast.
دیگر چیزی از این مقوله به شوهر خود نگوید	without saying anything to her husband so
چه طور می تونم از تو نفرت داشته باشم.	I couldn't ever hate you.
از قرار معلوم هنوز نتونستن شما دو تا رو ادب کنن.	I notice they haven't made you two prefects.
ولی این دخترها از هم ون لحظای که چشم باز میکنن مشغول کیف می شن تا وقت خواب.	while these girls were rising to more pleasure.
اما فریاد او چنان به آسمان رفته بود که نخست یقین کردم که خروش تندر است .	but the noise was so high in the air, that at first I certainly thought it was thunder.
مثل نشستن در اطاق انتظار در یک دندان پزشکی بود.	like sitting in a waiting room at a dentist's.
هر کس در حال حاضر یا بعداً خلاف آن را بگوید حتماً مست مست است.	whoever has said or will say anything else must be drunk.
وقتی آملی همسر او شود من بسیار خرسند خواهم شد.	I shall be so happy when she is his wife.
او هم در حال تب و به همین طریق فرار کرد و در حیاط توی چاه افتاد	who ran out in the same way in a high fever and fell into the well in the court yard
غرب میانه به جای آن که قلب گرم جهان باشد اکنون بسان لبه زنده عالم بود	west now seemed like the ragged edge of the universe
چون انصاف نیست که من به کیفر گناه دیگری برسم.	there is no reason why I should suffer the punishment of another's fault.
چرخیدم و به آ رومی به سَمت غرب شروع به حرکت کردم.	I turned back and started loping slowly toward the west.
از همه بدتر اینکه انتظار نداشته که زنش ناگهانتصمیم بگیرد با استری کلند برود.	above all, he had not expected his wife's decision to go with him.
زیرا اگر او راضی به این وصلت نباشد و چنین ازدواجی را نپسندد	for if it were not in accordance with his full will and pleasure
من دوستش داشتم ولی اون خیلی خیلی بی کله بود.	I loved him but he was so so thoughtless.
خیالات تیزپرش از پیدا نکردن فضایی برای پرواز در قفس بدن محبوس ماند	his energetic spirit that would have exalted in thus revisiting the past was imprisoned like an eagle in a cage
اما بزودی آخرین روشنایی و آخرین دکان ناپدید شد.	but soon the last light from thelast stall vanished.
با این وصف مردی است که اگر واقعا خاص باشد	still a man, who, if indeed peculiar
تمام زیر پایمان همه جا در نتیجه باران سیل آسای روز قبل همچنان خیس بود.	all under foot was still soaking wet with the floods of yesterday.
یا اینکه خود او یعنی شاهزاده پیر تا آن زمان مرده باشد	or that he the old prince himself would die before then
صدایش کرد و برد قمار خودش را با فخر و مباهات برای او تعریف کرد.	boasted to him of her winnings
در همان لحظه کمک کرد تا وزن خود را به وسیله دست به دست گرفتن زنجیر ابزار بالا بکشد	at the same time also helped to hoist his own weight, by pulling hand over hand upon one of the running parts of the tackle.
تفنگ را هم بیرون آوردم و دیگر کارم تمام شده بود.	I fetched out the gun, and now I was done.
ولی میدونستم که دو دوشیزه ایکس با وضع بهتری که داره آسونتر میتونه تحمل کنه.	but I thought she was betteroff and could stand it easier.
از همه بالاتر از کاترین عزیز و دلبندم دور نشوم.	above all, my beloved young mistress
توده در میان آسمان گسترده و داغ شناور شد و دور گشت.	the cloud floated off into the vast hot sky.
با احتیاط بیشتر به خود فشرده از میان باغ به جستجوی راه خروجی دیگر دوید.	he could and ran with her through the garden seeking another way out.
قصدش برای بودن در کنار او به هنگام اعلام حکم دادگاه.	later to appear with him in courtat the hour of his sentence
چون برای مدتی عادت کرده بودم که جان خود را فقط در مواردی که برای هدف ما مفید واقع شود درمخاطره قرار دهم و در یر این صورت حاضر نبودم که بی هودم بمیرم.	but from habit, for lately I had risked myself only when it seemed profitable to our cause.
سرم را تکان دادم و آبشار سفیدی از موهایم پایین ریخت.	I shook my head, and a cascade of white drifted out of my hair.
تعیین میزان مالیات را باید یکسره به وجدان مردم واگذار کرد.	the decision whereof should be left entirely to their own breast.
چه بهتر که آن شوهر خواهر سفیه شما را دور انداخت.	she did better still in throwing up that crazy brother in law of yours.
زیرا در نظر اول قیافهٔ آن مرد مرا متعجب ساخت.	so greatly was I impressed from the first moment by the appearance of this man.
یا در دعوائی اعم از جزائی و جنائی یا حتی دعوائی که مربوط به تعیین حدود املاک باشد شهادت دهند.	neither are they allowed to be witnesses in any cause, either civil or criminal, not even for the decision of meers and bounds.
همه و همه در نهایت او را به یک بیگانه تبدیل کرده بودند.	changed him into a stranger in the end.
با نام سرکش و پر افتخار او ملازمت داشت	went with the wild, dark plumed name
یک حالت مطبوع طبیعی داشت که تا آن زمان خودش را نشان نداده بود.	with a natural pleasant manner that had not shown itself until then.
لذا با شنیدن این اشاره به آن مرحوم خود را روی یک صندلی انداخت	no sooner heard this allusion to the dead and gone, than she dropped into a chair
من آن قدر دلم میخواد بریم که دی گه سر جام بند نمی شم	I'm just a twitterin' to go on.
عبارات زیبای بسیاری را برای بیان مطلب خویش به صاحب امپراطور آماده ساخته بود.	prepared many fine things he meant to say to the gentleman in waiting.
ژاکتم را گلوله کردم و به جای بالشت ازش استفاده کردم.	I balled up the sweater to use instead.
دیگر تا زنده هستم به شما زن دائی نخواهم گفت.	I will never call you aunt again as long as I live.
زیاد پیش از آن هرگز آن را به کار نبرده بود.	which he had never used before.
باید حتماً این کار را بکنیم تلافی ما باید آنقدر شدید باشد که شخص ضربه زننده هرگز دیگر به فکر چنین کاری نیفتد.	I am sure we should so hard as to teach the person who struck us never to do it again.
من هم مثل تو آرزوی آن را دارم. ولی نه به عنوان یک گردنبند.	I, too, covet that, but not as a necklace.
آن هم صرفاً به خاطر این که اوقات زنش را تلخ کند.	just to annoy her
سطلی به یک دست و جارویی به دست دیگر داشت.	she carried a mop and pail in her hands.
سه دختر جوان از لحاظ معلومات و عقل و استعداد ممتاز بودند	for every one of the three was clever, well educated, and accomplished.
در آنجا به نگهبانی بایستد و با چنان دقتی قراولی کند که گویی روز روشن است.	stand a look out there, with the same precision as if it had been day.
احساسات او را به نحو اتم و اکمل منعکس ساخت.	fully expressed his feelings, and has since become famous.
از لحاظ روحی آنقدر به نظرم شبیه به او آمده	seems to me so like him spiritually
بجز اسیر و بانوان که در اتاق خود صرف شام کردند.	except the captive, and the ladies, who supped by themselves in their own room.
که از گوشه کوچه پیچیده و از نظر غایب گردید.	who soon disappeared at the corner of the street.
درِ حمام را به روی خود بست و با دل راحت گریست.	he locked himself in the bathroom and cried
چشمانتان از شدن بی خوابی و خستگی چون دو کاسه خون شده است.	your eyes blood shot, like a person starving with hunger and going blind with loss of sleep.
رز ماری از پیچیدگی و آلوده بودن این زندگی ناآگاه بود	unaware of its complexity and its lack of innocence
آن را با حالتی گویا به جلو هل داد.	giving it a sort of oratorical push.
دیگر هرگز با هیچ کس دربارة هیچ چیز صحبتی نباید داشته باشد.	that he would never again be able to _speak_ of anything to anyone.
ما توانستیم دکلش را ببینیم و به طرفش برانیم.	we fetched the stabboard derrick, and made fast there.
چون محل آویزان شدن آن سمت راست کشتی و مشرف به لج و بود.	on account of its hanging from the starboard quarter.
تا نیروی آسمانی ایمان و دلسوزی و شفقت او را نسبت به تمام مستضعفان و رنجبران و ستمدیدگان این جهان دید.	to see the divine force of faith in him and his great pity for all that was poor, suffering, and oppressed in this world.
آن را با دست گرفت و درست روی سر من تکان داد	shook it directly over my head
من در اتاق انتظار منتظر فرمایشات آقای بارون هستم.	I awate in the entichamber the orders of monsieur le baron.
یک جفت جوراب از داخل آن درآورد که لابه لای هم قلم به شده بود.	pulled out a particularly knobbly rolled up pair of socks.
او از کوپه خارج شد و نویل را با خود برد.	she left, taking the toadless boy with her.
ممکن است که من در خارج از کشور باشم.	I may be away abroad.
من هم غذای خود را با تو صرف کردم	I used to divide my soup and beans with you
گفت که تا موقع صرف ناهار و صرف چای کنتس را آماده شنیدن این خبر خواهد ساخت	decided that at dinner and till teatime she would prepare the countess
مدتی مدید با وضعی خیلی رسمی و مرموز به مذاکره پرداختند.	held a long council together, compared with which, for secrecy and solemnity
آن دو اجازه داشتند از ساعت شش آخرین شب تا ساعت چهار بامداد	who, from six o'clock in the evening preceding themorning of his death until four of the final morning
که سگا خط بوی شما رو گم کنن اون وقت سوار شین.	that'll throw the dogs off the scent.
از دیدن این حال اهل خانه چنان قهقهه زدند که کم مانده بود از صدای خنده آنان گوشم کر شود.	which made the company laugh so heartily, that I was almost deafened with the noise.
آنگاه آن گوشت را نزد یاهو افکند و یاهو آن را با حرص و ولع بلعید.	he then threw it to the _Yahoo_, by whom it was greedily devoured.
در واقع همه چیز را از روغن وال انباشته بودند	that indeed everything was filled with sperm
که صدای پای سنگینی از دالان بلند شد و از زیر در چشمم به نوری افتاد که به اطاق آمده بود.	when I heard a heavy footfall in the passage, and saw a glimmer of light come into the room from under the door.
بفرما نده آنان امر کردند که مرا سلامت به آنجا برساند	the commanding officer had orders to convey me safe thither
روزگار قدیم چه قدر بهتر از زمان ما بوده!	the past was better than what we have now.
حالا که غذا را دیدم متوجه شدم که کیک جو بود که آن را به چندین بخش قسمت کرده بودند.	I now saw, however, that it was a thin oaten cake shared into fragments.
هیچ وقت چنان که باید و شاید مراقب او نبود	hadn't bothered to keep a close enough watch on him
که دستور رسیده است نگذارند شاهزاده خانم از ده خارج شود.	that they could not let the princess go
برق چشمانش از دور به او افتاد و در قلبش خلید.	the light of her eyes fell on him from afar and pierced his heart.
بلکه از جهت موفقیت خویش در این عمل و به سبب اغتنام فرصت مساعد برای آرام کردن جمعیت با مجازات این خیانت کار از کرده خویش راضی بود.	but he even found cause for self satisfaction in having so successfully contrived to avail himself of a convenient opportunity to punish a criminal and at the same time pacify the mob.
تا به حال کسی نتوانسته چیزی را بدون لمس کردن یا فوت کردن یا انجام یک عمل بیرونی از جایش حرکت بدهد.	nobody else in the history of the world has been able to compel an object to move without touching it or blowing on it or using any outside help at all.
ممکن بودبه سهولت از استودیو بیرون دویده قسم خورده باشد که دیگر پایش را به آنجا نگذارد.	she might easily have flung out of the studio with vows never to return.
وی دختر بود که از حقایق زندگی آگاهی داشت و این خطر را با چشمان باز پذیرا شده بود.	she was a girl who knew the world and the facts of life, and she had taken the risk with her eyes open.
اما این شکنجه دهنده که او را دوست داشت	but this loving despot
کاغذی در جلو رویش گشوده و قلمی را که با آن نوشته بود هنوز در دست دارد.	on which he lay with the written paper open and the pen still in his hand.
هنگامی که به بدن عریان خود نگریست به لرزه افتاد	he looked at his own naked body and shuddered
از یک رشته پلکان سنگی پایین آمد و قدم به صفه باریکی نهاد.	descended a flight of stone steps to a narrow landing stage.
به خصوص گوسفندان که چون پشمی لطیف دارند امیدوارم مایه پیشرفت بسیار در صنعت پشم بافی شوند.	especially the sheep, which I hope will prove much to the advantage of the woollen manufacture, by the fineness of the fleeces.
چند پرچم و چند توپ گرفته شده و دو ژنرال دشمن نیز اسیر شدند	banners, cannon, and two enemy generals.
سپس پنجره را بست و باز روی درگاه نشست.	then, closing the window, sat down again upon the sill.
زیرا روزنامه من که این خبر را نشر کرد	for my paper, which gave the first information on the subject
که کلاید امکان دغل بازی او را آنگاه منتفی دانست.	that at once he was compelled to dismiss the thought of intrigue.
با ترس روی سینه صلیب ساخت و در دل دعایی خواند.	crossing herself with trepidation and repeating a silent prayer.
یکباره زایل گشت و همه از تماشای او شادمان و محظوظ گشتند.	she might not do the right thing was at an end, and they were already admiring her.
تا اندازه مصارف خود را از آن قرار نماییم.	I want capital to build my plans upon.
با ریسمان دیگری که در دسترس بود او را به یک صندلی بست.	with more rope, which was at hand, he bound her to a chair.
با وجود اینکه هیچ خط والانتین را ندیده بود شناخت که خط اوست.	although he had not before seen her writing
من بیشتر از چیزی که تو بفهمی از رنجش تو ناراحتم.	I regret your suffering more than you realize.
قصد داشتم در را باز کنم و آن پزشک ناراحت و سپاسگزار و شرمسار را به حال خود تنها گذارم	I was on the point of opening the door and leaving my grateful but confused medical friend to himself and his shame
کلید قدیمی را درآورد و بی سرو صدا در را باز کرد.	took out the old key, put it into the lock, and opened the door noiselessly.
وی آن کیسه را به سوی قصر پرتاب کرد	flung it at the castle
تورو خدا آدم خوبی باش و مارو راه بده!	BE a sport and let us in!
یا اگر وقتی واقعا کاری کنند که خون از او فوران کند	or if indeed he should ever be made to spout thick blood
من طوری تربیت شدم که به قوانین رانندگی احترام بزارم.	I was raised to abide by traffic laws.
اما حقیقت آن بود که بر استی بیهوش شده بود و بعدا این نکته را به مادرش اعتراف کرد.	but the fact was that he really had lost consciousness, as he confessed long after to his mother.
من هم با این ازدواج به قدر تو موافق نیستم.	I don't approve of the match any more than you do
دائم راجع به این موضوع قرارشد که کمیته به عنوان کمیته تصمیم بگیرد	to discuss the question of the scouts or spies or whatever
در همان لحظه دست اهب آخرین کوشش خود را برای بیرون راندن قایق از دهان وال به عمل آورده بود.	at that moment his hand had made one final effort to push the boat out of the bite.
متعجب شد که این حادثه که اینک به وقوع پیوسته نه فقط جالب و جاذب نیست	he had attached such importance, and was surprised that this event, now that it had taken place
که آیا ایشان آن روز در وضع و حال او متوجه تغییری نشده بود.	whether she could not detect in him that day a marked change
امیدوارم عشق همه را ده سال جوان تر نکند.	I hope that being in love doesn't make every one ten years younger.
چون جان او در اشتیاق دیدار شما به لب رسیده است.	for she had a great desire to see your worship.
اما مقام هیچ مرد بالاتر از قبول حق شناسی نیست.	but no one is above gratitude.
من ب محض دعوت شما آمده و تخلف نکردم.	I have answered your first appeal
بیمار را چنان برگرداندند که ناله او دوباره برخاست و از درد باز از هوش رفت و به حال هذیان افتاد.	turning the wounded man over so that he groaned again and grew unconscious and delirious from the agony.
من مایلم شواهد دیگری هم در این مورد داشته باشم.	I should like to have some further proof of it.
موضوع نو کاملاً جای موضوع کهنه را گرفته بود.	as the latest interest had entirely borne down the first
تا ساعت هشت چندین بار به ساعت مچی خود نگاه کرد	she looked at her watch till eight
وی را برای جنایتش به زندان اندازند و دار بزنند	he should be put in prison and hanged
به خاطر آورد و آتش عشق و محبت وی بیش از پیش در دلش افروخته شد	love and tenderness for her, stronger and more vivid than ever, awoke in his soul.
سؤالاتی که قبلاً از من کرده بود با پاسخهائی که من داده بودم سنجید.	compared the questions he made with the answers I had given.
مطمئنم که تا آخر عمر هم دوستت خواهم داشت.	I always will, I suppose.
این پیام رو به جهانیان می رسونم که من زنی موفقم	the message I give the world is I am a successful woman .
من یکی از اشخاص اصلی و مهم این نمایش مذهبیم	I am one of the principal characters of the play
اگر به اندازه معقول ضخیم باشد چیزی به جز پوست نخواهد بود.	if reasonably dense, what can that be but the skin?
حاضر نبود برای برخورد با ماجرای دیگری یک دینار بدهد.	he would not have given a farthing to meet with another adventure.
تماشاگران بیشتری را جلب خواهند کرد شهرت بیشتری بدست خواهند آورد	that they would attract more people, and get more credit,
با چشمان طلاییش با نگرانی به من خیره شد.	his gold eyes watched me warily.
اما در کدام کوچه و کدام نمره خبر ندارم.	but I know neither the street nor the number
شای ته است ابتدا مقدمات کار را فراهم سازد	it would be as well to get all the preliminaries done with
هنگامی که زمین و آسمان هردو سرد بودند شروع به حرکت کند.	while the earth and sky were cool.
شاید در تمام طول سفرتان کمتر به این خوبی از شما پذیرایی شده باشد.	perhaps you will have found worse accommodation in the course of your journey.
محبوسین دیگر داریم که خطرناک و دیوانه هستند ک	the dangerous and mad prisoners are in the dungeons
پدرش در یکی از شهرهای کوچک حرفه تجارت در لوازم خرازی را پیشه کرده و بعدا ورشکست شده بود	his fatherhaving been a small town dry goods merchant before him, who hadfailed
دخترک از خیابان عبور کرد و به کوچه سمت چپ پیچید	the girl ran across the street, turned down a side street to the left
بخش جنگ که تمام صفحات وسطی روزنامه را در بر گرفته بود.	the entire middle section was a feature on the war.
گل مارگونه شاید فکری باشد که از قلم بانویی تراوش کرده باشد	the snaky flower a thought, strong from a lady's pen, perhaps
با آن ریخت لاغر مردنی که زیر درختان بادام باغ ملی نشسته	sitting under the almond trees in the little park
یک پیر مرد زشت و وحشی با پای چوبی جلوی کالسکه نشسته بود	, the truculent dirty old man with his wooden peg sticking stiffly out over the dashboard
او در انتظار خوابیدن راهزن مست و لای عقل نشسته بود	she sat by, watching until the housebreaker should drink himself asleep
به خصوص اگر روی هدف فرود بیاید قدرت ضربه مقاومت ناپذیر است.	especially if it descend to its mark, the stroke is then simply irresistible.
به سلیقه خود پایان آن را ساخته و پرداخته بود و علاقه خاصی داشت که آن را در خیال خود تکرار کند.	but finished in her own way, which she liked to repeat to herself.
زنی که به درون خزیده بود تا بدزدد و بیالاید	the woman who had crept in to steal and defile
آخه ممکن بود توی گمرک این بسته رو باز کنن.	what if they'd opened it at customs?
زیرا برفرض هم که به دستگیر کردن و بردن او توفیق یابند	for even if they arrested him and carried him off
دارای پنج پسر بود و من سومین ایشان بودم.	I was the third of five sons.
سه چهارم مایل به نظرش یک چهارم مایل رسید.	the three quarters of a mile would have seemed but one.
نیش طنزآمیز این سؤال جسورانه همهمه و جنبش خفیفی در میان حضار انداخت.	ater a slight nervous tremor on the part of the audience which
چون هیچ کس پولی برای دادن به وکیل ندا ره.	because nobody has any money.
لوسی دیگر نتوانست بر تارهای صوتی خود مسلط بماند.	she could not command her voice.
بدون اینکه زیاده از حد آنان را بستاید یا برای تهییج خوانندگان شخصیت احساساتی به آنان بدهد.	neither overpraising them nor sensationalizing their careers to set spines atingling.
ازدواج نکند تا هنگامی که راه صاف و خوبی به دور از جاده پهن و حاضر آماده کنونی برای خود هموار ساخته باشد.	not marry until he had trodden out a good clear path for himself away from the broad road which was quite ready made.
اما حریصی از مردم چابکانه به رقضص مشغول بودند کشیده شدند.	but avid were moving briskly around.
سپس در را پشت سر ما بست و کلید را برداشت.	locked the gate behind us, and took out the key.
بر خود لرزیدم و رنگم پرید و سفید شد.	I trembled, and turned white.
او بیشتر به یک بازیکن مهاجم فوتبال شباهت داشت تا یک پزشک.	he looked more like a quarterback than a doctor.
اما اگر کشیش بشود مسلماً هرگز زنش نخواهم شد.	but I certainly never will be his wife if he becomes a clergyman.
چندان که کشتی تنها با دو رشته سیم نگاه داشته شده بود.	till the vessel swung only by two.
آن دو تن را اشباهی تصور کرد که از گور ملوانان غرق شده برخاسته بودند تا او را نکوهش کنند.	he took the couplefor a phantom sprung from the graves of drowned sailors to upbraid him.
بس که با امور ادبی یا با ادیبان سروکار داشتند.	they were so much taken up with the affairs and men of letters.
آیا اینکه اصلاً ارزش آن را دارد که آدم نسبت به چنان موجود زبان نفهم و بیشعوری ملاطفت به خرج دهد!	if it were worth while being civil to the brute.
ناگهان شوق گریستن و نالیدن در جانش چنگ انداخت.	there came an awful longing to weep and cry
فرصتی برای فکر کردن و شور کردن در این مورد وجود نداشت	there was no time to reflect upon or to controvert his statement
بعد از آن که مقدار متنابهی از پول دولت را به جیب زد	having purloined a considerable sum of public money
لیکن خواهد کوشید که این کار هرچه زودتر صورت گیرد.	he would put it off as long as possible.
با آنکه مریضید خود را نیرومند و زورآزما میدانید	strong when you are sickly
من که به مک گاون نگفته بودم جمله آخر را ببرد سر سطر!	I never told McGoun to make a third paragraph there!
که تعصبات و مقررات موجود به احتمال قوی هرگز به او اجازه نخواهد داد	taboos and restrictions which made it seem likely that never at any time here would
دستانش را بر روی شیشه به شکل کاسه در آورده بود تا داخل ماشین را ببیند	cupping his hands to the glass in an effort to peer in.
تصور می کنم خشونت خاصی در چهره استری کلند بود که آن دختر را جلبکرده بود.	I suppose the girl had been attracted by a certain brutality in it.
دراز بکش و از لحاف من روی خودت بینداز.	lie down and cover yourself with my quilt.
شاقولی از یقه من تا زمین آویخت که درست به طول قبایم بود	let fall a plumb line from my collar to the floor, which just answered the length of my coat
همان گونه که دفعات پیشین نیز چنین کاری کرده بودم	as I have done many a time before
ولی خون او برای همیشه از حرکت باز ایستاده بود.	but the blood had stopped forever.
ولی چارلی هم که در خوردن کتک و مشت مهارتی به سزا داشت	who, being skilful in evading pursuit, ducked to avoid it
آن شهریار که سوارکاری ماهرست برجای خود استوار بماند تا کسان او دویدند و عنان اسب را گرفتند و اعلی حضرت از آن فرود آمد.	that prince, who is an excellent horseman, kept his seat, till his attendants ran in, and held the bridle, while his majesty had time to dismount.
البته شرطش هم اینست که از طرف من دستور دیگری دریافت نکند	if he heerd nothing from me to the contrairy.
بعد از این که قسم خورده بود از آن برای فرستادن نامه به دوستانش استفاده نکند.	after swearing that he wouldn't use her to send letters to any of his friends
امد ه ام مردی را در اینجا ملاقات کنم	 'I came to see a man here.
خواستم در را باز کنم اما از داخل بسته شده بود.	I tried to open it, but it was fastened inside.
یقین دانست که چیزی نخورده است و او را دعوت به نهار کرد.	felt sure that he had not eaten that day, and invited him to lunch.
بویی که در خانه بر جای مانده بود کافی بود	the odor in the house was sufficient proof
که برای یک بیننده معمولی به سختی قابل درک بود	which was so little perceptible to a common observer
در گودال جز توده عظیمی از گل چیز دیگری وجود نداشت.	the ditch a bed of mud.
از او خواهش کرد که پیغامش را فورا ببرد.	begged her to take the message at once.
قدرت نگاه گرگ ماده باعث شد که با حالتی عصبی دل پیچه بگیرم.	the sight of the she wolf made my stomach twist with nerves.
افسوس که در شرایطی هستم که باید آن را بفروشم.	a pity but I am in a situation now where I am forced to sell it.
تا مبادا ایشان مانع اجرای تصمیم ستوده و نیکوی او شوند.	lest they should prevent the execution of his praiseworthy and valiant purpose.
خط ریشش هنوز از خواب پریشان بعدازظهر ژولیده بود.	his side whiskers still in an uproar after a restless siesta.
قازقلنگ موجود کوچک یک پایی بود با بدنی نحیف و شکننده گویی از ذرات دود درست شده بود.	a little one legged creature who looked as though he were made of wisps of smoke
این چیزایی که بهت می گم قسمتی از ماجراس.	parts of it
گفت در وطنش جنگ بادبادک قواعد و مقررات خاص خود را دارد.	told us that in his hometown, kite fighting had strict rules and regulations.
اما اهل کسب و تجارت معمولا عشاق خوش بین و خیال پردازند.	but business men are frequently as sanguine and imaginative as lovers.
سیره جاری مملکت ما در ین باره کدام است	according to the present practice in my own country
اکنون فقط قصد داشت که راه مستقیم خود را در دریا پیش بگیرد.	now only intent upon pursuing his own straight path in the sea.
تو را همین جا نگه می دارم تا به خوبی ازت مراقبت شود.	I'll keep you here where you can be properly cared for.
ولی آن شب دیگر نتوانستم به دیدارش موفق شوم.	I had not one.
من میخوام یکس ال مدت عمومی گذاشته به شه عضویت ما در دستورکار جلسه	I'd like to see the one year thing on the agenda for our next public meeting
رؤیاهایی که در شش ماه گذشته آنچنان مایه شادیش بودند.	as she had been enjoying for the last six months.
در این سه روز از چشم تنگی و خست معمول در صحرا خبری نبود.	no three day niggardliness for them of the nominal desert law
به کلی منکر داشتن دوربین و سه پایه شده بود.	had denied any knowledge of it
در آن لحظه بازویی قرمز با چکش که رو به عقب گرفته شده بود به هوا بلند شد	at that instant, a red arm and a hammer hovered backwardly uplifted in the open air
دیدم که آن جمع از رفتار من خوششان آمده است	I saw the company was pleased with my behaviour
بیمار پتو را با حرص تمام در دست گرفت	then, clutching the coverlid with both hands
در این فکر بودم که آیا امشب هیچ خبری از چنین صدایی بود.	I was wondering if there were any evidence of such a sound tonight.
خود را آماده کرده بود تا تعظیمی کند و از خشونت کلام خود پوزش بخواهد که	had bent to ask her pardon for the violence of his language
حالا دیگر همه فهمیدند در آن بسته بلند و باریک چه بود.	now they knew what had been in the long, thin package he had brought with them.
مخصوصاً اصرار داشت که نباید تنها به خلنگ زار بروید.	especially that you should not go alone upon the moor.
روی دیوار هم با قطرات بخار آب پوشیده شده بود.	there was a flabby perspiration on the walls.
نخستین سخنانی که یاد گرفته بودم مرا مدد کرد تا آرزوی رهائی خود را آشکار نمایم	the first words I learnt, were to express my desire
درد و رنجش آنقدر گران بود که جدا به خیال خودکشی افتاده بود.	his pain had been so great that he had thought quite seriously of committing suicide.
دیشب هم شما تا دیروقت بیدار بودید و زیاد خسته شدید.	what with the hot morning and standing about all last night
من بی آنکه شما تکلیف کنید همراهتان به راه افتادم.	without any invitation from you, in spite of myself, I went with you.
حتی این زحمت را به خود نداد تا بفهمد	nor did she take the trouble to
روح و اندیشهٔ عامه را اشتغالات اجتماعی و عملی به خود گرفته بود.	other preoccupations, social or practical, absorbed the attention of the public.
در درویدا پایداری خاصی چون چرخش افلاک کند و هماره جریان داشت.	only a slow, wheeling inevitability like the constellations.
شنیدم مردی به سنگینی به چل یک سیب تکیه داد و نشست.	so when a heavy man sat down with rather a clash close by.
اصلاً به خاطر این کار لازم نیست معذب باشی.	you can have no scruple to accept such an accommodation.
انعکاس ماه نارنجی رنگ تابستان بود که ناگهان برخاسته بود.	reflection from a bloated orange summer moon that had risen silently.
بالاخره موی تمام کسانی که سخنان خیمه شب باز را شنیدند از تعجب راست ایستاد.	e veryone amazed at the words of the puppet showman
مردم هم قبول و قرا موش نخواهند کردکه شوهرش مفلس شده و فرار کرده	for the wife of a bankrupt would never be forgiven
من دی گه نمی تونم این جور زندگی کنم .	I do not intend to live with them any longer.
فقط دیدم که یواشکی از اتاق بیرون آمدند و جیم شدند و فکری هم به سر من نزد.	but I see them sneaking out of the room and hustling away, and I never thought nothing
دیگر برای همیشه قشون منهدم گردید و از افراد آن حد وسطی به وجود آمد	deserted houses, the army was lost forever and there came into being something nondescript
امیدوارم به زودی زود از مصاحبت دائمی او لذت ببرد.	will soon, it may be hoped, have the advantage of being constantly with her
خیلی هم اسباب افتخار من است که این را برایم آوردی.	I'm awful proud youbrought it to me.
بلافاصله روبان طلایی بلندی از انتهای چوبدستیش بیرون آمد	a long golden ribbon flew out of it
این اولین باره که از ما میخواد که کاری به راش بکنیم	now the first time she asks us to do something for her
فاصله زمانی چندان کوتاه است که ناچار چنین باید گفت	for it is so lately one may say so
پس همیشه هنگام مغرب در خانه خرابه گور بو بسته بود.	which was always closed at dusk.
حتی حالت طبیعی کف خاکی حیاط تنگ شده است.	even the bestial nature of the parvenus.
بالای دیوارها و سقفی را که از آن لوستری خاموش آویزان شده بود را.	see the top of the walls and the ceiling, the unlit chandelier that hung there.
چون که او خیلی در این مدت کوشش کرده و خیلی خیلی نسبت به من خوب بوده است .	for she has tried so hard and been so very, very good to me,
که این پسرک بالاخره روزی بالای دار خواهد رفت!	that that audacious young savage would come to be hung!
که آن هم به سبب ناچیزی و حقارت در بسته کوچکی از کاغذ جا گرفته بود	inasmuch as it was all comprised within the limits of a brown paper parcel, about half a foot square by three inches deep
فریاد و داد و بیداد به راه خواهم انداخت.	I would shriek and screech and writhe and thrash.
لکن هنوز دو قدم برنداشته بودند که در با صدا باز شد	but scarcely had they taken two steps before suddenly a door swung open
آنگاه به سرعت بالا آمد چنانکه گویی از دور کوه یخی که در آب فرو رفته باشد و به سرعت به سطح آب ژآید فرو میسرید.	then quickly upheaved, as if sideways sliding from a submerged berg of ice, swiftly rising to the surface.
عزم خود را جزم کرده بود که آشفته نشود.	firmly resolved to keep cool.
لیکن این مسئله باقی است که بدانم آیا ساخت این دارو گران تمام خواهد شد یا نه.	but it remains to be told if it costs much to make it.
زیرا آن گوهر گران بها را که چون از دست رفت دیگر هرگز به چنگ نخواهد آمد برای دخترش بجا گذاشته بودند.	since the jewel that once lost can never be recovered had been left to his daughter.
آن وقت دیگر خواهشی از تو ندارم جز این که اگر دلت خواست باز هم به من نامه بنویسی.	then, till I can ask for your correspondence as I ought to do, I will not expect more.
چون ناگهان نور زرد کوچکی به اندازة سر سوزن آن پردة تاریک را شکافت	for a tiny pinpoint of yellow light had suddenly transfixed the dark veil
خود اِما هم طوری برافروخته و ناراحت شد که قدرت نداشت مستقمیاً چیزی بگوید.	she was too much provoked and offended to have the power of directly saying any thing to the purpose.
مردان پاک دل و شریف ممکن نیست مورد تمجید و ستایش این و آن قرار نگیرند.	those who are virtuous cannot fail to receive commendation.
نخواست که ایشان را بیش از این در اندوه بگذارد	had no desire to keep them unhappy any longer
کسی که آن دو زوبین را پرتاب کرد چنین اتفاق افتاد	the man who darted them happening
با حدت و حرارت مشغول خشک کردن صورتش با حوله شد.	began to wipe his face diligently on the towel behind the door.
جوانهها بر درختان بداغ و بوتههای انگور فرنگی و درختهای بلند و باریک و صمغ آلود غان بر آماسیدند	the buds of the guelder rose and of the currant and the sticky birch buds were swollen with sap,
می تونیم او نم با خودم ون به باغ وحش ببریم	I suppose we could take him to the zoo
برای از دست دادن من غمی به خودش راه نخواهد داد.	will not miss me.
قول داد که بعد از به دنیا اوم دن بچه دست از سر من ورد اره بره پی کار خودش.	after that she would go away and let me go my way, too.
در همان لحظه جو دورگه دید وقت خوبی است	in the same instant the half breed saw his chance
در فکر این باشید که زودتر به سلطنت برسید و مرا کنت کنید.	your worship's be it to strive to become a king, and make me a count.
برای این آمدم به دیدنت که از شنیدن خبری نگران شده بودم.	I came to see you because I had heard something which made me anxious about you
هنگامی که غذا خوردن به پایان رسید اصلا یادش نبود چه خورده است.	when it was over she had no idea what she had eaten.
شک دارم آقای نای تلی هم تعارف او را پس بدهد و کشف کند که سرکار خانم واقعاً خانم تمام عیاری است.	I doubt whether he will return the compliment,and discover her to be a lady.
ولی نتوانستم از تفکر در این خصوص خودداری نمایم و گذشته از این بی درنگ خود هم تصدیق کردم که افکار و احساسات شخصی من نباید در این قضیه دخالت ورزد	but it was involuntary, and I immediately said to myself that my personal feelings had nothing to do with it,
منم یه چیزی می دونم که قرا ره به شه	I know something that's going to happen.
دوباره خواهش کردم که بگذارند از آنان جدا شوم	I again desired leave to depart
به شکل درخت بید مجنون بود آن را به خاطر داشتند و از مروارید ساخته شده بود.	a weeping willow, it was they must remember it set in pearls.
وقتی که تو کر سفید تمیزم را روی آن مرتب کردم	adjusted my clean white tucker
اما نه به آن شکل صمیمانه که دور تا انتظارش را داشت.	but in a formal way quite unexpected by her.
توی باغ درحال سیگار کشیدن دید و چنان شلاقشان زد که تمام شهر شنیدند.	smoking in the garden shed and walloped them so that you could hear it all over the town.
من تا دم مرگ به قولم وفادار خواهم ماند.	I will be true to the death.
حالا فرصتی برایم پیش آمده که با او تنها باشم.	I've earned a time alone with him.
قیمتش هم شصت و هفت و دلار و نود سنت است!	we get sixty seven ninety for it.
با یافتن محل کوفتگی در سر زن بازیگر و در آغوش گرفتنش با او آشنا شد.	making the acquaintance of his heroine by finding a contusion on her head and lifting her gently in his arms.
آن وقت اگر دید که ربرتا هنوز از مخمصه درنیامده است فورا دست به کار شود.	if she weren't all right by then he would act.
این را نوشتم دیروز و دیشب تمام وقتم صرف نوشتن آن شد و امروز بامداد آن را تمام کردم.	I wrote all day and all night, and finished it this morning early.
رویداد شادی بخشی که لتی بعد برای پدر و مادرش بازگو کرد.	an incident which she narrated to her mother and father.
چند روز پیش یک دست لباس برای خواهرم خریدم.	I bought one for her the other day
که هیاهوی سختی رسیدن دسته پاسداران را اعلام داشت.	when a violent uproar announced the arrival of the patrol.
آنم باید مخ بط باشد تا در این باره اشتباه کند.	no one could have made any mistake about it but one who had something of the same kind in his head.
ماه تازه در آمده بود و من در حالی که پشت به جاده داشتم چشمانم را به آسمان دوخته بودم.	my eyes were on the moon, and my back to the entrance
به دنبال او سرباز دیگری سوار بر ارابه آمد.	after him came another sitting on a cart.
من عرض کردم که ممکن است اشتباهی در این باب شده است.	I had the honor of saying to your eminence that there had been some mistake.
در این موقع بدون اینکه خبری بدهد به همراه رفیقش وارد اطاق شد	entering the room followed by his colleague, before he said any more.
افتان و خیزان به خانه رفت و توی رختخواب خوابید.	he crept home and to bed
چشمش به چندین بسته کادو افتاد که جلوی تختش روی هم چیده شده بودند.	the first thing he saw was a small pile of packages at the foot of his bed.
من کسی که جبروت و عظمت فروشد دوست ندارم	I never like upstarts
پدرت رو سوار کرد و بدون اینکه چیزی به گه به شهر رفت.	got your pa in it and off they went to town without a word to anybody.
داستان مرد سفیدپوستی را که از قضا وال گیر هم بوده	I remembered a story of a white man a whaleman too
بازویم را محکم بالا گرفته که ضربه را فرود بیاورم.	I had my arm all ready for the blow
من هرچی کتاب که از این جور اطلاعات بده خوندم چیزی نگفته.	I've read all the books that gives any information about these things.
اما برادر را با امیدواری آشتی دادن با پدر تسلی داد.	but comforted him with hopes of reconciling their father to the idea.
چند قدم جلو رفتم. جسابی هاج و واج شده بودم.	I take a few steps forward and stare at her door, intrigued.
بدون هیچ نجای خالی به جز قلب یا لوله کوچک عمودی که در محور پنیر موجود است.	without any hollow but the heart, or minute vertical tube formed at the axis of the cheese.
تمام صف کشیده و راه عبور دادند و چیزی نگفتند	they merely stood aside to let him pass by, as usual, nothing more.
خود را از مردم عقب کشید و به میخانه خویش برگشت.	dropped behind and returned to his tavern.
دست لاغر و کاملاً پوشیده با دستکش را به سوی او دراز کرد.	was holding out to him a slender, carefully gloved hand.
قدرت و اختیارات را از دست دولت مرکزی خارج سازند.	would take power away from the supreme authority.
همه ما از صمیم قلب سه فریاد هورا کشیدیم	we gave three heavy hearted cheers
خودش هم چندان مطمئن نبود که آنچه در زندگی کم دارد عشق باشد.	because she was also not convinced that love was really what she most needed to live.
سبیلی که تا آخر عمر آن را نگاه داشت و نتراشید. زندگی خود را تغییر داد.	he would keep for the rest of his life and that changed his entire being
از این که در دام افتاده بود به شدت خشمگین بود.	boiling with anger at herself for falling into his trap.
او بیش از یک سوم فاصله میان من و خود را نتوانسته بود بپیماید.	he was much more than a third of the way up.
آیا در این هنگام دست خوش آن گیجی مشئوم شده بود	had he now reached thatstate of sinister amazement
ناچار برای رهایی از دست وی سر را به طرف پنجره برگرداند	she turned her face to the window
فقط پسرکی بود که بر چمن بر پشت چمباتمه زده بود.	only a boy squatting in the lush lawn.
رهایی از بار این مسئولیت سنگین و دشوار سعادت بزرگیست.	to lay down all this heavy responsibility.
بر آن شدند که دست کم در آن حال مزاحم او نشوند.	agreed for the time to tamper with him no more.
خبری که شاید دیگر موقعی به دست نیاید که او را مطلع سازد.	a warning he might not be able to send another time
آن را دیوار کوچه و دیوار مشترک همسایه احاطه کرده است.	it is shut in between the wall of the street and the partition wall of the neighboring house.
جز به سخن گفتن به چیز دیگری نخواهی پرداخت.	for thou wouldst spend it all in talking.
این شد که شب را خوب و خوش گذراندند.	so they spent a jubilant evening.
وگرنه بفرمایید ببینم اگر خدای ناکرده تا چندین روز به مردی مسلح که کلاه خود بر سر داشته باشد برنخوریم	just tell me now, if for several days to come we fall in with no man armed with a helmet
وی در سال 1499 به دنبال آمد و در 1566 فوت کرد.	born in 1499, died in 1566
لیکن سوار که از زیر چشم مواظب حرکات او بود نگاهش داشت	observing which the gentleman held her back
به محل حضور و غیاب بازگشت تا مجددا در آنجا کشیک بکشد.	he went back to the time office to watch again.
هرچند راستش را بخواهید من خود هرگز زشتی آن بانو را ندیده	though, to tell the truth, I never perceived her ugliness
تا نزدیک یک ساعت یس از نیمه شب به گشت و گذار خویش از خانه قدم بیرون ننهاد.	did not start upon his excursion until nearly one o'clock.
پس از اینکه برای مقداری غذا آن همه پول داد	after which he offered a million for some food.
من در میان آشوب و غوغا دریافتم که تغییری در صدای او پیدا شده است.	I perceived a change in his voice. even in the hurly burly
برای اینکه او را به حرف آورم با صدای تیزی گفتم	I barked out, to force her to speak again.
مشروط بر اینکه قول دهد که از سخنان من نخواهد رنجید.	under his promise of not being offended
نه من برای این کار پول کافی داشتم و نه ربرتا.	I didn't have enough money to do that and she didn't either.
از کنجکاوی به آنجا رفتم و یک قفسه کوچک و یک میز توالت دیدم.	there is a small chiffonier and a dressing table.
زیرا حقیقت هرچند ظریف و شکننده باشد هرگز نخواهد شکست	for the truth may run fine but will not break
حس ترحم و دلسوزی را از دل خود بیرون راندم.	all pity left me.
لیکن چون دیدیم که چوپان از این داد و فریادها غوغایی در ولایت بپا خواهد کرد	but reflecting that the shouts of the shepherd would raise the country
اما پی برد پدرش خیلی پیر شده است و فکر کرد شاید باید سری به او بزند.	but realized his father was very old, and thought perhaps he should go to him.
من واقعانمی دونم که باید بهشون اخطار بدم یا نه	I didn't know to warn them.
لکن چون شاهزاده وی را آرام کرد به خنده پرداخت.	but when he tried to soothe her she began to laugh.
با این حال با عجله در صندوقش را باز کرد	but he quickly opened his trunk
ولی باز هم بهتر از تنها نشستن توی خانه است.	but it is better than being always at home.
سوم آنکه در خاطر خود برخی نکات مبهم داشت	thirdly, because he happened to have his own little shrewd doubts to solve
شیمیایی دی گه به اسم یک ماده کولینس تریس دربدن ساخته میشه.	another chemical, cholinesterase, is manufactured.
قدری نمک روی دلت پاشیدم تا بوی بد نگیرد	I sprinkled a little salt upon your heart to keep it sweet
پیوسته با صدای بلند خواند و به قدری تکرارشان کرد تا همه را از بر شد.	reading them aloud, going over them until he knew them by heart.
گذشته از این خواهر شما تحمل دیدن مرا هم ندارد.	besides your sister can't endure me.
نه مادر خود و نه هیچ کس دیگر را محرم راز خویش نشاخته بود.	she had not been able to make a confidant of her mother or any one else in regard to him.
بدم نماید به روزی خودم این کلکو یه جائی سوار کنم.	I wouldnt mind pulling some of it myself sometime.
اما اکنون آماده بود تا با خوشحالی فداکاری کند	but now she would readily have sacrificed
زانوی خود را به روی گلوی پسرک گذاشته بود	his knee was on his throat
روی عرشه کشتی پرتاب کرده به نقطه درخشان قیر زد و آن را ناپدید ساخت.	clean across the ship's decks, and struck the glistening tar spot out of sight.
اما به دیدن دو چشم ثابت که در آب باز ناف ته بود از جا جست.	but started at two reflected, fixed eyes in the water there.
ممکن بود به علت چنین کاری شغلش را از دست بدهد.	he might lose his job through a thing like this.
که البته در هرمورد دلایل متفاوت و عمیقی دارند.	whose causes are varied and profound.
آخرین شعرهایی که مارتین خوانده بود و آخرین شاعری که روت کتابش را مطالعه کرده بود.	the last poetry he had read, the latest poet she had studied.
در محبس با زحمت کمی تمام آنچه خوانده بودم و در حفظ داشتم به خاطر آوردم	a very slight effort of memory has enabled me to recall their contents as readily as though the pages were open before me
یقین دارم روزی به این موهبت نائل خواهم شد.	I believe that it will come to pass
دست منو گرفت و از تو کثافت بیرون کشید.	she snaked me in out of the wet.
ثروتمندی که فصاحت و بلاغتی داشت شیشه براق عینک	a rich tanner of fluent speech, whose glittering spectacles
تو در آن جا جواهرات را به من خواهی داد و پول را خواهی گرفت.	you'll turn over the jewels, and I'll give you your twenty five thousand.
او دو بار به صورت همان بازرس قدیم در آمده بود.	he was once again a beadle.
که در شبی مثل آن شب در دو قدمی خود برای اولین بار چشمان هراسیده او را دیده بود.	on a night like this, she had seen his frightened eyes up close for the first time.
چشم به مردی دوخت که در برابر ایشان قرار داشت	looking over that barrier at the person to whom they were both opposed
از بیرون نشون نمی ده که این قدر جا داره.	you'd never know it was this roomy from the outside
دلش هوای این را کرده بود که آواز بخواند.	he felt like singing.
خبر مراجعت او از ریو آچا به گوشش رسید.	he received the news of her return.
بیشتر از آن روز را خوابیدم و شب راه افتادیم.	WE slept most all day, and started out at night
همیشه فرصت خواهم داشت که احساسات خود را فدای رفاه و آسایش خانواده کنم.	I can always sacrifice my feelings for my family's welfare, he said to himself
دو باله نقشه را لوله کرد و در جیبش گذاشت.	then tucked the map away again
با تأنی و ابهت و تقلای زیاد پیش آمد	rounded to ponderously and with laborious pomp and circumstance
پاسداری و نگاه داری شخص تو بر عهده من محول است.	the counterpoise and burden that nature and custom have imposed upon masters.
یعنی اینکه باید دنیا را برای رستگاری خود تغییر دهی.	that is to say the world must change for the good of you.
اکنون قصد دارند تبر هیزم شکنی را بیندازند و نیزه وال گیری را برگیرند.	now seek to drop the axe and snatch the whale lance.
از خستگی به جان آمده و هنوز راه جنگل را به پایان نرسانده بود.	she wasworn out with fatigue, and had not yet emerged from the forest.
ابری از گرد و خاک راه افتاد.که مماس با زمین در هوا معلق بود پشت سرش باقی ماند .	making a cloud that hung low to the ground behind him.
واقعا از برای مکنتی از درجه سوم هفتصد هزار فرانک خیلی خسارت است.	it is a hard blow for a third rate fortune
در چند مورد مرسلین بدوی را نخستین مقدصایی که داشتند رساند.	in many cases carried the primitive missionaries to their first destinations.
فقط بشرطیکه قدم به خانهٔ من نگذاری زیرا عزم ندارم ترا امروز بپذیرم	but on the condition, went on the lady, looking full at him, that you do not cross my threshold. I do not intend to receive you today.
سطح رادیاتور آب گرم مطابق اصول صحیح علمی یا حجم اتاق متناسب بود.	the hot water radiator was of exactly the proper scientificsurface for the cubic contents of the room.
تا آن سعادتی را ذره ذره از نو بسازد.	, to gather up again the fragments of the happiness
اما اندکی بعد چون من به پذیرایی شب پیش او اشاره کردم کوششی کرد	but presently, upon my referring to his last night's hospitalities
در حالی که هر دو هم معتقد بودند بعید است.	as each believed almost impossible
جرأت آن را یاقتم که از قالب یک گدا بیرون بیایم و راه و روش طبیعی خود را از سر بگیرم.	I dared to put off the mendicant to resume my natural manner and character.
امروز مخصوصا از برای همین آمده بودم که اطلاع تازه که در این باب به دست آمده عرض نمایم	I came a moment ago to give your majesty fresh information which I had obtained on this head
ولی زنیکه رو کشتم . اصلا هم متأسف نیستم .	I ain't sorry none that I kilt her.
بلکه در عین حال از معنای این رفتار هم سخت به وحشت افتاد.	but at the same time frightened by themeaning of it all.
آن دفعه که آنجا رفته بودم آن را توی ویترین مغازه دیدم.	I saw them in the window last time I went down there.
ناشی از عنایتی است او به من دارد و از این است که من به او تعلق دارم.	comes to me of the favour she extends to me, and because I am hers.
بر زمین افتاد و از غم و شرمی که داشت گریه را سر داد.	fell a weeping with shame and grief.
آنان در زندگیش رخنه میکنند و کم کم جزئی از آن میشوند	they wind up becoming a part of that person's life.
اما کمال اعتماد را به کسی خواهد داشت که من به او اعتماد داشته باشم	but that whoever possessed the good opinion and confidence of the ship's owner would have his preference also
من به خاطر رهائی خود چندان یادداشت و عرض حال دادم	I had sent so many memorials and petitions for my liberty
فنجان قهوه و جام شراب مقابلشان روی میز بود.	coffee and wine were in front of them.
که از یک طرف کوچه بط رف دیگر کشیده شده بود	which traversed the streetfrom side to side
چنان با حقیقت قرین که جای هیچ گونه چون و چرا نیست.	the truth of which admits of neither reply nor question.
این کتاب را به من بده و پول را برای خود بردار.	telling him to take the money and keep it for himself.
توصیف آن همه تحقیر که در این کلمه گنجانده بود از منساخته نیست.	I cannot describe the unmeasurable contempt he put into the two words.
که من خیال کردم پرندگان سفید بزرگ غاز هستند	when I thought those big white birds were geese
من تاکنون پشت سر هیچ ساحری غیبت و بدگویی نکرده	I never spoke ill of any enchanter
تنها یک بار اسبی سرکش که از آن یکی از فرماندهان بود چندان سم بر زمین کوفت که دستمال من سوراخ شد.	only once a fiery horse, that belonged to one of the captains, pawing with his hoof, struck a hole in my handkerchief.
گوسفندها همه از نژاد مرینوس بودند و سراسر بدنشان از پشم لطیفی پوشیده بود.	they were all merinos, which meant wool all the way down to their hoofs and noses, and a cobbled fragile skin which moved like slippery paper.
من از آغاز تا انجام این کار پر ابتکار راهنمایش بودم.	I directed in the whole contrivance.
ولی هیچ گاه موقع صبح او را بم نزلم راه نخواهم داد.	but I will never receive her here in the morning.
در مواقع بحرانی هم مسئولیتی در قبال فروشندگان ندارند.	it always flourishes when times are bad.
اما ظاهراً شرایطش ون شامل حال من نمی شه.	but apparently I don't fulfill requirements
زیرا عزت نفس و احترامش به مذهب او را از مجرم شناخته شدن در امر زنای دروغین	because the sense of his own dignity and respect for religion forbade his taking upon himself a fictitious charge of adultery,
او را دیدم که در این جوان خوب روی	I saw him looking down at this handsome boy
تفنگ آماده را به طرف قلبش نشانه گرفتم و آتش کردم.	I fired at her heart.
بعد در جریان مذاکرات از شما خواهش خواهم کرد که با هم به تنهایی صبحت کنیم	he is cognizant of the business on which I wish to speak to you.
آخه قبل از رفتن به جنگل بهش احتیاجی نداشتم.	I didn't need to use it before we got in the forest.
تا آن موقع خیلی کم به طرف من نگاه کرده بود.	he had hardly turned his eyes in my direction before.
وقتی وال سفید آنجا افتاده و سر و دنبش به کشتی بسته است.	when the white whale lies down there, tied by head and tail.
آواز قشنگی است و پشت سرش هم آهنگ رقصی دارد.	a bonny tune it goes to a dance.
در ضمن هر نوع ملاقات با وی را نیز لغو کردند.	the prohibition of all types of visits
چون وقت خوابیدنم رسیده فکر کردم پاهایم را کمی نرم کنم.	but it's getting near my bedtime, and I was just thinking I'd like to stretch my legs.
پس باید بکوشم تا بدون مزاحمت دیگران این زندگی را تا آنجا که مقدور است بهتر به پایان برسانم.	so I must live out my life as best I can without hurting others.
به خود اجازه داد و با لحن مؤدبانه آمیخته با مزاح متذکر شد	ventured with respectful jocularity to remark
دریافت تا زنده است از آن بدر نخواهد آمد.	understood that she would never come out again as long as she lived.
خواهرم اره و سوهان به رام نیاورده که من فرار کنم.	my sister hasn't brought me any saws or files to help me escape.
چنانکه من به حساب خود سه روز تمام در اعماق آن غار تاریک که از نظر ما پنهان است اقامت گزیدم.	so that, by my reckoning, I have been three days in those remote regions beyond our ken.
اما آزردن او با تبرئه خویش از این بدتر بود.	but to make her suffer by justifying himself was worse still.
با توجه بدین که شغل نجار عبارت باشد از تنه قدم و پر شاخ صنایع دستی متعدد بود	the carpenter's pursuit being the ancient and outbranching trunk of all those numerous handicrafts
آن عروسک نیز به مدت سه روز بدون وقفه با آهنگ آن ساعت دور خود پیچید و رقصید.	the toy danced uninterruptedly to the rhythm of her own music for three days.
تنها قولی که صبح روز عقدشان دیگر بار از او گرفته است.	was the one promise he had still exacted on the morning of their marriage.
حتمی باید دی گه یه چیزی به راش بیارن.	you got to buy somethin
اما بعد از این مدت خانم رید کودک را به جایی روانه کرد که شما با آن آشنا هستید	at the end of that time she transferred it to a place you know
در پای این درخت نیمکت دایره شکلی ساخته بودند.در طرف دیگر هم یک پرچین کشیده شده بود.	circled at the base by a seat, led down to the fence.
نمی دون ستم شما در آتلانتا تشریف دار ین.	I didn't know you were in town.
او نم حالا که تاریخ داره تکرار می شه	now that history is to repeat itself
به قیمت تفکرات عمیقی برایش تمام شده است و اهمیت عظیمی در بردارد.	cost him great thought and was of the utmost importance.
که فاصله زمانی بین دو شکار از چند روز بیشتر نبوده است.	that the interval of time between the two assaults could not have exceeded very many days.
مارتینی اتاق را پیمود و به کنار بستر رفت.	he crossed the room to the bed side.
متوجه نشد صدای هلهله و تشویق برای هری پاتر به مراتب بلندتر از قبل است.	he hardly noticed that he was getting the loudest cheer yet.
زیرا از یک طرف جوانک سفارش کرده بود به او قدری تریاک بدهند	since, in addition to a moderate dose of opium prescribed by the apothecary
در حیرت بودند که آیا کسی متوجه نگاه آن دو به یکدیگر شده است یا نه.	wondered if anybody had noticed anything in their mutual glance.
بلکه فقط از این نظر که به حضرتعالی تعلق دارد.	merely as something belonging to your worship.
اگر یک بار دی گه از این کارها بکن ین	if you do anything like this again
دو وطن پرست مسلح به عنوان نگهبان با ایشان به راه افتادند.	a guard of two armed patriots attended them.
چون تو باید بدانی که ما مهتران پهلوانان سرگردان	for I would have you know, friend, that we squires to knights errant
برای او به منزلهٔ انضباط فکری و مکتب سبک شد.	served him as mental discipline and a school of style.
باور کن اگر مار زنگی با شه باز بهترمه.	I jis' 's soon have rattlesnakes aroun'.
هر دو با هم بیش از چهل سال نداشتند.	they were forty years old taken together.
او فریاد کشیده است که برد متعلق به او است و مادربزرگ باخته است.	whereupon he cried out that the winning stake was his, and hers the loser.
تا وقتی که تونست برای خودش شکار کنه مواظبش بودم.	I cared for him until he was able to hunt for himself.
ولی در هر صورت زندگی وی با بی کسی و درماندگی آغاز شد و از کجا معلوم که با همین ترتیب نیز پایان نیابد.	but its beginning was as friendless as its end is likely to be.
من تعقیبش کردم و با او در گیر شدم.	I tracked him and fought with him.
ولی حالا دیگر واقعاً به صورت جزیره متروکی درآمده است.	but now it is a desolate island indeed.
آنگاه مکث کرد و به تجسس چیزی برای پوشانیدن پول پرداخت.	but, looking for something to cover up the notes that she might not see them
که بعد از این نصف این گنج را به تو واگذار نمودم و به تو تعلق دارد	of which from this day forth one half belongs to you
اما در کیسه جادار توری شکار فقط سه پرنده کوچک بود	while in the great roomy net of the game bag there were only three light little snipe.
به نظر من که خیلی راحت توی دام افتاده.	I'd say she'd be very easy to lure into a trap.
مرا تهدید کردند و گفتند که اگر از جای خود بجنبم مرا از عرشه کشتی به دریا خواهند افکند.	threatening to throw me overboard, if I offered to stir.
هیچ یادم نیست که یک هم چه کلاهی سرم رفته با شه	I hain't been so put out since I don't know when.
همچنانکه راست به دیواره پیش تکیه داده بودند با برق و فروزندگی آشکار شدند.	as they stood upright against the forward bulkhead.
تنها لطف زندگی و یگانه امید خوشبختی او رفته بود!	he was gone, the only charm of her life, the only possible hope of joy.
پرچم سیاهی برافراشته و به تمدن اعلان جنگ داده است.	it had hoisted the black flag and declared war upon civilization.
بگذارید یک لحظه نفس تازه کنم و ببینم چکار باید کرد.	let me have one moment to draw breath and reflect.
یک لنگه پوتین گل الود در دست مرد بود.	who was holding a moldy looking old boot in his other hand.
تا بدانند که از این پس اگر کسی به خاطر من مرد	let it be understood from this time forth that if anyone dies for me
با آن مقدار نیروی اندک که برای او مانده است بکوشد زوبین را به نحوی در وال فرو کند.	with what little strength may remain, he essays to pitch it somehow into the whale.
دوباره به ساحل رودخانه و در آنجا پشت بوتة جادویی پنهان شدم	but crept back to the bank again, whence, sheltering my head behind a bush of broom
این سخن را گفت و از اتاق خارج شد.	she said, and went out.
حتی یک کلمه دیگر با او حرف نخواهم زد.	I won't say another word to him.
بعداً یک دقیقه سکوت کن و سپس فقط او را ببوس یا یک کار توأم با مهربانی و از این قبیل	than take a quiet minute and just kiss her, or do some kind thing
اگرچه این بار هم معلوم نبود این موفقیت به سودش تمام شود.	though here too it was an equivocal advantage that he won.
به مین سبب بود که کوتوزوف برخلاف امیال محافل درباری به اتفاق آراء به فرماندهی کل منصوب گردید	the unanimity and general approval were founded with which, despite court influences
که خون خود را در سر این کار بریزم تا بر همگنان معلوم دارم	shed my last drop of blood to prove to my noble colleagues
هیچ کس تو عمرم تا حالا این جوری با من حرف نزده است.	nobody ever talked to melike this in all my life!
اما این امکان نیز وجود دارد که فقط درست درک نشده باشند.	but also they might have been misunderstood.
ماسک کائوچویی که روی بینی و دهانش را گرفته بود.	dust mask over nose and mouth
غلتی خورد و آنقدر خود را عقب کشید که گویی عملا می گفت پایم هم به پایت نخواهد خورد.	rolling over to one side as much as to say I won't touch a leg of ye.
که تمجیدهای من او را به هوس انداخت تا چنین موجودی را که متصف به آن همه محاسن بود ببیند.	that my praises excited in him a desire to see a damsel adorned by such attractions.
هرگز در عمرم ندیده بودم که چنین چیزی این قدر ناگهانی اتفاق بیفتد.	I've never seen a thing come so suddenly
اندکی پس از این تا آن حد که بدون استفاده از قلم مو و پرده کرباس ممکن است	I shall ere long paint to you as well as one can without canvas
ولی به نظر من مو دی خیالاتی نشده بوده.	but I don't think so, somehow.
خیلی خوش شانسم که جون سالم به در بردم.	I'm lucky I escaped with my life!
که به ظاهر کم خور و چاپلوس باشد و باطنا زرنگ وکلاهبردار.	subservient on the surface, but cunning and clever beneath.
که پس از خواب بعدازظهر تمام وجودش را در خود گرفته بود.	that would saturate his soul after his siesta
هر وقتی که صحبت از شجاعت و نیک نفسی و جوانمردی به میان آید.	I make any allusion to affection, wit, or amiability
بدون شک علت زردی رنگ صورت او نیز همین بوده و به همین دلیل هم این قدر نزدیک بخاری نشسته و در داخل خانه پالتو پوشیده.	which was the reason, doubtless, his face was so sallow, and that he sat so near the hearth, and wore a surtout in the house.
تا حد لزوم تلاش کرده و استادانه عملیات را رهبری کرده بود.	he had fought as long as it was needed, and directed operations with a masters touch.
عجیب بود که چطور بر آن خطای بزرگ آنی غلبه کردم	it was wonderful how I got over the temporary blunder
من دوست دارم که تو خطاهای مرا به من گوشزد کرده و مثل خواهر من باشی.	I like to have you tell me my faults and be sisterly
خیلی صریح و سرراست به هم رقص خود گفت چه قدر حیرت کرده است.	she spoke her astonishment in very plain terms to her partner.
گویی آستینشان به چارچوبی که هنوز ساخته نشده بود تکیه کرده است	they their very selves were closing in around a structure yet unbuilt
به من هم اجازه داده شود در سر کار خود بمانم و خدمت خانمم را بکنم.	I to remain as housekeeper.
اگرچه وسائل و ادوات مخصوص دو گروهبان هم در این گیر و دار مفقود شده بود.	though this included the sergeants' cherished kits.
شما بط رف راست متوجه شوید و به خانه خودتان بروید و من نیز به سمت چپ را پیش خواهم گرفت.	you to the left, homewards, and I to the right, here?
تخم خاموش گناه است که همیشه قابل بارورشدن است.	the quiet egg of sin, always fertile.
بی درنگ دهقانی را که خود در خواب دیده بود به یاد آورد.	instantly he recalled the peasant of his dream.
از وقتی که سخنران حرفش را تمام کرد و سر جایش نشست	when the lecturer stopped and sat down.
خود نیز با ناراحتی مبهمی دست به گریبان بود.	he was vaguely uneasy.
تا به جائی که تصمیم به انتقام گرفتن بگیری بکوش از این حس بهراسی	even to a desire for vengeance on the evil doers, shun above all things that feeling.
به همین دلیل معتقدم که این حق شماست که بدون ین واقعاً چه به سر سدر یک اومده.	I think that you have the right, therefore, to know exactly how it came about.
برای این که به او نشان دهد سه بار چون گرگ زوزه کشید.	thrice, to show him, she barked like a wolf.
زیبائی دریاچه را تحسین کردم لکن در عین حال حس دردناکی قلبم را ناراحت کرد.	I felt how lovely it was, but the loveliness weighed upon me somehow or other, and made me feel melancholy.
آزرده نشوید به ویژه برای آنکه اندکی مست هستم.	I'm rather drunk, too, I'll tell you that frankly.
چوبدستیش را بیرون آورد و خم شد و زیر لب چیزی را با دقت ادا کرد.	she crouched down, pulled out her wand, and whispered a few, well chosen words.
به خانه سعادت او رخنه کرده و همه چیز ایشان را ربوده بود.	a desperate burglar slid into his happy home, and robbed them all of everything.
شادان از اینکه دیناری نپرداخته از آنجا بیرون آمد.	he passed out very well pleased at having paid nothing
یه روز پدربزرگم یه گرگ رو کشت و به اون درخت آویزونش کرد.	once my old man hung up a dead coyote in that tree.
اگر بخواهم فهرستی از امراضی که ممکنست انسان دچار آن شود ذکر کنم پایان نخواهد داشت	that it would be endless to give him a catalogue of all diseases incident to human bodies
توده ای عظیم از آهن و شیشه و تخته های سنگ در تقاطع دو خیابان که بالای بامش تاری از ارتعاشات سیمهای تلگراف تنیده شده بود	an enormous pile of iron, glass, and blocks of stone at the corner of two streets, cobwebbed aloft by the radiation of telegraph wires
بعد هم تا مدتی نتوانست غیر از این چیزی بگوید.	all that he could say for some time.
من فقط به خاطر اربابت به این موضوع علاقه من دم.	I have no interest in this matter but that of your master.
زیرا خیاط عجله کرده و برش پارچه را به درستی انجام نداده بود.	for the tailor had been hurried and some of the seams were awry.
با اظهار عجز و فروتنی پیشنهاد صلح کردند که بزودی با شرائطی که بسیار به سود امپراطور ما بود برقرار شد.	with humble offers of a peace, which was soon concluded, upon conditions very advantageous to our emperor
افسری دیگر بعدا اظهار آن سرباز را تأیید نمود.	I asked some officer about this afterwards, and he said it was perfectly true.
پس او را مطمئن کردم که شکل و ترکیب من مانند شکل و ترکیب غالب همسالان منست	I assured him, that I was as well shaped as most of my age
گفتم با یک شب کار ولی در حقیقت دو شب کار بود	I have said by one night's work, but, in truth, it was by two nights' work
بینی دراز و افتاده چانه نوک تیز لب درشت پایینی	by the long drooping nose, the peaked chin, the heavy lower lip
چنان که گفتی بیم داشت کسی به او یا از آن بدتر به همسرش اهانت روا دارد.	as though he were afraid someone would be rude to him, and still more to her.
امواجی رو که تا شعاع یک کیلومتریش با شن دریافت می کنه.	picks up stuff about a mile around.
لیکن به هر ترتیب برای گلوی خشک ما بسیار مطبوع و دل پذیر بود.	but good for parched throats.
امیدوارم که شما نسبت به من عصبانی نشده باشید .	I hope you are not angry with me, sir?
شرط نبرد ما این خواهد بود که مغلوب تسلیم غالب گردد	the conditions of our combat shall be that the vanquished shall be at the victor's disposal
اما در سایه وجود فرزندانش و نیز به سبب آداب پسندیده و مهارتش در امور حقوقی توانسته بود	by reason of his children as well as his own good manners and legal subtlety
که هر یک از ایشان 350 لیره برای کرایه پروازشان بدهکارند	each man owed GBP350 for the air fare
پس به گریه افتاد و صورتش را با دستمال پوشاند و از اتاق بیرون دوید.	bursting into tears she hid her face in her handkerchief and rushed from the room.
من حضور ذهن داشتم و به هر دو گفتم پدرشان به خاطر کار مهمی از لندن رفته است.	I had the presence of mind to say that their father had been called away on business.
که تا این دم حتی یک تن از اعضای خانواده خودش و یا خانواده عمویش برای حمایت از او پیش نیامده بودند.	was the fact that thus far not one singlemember of his own or his uncle's family had come forward tochampion him.
شما همواره به ارزش این تعهد معتقد هستید. آیا چنین نیست!	I suppose you still regard that security as of value?
من از همونها میخ وام یکی واسه من به خونین	I want you should say one for me.
من که نمیخوام سر از کار مردم در بیارم.	I don't stick my nose in nobody's business.
به سرعت به طرف آن در رفتم و به داخل نگاه کردم.	walking swiftly up to the door, I looked in.
جز آنکه گفتند که آن آلت لبه تیزی نداشته است.	other than to say it must have been blunt.
من بهشت را پیدا کرده بودم و با تمام توان آن را نگه داشته بودم.	I'd found heaven and grabbed it as tightly as I could
نه فقط خانم دلخواهش را از دست داده بود	not only losing the right lady
که به بهانه نرسیدن اسناد لازم از شهر وی را نگه داشته	who had made him stay by assuring him that some necessary documents had not yet arrived from town
اطمینان می دم که همه مدارک کاملاً بی نقصن.	I can assure you every piece is perfect.
من دیدم که چگونه صفوف ایشان شش مرتبه تشکیل شد و مانند روز رژه به راه افتادند.	I saw them close up their ranks six times in succession and march as if on parade.
به او اشاره کردم که دیگر مرا ننگرد و دنبال نکند	beckoning to her not to look or to follow me
افکار همان خواهد بود که خود انسان بوده است.	ideas were what they were.
مجبور شده بودند به مستخدمان نیز اجازه دخول بدهند	but it was also necessary to authorize the admission of servants
ولی از برخورد با اسلحه در میدان جنگ پاره خواهد شد نه بر اثر فرسودگی و گذشت زمان.	but ragged more from the wear and tear of arms than of time.
ابن قیصر مردی بود خوددار و خودکفا و آرام.	remote, abstracted, self sufficient.
غریبه هم متوجه این کار شد و از میزبانش قدرانی کرد.	the stranger understood and appreciated.
با عجله یکی از پاسبانانش را فرستاد تا آن راه راه نگاه دارد.	he hastily despatched one of his agents
زن ماهروی دست او را گرفت و محکم بفشرد	she seized his hand and pressed it frenziedly.
که این نان گندم سیاه و این آبدو و این مرباهای گوارا و این گردوهای خوابانده در عسل ویان خوراک مرغ لذیذ را هرگز در هیچ جا ندیده و نخورده است.	she had never seen or eaten such buttermilk cakes, such aromatic jam, such honey and nut sweets, or such a chicken anywhere.
لابد از اینکه پدر رالف با خونسردی رؤیاهای ارزشمندش را کاویده بود عمیقاً رنجیده بود.	he must have hurt her deeply when he held up her precious dreams to dispassionate inspection.
پدران باید همیشه از خود چیزی بدهند تا بتوانند خوشحال باشند.	I am the author of your happiness and of your existence.
که صدای زندانبان او را به اتاق انتظار خواند	that the inspector's voice called him to the visiting rooM
سپس به زیر تختش خزید کف پوش شل زیر تختش را برداشت	then crawled under his bed, wrenched up the loose floorboard
با این حال در این مدت کوتاه بسیار تغییر کرده بود.	he had changed greatly during that period.
بنابراین عامل برش بایست به نحو غیر معمول دقیق باشد	he has, therefore, to be uncommonly heedful, lest a careless
بلکه به تعویق انداختن آن برای مدت کمی هم غیرممکن است.	but also that he could not put off the telling.
لکن حتی به تجسم این منظره هم فایق نیامده و از فکر این موضوع به کلی منصرف شده بود.	but had found the picture too mortifying and exasperating, and had quietly dropped it.
مشروط بر این که نزاکت و آبرو اجازه دهد که پهلوان مغلوب از امر غالب تبعیت کند.	provided the injunction be such as shall be becoming a knight.
بنابراین ممکن است درس شما باشد اما باز هم بیشتر برای من است	therefore to ye, and still more to me
روحش از گناه فارغ است و در روی همین جهان خاکی به رستگاری تام و تمام نائل گردیده است.	therefore there was no sin in his soul, and he was experiencing complete salvation here on earth.
ولی من یک طوری دور او چنبر زدم و یک لحظه مانع عملیات او شدم.	but I twined round him somehow, and stopped him for a moment
از این جهت به این حادثه پیش پا افتاده اشاره کردم	I mention this small episode
چون با دست موفق به تکان دادن آن نشده بود.	because he hadn't even been able to budge it by hand.
بعد از یک هفته آب کاملاً فرونشست و سرانجام به مسیر عادیش افتاد.	over the next week the water ebbed and finally returned to its normal channels.
خلاصه زدم به جنگل و با خودم گفتم که دی گه کاری با کار کلکایی که فانوس دارن ندارم.	I went into de woods en jedged I wouldn' fool wid raffs no mo', long as dey move de lantern roun' so.
قبل از خواب شبش به محل آسیای بادی کشید.	dragged them down to the windmill before retiring for the night.
حتی از او هم بعید بود.اصلاً انتظارش را نداشتم.	I could not have believed it even of him.
آنگاه ناشناس سلاح رزمی را که در تن داشت به صدا درآورد.	the armour in which he was clad rattled
سپس ناگزیر شنا کردم تا به آن دست یافتم.	after which I was forced to swim till I got up to it.
این بود که با حدت تمام شروع به ناله کرد.	so he fell to groaning with considerable spirit.
توی جنگل دستمو کردم توی جیبم که چوبدستیمو دربیارم	then I put my hand in my pocket
لیکن در ورای آن خیلی چیزهای دیگر نهفته بود.	but there was more behind.
به قصد این سفر کرده است که به افتخار ملازمت عالی جناب نائل آید و اجازت خواست تا من به کاخ در آیم.	who came on purpose to have the honour of attending on his highness.
معلومه که نسبت به اخرین باری که دی دمت اصلاً بهتر نشدی.	I can see you haven't improved since I last saw you.
به همین جهت نا گریز بود تا از حقیقت و نیکی تبری جوید و از اعمال انسانی روی برتابد.	so he had to repudiate truth, goodness, and all humanity.
یک دفعه اتومبیل نو و پر زرق و برق دم در به یادم اقتاد	then recall a glossy new car on the drive when I arrived.
بر فرض که چنین اتفاقی روی دهد این کار در آن کشور از امور شگفت انگیز و غیر طبیعی به شمار خواهد رفت.	which in that country would be reckoned monstrous and unnatural.
او را راهنمائی کردم تا برای من دو چهارچوب صندلی بسازد.	I directed him to make two chair frames.
زیرا از هیچ چیز به قدر افراط در آوردن کلمات زائد یا به کار بردن تعبیرات مختلف بیزار نیستند.	for they avoid nothing more than multiplying unnecessary words, or using various expressions.
اما هنگام بحث روی سخنش با آقای شی شلی نبود.	but he had not meant to be personal.
همیش وقتشونو صرف چرند گفتن درباره گذشته می کنن.	spent his time talking about the good old days.
ای کاش بهش اجازه نمی دادن از اون چشم سحرآمیز استفاده کنه.	I don't think that eye should be allowed.
نومیدانه و در جست و جوی رحم به اطراف نگاه کرد.	looked around him with a pathetic hopelessness in his eyes.
ناگهان به این فکر افتاد که درست در همین نقطه که نشسته	she was assailed by the certainty that she would be sitting in that place, in the same position
پیش از مرخصی تو باید مشورتی با رؤسای دیگر نمایم	before doing so I must consult the trial justice
دور تا را به همسری خود در خواهد آورد	he will persuade her to marry him.
گروهی از زنان حاضر در کلیسا اگر لباس عزا در بر نداشتند چنان آشکار اندوه پاید را از بشرهایشان پدیدار بود	so plainly did several women present wear the countenance if not the trappings of some unceasing grief
ولی بلافاصله این فکر را از سر بیرون راند و آن را به حساب شلوغی افکار خود گذاشت.	but he dismissed the thought without delay as a piece of theological nonsense resulting from his state of confusion.
حالا دی گه اون کلمه رو به زبون آوردم.	I have said the word.
که بنابراین هیچ خطر در آراس برای او متصور نخواهد بود.	that accordingly there was no danger.
باید حق مطلب را در مورد شوهر عزیزم ادا کنم و بگویم اصلاً نباید ناراحت باشد که چنین دوستی دارد.	I must do my caro sposo the justice to say that he need not be ashamed of his friend.
پس پاکت را در جیب گذاشت و برای شام خوردن سوی مهمانخانه رفت.	put the package in his pocket, and went off to dine.
هر چند مشکل میشد به یاد آورد که آن همه جورابهای کوچک و بند کفشها از آن کیست و کدام کفش از آن کدام کودک است.	though it was difficult too to keep in one's head and not mix up all the stockings, little breeches, and shoes for the different legs,
یا قوانین جنگ را بتوان در فعالیت شخصی یک فرد شناخت.	that it is possible to find the laws of a war in the personal activity of a single man.
بعید نیست که بعداً هم او متمول و محترم شود و شاید هم زندگی خود را با اسم و رسم به پایان رساند!	perhaps he may even be a rich man later on, prosperous, respected, and may even end his life a famous man!
اولین کتابی که به دستش رسید برداشت و صورتش را پشت آن پنهان کرد.	picked up the nearest book and hid her face behind it.
در آن روز تولد خود به همراه دو کودک دیگر پس از کتک خوردن مفصلی حبس شده بودند	he was keeping it in the coal cellar with a select party of two other young gentleman, who, after participating with him in a sound thrashing
آن وقت آقا معلم باز او را سرزنش کرد.	got a new reprimand from his teacher.
ولی من یادم نیست که چه طور مشهور شدم.	I can't even remember what I'm famous for.
به تندی به سمت کسی که پشتم آمده بود برگشتم.	 I jerked back as a face appeared before me.
من واله و شیدای یک سبد رخت سفید شسته بودم	mine was that I loved a washerwoman's basket of clean linen so well
به همین ترتیب دو نفر رفیق انتظاری را در میان سکوت گذراندند.	there the two friends sat, in silent expectation
با اصرار تمام خواستم که مراسم تشییع جنازه آبرومند و درخور شأن متوفی باشد.	I insisted on the funeral being respectable.
آن عالی جناب به خدمتگارش یعنی اسب کرند فرمان دهد که آنچه را دیده است پنهان نگاه دارد.	for as to what the sorrel nag, his valet, had observed, his honour might command him to conceal it.
مادرم او را به شام سبکی دعوت کرده بود	took a bit of dinner from my mother
مصدر که در این میان توانسته بود آشپزخانه را بیاید	the orderly, who had meanwhile had time to visit the kitchen
انتظار داشت کلمات سخت و تمسخرآمیزی از او بشنود که نتواند هرگز فراموش کند.	expecting some coarse and jocular remark from him which she would never be able to forget.
من فوراً خود را به وسط رودخانه میان جریان آب انداختم و برگشتم	so I shoved for the middle of the river on a long down stream slant
خیلی خوشحال میشم اگه در مقابل هر دلار یک پا وند گیرم به یاد.	I wouldn't be surprised if I got a dollar a pound.
پس باید دیرک افقی تیر اصلی را صاف کنیم	so we must rig the jib boom
به سوی خانه شماره چهار در پایین خیابان حرکت کرد.	set off down the street toward number four
سپس ارباب خود را به جا گذاشت و به جستجوی دانشجو رفت	leaving his master he went in quest of the bachelor
او پیشنهاد پدرت را برای قبول این مسئولیت رد کرد.	then refused all offers of his to get involved.
به محلی که ممکن بود اشیاء گران بها مفت و رایگان به دست آید رفتند.	rushed to places where valuables were to be had for the taking.
وگرنه قبل از اینکه خودم را بکشم خون سه نفر دیگر را نیز به زمین خواهم ریخت.	or I shall do three more murders and kill myself.
در حالی که تمام درماندگی و یأسم را در قلب خود ریخته بودم .	thrusting back all my misery into my heart,
میخ وام تا پونزده دقیقه دیگه جلسه رو سای ستاد تشکیل بدی.	I want you 'to schedule a general staff meeting fifteen minutes from now.
داخل اتومبیل بازگشتم و آهسته در عرض خیابان پیش رفتم و به دنبال او نگاه کردم.	I got back in the car and drove slowly through the streets, looking for her.
اشاره این زن به خدمتکاری بود که اخیراً در گذشته بود.	referring to a servant who had died recently.
فقط توانستم با بهتی ابلهانه به او خیره شوم.	I could only stare at her in stupid surprise.
تنها آن وقت بود که متوجه وضع مضحک خود شدم.	then I lay only alive to the comical predicament.
فراموش کرده بودند که قبل از پنج سالگی اسم او را در مدرسه بنویسند.	had forgotten to make the proper arrangements in advance.
صحافی آبی داشت و جلد آن از چرم مصنوعی بود.	a marbled blue binding and imitation leather covers.
یک بسته کوچک اسلحه برای یک کار جزئی احتیاج به یک مغز دقیق نظامی نداشت که دریابد این کار باید حمله و تسخیر سریع یک ساختمان باشد.	a single packet of arms for a single job, and it would not need a keen military mind to realize that job had to be the taking of one building within a short period.
زیرا بوسهٔ من بوسهٔ ترحم و شفقت بود و نه بوسهٔ عشق	for that I did so solely out of pity for her
تا آن که انفجاری مهیب درست در کنار گوشش رخ داد.	until there was a terrific explosion right in her ear.
اما از بدبختی عجالتا تمام هوشم با خودم است	but at present unfortunately I am not
دست خود را از روی دستگیره برداشتم تا کمی مکث کنم و بغضی که گلویم را گرفته بود کمی تسکین یابد.	I drew back my hand from the lock, and stopped to have a sob before I went in.
نشسته بود و با آرامشی که سابقه نداشت به ایشان چشم دوخته بود.	he sat watching them in such quiet as the night knew.
تا چندی سه ساعت در هفته از قرار ساعتی دو فرانک به او درس داد.	for some time he gave him three hours a week at two francs an hour.
آن قدر خم شد تا صورتش جلو صورت او قرار گرفت.	bending over until her face was level with his own.
زیرا به جای دو ماه قبلاً دو روز فکر کرده بودم.	I thought drowned people were found after two days.
اگه تو راه خورده چوب پیدا کردین با خودتون بیا رین	if you see stick wood to burn, bring it on.
به او نزدیک شد و به آرامی لبانش را بوسید.	went to him and softly kissed him on the lips.
اما مستی او وحشیانه بود و با کج خلقی توأم.	but his drunkenness was savage and morose.
هم جالب بود و هم گه گاهی پریشان کنند.	interesting and sometimesdisconcerting.
خجلم از این که بلد نبودم با او مباحثه کنم.	I feel bad I didn't argue with him.
هدفی که البته با وجود قاطری لنگ امکان پذیر نبود.	which, of course, he could not manage to do on a lame mule.
خدا میدونه چند وقت بود ای نقده نشده بودم.	I aint been so tired in I dont know when.
تصمیم گرفتند که سه تنشان به خانه برگردند و شرح ماوقع را به پدر او بگویند	the four then settled it between themselves that three of them should return to tell his father how matters stood
این معبر به طور عجیبی پرپیچ و خم و برای عبور شترها بسیار مشکل بود اما زیاد طولانی نبود.	badly broken, twisting, and difficult for camels, but short.
تریسی نمی باسیت وحشتی از اینکه دیده شود داشته باشد	so you don't have to be concerned about being seen.
ظاهرا هر دوی لوکوموتیوها کام لا منهدم شده بودند و قابل تعمیر نبودند.	I judged them both beyond repair.
چوب دستی چرخید و راه سمت راست را نشان داد.	 he whispered again to his wand, and it spun around and pointed him to the right hand one.
لیکن اگر دو برابر آن هم خسته شده بودم	when, I might have been twice as weary
پنج تا سرباز جمع شدند تا به او دستبند زدند.	took five of them to get the manacles on.
ولی به جهاتی که چندان بر من روشن نیست خوشحال بودم	but for other reasons, unsubstantial enough, I was glad.
اما مادرش با پی بردن به این موضوع او را سرزنش کرد	but her mother scolded her disbelief.
بدین امید که آن را از چند گیر رها سازد که وای!	hoping that way to disencumber it of some snarls when lo!
اما هنگامی که در آن تاریکی بر میز خود خم شد	as he leaned forward on his bench in the dusk
بالاخره جناب آقا رفت تا خودش تنها به خواه رایش بخندد.	at last he walked off to quiz his sisters by himself.
محض اطلاع بیشتر خوانندگان بد نیست از اوصاف دیگری هم ذکر کنم	it may be stated, for the reader's more certain information
من اون تصمیم رو خیلی وقت پیش گرفتم و حتی حالا هم بهش پایبندم.	I made that call a long time ago and I stick by it, even now.
ظاهراً او هم به اهمیت ملاقات دکتر بی کر پی برده بود.	I think he too had understood at last the significance of that visit to the doctor.
از هتل بیرون آمده در جهت رستوران ببال ای خیابان پیچید.	he left the hotel and turned up the street in the direction for the restaurant.
می خواد او نو به من بفروشه و هفتگی به رام کار کنه.	so he wants to sell and stay and run it for me at a weekly wage.
که نه تنها اکنون بلکه دیگر هرگز فرصت گفت و گوی مفصل را نخواهند داشت.	that he would never now be able to speak freely of everything
سپس با خرسندی پرسروصدائی نشان داد که فهمیده است.	then a loud exclamation showed that he had understood.
اما او دستور داد از پذیرایی اشخاص خودداری کنند	but he gave orders to admit no one and to invite to dinner
در ننوی خود دراز کشیده و بیدار مانده بود	lay sleepless in his hammock in the back room
پس از اینکه محتویات کیسه کوچک را با ولع تمام وارسی کرد	after a close and eager scrutiny of the contents of the little packet.
با امید فراوان دست به کار زیاد کردن آن شد.	he began to encourage them with considerable hope.
خودتم خوب می دونی که توی وزارتخونه خبری نیست!	you know, much more exciting here than at the office!
قبلاً هیچ گاه اطاقی ندیده بودم که حتی نصف این زیبایی را داشته باشد.	I had never before seen any half so imposing.
این تصور که او شیء اصلی ای را که به جستجویش آمده بود نابود کرده بود برایش قابل تحمل نبود.	the idea that he had destroyed the principal object of his expedition was too intolerable to be accepted.
هیجده سال تمام پیوسته مرا در بیم و امید نگه داشته و ذره ذره جانم را ستانده است!	not by inches, but by fractions of hairbreadths, to beguile me with the spectre of a hope through eighteen years!
حالا که خیلی دوست داری همه چیز و به دونی اینم بدون که مادرت خودشو به کشتن داد و تورو رو دست ما گذاشت.	then, if you please, she went and got herself blown up and we got landed with you!
چون در شرح اعمال یک تن پهلوانان سرگردان است ناگزیر باید عالی و باشکوه و بلند و شیوا و واقعی باشد.	being the story of a knight errant, be grandiloquent, lofty, imposing, grand and true.
محال است که اعلی حضرت که شهریاری بسیار خردمند و فرزانه است عده نسبتاً بسیاری از این فرزانگان لایق را به خدمت خود نخوانده باشد.	it was impossible that his majesty, a most judicious prince, should not provide himself with a good number of such wise and able counsellors.
سه هزار روبل یک ماه پیش و سه هزار روبل اکنون و بنابراین حساب شش هزار روبل درست است. موضوع کام لا روشن است.	three thousand then and three now made six, that was clear.
صبح خیلی زود وقتی پرندگان شروع به خواندن کرده بودند در باغ نشسته بود .	sitting very upright early in the morning with the birds beginning to cheep in the garden outside .
اما این موضوع نتوانست به مراتب تنفر من از او چیزی بیفزاید.	yet I did not despise him the more for it
شاید آخرش دوستان هم بستر خوبی از کار درآمدیم هیچ معلوم نیست.	perhaps we may become jolly good bedfellows after all there's no telling.
بی خوابی و ناراحتی پدرش که جایگزین بیعلاقگی و خونسردی سابق وی شده بود بیم داشت	sleepless activity after his previous apathy
من نه تشکر شما را می خئاهم و نه لایق آنم.	I neither want any thanks, nor merit any
شاهزاده با او درباره نقشه ساختمان جدید گفتگو کرده	the prince after speaking to him about the building
زیرا تصمیم گرفته است که من باید به آنجا بروم.	whither he was resolved I should go.
حالا سه هفته بود که در لو و ود بودم	I had then been three weeks at lowood
آن را از سر بیرون رانده و فراموش کرده بود.	that she forgot about it.
در نتیجه من به پشت پیشخوان رفتم و اولین پیشبند سفیدم را به کمر بستم	I moved into the shop and wore my first white apron.
چون راهش را بسته بودند اجازه خواست بیرون برود.	asked to be allowed to pass as they were blocking the way.
که این سرپنجه میل دارد که تو را مهلتی بدهد.	they are ready to open for you
که فی الحال همه را فراموش کرد و به حالت روحی بامدادی خود بازگشت.	that he instantly forgot it all and dropped back into the same frame of mind that he been in that morning.
ای نا رو دو تا یه شاهی می دیم	them's two for a penny.
هیچ چیز برای من خوش تر از این نیست که مدتی در صلح و آرامش توی خانه شما اقامت بکنم.	I should like nothing better than to stay in your house in peace for a while.
زیر زیرکی به دور و برش بنگرد و طرز انجام دادن هر کار تازه را یاد بگیرد.	to glance surreptitiously about and learn how to accomplish each new thing
دمش را راست دراز کرد و روی کف ایوان خواباند.	its tail stretched out straight and flat to the floor
افتخار و پاداش کار من نصیب شخص دیگری گردد.	some other carry off the thanks and rewards of my trouble.
هنوز هم عضلاتش به طور بارزی ورقلمبیده و برجسته بود.	even now the muscles were still clearly in evidence.
به من لقب و عنوان بدهند و در محافلی مرا بپذیرند که تو جرأت نداری صورتت را نشان بدهی.	to have a title, to be received into circles where you dare not show your face
تمام روز را در حوالی و طول ساحل رفتند و شب در ساحل آتشی روشن شد	all day they coasted and in the evening saw fires lighted on land
که گفتی نقاشی دست اندر کار کشیدن تصویر اوست.	that he might have been sitting for his portrait.
درست و حسابی مثل یک ماده شیر رها شده در خیابان.	a lioness in the streets.
من به شما خواهم گفت. او آخرش فرار خواهد کرد.	I'll tell you, he'll run away.
زیرا در این تالار که جمع کثیری گرد آمده بود هوا به شدت گرم شده بود.	for the crowded place was very hot.
به آرامی بسته شد به سوی بالا به حرکت در آمد.	was shot smoothly upwards.
ولی بالاشف فورا توقف نکرد و آهسته به حرکت خود ادامه داد.	but continued to advance along the road at a walking pace.
در این صورت باز باید حق او را نیز منظور دارید.	if you love and esteem him so much, you understand me?
چون لباس ندارم نمی تونم از خو نه بیرون برم.	I can't go out for lack of a coat.
به قدری که کافی بود تمام جهان یکجا بتواند از آن داخل شود.	wide enough for the entire world to pass through.
اگر هم اخلاق عجیب و غریبی دارد نباید به او ایراد گرفت.	then, if he has peculiarities of temper, allowance should be made.
اما باز هم به نحی آن طغیان درونی را خفه کرد	but somehow still smothering the conflagration within him
اگر شما به دادش نرسید ممکن است قبل از تابستان سال آینده از غصه هلاک شود و آرزوهایش را به گور ببرد.	he'll be under the sod before summer, unless you restore him!
تمام بی رحمی و قساوت قطع نامزدی خود را با وی احساس نمود.	the cruelty of his rupture with her.
بعد تکه کوچک تنباکویی را که روی زبانش مانده بود را برداشت.	then removed a little flake of tobacco that had stayed behind on his tongue.
اکنون هم کالسکه را به راه انداخته بود که در حیاط دوری بزند و سرش را برگرداند .	he having driven up the yard to turn his cart
چون چتر نیز چادری است که بر همان استخوان افراشته است.	the umbrella be ing a tent spread over the same bone.
چیزی که ماچ ادا حتی حاضر نبود درباره آن فکر کند.	something he could not bear to think about.
بلکه نامطبوع شده بود و او دیگر نمیتوانست به این شیوه دلبسته باشد.	but revolting to him, and he could take no further interest in it.
که در مدت این سه ماه با یک چنین نگرانی مراقب من بود آزاری برسانم	who has been watching me with such expectation for three months.