این حس بی گناهی ایشان بر پایه امیدواری به عفو و بخشش متکی است.	based on the same hope of forgiveness.
کاترین بار دیگر پهلوی وی نشست و ده دقیقه دیگر نیز منتظر ماند	after keeping her seat by his side another ten minutes
مجلسی که او را به آنجا دعوت کرده بودند	to which he had been invited on the supposition
بر جبینش حکمت نشسته بود و در دستانش قدرت.	on his brow sat wisdom, and in his hand was strength.
بدین معنی که بنا را از بام شروع کرده و یک راست به طرف شالوده امتداد داده بود	by beginning at the roof, and working downward to the foundation
چون در هر قدم با خطر جانی مواجه است.	for at every step he runs the risk of losing his life.
بلکه همه چیز دست به دست هم داد که این بیمارستان را بسازد تا ثابت کند که خسیس نیست.	but everything together, he began this hospital to prove, do you see, that he was not miserly about money.
تصمیم گرفت او را به حال خود رها کند.	she decided to release him.
تا بتواند چشمانش را در مقابل پنجره کوچک بگیرد	to press his eye against the little window
درست است که اِما تصمیم قطعی گرفته بود از منزل پدرش نرود	for in spite of her previous and fixed determination never to quit her father
که تنها گناهش خدمت به او و خانوادهء او بود	whose only crime was fidelity to himself and his family
زیرا که او بیش از آن یکی شما را دوست دارد.	because she loves you the best.
یعنی صورتحساب آبجو و عرقی که در آن شب مصرف شده بودا.	for the beer and liquor that might be consumed.
اما چون قصد داشت شصت پوند باقیمانده را هم تهیه کند	but he meant to make the sum complete with another sixty, and with a view to this
چرا شما دو تا با قطار به مدرسه نیومیدین.	why you two didn't arrive on the school train.
یادت می یاد سر جریان مالیات چه بلایی سر خودت آورد.	I know how he did you about your taxes.
تا ترتیبی بدهد که مراسم تدفین همان شب انجام بگیرد	to circumvent all the legal procedures so that the burial could take place that same afternoon
من نمی دونم آدم خوبی بود یا نه این مهم نیس	I don't know whether he was good or bad, but that don't matter much.
زیرا که مدت نیم قرن است که دوام یافته است.	since it has already lasted half a century.
اگه این دنباله داشته با شه من از می دون در میرم!	if it goes on like this, I shall stop my subscription.
نرم و آهسته با نیم لبخندی به لب و نوعی صمیمیت به نشان معذرت خواهی و عذرخواهی.	softly, with a half smile and an air of apologetic familiarity.
اما بلافاصله دو دست از پشت سر او را گرفت.	but there was a sudden movement on either side of him and two pairs of hands grabbed him and held him back
البته یک دقیقه بعد از یک ساعت تعیین شده به سطح آب رسید.	though he returned one minute outside the time limit of an hour.
روز بعد اعلانی به در بزرگ نوانخانه نصب شد	a bill was next morning pasted on the outside of the gate
همچنین ادامه قدم زدن کنار دریا و به شگفتی آمدن از این که چگونه زیبایی بیرون پژواکی از زیبایی درون است.	to continue, as one walked by the sea, to marvel how beauty outside mirrored beauty within.
البته به استثنای سرگرد پیر که در عین ناراحتی موفق شده بود حرفش را ثابت کند.	with the exception of the old major, who triumphed gloomily.
هرچه زودتر به جای دیگری به روی بهتر است.	the sooner you go somewhere else the better.
آن سال مادرش در سن نودو سه سالگی مرده بود.	year her mother had died at the goodish age of ninety three.
با موهای مجعد پرپشت که روی پیشانی سفیدش ریخته بود	with a riot of soft brown curls on his white forehead
مدتی ناشناس زندگی کنند تا ربرتا بتواند به عنوان همسر او فرزندشان را به طور مشروع به دنیا بیاورد.	yet where ashis wife she could honorably bring their child into the world.
خواهر هر روز امکان دارد از من جدا شود.	a sister might any day be taken from me.
اما کور با فشار ساده بازوی خود مرا به سوی خود کشید	but the blind man pulled me close up to him with a single action of his arm.
این بود که فورا به شما گفتم که کیستم.	I felt sure that you would expel me, so I told you at once who I am.
هنوز این حرف را در دل نزده بود که خودش کف اتاق غلتید!	the next instant he was sprawling on the floor!
به گمونم مغزم اون ورزیدگی مغز شما رو ندا ره.	I guess my ear ain't had the trainin' yours has.
من با کمال میل حاضرم این پولو قرض بدم.	I'm willing to lend you the money.
کلمات آخر را زن بیچاره به زحمت داد زد.	she articulated with effort.
اما او خود را از همه چیز کنار گرفته بود و به حکم آنچه از مذاکرات او فهمیدم در آن چندسال چیزی نبوده است که تأثیر خاصی در او کرده باشد.	but he remained aloof, and judging from his conversation there was nothing in those years that had made a particular impression on him.
من نیز از دیدن آن همه آدمک سرگشته و حیران بودم.	I was equally confounded at the sight of so many pigmies
جورج در دفتر هلن بود و کارت دستیابی را برمی داشت	he was in her office getting the access card.
امیدوارم که دیر رسیدنش باعث نشده با شه که از چیزی محروم به شه.	all the same, if he's missed anything by it which I hope he hasn't.
که بعداً معلوم شد بعضی از سرخ دار و برخی از شاخ و برگ سروند.	as afterwards appeared, were, some of them of yew, some of cypress.
قبلاً هنگامی آنجا را دیده بودم که تنها پدرم در قبر خفته بود.	on which I had looked out, when it was my father's only
وانگهی من دیگر به شفقت و ترحم کسی نیازی نداشتم.	I did not want kindness from anybody now.
که جنگی به وقوع خواهد پیوست ویکی از ماها باید ازبین بره	that a struggle is coming and it's going to be us or him
با یک چکش کوچک شروع به شکستن آن کرد.	began breaking it apart with a small hammer.
من همواره حاضرم که هوش و عقل افراد توده را تصدیق کنم.	I am always ready to recognize intelligence in the peasantry.
او مهمانخانة ما را به ویرانی خواهد کشانید و مشتریانمان را از سرمان خواهد پراکند.	the inn would be ruined
گویی در پشت هر کلمه معنی دیگر نهفته بود!	as though there were another meaning hidden.
حاضر بود مبلغ هنگفتی پرداختنی بوده و این دعوت را قبول نکرده باشد.	she would have given much not to have accepted.
من اینجا منتظر شما بودم تا به دنبال آلیس بیاین و بعد به شما این یادداشت رو بدم.	I was to wait here for you to come looking for her and then give you this note.
با مشت به در کوفتم و نسبت به عمل وی شدیداً اعتراض کردم.	I thumped on the panels, and rattled the latch angrily
فقط برای اینکه حرفی زده باشم این مطالب را گفتم.	I only said it because because of something to say.
ومانند گذشته او را از آن خود خواهد ساخت.	she would possess him as before she had possessed him.
با این امید که هواپیمای سفارشی او بالاخره در آسمان ماکو ندو ظاهر خواهد شد.	hanging onto the sound of the breeze in hopes that the airplane would appear.
او قول داد که فوراً آن را به او برساند.	she promised to deliver it at once.
من در آخرین لحظات زندگیش حضور داشتم و او را برای همیشه تبرک نمودم.	I was at his bedside when he died, and gave him my blessing for eternity.
تا فقرا بتوانند یاد بگیرند برای خود مستراح بسازند.	so that the poor could learn how to build their own latrines.
حساسیت دردناکی نسبت به نقص سیمای خود پیدا کرد	he had grown exceedingly sensitive to the fact of hisfacial handicap.
لذا اگر او را قبل از زمان از دست بدهد	now that if he were to get rid of the animal before the time named
نه حالا که با تو بودم حالا که واقعیت رو حس کردم.	not now that I've been with you' the real thing.
برای اطمینان دادن به او دستم را روی دستش گذاشتم	I put a supportive hand on his arm.
راستش هرگز خودم را نخواهم بخشید که نیتی نکردم.	I shall never forgive myself for not asking her to.
آن وقت ما همیشه طرز فکرمان مثل هم خواهد بود.	we might always think alike.
بدی دن او رفتم به این علت که به من گفته بودند مرواریددرشت سیاهی دارد و حاضر است آن را ارزان بفروشد	I went to see him because I was told he had a large black pearl which he was willing to sell cheaply
خیلی وقت پیش به او قول داده بودم تو را پیشش ببرم.	I promised her long ago to bring you.
من زیبا و جوانم و نقدینه نیز بسیار دارم که با خود بیاورم.	I am young and beautiful, and have plenty of money to take with me.
در اینجا بغض کرد و نتوانست دنبال حرفش را بگیرد.	my mother broke down again here, and could get no farther.
نکات عملی بسیاری را باید به او یادآوری کرد!	so many practical considerations to remember!
مگر آنکه انقلاب ناگهان و به سختی بیرون جهد و شمشیر شعله افکن آسمانیش را در این ترازو اندازد.	unless the revolution, uprising suddenly, flings into the balance its flaming archangel's sword.
روز شده بود و نور زرد رنگی در آسمان پدیدار بود	a bright yellow streak crossed the sky
ضم نا دلم میخواد با دائی و زن دائی من هم آشنا به شی.	I want you to meet my uncle and aunt.
خانم باری مور پیش بندش را جلو صورتش گرفت و به تلخی گریست.	she wept bitterly in her apron.
منزل استاد را از پلاک روی در خانه تشخیص داد.	he could distinguish the escutcheons over the door
مضطرب و هراسان شدم و به کاترین گفتم بیش از آن نباید جلو برویم و هر چه زودتر باید برگردیم.	I began to be weary, and told her we must halt, and retrace our steps.
برای یافتن راه نجات از چنگ عفریت دروغ به من یاری کن!	help me to find the true path out of the labyrinth of lies!
او دوست ندارد وقتی در خانه است اتاق را تمیز کنند.	he hates me to be fidgeting over these things in his presence.
من هیچ وقت به حرف مردم اهمیت نمی دم.	I've never bothered about what people said.
همین حالا تلفنی راجع به تو به من شد	I just got a phone call about you.
در هر حال به اونها خیره شدم و نگاهمو درونش ون ثابت نگه داشتم.	I stared into them anyway, keeping my gaze locked there.
به قدری از این تغییر حالت ناگهانی او جا خودرم که ابتدا به کلی دست و پای خود را گم کردم و ساکت و خشک آنجا ایستادم و به نظارة او پرداختم.	I was so confounded by the alteration in him, that at first I could only observe him in silence
آقا و خانم مو رلند خیلی زود فهمیدند که فقط با هیجان و شادی و غرور و رضایت باید به این قضیه فکر کنند.	they soon learnt to consider it with only the happy agitation of gratified pride
اما این تا وقتی است که آن شخص به شخص دیگری توهین نکند و او را نکشد که چرا به دین او اعتقاد ندارد.	so long as that person does not kill or insult any other person, because that other person don't believe it also.
یک قدرت جبار و مستبد و بی حد اگر روی یک مگس هم باشد یک نوع خوشی لذت دارد.	as for barbarous, unlimited power even if it be only over a fly why, it is a kind of luxury.
شهری که به تابش خورشید یا ماه نیاز ندارد	which has no need of sun or moon to shine in it
ولی او فوراً تصمیم گرفت به این ضربه نیز متوسل شود	but, she was quite prepared to make trial of the latter mode of proceeding
خسته و وامانده اما تهییج شده و مغرور پیروزی بر حریفان دیگر از شورا مراجعت کرده بود.	had just returned from the council, tired and exhausted but eager and proud of the victory that had been gained.
امیدوارم در مدتی که در اینجا اقامت دار ین راحت باشین و بهتون خوش بگذره.	I hope and trust that your stay here will be both comfortable and enjoyable.
ولی در آن زمان ماشین تحریر حیوانی بود که به تازگی به ادارات پا گذاشته بود	but at that time the typewriter was still an office animal without its own code of ethics
از اون راهنما خوشم نیومد. ممکنه منو به شناسه.	or seeing that guide up there who might remember him now.
ولی نه چندان که مجاب شود و از اشتباه خود عدول کند.	but not so satisfied or convinced that I could disabuse him of his error.
لااقل دوشیزه خانم ما دیگر مشتاق بود که این دوستی و آشنایی ادامه پیدا کند.	parted, on the lady's side at least, with a strong inclination for continuing the acquaintance.
چنانست که شما سعادت و رفاه مرا در میان دستان خود گرفته	you take my peace and happiness in your hands
آن شیء برخلاف آنچه رعایا نخست پنداشته و ترسیده بودند موجودی زنده نیست.	that it was no living creature, as they at first apprehended.
هنوز هیچ کس بیدار نشده و به سرکار نیامده بود.	not a soul had awakened to the business of the day.
چرا خودم را تا این اندازه در نظر آنان پست کردم!	what a fool I have been to humiliate myself before them!
از درون بخاری برداشته و روی میز نهاده بود.	which had been blackened by the fire.
ناتاشا هرگز شاهزاده آندره را با چنین قیافه ندیده بود.	such as she had never seen on him before.
از من خواست مقداری از آن را برای جویدن خود ببُرّم.	begged me to cut him a quid.
سرانجام در این مؤسسه عظیم به مقام پراهمیتی دست یافته است.	he was a figure of some consequence in this enormous institution!
هر جا که بخواین می تونیم پیاده تون کنم	I can let you out anywhere you want to get out
به تشک عقب تکیه دادم و چشمانم را بستم.	I leant back in my seat and closed my eyes.
آن روز موقعیت خوبی بود و حیف بود که به کنار برکه نروم و به ماهی بزرگ سری نزنم.	it seemed a pity not to go down to the other pool and have a look at the big carp.
به صندوقچه یا وصیت نامه شما دست نخواهم زد.	I will not touch your iron chest or your will.
وقتی هم به رختخوابش رفت خواب او را دید یا نه.	prepared herself for bed, as to dream of him when there
فکر بدبختیش او را به چنان حال زاری انداخت	he so took to heart the thought of his misfortune
از شهر بیرون رفتم و در صحرا راه افتادم.	I left the town and began to ramble about the fields.
شاید اگر آهسته حرکت کنم بتوانم بدون جلب توجه او خود را از اینجا دور کنم.	perhaps, if I walk softly, I can slip away unnoticed.
چنانکه حضرت علیه اگر توانستید او را به چشم خود ببینید داوری خواهید کرد.	as you will perceive when you see him.
خود را از مسایل سیاسی کنار کشید و صاحب ملک خانوادگی نسبتاً بزرگی شد.	managed to come out of all political troubles as the proprietor of a respectable family estate.
همچنانکه مشابهتی از نظر تتبع و تجلیل همه اسرار مربوط به زمان طفولیت و زندگی	the glorification of all the mysteries relating to the infancy
فقط باید گفت که صحیح نیست اشخاص را با چنین خشونتی سرزنش بنمایند!	only there's no call to tell a man he is, so bounceably.
یک ثانیه بعد هر شش تن آنجا جمع آمدند.	a second later, all six were reunited.
به محض اینکه قطعی شود که ارباب او دیو را نابود ساخته	as soon as it should appear certain that his master had decapitated the giant
سر در پی او گذاریم و آنقدر بگردیم تا او را پیدا کنیم	to go in search of him until we find him, and
برایشان میز کوچکی ترتیب دادم تا به فراغت خاطر بنشینند و چایشان را بنوشند.	I set a little table to accommodate them.
ضرورت داشت که او از لحاظ عظمت روح و نیروی اخلاق سرآمد تمام همگنان یعنی تاجداران هم عصر خود باشد	a moral superiority over those sovereigns of the day who co operated with him.
برعکس چنان متین و منطقی صحبت کرد که کشیش مجبور شد شفای کامل او را تصدیق و تأیید کند.	but, on the contrary, spoke so rationally that the chaplain was compelled to believe him to be sane.
حتی یک لحظه هم آنچه به من گفته بود باور نکرده بودم.	I did not for a moment believe what he had told me.
نیروی تنفس کمی دشات. بزودی به تنگ نفس دچار شد و از کار بازماند.	was not long breathed, soon fell to panting, andhalted short.
صد تا مطلب هست که باید به تو بگویم.	I have an hundred things to say to you.
به محض اینکه دوباره تنها شدیم با اضطراب او را تشویق به حرف زدن کردم	I prompted anxiously as soon as we were alone again.
خویشتن داری لازم را نخواهد داشت و در برابر دخترها سست خواهد بود.	he might prove too easy not stern enough.
باید این قدر احمق و ضعیف باشد که چنینکاری بکند	who affected imbecility and decrepitude
او با مهربانی این جمله را گفت و به من لبخند زد	he says, with a loving smile
من دانستم که مقصودش اینست که همراه او بروم	which I understood was to attend him
فکر کردم شاید او هم مرده باشد و دیگر مشکلی از جانب او به وجود نیاید به نوعی آرزو کردم این گونه باشد.	I thought'vaguely hoped'that he'd died, too, and ceased to be a problem.
ابتدا نظر سریعی به یازده ورقی که هر دو طرفش نوشته شده بود انداخت	gave a quick glance at the eleven sheets covered on both sides by a diligent handwriting
هرمیون در حالی که شنلش را بالای سرش نگه داشته بود	she was holding her cloak over her head and was, inexplicably, beaming.
ولی بزچرانان او را از این زحمت معاف داشتند یعنی دیگ را از روی آتش برداشتند.	he refrained from doing so as the goatherds removed them from the fire
عزیزترین پیوندهایی که تاکنون قلب شما به شادی انباشته است.	the dearest ties that will ever grace and gladden you.
آن پاره پاره شدن مشئوم چیزهای عالی صورت گرفت	that fatal dismembermentof flourishing things
صلاح نیست تک و تنها این راه را پیاده بروید.	to be walking quite alone.
شنیدم که دو روز شکار رفتن برایت مساله بغرنجی شده بود.	I heard how it's a question of the greatest consequence, whether or not you're to be away for a couple of days' shooting.
من این حرف را از زیردستان خود در این کشتی شنیدم.	hear it from my own hands
باید گفت در قرن کشتی بخار و راه آهن لکن من میگویم در قرن تباهی و راه آهن ما	I might say, perhaps, in our century of steamboats and railways, but I repeat in our century of vices and railways
اما هرگز اجازه نداد تا از وی عکس بردارند.	but he never let himself be photographed.
از اون روز به بعد دی گه اصلا شمارو ندیدم.	I haven't seen you at all, since that one time, you know.
تا آن موقع چنین حالتی به من دست نداده بود.	I haven't had anything like it since.
این بحث مسلماً برای خواننده روشن بین هم مطبوع است و هم مفید	which could not fail to have been both pleasurable and profitable to the right minded reader
برخاست تا کلاه خود را برداشته و برود و از موفقیت کامل دو نفر نامبرده اطمینان حاصل نماید.	actually put on his hat preparatory to sallying forth to obtain the assistance of those worthies.
نگاه رنجور خود را برای استمداد به گردش درآورد	he looked feebly round for help
با آن ابزار ملاحی که تقریبا همه کار از آن ساخته است در حد اندیشه و تحمیل یک دریانورد هر چیز که پسند شما باشد خواهند ساخت.	with that almost omnipotent tool of the sailor, they will turn you out anything you please, in the way of a mariner's fancy.
کاری جز این نداشتیم که دست روی دست بگذاریم.	time hung on our hands.
اما یادآوری تمامی صحنه یکباره برایش غیر قابل تحمل بود	he could not bear to let his mind rest on it.
مجبورم به عمق تونل برم تا افسون رو اجرا کنم.	I have to get deep inside the tunnel to work the spell.
بسیار لطف فرمودید که بار زحمت رفت و آمد را از دوش من پیرمرد برداشتید	so goodof you to save an old man the journey
نیروی دریائی دشمن را که لنگر انداخته بود نگاه کردم	viewed the enemy's fleet at anchor
حس کردم که موقع آنست از پشت میز برخیزم.	I judged the time had come to push back my chair.
قرار بود آن روز من در مورد آگهی وی فر پنتر کار کنم.	I'm supposed to be doing some filing this morning
به عقیده من او واقعا مرد خوبی است اما خیلی خنگ است!	I believe he's really a good man, but so stupid!
که بسیار صبر و تحمل نموده در بیرون آوردن گلوله که در آن موضع معلوم جای گیر شده بود.	who had heroically borne the extraction of the ball and was as well as his state would permit.
منتها به شرطی که شما به فکر کارهای غیراخلاقی و غیرقانونی بیفت ین.	providing she doesn't wish to do something which is morally and legally wrong.
مادام که بالمره خود را باخته بود این سخنان را بر زبان راند	stammered the unhappy woman, completely overwhelmed.
آرامش دست کم برای مدتی بر صحنه حاکم شد.	quiet, at least for the time being, fell upon the scene.
من از پشت سر بانگی شنیدم مانند اینکه دوازده دستگاه جوراب بافی در کار باشد.	I heard a noise behind me like that of a dozen stocking weavers at work.
یعنی پس از صرف شام در خانه عمویش به دیدنش بیاید.	after his uncle's dinner in order that
چون ممکن بود که در گمرک ازاو جستجوی بدنی به عمل آید.	just in case of a skin search at customs.
به نظرم بهتر است که زیر آب بازدمت را بیرون بدهی	I think you breathe out under watershe explained.
در ین هنگام از شدت طوفان بسیار کاسته شده بود.	by this time the storm was much abated.
کسانی که سعی کرده بودند ارتباط با جهان بیرون را متوقف کنند.	who had tried to stop the communication with the outer world.
هیچ وقت نگفتم که به خاطر قضیه دل و روده موش متاسفم.	I never said sorry for the rat guts.
لبخند ناتاشا مبین این سخنان و مطالب بسیار دیگر بود.	much, much more was said in her smile.
که برای نخستین بار به شنوندگان حالی کرد که انبوهای و کثرت آنان چقدر است.	giving the listener, for the first time, some adequate idea of its immense extent.
از الوارها پرید و در امتداد عمود به جهت حرکت گرگ پیش رفت.	leaping over gullies to head off the wolf
تا نگاهی به خوراک قلوه و جگر گندیده بیندازد	to look at the putrid haggis.
سه روز پیاپی هنگامی که اندیش ناک به اصلاح صورتش مشغول بود	was one of his thoughts for three mornings in the meditative process of shaving
چون کاغذ دی گه آن قدرها جا ندا ره	I ain't got much room lef' on the page.
اما من از او کندم و با هجوم بدنی خود را محکم به در کوفتم.	but I tore from her, and with a sudden bodily rush dashed myself full against the mark.
مشغول خوردن شدم و آنان از دیدن این منظره حظ کردند.	fell to eat, which gave them exceeding delight.
مملو از معلولان و کسانی که از نومیدی معلول بودند	with the crippled and the hopeless
اما هر چیز آن درست مانند انسان ساخته شده	but exactly shaped in every part like a human creature
اما اصرار داشت که خیلی لازم است منهمراه او بروم.	but he insisted that it was very necessary for me to accompany him.
به آقای لاری بگو بگذارند هوای آزاد او را به هوش بیاورد	tell him yourself to give him no restorative but air
از سخن گفتن خودداری کرد و تنها با ین اکتفا نمود که مرتبا صلیب برای بوسیدن با و بدهد.	had stopped talking now, and only held the cross for the wretched fellow to kiss.
بعد از آشنائی با دوشیزه ایکس دی گه اصلا نمی تونستم به این مسائل فکر کنم.	I couldn't after I saw her.
به او بگو اشتباه شده بود و رفع شد!	say it was all a mistake!
تا زمانی که مطمئن نشده بود دقیقا باید چه بگوید آن را مطرح نکرده بود.	putting it off until she was sure of exactly what she wanted to say.
راستش من نمی تونم این روند رو متوقف کنم و یا حتی نمی تونم سرعتش رو کم کنم.	I can't stop it and I can't slow it down.
برایشان پول و اسلحه و لباس به داخل زندان می او ردند.	friends who smuggled in guns and money and clothes.
بلافاصله پشت سر او یک نفر دیگر وارد شد.	another followed close behind.
منتظر ماند تا به او نگاه کنم و بعد قدم به آستانه در بگذارد.	waiting until I met his gaze before he stepped through the threshold.
او روی کلمات پست خود را ترک گفتید تکیه خاصی	laying a particular emphasis upon the word desertion.
اما این دفعه دیگر صندوق کوچکش را نداشته و در عوض یک کلنگ و یک بیل به دستش بوده است.	but a shove land pick.
شما اگه تونستین به خو نه ما خبر بدین که من به سلامت رفتم.	so let the home folks know I got this far in safety.
در نتیجه نه سؤال کرد که آن مرد کیست و نه خواهان نشانی او شد.	so that he did not ask for identification or even for her address.
به این دلیل به یکی از آن دخترها رو کند.	was accustomed, and so turn to one of those.
دقت عملی خودکار و مبتنی بر معیارهایی دقیق ماشین گونه و خطاناپذیر.	an automatic accuracy, founded upon criteria that were machine like and unerring.
اما این برتری از نظر قدرت جسمی بیان یا زیبایی نبود	but not of powers or conversation or grace
اما باز هم نخواست وی را از اشتباه درآورد و برعکس ترتیبی داد تا این بازی ادامه یابد.	instead of making things clear, he arranged to prolong the situation.
به جهت اینکه فردا باید حساب دار الاعانه را تصحیح نماییم.	for the examination of our cash takes place to morrow.
انگار که به خلسه فرورفته باشد سر خود را به چپ و راست غلتاند.	at the same time swaying from side to side as in a trance.
ولی متانت او باید در حدی باشد که هرگز به پای اخوی بزرگوار نرسد.	but only by relationship, and in an inferior and tributary degree.
شاید خودم به روزی بیفتم که به عاقبت کار این مرد غبطه بخورم.	I may yet come to envying his fate.
که چون برای انجام کار لازمی که ممکن است یکی دو ساعت به طول انجامد ناگزیر است بیرون برود	while he attended to some pressing business, as he would return in an hour and a half.
تمام هم و غمشان این شده بود که نگذارند حیوانات خودشان از این ماجرا بوی چندانی ببرند.	very anxious to prevent their own animals from learning too much about it.
بلافاصله کالسکه ران با چنان شدتی اسب را متوقف کرد که نزدیک بود هر دو بیفتند روی اسب.	the horse was immediately checked with a violence which almost threw him on his haunches
خود را به هزار زحمت تا پیش تو رسانیدم	I dragged myself to the foot of the stairs
به ناخدا اطمینان داد که اگر از آن پیشتاب اندک صدایی برخیزد	assuring him that if the pistol so much as clicked in the lock
او برای آنکه از زحمت پایین رفتن از پلکان راحت شود همه را از پنجره به حیاط انداخت.	she spared herself the staircase, and flung them down out of the window.
خشم و غضب فروخورده خود را ناگهان با هیجان تمام بازیافت	bursting out with the rage he had kept down so long
ضم نا برای من مقدور نیست که تک و تنها در این خانه بمانم.	I can't stay here all alone.
که قشون روسیه در آن افتاده بود نجات دهد.	in which we were situated.
تمایل شدید به نجات دخترک و بیدار کردن نور امید در قلب او بود	was her fond wish to win the outcast back to repentance and hope.
این کار خیلی چیزها را از پشت نرده بیرون خواهد آورد.	that might end in revelations.
بیش از این فکری در این بار نکرده است.	the water carrier, and would have thought nomore about it.
از چیزهایی که موقع تحصیل در آنجا دیدم هیچ خوشم نیامد.	I didn't like what I saw when I was studying there
یک جاودانگی برای یک مدت معین و فرصت را در اختیارش قرار داد	an immortality or a fixed period that made him invulnerable to the risks of war
امروز هم برای دیدن چند سگ شکاری او را به این سواری دلچسب فرستاده بود.	had sent him on this pleasant ride to see after some greyhounds.
نه تنها در مقابل تمام هم قطاران بلکه در پیشگاه وجدان خود	not only in my comrades' eyes but in my own
برای استفاده از آن البته انسان باید دل و جرأت بیشتری داشته باشد.	consequently the more credit in taking it.
بدون این که یارای مقاومتی داشته باشد به عقب افتاد.	sank feebly backward.
پشت میز خود نشستم تا چاشت خود را که یک تکه نان شیرینی بود بخورم.	sat down at my table to eat a piece of sweet cake for my breakfast.
شاید که تو وقتی خود را حاکم دیدی مادرت را نیز نشناسی.	perhaps when you find yourself a governor you won't know the mother that bore you.
زیرا با دانستن اینکه فاصله کمی مانده تا به زمین برسد	for, finding how little was wanted to enable him to plant his feet firmly
فردا هم نوبه ما خواهد بود فرزند و انتقام مال ماست	to morrow perchance it will be our turn
که او در گوشه کالسکه به خواب رفته است بیدارش کرد.	realized that he was asleep in his corner and woke him up.
که حالا مجبورست پاهای لطیف و زیبایش را در باتلاق بگذارد	she had yet but dipped her dainty foot in the slough,
زیرا معلوم نیست که غنایم اولین ماجرای قهرمانی شما به کار نگاه داشتن بیاید.	for it is not quite certain that the spoils of the first adventure will be good ones.
لذا محکم و استوار انتظار او را کشید و بالش را سپر کرد	so he waited for him keeping well under cover of his cushion
هنگامی که خود را بر زمینی یافتم که استوار و ثابت بود اندکی خاطرم آسوده شد	I felt some little satisfaction in finding myself on firm ground
پس به سوی مادرش رفت و خاموش کنار وی ایستاد.	then went up to her mother and stood without speaking.
باز هم از آن راضی و خوشنودیم برای این که این دقایق هرچه هست از آنِ ماست.	for this moment, it is mine, it belongs to me.
که به خود زحمت اشاره کردن به یکدیگر و رد و بدل کردن نگاه را هم ندادند.	that they didn't bother to nudge each other or exchange glances.
این معنیش ای نه که کف بینی تم وم شده.	this means we've finished palmistry
که به گمان این دو چاکر باید نوشته و خط باشد.	which we humbly conceive to be writings.
بر آن شد که آن خانه را هرچه زودتر ترک کند.	now wished that she was out of here.
من برای شما همان اهمیتی را دارم که شخص خودتان!	I'm of the same importance to you, as you are to yourself.
در کار و کسب خود نیز کاملاً ماهر و کارکشته است.	has the very best society in the profession.
هدف این بود که به طور علمی ثابتش کنم	the thing was to prove it scientifically.
پس از آنکه اندکی به تا مل و تفکر پرداخت	un and a straight made 'un.
چون الان میدونستم که میخ وام به حرفش گوش بدم.	because I knew now that she was going to get it.
برای اطمینان خاطر که مبادا در غیبت او عادات پدرش تغییر کرده باشد نظری به ساعت افکند	he looked at his watch as if to ascertain whether his father's habits had changed
آیا درست چنان مردانی بودند که بتوانند در دماغه قایق بایستند	were the right sort of men to stand up in a boat's head
به محض خاموش شدن کبریت انگار دیوارها سقف و سر تا سر خانه متروکه روی سر سفید وی ولای پیر فرو آمد و پیرمرد در سیاهی محو شد.	at the very moment the match went out, and he disappeared, overwhelmed by the shadows, as if the walls and roof of the desolate house had collapsed upon his white head in ghostly silence.
بر فرض هم مطالبی که مردک تعریف کرده درست باشد.	supposing the truth about that family to be the ugliest?
دوستانش هر کاری کردند که دوباره لباس را بپوشد فایده نکرد و از تصمیم خود برنگشت.	in that blunt voice of hers, and chucked it on a chair and went through
از رفتن او جلوگیری خواهم کرد و اجازه نخواهم داد که ننگ و ناپاکی دامن این خانواده را آلوده سازد.	will hold her back by force and will and not let the family be disgraced, thought she.
فورا فهمید که کلاید جای خود را در میان این جماعت بازکرده است	she at once conceived of him as slated for real success
دلش به حالشان سوخت و کاری کرد تا بهتر بشناس دش.	she had the compassion to help them learn to know her.
کلاید حقیقتا بر آن بود که از هیچ کمکی به ربرتا فروگذار نکند.	clyde did not object to assisting her in any way that he could.
تا ظهر روز بعد هم از جای خود حرکتی نکرد	she would still have remained brooding over that deathbed
لباسی از ماهوت سیاه تازه پوشیده و کراوات سفیدی بسته بود.	entirely in black, in perfectly new garments, and with a white cravat.
دو سال آزگار برای ساختن آن جان کنده بودیم!	we had worked on it for two years!
خوشبختآنه صدایش آن درهم آمیخت و در راهروی سنگی دخمه پیچید.	lucky their voices echoed so much in the stone corridor
او با اصرار و سماجت تمام در وجود من برای خود موجودی افسانه وار و دوست داشتنی یافته و یک دقیقه هم نخواسته بود متوجه حقیقت امر شود	I can hardly regard her in the light of a rational creature, so obstinately has she persisted in forming a fabulous notion of my character and acting on the false impressions she cherished.
ارزش این را ندارد که به او اعتنا کنی.	she is not worthy of notice
در این جا تنها قرارداد بین ارتش و افرادش یک تعهد اخلاقی بود.	the only contract was honour.
برای همینم آب اینجا به نظرش گرم و مطبوعه.	I suppose it feels quite warm to him.
علاوه براون دخترهایی با دامن کوتاه هم آنجا بودند	one other guys to look at too not to mention some girls in those little tiny skirts
پس ای نا دی گه کی می خوان بیان.	when you'd come ter see me
آنگاه سوی تختخواب برگشت و با عزم جزم چیزی را که روی آن نهاده بود برگرفت.	then returned to the bed, and resolutely seized the object which he had deposited there.
بعد از نیم ساعت ناراحتی پایش خسته شد و به خانه برگشت.	after half an hour of boredom his legs grew tired and he went home.
فکر کرد که چون ما هر دو از هر جهت برابریم	reflecting that as we were both equal
من هنوز بابت تخلیه به همخونه هام حرفی نزدم	I haven't even given notice yet.
حالا می خواهم چیزی به تو تزریق کنم که تو را به خواب ببرد تا احساس ناراحتی نکنی.	I'll give you something to put you to sleep so you won't feel any discomfort.
به خصوص پس از کشتار دومی که به کلی بیرون از انتظار بود.	especially after this second, quite unexpected murder.
او چون به قصد گوش دادن به صدا ایستاد	who, halting to listen attentively
به امضای پدرم و رؤسای صاحب منصبان دربار او.	signed by my father and his principal officers
لطفاً همان جا که هستید راحت بنشینید و ساعتی برایم صحبت کنید.	so be good enough to sit and chat an hour.
فقط یه مایل با جایی که لباسامو در آورده بودم فاصله داشتم.	I was only about a mile from where I'd left my clothes
تمام اهل کمیسیون را به هیجان آورد و تمام مستعد تصدیق بیانات او بودند	I acknowledge it affected me, and, indeed, all the committee also,
مبادا هری با کسی در دنیای جادوگری ارتباط برقرار کند.	to stop her from carrying messages to anyone in the wizarding world.
گرد میز دیواره متحرکی به بلندی پنج بند انگشت برای ممانعت از بروز سوانح قرار داده بودم.	I had fixed a movable rim quite round, of five inches high, to prevent accidents.
تا یکی را پیدا کند و برای مسخره کردن با ربان با او هم صدا شود	to establish a derisive liaison with some one else
اما در سکوت مطلق به راه خود ادامه داد.	walked on in a steady and set silence.
هوا تا فاصله چندین میلی کاملاً روشن شده بود	were sheets of flame, lighting the atmosphere for miles round
لازم نیست کت با یا به وسیله تلفن مطلعمان کنید.	you need not bother to write or telephone.
به اولین سؤالی که در بندر از او کردند پاسخی دور از انتظار داد.	the first thing she was asked in the port was
اما به کلی فراموش کرده بود باید چه کند.	but utterly forgetting what he was to do
من از زیر نردبون رد میشم ودلم سیاهو توراه ببینم	I don't walk under ladders and I never care to see a black cat cross my path
به همین نیت رفتم و شیئی را از گرو درآوردم.	so redeemed the pledge.
مسئول آنجا دروازهء چفت و بست از هم به در رفته را بست و کلون آن را کشید.	the postmaster shut and barred the crazy double gates.
زیرا شاعر باید چه وقیح باشد که خود را نخستین شاعر جهان بداند.	for there is no poet who is not conceited and does not think he is the best poet in the world.
پمخصوصا این را گفتم که دیک خشم ترا بجوش آورم	I said it on purpose to madden you
اما از ترس بود فلهذا امیدوارم که جرمی و تقصیری بزرگ نباشد	but it was not criminal
در اتاق مجاور اتاق پدر بیمارش به سر برد.	in the room next to the one where the prince lay.
که مثل آن پیرزن که دچار سوء هاضمه بودجهازش شکسته.	that, like the dyspeptic old woman, he must have broken his digester.
لکن ساعت دوستش چنان وی را مجذوب کرد که سرانجام تصمیم گرفت آن را بهر قیمت که هست تصاحب نماید	but this watch so fascinated him that he could not restrain himself.
اما استعداد چیز یادگرفتن و ادب و پاکیزگی من او را بسیار متعجب کرده بود	but my teachableness, civility, and cleanliness, astonished him
صورت خصومت با ترقی اجتماعی را از کف خواهد داد و با آن مساعد خواهد شد.	from being hostile to social progress, it will becomefavorable to it.
به علت آنکه خرده کاه بو جا را در اصطبل ریخته	because she had spilt chaff about
پوستت برای تقاشی مناسب است محکم و شفاف و از این قبیل چیزها.	your painter's flesh is good solidity, transparency, everything of that sort.
تنها صداف خش خش کاغذی بود که او ورق زد.	the only sound audible was the rustling of the note paper as he turned it.
هر چند ایشان همواره او را به صورت هم طراز اجتماعی خود تلقی نمایند	though always, by them, familiarly regarded as their social equal.
من دی گه یه جو ونک بی ارزش نیستم.	I am no longer an insignificant youth.
در جلو درهای قصر به تفرج و بازی مشغول بودند.	taking their ease at the castle gate.
میدانی باید بخوابی تا زودی خوب شوی و بتوانی پیش من بیایی.	you know, because then you will get well faster and can come to me.
در شامگاه تقاضای یک راهنما و تعدادی نوازنده آکاردیون کردند	at dusk they asked for an escort and some accordion players
در مقابلم نور قوی قرمز وحشتناکی در پشت چند میله سیاه ضخیم مشاهده کردم.	seeing before me a terrible red glare, crossed with thick black bars.
آن وقت دیگر از جنگ و اسلحه کمتر کاری ساخته است	then there is little use in war and weapons
یک لگدان آبی پر از آب روی میز بود که بعضی نباتات دریایی در آن قرار داشت.	a nosegay of seaweed in a blue mug on the table.
نمی خوام تو این گرما وسط راه به مو نیم.	I don't want to get stalled in this baking heat.
چون به خشکی پریدیم زانو زدیم و خاک وطن را بوسیدیم.	all sprang out and kissed the ground
ولی این دلیل نمی شه که تو هم از این کارها بکنی.	but dat ain' sayin' you is gwine do sumpin' lak dat!
اما قطر آن کمتر است و رنگ آن بازتر و نزدیک زیتونی.	but is of a less portly girth, and a lighter colour, approaching to olive.
اِما کدبانو را به حرف گرفت تا آقای التن بتواند توی اتاق اول حرف دلش را بزند.	by engaging the housekeeper in incessant conversation,she hoped to make it practicable for him to chuse his own subject in the adjoining room.
به گمانم شما دو نفر خیال دارید اینجا بمانید و کمک کنید.	I'm assuming you two intend to stay and help?
بسیاری از تصاویر و تابلوهای مقدسان دوره و یا تزئینی نداشتند	many of the ikons were without settings
من با و اندرز دادم به پرورش اسب بپردازد و اینک کارش رونقی بسزا یافته است.	I recommended him to take to horse breeding, and now he's doing well.
که جمعیت کثیری از موژیکها در کنار آن ایستاده بودند.	where a large crowd of peasants was standing.
او دیگر فرصت سر خاراندن هم نداشت و قادر نبود گاوداری و خو کدانی خودش را بیشتر توسعه بدهد.	he barely had time to enlarge his overflowing barns and pigpens.
به شرط اینکه کسانی به این سرگرمی علاقه داشته باشند	if there were any gentlemen given to that amusement
در این فکر بود که استعداد آوازخوانی اپرا را در خود تقویت کند.	he devoted his free time to the enrichment of his lyric repertoire.
من تو بانک خیلی اعتبار دارم. سهام زیادی دارم.	I own plenty of stock in the bank.
از صبر و شکیبایی شما در تحمل صدمات و جراحات	your patience under misfortunes as well as wounds
مجسم کردن همهٔ این اقدامات دهشت انگیز امری محال است.	all sorts of things you can't imagine.
او با فشار از رحم جانوری بزرگ به رنگ خاک که هم اینک درد زایمانش شروع شده بود	he was going to be squeezed out of the laboring cunt of some great sand colored beast that even now lay in the throes of its contractions
عدهٔ کثیری در ایستگاه منتظر او بودند و به محض مشاهدهٔ وی شروع بحر کت دادن کلاه خود کردند.	a large collection of friends had assembled to greet him, and did so with profuse waving of hats and shouting.
حتی اگر برایتان ناخوشایند باشد و تمایلی به آن نداشته باشید	even if it should be disagreeable to you.
ظاهراً ثروتی برابر با بیست هزار لیره به هم زد.	it appears he realised a fortune of twenty thousand pounds.
مانند اینکه بار سنگین و کمرشکنی را از دوش من برداشته بودند. یا اینکه بندهای مسئولیت را از دست و پای من گشوده بودند	I was aware of a sense of freedom, as though I had no responsibilities at all.
از اشتها و شکم من مات و مبهوت شده بودند.	showing a thousand marks of wonder and astonishment at my bulk and appetite.
به شرط آنکه طرفی که تیر نوک تیز به وال کوبیده به وضوح قدرت خود را در هر موقع که لازم شود در کشیدن وال به پهلوی کشتی نشان دهد	so long as the party waifing it plainly evince their ability at any time to take it alongside
قرا ره با یه نفر دی گه به جشن برم!	I'm going with someone else!
از هر حیث نسبت به یاهو حیوانیست بس ارجمند	as they are in all respects more valuable brutes
می خواهم حالا این کار و بکنی یعنی فردا.	I want you to do it now tomorrow.
از روی رحم و دلسوزی یا به خاطر خوش آیند من نباشد و یا از این نظر نباشد که بار دیگر مرا فریب دهی.	be not given out of complaisance or to deceive me afresh
کوچک و واضح که گویی در مقابلش روی میز قرار داشتند و با این حال بسیار دور.	small and clear as if they were under his eyes upon a table, and yet remote.
با دست نیمه جانی که روی تخت بیمارستان بلند شده بود.	a limp hand raised from a hospital bed.
دینش را تغییر داد و ایمانش را انکار کرد	turned renegade and renounced his faith
زیرا آخرین حرف زده نشده است ولی طوفان به غرش درآمده است و هر گاه حرف آخر امروز زده شود جنجالی بپا خواهد شد.	the storm will break if anything is finally settled tonight.
من فکر کردم تو می خو ای او نا رو اجرا کنی.	I thought you were going to cast them.
از خانوادة معروف و با روابط مهم و پولدار.	of a well known name, with connections, with a fortune.
پس از نوشیدن چند جام بیش از عادت خود چون شنید	having had rather too much at the pub heard
اما پدرش به او یاد داده بود که احترام بزرگترها را نگه دارد.	but his father had taught him to be respectful of the elderly.
تو یا باید فعالیت شدید و پرتحرکی داشته باشی یا هیچ.	you must have intense, energetic action, or nothing.
آن گاه نوری سرخ چشمانش را تار کرد و سرانجام دیواری بلند برپا شد و همه چیز را از نظر مخفی کرد.	then there was a blinding dazzle of red fire before her eyes and a wall seemed to rise up and hide everything.
البته حالا باید کمی زر و زیور به خودم بزنم.	I must put on a few ornaments now
مالی را که از آن تو نیست به صاحبش واگذار!	give up what is not thine.
برای این که اطمینان یابد که اشلی هنوز دوستش دارد.	to assure herself that he still loved her.
گرچه برای کنت غیرمترقبه نبود اما برای مطالعه کنندگان غیرمترقبه خواهد بود	which although expected by MonteCristo,is unexpected to our readers
در برابر دیدگانش آورد و او را به دلیل نفهمیدن داستان بخشید.	he forgave her for not understanding the story.
پیشاپیش همه در پیچ و خم آبکند چهار نعل تاخت.	was the first to gallop back along the side of the ravine.
ضربات البته با مهارت و شدت کاملی فرود آمد	dealt with singular vigour and dexterity
تمام آرزوها و امیدهای شخصی فراموش شده و خفته در نهاد وی بیدار شد.	all the personal desires and hopes that had been forgotten or sleeping within her had awakened.
اما در نظر داشته باشید که من فقط به عنوان پیشنهاد عرض کردم.	but observe I was only speaking by way of a general proposition.
درک کرد که در جهان چیزی تغییر کرده است.	she realized that something had changed in the world.
گرچه هیچ کدام سر یکپارچه سرخ او را به ارث نبرده بودند.	though none had inherited quite such an aggressively red head as his.
بعد صدای درب را شنید که بسته شد و سکوت کامل گردید	the noise of the door with its creaking hinges and bolts ceased
زیرا اظهار این یا آن عقیده برایشان یکسان است.	for to such a man it does not matter whether he says one thing more than another.
اما او آنقدر جوان ولخرج و عیاشی است که آنجا هم نتوانست کاری بکند.	but he is such a dissipated young man, they will never make much of him, I think.
ناگهان دریافتم ایلیوشا دچار حساسیت شدیدی شده است و حال آنکه شما باید بدانید من با هرگونه حساسیت مخالفم.	I noticed that there was a sort of softness and sentimentality coming over the boy, and you know I have a positive hatred of this sheepish sentimentality, and I have had it from a baby.
اما مات یلدا هر طور بود آن را جا داد.	but she managed it in the end.
بلکه فقدان آن نیروی حیاتی است که دل نامیده میشود	but a lack of vital force, of what is called heart,
اصلاً حتی نفهمیده بودم گلوله خوردن در این هوای سرد چطور بدن انسانیم را به من باز گردانده بود.	I didn't even really understand how being shot had given me back my human form in this cool weather.
خودتان نیز هرچه ممکن ست زودتر از اینجا بروید.	to leave here as soon as possible.
البته یه عالمه جن خاکی هم توی باغم ون داریم.	gnomes all over the garden.
راه رفتن ساختگی و دائمی روی دو پای عقب	my affectation of walking continually on my two hinder feet.
دهان را گشوده در جواب ژنرال فریاد کشید و عبور کرد.	shouted with his mouth wide open and passed on.
زنی که از طبقه پایین اجتماع خود را به شایستگی بالا کشیده است.	who had come out of nowhere and risen to the top by virtue of her own merits.
هنوز تک تک تارهای موی قشنگ او به آن چسبیده و من آن را نشستم تا آخرین یادبودهای او را حفظ کنم.	there they are, just as she used them, unwashed and untouched.
هرگاه در تصمیم سابق خود باقی بودید من نه حرفی خواهم زد و نه اقدامی خواهم کرد که این تصمیم عوض شود.	if you still adhered to your former determination, I pledged myself, by no word or act, to seek to change it.
سر آن را در دهان گذاشتند و با حرص و شتاب نوشیدند	they upended it and drank thirstily.
در هر چیز که به نحو شایان توجهی زیبا باشد نیرو و قدرت رابطه بسیار با جادو دارد.	in everything imposingly beautiful, strength has much to do with the magic.
چنانکه گفتی در حال خفه شدن است بازش کرد	threw it wide open as though he were stifling
نمی تونستم جلوی چیزی رو که داشت بهش آسیب میرسوند رو بگیرم.	I hated the thing that was hurting her.
تا اول یقین کنم که غیظی که کردم از من عفو نموده	in token of forgiveness of my anger
احساس گرمایی از ماجرای مرگباری که گذرانده بود دراو بوجود آمده ب ود	it was a deep sense of heat that had come out of his own deep and mortal time
روی هم رفته از سر و صدا کردن مثل دیگران ابا داشت.	yet upon the whole he refrained from making as much noise as the rest.
واسه همین مجبور شدم چند تا اسم اختراع کنم.	so I invented a few.
بلکه فقط مردن در پیش روی امپراطور چه سعادت عظیمی خواهد بود!	he did not even dare to dream of that , but simply to die before his eyes.
سربازان را از ابراز عشق و محبت به خویش منع نماید.	to forbid the soldiers to express their love of him by such shouting
این حدس آزاردهنده دائمی که مردم نظر خوشی به او ندارند	a perpetual suspicious conjecture that the views entertained of him were not to his advantage
اما وقتی ارتباط برقرار شد دیگر چیزی برای گفتن وجود ندارد.	but when communication is established they fall silent.
در طی یک جلسه بسیار باشکوه به طور رسمی	solemnly given and pronounced under their hands and seals.
من خودم را به او نزدیک کردم و او در حال کلنجار رفتن با من بود	I shimmy close to him and pull one of his hands inside my bra.
اشعار را به صدای بلند بخوانید تا همه بشنوند.	read it so that you may be heard
که کسی قدر و منزلت خود را پست نماید.	any one to deny his origin
به نظر من که شکست اربابش باعث شد یه مدتی عقل از سرش به پره.	I certainly believe his master's defeat unhinged him for a while.
تکانی به توتین دادند تا دچار آن خطر نشوند.	made shift to avert it.
اگر خر همچنان در اعماق جنگل پنهان باشد ممکن نیست که صدای ما دو تن را بشنود و جواب ندهد.	it cannot be but that the ass will hear us, and answer us if he is in the forest.
با این همه انگار اثری از دیو انگش داشت.	but at the same time there was a gleam of something like madness.
پسر بیچاره مجبور شد گفته مادر را تأیید کند.	the poor fellow was obliged to confess the promise torn from him by his mother.
ولی در چشمانشان پیدا بود که از آتش کنجکاوی بلفضولانه در تب و تابند.	but their eyes revealed the indiscreet curiosity which was devouring them.
باز قبول نکرد که این جور مشکلات اهمیت دارد	he was still unwilling to admit that the inconvenience of such a mixture would be any thing
خود را آماده کرده بود تا به جستجوی او برود.	he had been ready to set out in search of her
اما میدانم که به زحمت تا سه ساعت دیگر زنده خواهم بود.	but I know that I shall hardly live three hours.
فقط در حالی که به صندلی خود تکیه داده بود به من خیره شد.	but only gazed, leaning back in her chair.
اسب ابرش آن لفظ را دو بار تکرار کرد.	the gray repeated the same word twice
نه تنها حقایق را ننوشته بلکه دروغ پردازی کرده است	would not be to write truth, but falsehood
این قربانی کاذب که تنها شش ساعت به صلیب کشیده شد و باز از مرگ برخاست!	this sham victim that was crucified for six hours, forsooth, and rose again from the dead!
باز با همان خونسردی قبلی خود در عرض و طول حیاط به قدم زدن پرداخت.	returned to his beat with the same serenity as before.
از او خواهش کردم خودش را به زحمت نیندازد.	I begged she would not give herself so much trouble.
یکی دو روز قبل برای دیدن مادر کلاریس رفته بودم.	I went and saw her mother the other day.
ولی امکان آواز از او سلب شد چون درست در همان لحظه ناگهان یک اتومبیل آخرین سیستم از روی گل و شل حیاط خلوت وارد شد	if one of those new automobiles had not suddenly driven across the mudhole of the patio
همه تأیید و تسجیل کردند که من همان بودم که اکنون هستم.	all convinced me that I was the same then and there that I am this moment.
تازه معلوم نیس تو بتونی منو به زور ببری	you ain't so sure you can whup me anyways.
ولی مطمئنم دخترک خیاط من اصلا شک ندارد که ماده وجود دارد!	I'm sure my sewing girl hasn't any doubt but that it exists!
هرچند بحث درباره این موضوع خارج از توان بود.	although already beyond his depth in regard to this.
لازم نبود به جایی برید که ازتون پذیرایی نکردند	no need to go through less hospitable channels.
شاید مُردیم و این جاییه که برای زندگی بعد از مرگم ون انتخاب کردیم.	maybe we're dead and this is what we've chosen for the afterlife.
اون وقت آفتاب بز نه دی گه از این دور و و رها بیرون رفتین.	you'll be offa this land when the light comes.
اما من بر حسب اتفاقی که دو هفته پیش از آن روی داده بود راز خود را بر ارباب فاش کرده بودم.	but I discovered that secret to my master upon an accident which happened about a fortnight before.
این گستاخی و بی باکیم تنها به خاطر اینست که جهانیان بدانند و آگاه باشند که اگر نظر لطف و عنایت تو شامل حال من باشد ماجرایی نیست که در آن پا نگذارم و به پایان نرسانم.	only to let the world know that while thou dost favour me there is no impossibility I will not attempt and accomplish.
آن حالت وحشی چشمانش که حاصل گرسنگی بود از میان رفته بود.	the hunted animal look had partly gone from her eyes.
دکتر سعی کرد که نوسترومو صدای فرو ریختن قلبش را نشنود.	the doctor said, with a roughness of tone intended to hide the sinking of his heart and the faltering of his voice.
نه بذار او نو بذاریم کنار وگرنه خیلی پیچیده می شه.	it gets too complicated otherwise.
زیرا مزاج شما یه آن عادت کرده و با آن سازگار شده بود	because your system was already impregnated with it.
خوشم نمی اید به گوشه و کنار سرک بکشد و فضولی بکند.	I don't like her snooping around.
که میخواستند پیش از بیدار شدن شهر و مردمش و پر ازدحام شدن خیابانها و کند شدن سرعتشان از این سوی شهر به آن سوی آن بروند تنها راه و شیوه مناسب برای حرکت در شهر بود.	to go through the waking town from end to end without a check in the speed a mass of heavy,
شما برای این جور چیزها هنوز خیلی جوان و سبک مغزید.	you are too young and light for this kind of thing.
از حال و روزش پیدا بود که مریض است.	with every appearance of being seriously ill.
جلو رفت و تصویر خود را در آینه بوسید	she impulsively bent forward and kissed her reflection in the mirror
چهار یا پنچ تن از آنان سرگرم بردن ذخایر ما بودند	four or five of them were busy carrying off our stores
آن طرز حرف زدن که مدام در حال فرمان دادن بود	his emphatic speech
ولی آقای فریزر مرد بد اخلاق و سخت گیری از کار درآمد.	but he turns out ill tempered and exigeant
من حتی نمی تونستم از رنج ادوارد لذت ببرم.	I couldn't even enjoy his anguish.
حالا این که تو به آن تعلق داری یا نداری به خود من مربوط است.	whether you would belong there or not.
این شیوهٔ او برای تسلط بر روح مردم بود.	it was her way of feeling her sway over it.
بنابراین من عهد خود را نسبت به انتقامی که باید از آن گناهکار بگریم فسخ کردم	so I recall the oath in so far as relates to taking fresh vengeance on him
بعد از ظهر هم باید پول یک صورت حساب را بدهم.	I had to pay a bill this afternoon.
دو دختر که شلوار جین پوشیده بودن سر میز ما آمدند.	to see two of the girls in jeans approaching our table.
شما خواهید توانست روی پرچین خم شوید و از پشت ببینید.	you can see it from the back by leaning over the hedge.
این فکر تا به آن روز یگانه دل خوشی او در دنیای بی فروغش بود.	to date this was her one solace in an otherwise gray world.
همراه با زن و فرزند و حتی طفل شیرخوار.	husbands daughters and sons even infants in arms.
فقط به طور موقتی با استفاده از کلمات آن را قابل فهم کرده بودند.	momentarily captured by words
من نگفتم که مایلم شما این کار را انجام بدهید.	I did not say that I desired you to do it.
اما عاری از سستی و تک اهل که مخصوص اهل نانتوکت است	but twelve years old, whose father with the earnest
مصمم بود که انتقام خود را بط رزی فجیع از او بستاند.	resolved to avenge himself when a more convenient opportunity should offer.
یک دقیقه را با خیره شدن به او هدر دادم.	I wasted a moment staring at him.
به اینکه هیچ وقت مجبور نباشم ولت کنم چسباندم و خم شد تا مرا ببوسد.	I pressed myself to him even tighterof never having to let you go. and he leaned down to kiss me
بلکه علت انتحار او آن بود که زنی احمق و نامتعادل بود.	but because she was a foolish and unbalanced woman.
نزدیک قطعه سنگ بزرگی که در کنار آب قرار داشت خم شد و مشتی صدف درآورد.	he bent down and picked up a flat stone by a rock.
بیتابی او برای اینکه موضوع را به شوهرش بگوید آنقدر زیاد بود که خیال کرد او به همین اندازه او غافلگیر خواهد شد.	so great was her impatience to tell him the circumstance, at which she guessed he would be as much surprised as her.
از آنچه گفتی من بسیار مضطرب و بیتاب شدم	for what thou hast told me has amazed me
حیوان را متوحش ساخته و با دادن فرصت با و فرارش داده بود.	alarmed the beast by giving him wind of the dart, and somade him run.
تعداد کمی از آشنایان در مراسم تدفین او شرکت کردند.	very few people were at the funeral
که قادر به تحمل این گونه زندگی نیستند و باید تحول و تغییری صورت پذیرد.	that they could not stand this existence, and that they would have to alter it.
موجب گردید که شما از نام و نشان من پیش از وقت مقرر متسحضر شوید.	has given you the knowledge of my name altogether prematurely.
یکی مدعی است که داستان آزاد کردن محکومین به اعمال شاقه بر تمام ماجراهای کتاب برتری دارد	a third says the liberation of the galley slaves is the best of all
زیرا آنچه کوتوزوف گفته بود مولود افکار و تخیلات محیلانه نبود	because what he said was not the outcome of cunning calculations
هر دلیل و منطقی که لازم است بیاورد تا جناب آقا تشریف بیاورد.	spare no arguments to induce him to come.
تا با او مصاحبه کنند و تصویرش را بکشند.	to interview and make studies of him.
اضافه کرده بود که چون از سکوت در چنین موردی نباید تعبیر دیگری کرد	adding, that as silence on such a point could not be misconstrued
تا اینکه بالاخره خسته و گرد آلود به مقصد رسید.	until he came, in a great heat, and covered with dust, on the little market place of the market town.
به امپراطور گفتم که بخت مرا یاری کرده و آن زورق را در سر راه من افکنده است.	I told the emperor that my good fortune had thrown this boat in my way.
پس آهسته از جا برخاست و به جانب میز رفت	rising slowly he moved to the table.
زیرا انسان همیشه بر آن است که از دوستی کسانی که خود را به اختیار وی گذارند سوء استفاده کند.	but there is always a temptation to take advantage of the love of those who are absolutely delivered into your hands.
در حالی که بیست درصد اظهار نظر کردن تردی وی فر باید کمتر با شه	while 22 per cent felt it could be less crunchy 
اطمینان نداشتم که آنچه گفته بودم مناسب بود یا نه.	still uncertain of myself and whether I was saying the right thing
اما بلافاصله به هدف او از آمدنش پی برد.	she knew immediately why he had come back.
بعد هم آن بستر را پاره کن و پوشال آن را بگرد.	rip open that bed, and search the straw.
من پیرمردی هستم که میخواد دختر جوانش رو نصیحت کنه.	I'm an old man trying to give a young daughter advice
برخی از پندارهای خود را دربارهٔ قهرمان خویش از دست داده بود.	she had begun then to lose some of her illusions about her hero.
بس که تکانم داد همهٔ اندرونم زیر و رو شد!	I got such a shak ing it near brought my liver up.
دستور داده شد فردا نامش را از آمار هنگ خط بزنند.	he's to be stwuck off the list tomowwow
این نخستین بار بود که نگاهش بر کریستف افتاد و او را خشمگین نساخت.	for the first time he was not irritated by her eyes meeting his.
مجبورمان کرد پرندگان اهلی او را از محصول بی مقدار خودمان دانه بدهیم	obliged to feed scores of his tame birds on our wretched crops
اما فقط دو حلزون بی صدف ریز از دهانش بیرون آمد.	but only bringing up two very small slugs.
امیدوارم شما دو تا منظور منو درک کرده باشین.	I hope you two are marking my words,
در حالیکه فرمان را که بی تأمل و بدون حک و اصلاح دیکته کرده بود	he remarked when he had read over the proclamation which
اما سرما تا حدی هم زادة تب و لرزی بود که در خواب بر او مسلط شده بود.	but the chill was from the fever that had begun long before in his sleep.
اما با دستور سرهنگ گروهبانی بلافاصله ساعت را بالا آورد و در حالی که با دقت آن را میان دو دستش گرفته بود ساعت را پس داد.	but at the colonel's clamour it was produced quickly enough, a corporal bringing it up, carried carefully in the palms of his joined hands.
اما این طور که معلوم شدهحق با من بوده است.	but it turns out that I was right.
در عمرم هیچ وقت تا این حد شوکه نشده بودم.	I've never been so shocked in my entire life.
که آلبر نگفت پدرم و مسی و مورس رف گفت.	that the young man did not say my father
ریشی سیاه و بلند که شاید یک هفته آن را نتراشیده بود	has black beard of a week's growth.
در ایوان بنشینید و منظره را تحسین کنید بدون آنکه توجهی به نیازهایتان داشته باشید	sit on your front porch and admire the view without paying attention to your needs
لازم نبود در قلب خود آن همه دچار کشمکش و زد و خورد شوم	have to encounter so many struggles in my own bosom
هر ضلع حصار به طول صد و پنجاه و دو گز است.	each side of the wall being five hundred feet long.
که این محل با سنگرهای کوچکی که در آن حفر شده بود	on which small trenches had been dug
یک لحظه بعد هنگامی که شاهزاده با ژنرال از ویلا خارج شد	but a minute or two later, when he and the general had left the villa
اما وی ترجیح داد که در حین گفتگو او را بردست بگیرم.	but he chose rather to let me hold him in my hand during our conversation.
بیا اینجا با هم گفتگو کنیم و از نزدیک با هم آشنا شویم.	come here, let us talk and get acquainted.
جلوه حیات و آن روحیه سابق دوباره به کالبدشان بازگشته بود.	numbed nerves were coming back to life and the old spirit was beginning to burn.
جسد سفید دلفین مانندش به زیر آب فرو رفت.	pale dolphin body dipped down to the bottom of the fragrant water.
به او گوش زد کرد که حتی در زمان خوابیدن نیز آن را از کمر خود باز نکند.	she would not have to take it off even to sleep.
یک ذره از کسی که به شکل اون درمیایم.	of course a bit of whoever we want to change into.
چون او هم از فکر این مجلس رقص حسابی خوشش آمده بود.	for she enjoyed the thought of it to an extraordinary degree.
دلیلش نیز این بود که دیگر از تغییر خسته و دل زده شده بود.	for now he had grown weary of change.
چون من ممکن است از آن دسته باشم وقتی معلوم شد که اصل و نسبم والا و ارجمند است	I may be of such that after investigation my origin may prove great and famous, with which the king
تو مرا غرق تعجب کردی! از تو خیلی چیزها انتظار داشتم لکن هرگز متوقع چین خونسردی نبودم!	you surprised me, my friend you did, indeed.
در صورتی که در میان پهلوانان سرگردان اصل بر این جاری است که وقتی خویشتن را در ماجرایی آزمودند	it being a settled point with knights errant that when they have tried an adventure
که ظاهرا در کنار جزیره پست مرجانی توقف کرده بود.	which seemed to have touched at a low isle of corals.
سپس برایش شرح دادم که چگونه پسرعمهام مریض است و من باید به دیدارش بروم.	I told him how my cousin wished me to visit him, because he was sick
که وظیفهءاساسی اثر هنری آن است که پسند افتد.	that the essential function of a work of art was to please.
گذار از معلمی سر خانه به زنی خانه دار بر ذهنش اثری پایدار گذاشته بود	the passage from governess into housewife had wrought itself a little too strongly into her consciousness
چند نفر مردی که خود را به صورت پدر و اقوام او درآورده بودند	more than one man who might be supposed to bear a strong resemblance to his father
البته تا حدی که سازش بین تفصیل و احترام ممکن باشد.	, in so far, at least, as detail andrespect are compatible.
بیش از پیش زیر صاعقه و هرچه بیشتر در حال افتادن و مردن با هر قدم که برمی داشت.	losing more men at every step that it took.
من پول لازم را با انتقال اعتباری خواهم فرستاد.	I'll send the money by credit transfer.
برای آنکه با یقین بیشتری این مهم را به انجام رسانیم	that we may have surer ground to go on
همیشه امیدوار بودم که زندگیم را دور از آن صداهای گوش خراش بگذرانم.	I had been hoping to live the rest of my life out of the sound of those things.
در مجالس رقص نیز به برخی از بانوان توجه خاصی داشت.	he flirted with a few of them at the balls.
نه برای خواب بلکه برای تمدد اعصاب و قدری استراحت.	less to sleep than to rest his limbs, cramped with cold and study.
پس از اندکی واقعاً هم هردو تا حدی به این موضوع اعتقاد پیدا کردند	they so far succeeded
این چیزی است که پا پا انتظار دارد و من هم مواظب هستم تا مبادا بر خلاف دلخواه او عملی صورت گیرد.	so papa expects, and I shall see that it is done.
که بعضی جاها رو به تو و بعضی جاها رو به بیرون کج شده بود.	which leaned inward in places, and outward the rest of the time
چون فکر من هنوز آنقدر راحت نیست که بتوانم آسوده بخوابم	for my spirits are not yet tranquil enough to let me sleep when it would be seasonable.
این که گذشت سالیان به سختی توانسته بود اثری بر آن بگذارد.	the passing years scarcely seemed to brush it.
این ماجرائی بود که وی تصمیم باج رایش گرفته بود.	that event was what he had decided to arrange.
لیکن یکی به هوای دیار معشوق و دیگری به خاطر اینکه هرگز او را ندیده است	the one to see her, the other at not having seen her
آنگاه در حالی که شهر خفته بود بار دیگر به راه افتادند.	then rode forward again when all the town was asleep.
پوسته درخت سائیده شده بود و استخوان سفید درخت نمایان بود.	the bark had been rubbed away to show the branch's white bone.
پس دیگر ممکن نیست اشتباهی به من دست داده باشد.	so I'm not mistaken, as it happens.
زیرا مصمم بود پس از کشف مطلب بر حسب معمول کتکشان بزند.	but determined, when he had found it out, to give them a good thrashing, as he always did on such occasions.
پس از آنکه بار دیگر دست شاهزاده خانم را ببوسد	once more he kisses her hands
من هم نه یک کشیش نمونه بلکه بدل خوبی هستم.	I am not a model clergyman only a decent makeshift.
اما به یاد آورد که ممکن است در آن نزدیکی کسی حضور داشته باشد	but remembering that there might be spectators
من نمیذارم تو تنها به مو نی چون اگه بیفتی مریض به شی هیشکی نیس بهت کمک کنه	I ain't havin' you out all alone, so if you get picked up there ain't nobody of your folks to he'p ya.
اما تنها تا آن حد که سخنی بر زبان نیاورد.	but only so far as to be silent.
که جزء عمده عمرش نمایش ساکت و گویای عمل بود و نه فصل بی روحی از اصوات.	whose life for the most part was a telling pantomime of action, and not a tame chapter of sounds.
صداهای ان دو و محتوای گفت گوشان عقیده معلم را عوض کرد.	the sound of their voices, and what they were saying, made him change his mind.
به هیچ کس و هیچ چیز هم خیانتی نشده بود	nothing and no one to betray
از کنار آن شبح شوم هم دویدم و زار و پریشان و بیچاره خود را به اتاق خواب خود رساندم.	then I ran from her, down the long narrow passage to my own room,tripping, stumbling over the flounces of my dress.
سواران لباس جشن و شادی در تن داشتند و با نظم و ترتیب خاص حرکاتی نرم و سبک به دور چمن کردند و همه با هم فریاد برآوردند	marshalled in regular order, ran not one but several courses over the meadow, with jubilant shouts and cries of
این طور که معلومه زیاد هم برات مهم نیستم.	I get the feeling you don't like me so very goddam much.
این مرد حاضر بود همه را فدای اشتهایش بکند.	he was willing to sacrifice anyone to his appetites.
این دیوار اتاق تو را من دیوار قلعه و حصار گمان کرده بودم	I took the wall you are mining for the outer wall of the fortress
از بس عقب او دویدم و او را صدا زدم از نفس افتادم.	I was quite out of breath with running and calling after him
بر خلاف همیشه این بار از غش و ضعف خبری نبود.	surprisingly, for less strain than this had frequently brought on fainting fits.
اما دو قلوه ای ناهمسان با خواهر و برادرهای عادی هیچ فرقی ندارند	but that two egg twins were no different from ordinary siblings
خود را این طور نزد دوستان و خویشان معصوم جلوه دهد .	foisting it off on her friends and relatives.
موقعی که بار دیگر سوگند وفاداری و عشق ابدی خود را به او بازگو کرد.	when he repeated his vow of eternal fidelity and everlasting love
این گمان به خطا به خصوص در مورد فرزندانی که زاده فکر و قریحه انسانند بیشتر وجود دارد.	this sort of deception prevails still more strongly in the case of the children of the brain.
حسادتش هم از آن غصه دیگر لبریز شده بود.	his jealousy could bear no more of the other distress.
پس بایستی یا پایین چوب را نقب زده یا بالای آن را	it was necessary therefore to dig above or under it
حتما از اول تا آخر سال مشغول سرودن آواز سال بعد شه.	I suppose it spends all year making up the next one.
همین که صدای پایی را که از دری روبروی در ورودی برخاسته بود شنید	when she heard a light step approaching the door opposite to that by which she had entered
این همه کارها را تنها به سبب آزردن حیوانات همنوع خود کنند.	engage in a confederacy of injustice, merely for the sake of injuring their fellow animals
تا چاقو را از دسترسش دور کنم که نتواند با آن به خودش صدمه بزند.	pushing the knife away from his body so that he wouldn't hurt himself on it.
در موقعیتی نیستیم که از عهدة این کار بربیاییم.	we are not in a position to do it.
من فکر کردم که تو ممکن است به گوئی.	I thought you might.
همین که چشمش به جوان افتاد گریان و نالان و نفس زنان خود را به پای او انداخت.	perspiring and flurried, she fell at his feet the moment she saw him.
حالت هراسان کسی را داشت که هر لحظه انتظار دارد شیئی به سویش پرتاب کنند.	looked as if her nerves were quivering with the expectation that something would be thrown at her.
گفته بود که سراپای تن من از پوست و موی حیوانات دیگر که مصنوعاً ترکیب یافته پوشیده شده است	that my body was all covered with an artificial composure of the skins and hairs of other animals
پنداری دولت و مملکت فقط عرصه کشاکش شهوت گروه های جور واجور از اهریمنان بی مغز بود که با شمشیرها و اونیفرمها و جملات پرطمطراق و به ظاهر با شکوه چون آفت به جان آن دیار افتاده بودند	as though the government of the country had been a struggle of lust between bands of absurd devils let loose upon the land with sabres and uniforms and grandiloquent phrases.
این بگفت و دستمال خود را از روی چشمانش برداشت.	with a menacing note in her voice, taking the handkerchief from her eyes.
پدرش ممکن است آن چنان عصبانی شود که مرا از خانه بیرون کند.	he would perhaps be so angry that I should have to leave
من شما را در همان جامه خاکستری هر روز بیشتر دوست دارم.	I prefer you in your little gray everyday dress.
سپس سر خود را به حال دردناک چرخی داد و با صدایی شبیه زوزه مار گفت	then painfully twisting round his head, said in a sort of hiss
ناگهان دومرتبه در آن درد وجود داشت به یاد آوردم.	there was suddenly pain there again I remembered.
شاید رفته با شه دست شویی یا یه جای دی گه.	maybe she went to the bathroom or something?
خدمتکار با تردید او را با طاق کوچکی که مجاور اطاق پذیرائی بود داخل کرد و سپس او را به پیشخدمت مخصوصی که در این اطاق همواره حاضر بود	the bewildered domestic showed him into a little ante chamber leading to a waiting room that adjoined the general's study, there handing him over to another servant
آن هم در ملأ عام و با افراطی شدیدتر از سابق.	for the first time in public, and with an uncontrolled voracity
ولی تو همة بیست و پنج روبل را بباددادی!	but he flung away all the twenty five at once!
در واقع چیزی نبود که از خاطر بردن داشته باشد.	what was there to dismiss!
واضح است که این عمل وی فقط برای مزاح کردن بود.	evidently for no other purpose than our entertainment.
اکنون من حاضرم با او ببال ای دار روم.	I will go with him now, if it's to death!
نه من هرگز چنین سخنی را از دهان او خواهم شنید	I never have told her that I loved her
فلهذا به قدری که ممکن بود با مشارالیه گرم گرفته و عقلش را دزدیدند.	were so full of affability that they would have shaken hands even with the banker's servants, so much did their gratitude need an object to expend itself upon
وظیفهٔ اساسی وی آن بود که از پدرش مراقبت نماید و دائما گوش به فرمان او باشد	his chief duty being to look after his father
من متنفر بودم از اینکه حق انتخابی نداشته باشم.	I hated the feeling of having no choice.
چه برسد به اینکه بخواهی برای اشخاص لاقید و بی دین این راه را روشن کنی.	still less to make the thread clear for the careless and the scoffing.
آن قدر آن را خوانده و مرور کرده بود که صفحات کتاب کهنه شده بودند.	that was falling apart because he had looked at it so often.
که اگر من به بالا رفتم دیگر حالت پایین آمدن نخواهم داشت	I should never have the courage to come down again
من هیچ چیز نگفته بودم که بفهمد به چه کاری مشغولم.	I had given him no sign of my occupation.
میل دارم با شما دربارهٔ برادر جوانم سخن گویم	I should like to tell you, dear friends, of that youth, my brother
تا به صورت غبار آلودگی تیره رگبار پیشتاز در دره درآمد.	to the dim mistiness of an advancing shower in a vale.
سوار بر اسب زیبای کبود اصیلی با دو هوسار از دهکده بیرون آمد.	came riding from the village on a handsome sleek gray horse, accompanied by two hussars.
دلگرمش کرده بود که با تقاضای فرجام حتما محاکمه دیگری برگزار خواهد شد	a new trial on appeal would certainly be granted
ناگهان پی برد که هابیت پیر را از ته دل دوست داشته است.	he realized suddenly that he loved the old hobbit dearly.
که فکر کنید چگونه این غول عظیم واقعا پادشاه تاجدار دریاست	how this mighty monster is actually a diademed king of the sea
رفع اشتباه از دیگران به معنی بیزاری از ایشان نیست.	candour is not to be confounded with scorn.
به این روش تقریباً حدود دو سال جلو رفته بودند.	after almost two years of crossing
بلکه باید درصدد جست وجوی غذای گرم دیگری برای روحمان برآییم که	we have but to seek another nourishment for the mind,
هفت یا هشت موی خرمایی رنگ نیز مانند تارهای زرین و به درازی برگ خرما از آن خال روییده است.	with seven or eight red hairs like threads of gold, and more than a palm long.
ولی او با فروتنی تمام فکر کرد که منظور از کسی او نیست	but that young man, being naturally modest, probably considered himself nobody
با ترس و لرز از او پرسیدم که به چه کاری مشغول است.	I cautiously asked him what he was doing.
ریشه کن هم نخواهد شد مگر آن که این جسم فانی خود را به سرمنزل بقاع برساند.	nor will it be eradicated till this mortal shall put on immortality.
چقدر بدجنسی است که انسان برود توی این جنگ!	how wicked it was of you to go to that battle!
به کدبانو دستور داد تا مجلدات بزرگ را بردارد و به حیاط پرتاب کند.	he told the housekeeper to take all the big ones and throw them into the yard.
آن را منحصر به عقل سلیم و ذوق مستقیم و عدالت و رفق و مدارا و رسیدگی سریع به مرافعات حقوقی و جنائی میدانست.	to common sense and reason, to justice and lenity, to the speedy determination of civil and criminal causes.
خوشحالم از این که به شما چنین دین بزرگی دارم.	I have a pleasure in owing you so immense a debt.
مجبور بودم مثل یه مرد شکنجه رو تحمل کنم.	I was just going to have to take the torture like a man.
زیرا بر حسب ظاهر چه شاه و چه مردم هیچ دانشی را دوست نداشتند جز ریاضی و موسیقی	for neither prince nor people appeared to be curious in any part of knowledge, except mathematics and music
بالاخره باز شوهر نامناسب کردن بهتر از این است که دختر در خانه بماند و هوسرانی و عاشقی کند.	after all, a daughter looks better ill married than well whored.
کاملاً فراموش کرده بودم که سال گذشته مدتی در آن ناحیه اقامت داشتم.	my residence in that locality had already grown dim and dreamy.
هرگز چنین تغییر وضعی ناگهانی در دنیا دیده نشده است.	THERE never was such an overturn in this world.
چون شب اول مطلقاً به هیچ جا نرسیده بودیم.	for on the first we drew entirely blank.
با کمال تعجب مشاهده کرد که ناتاشا با لباس روی نیمکت به خواب رفته است.	to her surprise found her still dressed and asleep on the sofa.
مضافا به اینکه دود آمیخته با مه تمام محل را از نظر مخفی ساخته بود.	especially as the smoke mingling with the mist hid the whole locality.
در میان سربازان به کنار آبپاش رفتم تا کمی آب بنوشم	 I walked off to drink some water at the fountain
همه نژاده نیستند و از دانش چندان بهره نم گیرند.	are not always of noble birth, or liberal education.
کاترین این سخنان را با لحنی آزرده و رنجیده ادا کرد و سپس رویش را به طرف بخاری برگرداند و پشت به من کرد.	said the young lady, scowling, and turning her face to the fire.
سخن گفتن این است و فصاحت و بلاغت این	that is what I call talking to some purpose
چهار سال بود کهندیده بودمش و با زنش هرگز ملاقات نکرده بودم.	I had not seen him for four years, and had never met his wife.
من به رایی ه مدتی تغ یی ر کردم.	I turned for a while.
من اعتقادی به افراد بیزار از مردم و مردم گریز ندارم	I have no faith in misanthropes.
شک داشتم که اصولاً ماهی برای صید کردن وجود داشته باشد.	I doubted whether there were any fish to catch.
که هر لحظه امکان داشت برای همیشه از دیده بپوشاندشان.	which in another moment must hide them from sight for ever.
قوه از او سلب شده و نتوانست دوباره به روی صندلی نشست	but his strength failed him and he sank into a chair
هوش و حواس از سرم پریده و بگذار به گم که راست راستی ترس ورم داشته.	I'm at my wit's end, and I don't mind acknowledging 't I'm right down scared.
اما فرقی ندارد برای هر فرمایشی که باشد در صورتی که از دستم برآید به جان و دل در انجام او سعی خواهم کرد	but if I can serve you in any way I shall be delighted
امیدم به این که همه با هم برویم خارج اصلاً کم نیست.	I have more than half an expectation of our all going abroad.
من مادرم را در کمال صحت و سلامت و خوش و خرم یافتم.	there I found my mother in good health and spirits.
خیره بدو نگریستم و آثار خنده سرزنش آمیزی بر لبانم ظاهر شد.	I stared full at him, and laughed scornfully.
جمله آقایان تأیید کردند که او دیگر به صورت جوانک رذل و جسوری درآمده است	that they by common consent pronounced him a hardened young rascal
اینک به محض ورود ربرتا جملاتی بر زبان آوردند	interjected a few genial and well meant
هر چند رختخواب مرد قاطرچی از جل و پالان قاطرهای خودش درست شده بود	though only made of the pack saddles and cloths of his mules
ذهنش برای چنین عاقبتی که در نهایت هم قسمتش شد آماده بود.	his mind was prepared for just such an end as did eventually overtake him.
فکر کنم نگران این است که حالا با آمدن تو اوضاع برایش تغییر کند.	I think he's worried that things are going to change now that you've moved in.
شاخه هاشان از چند متر بالاتر از سر مارشد کرده بودند.	their branches not beginning until a few feet over our heads.
آن لبخند بسیار طبیعی باعث شده بود احساس کند	his perfect smile giving him the impression that
عکس شوهر و دخترش که فوت کرده بودند بردارد.	pictures of her late husband and daughter.
به طرف پنجره رفتم و پرده را کنار زدم.	I went to the window and swung back the shutter.
با گامهایی آرام و فنروار به اتاق ناهارخوری رفت.	he walked with a slight swing on each leg into the dining room
عمداً به جلو و به کاپوت اتومبیل متفکرانه نگاه کرد.	looked ahead of her intently at the bonnet of the car in profound meditation.
ولی اینکه تمام کسانی که با وی موافقت نداشتند کلا در اشتباه بودند	but that all others who disagreed with him were wholly in the wrong
بعد هم دست در دست یکدیگر به دنبال بقیه وارد سالن رقص شدند.	they followed their chaperones, arm in arm, into the ballroom
من خودم همیشه نظرم این بوده که او خوشگل است..	I have always thought her pretty
حساب کن با رستوران و چیزهای دیگر تو تابستان بین هشت هزار تا پانزده هزار تا در روز.	well, anyway, with restaurantsand everything, say summers between eight and fifteen thousand a day.
چون در ضمن که این وال نر همواره واجد بروبالای تنومند خاص لویاتان است	because, while he is always of the largest leviathanic proportions, the ladies
ولی زیبائی اندام او را به خوبی نمایان ساخت به مردم پاریس نشان دهد.	gave her an excellent opportunity of displaying the elegance of her figure.
هر چه اصرار و التماس کردم ساعتی دیگر هم بماند قبول نکرد	I had brought, and turning a deaf ear to my entreaties for her to remain another hour
یه سؤالی رو که تو هم ون صفحه کتاب با شه ازش بپرسم. او نم جواب بده.	to ask her any questionin the book, and she would answer it.
بار دوم نیز کشتی او به کلی ناپدید شد	for the second time his ship was utterly lost
از اینکه دوراندیشی کرده و هشتاد پوندش را با خودش آورده بود خشنود شد.	but an opening which made him congratulate himself on his foresight in bringing with him his eighty pounds.
که این مجلس تفتیش را هر قدری که ممکن است زودتر تشکیل دهند	then, that the examination shall take place as soon as possible
لطف کنید و دو دقیقه وقتتان را به من بدهید.	but please, be so kind, spare me two minutes,
آن طور واقعی پارس کردن و آن طور به وضوح آهای دزد گفتن دو چیزی بود که در آن خانه فرا نگرفته بود.	two saving graces he had not learned in the house.
عاقبت پس از آنکه چند روز با بیک ارگی روی چنبر لنگر نشست و با اشتهای شدید خورد	at length after sitting on the windlass for a few indolent days
ولی صدای رت طوری بود که گویی اصلاً متوجه نشده است.	but his voice went on as easily as though he had not marked it.
موی سرشان به رنگ قرمز درخشانی در آمده بود.	their hair had turned a bright red.
آگلائه گفت بهترین پاسخ آنست که هیچ پاسخ ندهم یا چیزی شبیه به این.	she replied that 'no answer is the best answer. ' I think that was it.
چون در آن موقع من قادر خواهم بود خرج خودم را درآورده و به دخترها نیز کمک کنم .	for in time I may be able to support myself and help the girls.
اما در یک چنین موقعی معتقدم که باید قیام کند و کاری کند که این اراذل و اوباش دمشان را روی کو لشان بگذارند و بروند.	but at a time like this, I do think he ought to stand rightup and bawl out those plug uglies to a fare you well!
قبل از اینکه از تشنگی و گرسنگی از پا بیفتم با تبر لبه قایق رو تا سطح آب چاک می دم.	I shall cut down the gunwale with the axe right to the water's edge before thirst and hunger rob me of my strength.
تمامی آن شیوه که برای استفاده از سکوب منبر بکار زده بودند با توجه به اینکه خود کلیسا چگونه کلیسایی بود	the whole contrivance, considering what manner of chapel it was
من وسایلی داشتم که به راحتی او را بازشناسم.	there is something that would tell me how to point him out.
نسبت به حقیقت طبیعی نکات عمده این امر در برخی اذهان پدید آورد از میان ببرد.	as to the natural verity of the main points of this affair.
مرد لرزان و موقرانه کلاهش را روی قلبش گذاشت	he placed his hat over his heart, tremulous and dignified
که هوس که به جان من چنگ انداخته است این است	that the desire which harasses me is that of
ممکن بود دیگر نظر خوشی نسبت به من نداشته باشید.	I can hardly suppose you would ever have thought well of me again.
قلب سنگت را از تو بگیرد و قلبی از گوشت به تو بدهد.	to take away your heart of stone and give you a heart of flesh.
به اتاقی که در آن تختخوابی شبیه اتاقک کالسکه قرار دارد رفت.	he turned into that with the panelled bed
یا برای کارهای مربوط به شهرها و اصناف مختلف و یا به خاطر کارهای شخصی خود	either upon affairs of the several towns and corporations, or their own particular occasions
این ذات و طبیعت انسانی است که خوش ندارد درباره رقیب و خصم خود تعریف و تمجیدی بشنود.	it's human nature.
شاید هم معنی آن این بود که همسرش از خواب بیدار شود.	that seemed intended to awaken her too.
چه هومیروس به زودی دریافته بود که آن دو دارای آن ذوق و قریحه سرشار نیستند که برای پی بردن به حقیقت شعر شاعر لازم است.	for he soon found they wanted a genius to enter into the spirit of a poet.
چون هم عقلش از هریت بیشتر است و هم مقام و موقعیتش بالاتر است.	for he is as much her superior in sense as in situation.
وقتی رسید که دن کیشوت نقش زمین شده بود	but by the time he reached him he was already on the ground
مجبور شد بعد از خوش وبش با خانم الن بلافاصله برود.	obliged him to hurry away as soon as he had satisfied the demands of the other.
لذت پی بردن به اینکه من در نظر خود اشتباه نکرده بودم	in the satisfaction of knowing that I have been right in my opinion
آن وقت تو در توطئه پلیدی علیه من دست داری.	here I find you deep in some dark plot against me.
با وجود این این طور مقدر شده بود که جوان مهربان وی را غافلگیر کند.	but it so happened that the boy one day succeeded in giving the proud maiden a surprise.
به پایین خم شد و به امواج خروشان نگاه کرد	she looked down into the sparkling waters
تیغ از نیام کشید و با دم شمشیر دو ضربه برآن نواخت	he drew his sword and gave it a couple of slashes,
تو با این نقشه به بهترین و مؤثرترین وجهی انتقام خودت را از من خواهی گرفت.	you'll hit on exactly the most efficient method of revenging yourself on me.
آرتروز او بدتر نشده بود ولی یقینا بهترهم نشده بود و چند دقیقه بعد ازی ازده از روخانه اسنیک گذشت و وارد شهر همستد شد.	his arthritis no worse but certainly no better, and at just past eleven he had stopped at a small cafe for lunch.
بعد قسمش دادم که هر که و هر چه هست آرام باشد و بگذارد من برخیزم و چراغ را از نو روشن کنم.	then conjured him, whoever or whatever he might be, to keep quiet, and let me get up and light the lamp again.
نه بوی گل بود و نه بوی عطر مصنوعی.	because it was not the scent of flowers or of artificial essences
دامن لباده را رها کرد و اهمیتی برای موقعیت خود قایل نشد.	the soutane in folds no more graceful than the easy length of the body inhabiting it.
چون بالاخره من نیز همان جان را دارم که دیگری دارد	for I have as much soul as another
شاید دوست داشته باشی یه شنای دیروقت با من بکنی.	maybe you'd like to take a midnight swim with me?
پس از آنکه سی بار آه کشید و شصت بار آخ آخ گفت و صد و بیست بار نفرین و ناسزا نثار کسی کرد که به چنین روزش انداخته بود	letting off thirty ohs, and sixty sighs, and a hundred and twenty maledictions and execrations on whomsoever it was that had brought him there
کمی صبر داشته باش و بگذار از خواب بیدار شود.	wait till lie wakes, and be patient.
تا بجز مسائل کش تیرانی روی رودخانه در مورد دیگری با هم حرف بزنند.	to talk about anything other than river navigation
بیش از دو تفنگ از پنچ تفنگمان قابل استفاده نبود.	only two guns out of five remained in a state for service.
زیرا با آنکه در این لحظه مشغول صحبت کردن با تو هستم	for although I shall talk with you again
لذا بار دیگر از کلارا پرسید که منظورش چه بوده است.	so she again asked her what it was she was going to say before.
باری همین که خواستم دست و پا بزنم او چنان مرا در دست خود فشرد که دیدم کار عاقلانه اینست که تسلیم شوم.	when I offered to struggle he squeezed me so hard, that I thought it more prudent to submit.
انرژی عظیمی آزاد شده و به غلیان درآمده بود.	a great gush of energy was being released.
آن خون ریخته سی رطل شراب سرخی است که در شکم آن بوده	that the dead giant is a hacked wine skin
چون هرگز واقعاً نفهیمده بود که آن دختر تا چه حد عاشق اوست.	because he never imagined how much she loved him.
نسیم ملایم و با طراواتی با موهای سرهای برهنه	a fresh soft wind played with the hair of the bared heads
من به شما گفتم که شما نام عجیب و زیبایی دارید.	I told you at the beginning of lunch you had a lovely and unusual name,
بالاخره به اینجا آمدم سفر را به پایان رساندم.	I got here. I made it.
اگر به هنگام شب صدای غرش آب را در برخورد با موج شکن بشنود	if by night he hear the roar of breakers, starts to vigilance
چون کار بسیار در حاکم نشین یکی از ولایات مجاور داشت	recalled by his duties to the capital of a neighboring arrondissement
او از ارتباط خود با آن سفر شوم بیمناک شده بود.	he was fearful of his entire connection with thisill fated trip
بلکه هر سرباز با صورت تازه و شاداب و شسته و تراشیده و اسلحه و تجهیزاتی که تا اخرین حد امکان تمیز و براق شده بود	but every soldier with his freshly washed and shaven face and his weapons clean and polished to the utmost
با داشتن چنین رفیق و چنین شوهر تا چه حد خوشبخت خواهم بود!	I may be with such a friend and such a husband!
این بار بیش از بار نخست بر من تیر باریدند.	they discharged another volley larger than the first.
بلکه در واقع نوعی سنگ تعیین مسافت است تا دقیقاً بتوانند ساعاتی سعادتمند را با هم بگذرانند.	but was the lodestone that had given them both so many happy hours.
اما او تا مدتی که مشغول باز کردن در خورجین بود سرش را به طرف دیگر گردانده بود.	but he kept it averted for some time while employed in unlacing the bag's mouth.
به خصوص که سخنان شما ظاهراً بیشتر به حقیقت شبیه است تا کلمات او	especially as your story is a more likely one than his?
به خصوص با علم به اینکه چگونه این پول به دستتان رسیده بود.	especially as I knew how you needed the money yourself.
سرنوشت کشتی بود که ماهر دو به آن علاقمند بودیم.	since in that our interests jumped together, and that was in the disposition of the schooner.
اگه کلاه داری بذار سرت تا کسی صورتت رو نبی نه.	if you've got a hat, bring it along to hide your face.
با پشتکار و جدیت درجه خود را بازگرفته بود.	had twice regained his commission.
اما آسوده باشید که ما بیهوده کاری نخواهیم کرد.	but be assured we shall take no improper advantage of them.
کافی است که جانش را در راه یک ایمان یا در راه یک درستی نثار کند.	it suffices to give one's life for a conviction or a loyalty.
رسیدگی در دادگاه و بعد توقیف و ضبط اموال.	a judgment and then a distraint
بعد بدون اینکه در صدد اطاله کلام باشد در میان سکوت کامل به دنبال زنش پائین رفت.	making no effort to prolong the discourse, descended in silence, followed by his wife.
بی آنکه من خبر خوشی راجع به جشن یا مهمانی رسمی به تو داده باشم	without my bringing thee any joyful tidings to furnish an occasion for adorning and bedecking thyself
در این فکر بود که مانند دوستش سنکا دو آن خیرخواهی پیشه کند.	he'd be as generous as his friend SenecaDoane.
سپس از پست دریچه به کنار رفت و سر دیگر افسار را محکم به چفت در انبار بست.	coming down from the hole tied the other end very firmly to the bolt of the door of the straw loft.
اما وقت چیز خوردن نبود قدری از روم نوشیده و داخل غار گردید	but he thought not of hunger at such a moment
شانس آوردی اون داغ ون تر از تو بود.	I hope she calls later.
منشی او که در کنار بخاری نمازخانه نشسته بود	the clerk, who was sitting by the vestry room fire
روابط اجتماعی پیش از آنکه شروع شود گسسته بود	social intercourse had paused before it started.
من هم به دنبال او به تالار رفته بودم	I followed him in
ناگهان از تشنجی که به طور غیر منتظر گلویش را گفت	was suddenly checked in his speech by an unexpected cramp in his throat.
زیرا جناح راست به احتمال قوی قدرت نخواهد داشت مدتی مدید در مقابل دشمن مقاومت کند.	as the right flank would probably not be able to withstand the enemy's attack very long.
شاید در این لحظه بر اثر دشنام ارباب دچار رنجی روحی شده بود	perhaps, at this moment, under a powerful sense of injury
که ناخدا جرأت نکرد با ایشان در کشتی بدان سنگینی راه بیفتد.	that the captain durst not put off with them in so heavy a vessel.
من کاملاً مسئولیت پذیرم و هیچ وقت زبونم رو داخل دهن دخترتون نکردم	I am very responsible and have never had my tongue in your daughter's mouth.
با دست به آن طرف خیابان اشاره کردم و ناگهان متوجه شدم مردی شکم گنده مشغول عوض کردن لاستیک پنچر اتومبیلش است.	I gesture across the road, where I notice for the first time that a man with a huge belly is changing the wheel on his caravan.
بعد بانگ خشن و عمیقی از دور بلند شد.	then a deep, sullen boom came floating down out of the distance.
که کور از قفل شدن در به شک افتاده است	the bolted door must have seemed suspicious
نکات با ارزش را در خصوص یکدیگردرکمتراز چند ثانیه حدس زده بودند	they had guessed everything of any importance about each other in two seconds at the utmost
در حقیقت برای درس دادن به کودکان ساخته نشده بود.	in truth he was not made for teaching children.
هرچند با اجازه خواننده باید این نکته را درباره خود عرض کنم که رنگ روی من همان قدر سفید است که رنگ روی مردان هم وطن من	although I must beg leave to say for myself, that I am as fair as most of my sex and country
در همین جا بمانید و چنانچه دستور حرکت رسید با باروبنه حرکت کنید	to move on with the baggage train should orders come for it to move
در حالی که گاهی دیگران می گفتن تو احساس نداری.	when everyone else said you were just a heartless coquette.
ره رفتنش با دلهره و تپش قلب توام بود.	the familiar excitement making her pulse leap.
مانع شد تا تمامی تنه درخت را با داس خرد کنند.	prevented them from mutilating the tree all the way to the trunk.
بله دیده امش وقتی دیدمش فکر کردم ممکن است به ستونی از نمک تبدیل شوم	I've seen him. I thought I was going to turn into a pillar of salt.
ولی مرتبا به ملاقات شما خواهم آمد. خیالتان راحت باشد.	I shall see you here quite often enough.
صبر کردم. به شکارهایم اجازه دادم تا چند دقیقه دیگر زنده باشند.	I paused, giving my hunters a few minutes' head start.
چون ابری تندر خیز و طوفانزا بربالای سر ما آویخته بود.	hung over us like a thunder cloud.
مرا از زحمت به زندان انداختنش راحت کرده است.	that saves the trouble of putting him in irons.
با پاهای لرزان و نازک به وسط اتاق آمد	, staggering on his thin legs, advanced into the middle of the room.
روی میز در کنار کلوچه که به آن لب نزده بودم گذاشتم.	put it on the table, beside the untasted tart.
چون که تو خیلی بزرگ شدی و اصلاً دیگر شبیه خودت نیستی.	for you look so grown up and unlike yourself
لکن ژنرال دست راست خود را روی شانهٔ او گذاشت	but the general once more laid his hand in a friendly manner on his shoulder
اما التماس کرد که تام هر چند وقت یک بار برگردد	but she implored him to come back every little while
هنگامی که به رختخواب رفت تصمیمش را گرفته بود.	by the time he had got into bed, he had made up his mind
گمان دارم که لطمه سختی از باد خواهیم خورد	we shall have a gale
لباس از تن درآورد و مشغول سنجاق زدن به موهای کم پشت خود شد و احساس آسودگی بسیار کرد.	took off her dress, and began arranging her thin hair for the night, she had a great sense of relief.
دیدم بهتر است یک سؤال دیگر از او بکنم.	I thought it as well to put one more question.
از صندلی بلند شد و قلمش را پایین گذاشت.	leaving his seat and his pen
من در انتظار تو بودم و در تمام مدت بامداد با عطش خاصی آرزوی ملاقات ترا داشتم	I've not been simply waiting, but thirsting for you the whole morning.
وقتی آمدی بالا به نظرم خیلی قیافه غمگینی داشتی.	I thought you looked so sad when you came up stairs.
از نزدیک با افراد شریف و محترم و حتی لایق و ممتاز سر و کار داشته است.	he has been in contact with decent, respectable, andeven able and distinguished people.
من متوجه شدم که شما در بودجه مبلغ ده هزار لیره برای خودتان منظور گردید.	I notice in the budget you award yourself the sum of ten thousand pounds.
کنت فهمیده بود مقصود آند را چه چیز است	who felt the perfidious manoeuvre of the young man
هنوز عامل یگانه قطعی ارائه نشده است که تمایز اصلی بین این دو بر آن استوار شود.	nor has there yet been presented a single determinate fact upon which to ground a radical distinction.
ولی معمای به این خوبی نباید فقط پیش یکی دو نفر حبس بشود.	but so good a charade must not be confined to one or two.
اما تا آن وقت نشنیده بودم که آفتاب خوردگی آدم سفید پوست را زرد بنفش تیره بکند.	but I never heard of a hot sun's tanning a white man into a purplish yellow one.
صدایی گرم و آرام که تا آخر عمر آن را فراموش نکرد.	whose hushed tones he was not to forget for the rest of his life.
تا مردم بفهمند که بله او این همه چیز دارد.	that folks may know you've got them,
اگر پیش از آن دفتری ترتیب داده شده باشد به مرور زمان یا بر اثر اغتشاشات داخلی از میان رفته است.	at least has been destroyed by time or public disturbances.
اما در حال حاضر تحت تاثیر قرار دادنم سخت است.	but I'm hard to impress right now.
برای یک زن کار بیش از حد زیادی بود.	there was too much work for one woman.
خود را تسلیم سرنوشت مرموزی که خاص مردان است کرد.	he succumbed to the inscrutable fate which is a mans.
زیرا قصد داشتند محصولاتشان را در اماکن عمومی به فروش برسانند.	if they were hoping to sell to the public.
ولی در اشتیاق دانستن اینکه چه بر سر پسر ارشدش آمده است جانش به لب رسیده	though dying with anxiety to hear of his eldest son
در عجب بودم که هنوز کسی او را نزده بود.	I was surprised no one had hit him yet.
تنی چند نیز که در آنجا حضور داشتند به دنبال ایشان افتادند.	with them some of those who were present.
زیرا معتقد بود که با توجه به درک لیدی راسل نظریاتش در نهایت پذیرفته خواهند شد	from whose known good sense he fully expected to have just such resolute measures advised as he meant to see finally adopted
با این نگاه قصد داشت به او بفهماند خواستار پاسخ قطعی است.	meaning to imply a demand for a decisive answer.
تا دلیل مرگ را ثابت کند. تنفس سیانوری که برای چاپ عکس در لگنی ریخته شده بود.	that the cause of death had been the cyanide vapors activated in the tray by some photographic acid
بعد با صدای بلند خندید و درشکه را به لرزه انداخت.	 he returned, and burst into a roar of laughter that shook the chaise.
اما جوان کوتاه قامت رویش را برگردانده از کنار دهلیز گذشت.	but to me most unpleasant of men
تا آن که چون شهاب بسوزی و غباری نیز برجای ننهی.	than to burn like a meteor and leave no dust.
چقدر آرزو داشتم که در آن جاده بیشتر پیش بروم!	how I longed to follow it farther!
آنگاه باز رو به جلو نشست دهنه اسبش را کشید	then turned forward, twitched his own bridle
تا اینکه من پشیمان شدم که عجب جایی آمدم ببینم تو شهرمان چه خبر شده.	till I was afeard I had made a mistake coming to her to find out what was going on in the town
رد شدن او نو از کنار گوشش احساس کرد	he felt it ruffle his hair as it passed.
به سوی وی برگشتم و دو سه قدمی به سوی او رفتم. بار دیگر به او خیره شدم.	I turned directly, came back, and looked again.
مثلاً بسیار خوب مسالة دست بوسی را درک کردهاست.	for instance about kissing of hands
بدی حالش نتیجه دوری و فراق از تو نیست.	that his condition of health is not occasioned by attachment to you.
با بالا رفتن از دیوار به آنجا رسیده بود	had arrived there by scaling the wall
او به خاطر اینکه بیشتر رعایت احتیاط کرده باشد دنباله دستمال را به دور من پیچید.	with the remainder of which he lapped me up to the head for further security.
اصلانمی دون ستم این ورزش ان قدر پر خشونت است	I had no idea it would be so violent.
دومین بار به علت تصادم با یک تخته سنگ.	the second by striking against a rock.
همچنین خوب میدانی که من برای ازدیاد ثروت و مکنت خود به قدری که متناسب با حیثیت و مقام و سعادت تو باشد به اندازه کافی صبر کرده	nor art thou ignorant either that, in my hopes that time and my own exertions would improve my fortunes
دیگر حاضر نبودند در خانه تلفن داشته باشند و تا سالیان سال آن را رد کرده بودند.	or refused to have a telephone for many years.
رویم را برگرداندم و قدم زنان از او دور شدم	I swivel determinedly, and start to walk away, over the gravel.
شاید هنوز هم امیدی باشد که این پسرک مایهء خیر و برکتی برای تو بشود	there's hopes wot that boy will yet be a blessing to you
از در مخفی پشت تابلوی یک ظرف بزرگ میوه.	concealed door behind a painting of a bowl of fruit.
من آن برجستگی را با پیشانی تو اشتباه گرفتم.	I took that hump for your forehead.
به یاد آوردم که میان آدمی خواران گرفتار آمده بود و ایشان او را خال کوبی کرده بودند.	who, falling among the cannibals, had been tattooed by them.
تنها صدای سبک خرد شدن کلوخی این آرامش را به هم زد.	only a slight crunching of clods could be heard from his passage.
خوب پس بد نیست ببرم کلید را بدهم و ضمناً یک سرو گوشی هم آب بدهم.	I'll take it to them, and see what's going on.
در این هنگام مادرم از آستانة در اتاق نشیمن بازگشت	when she turned round at the parlour door, in the dusk
من همیشه توی سرکوب احساسات ناخوشایند درونیم خوب بودم .	I've always been very good at repressing unpleasant things
که نزدیک بود او را به درون یک بشکه پر از کود اژدها جلوی یک عطاری بیندازد.	he nearly knocked him into a barrel of dragon dung outside an apothecary.
در پاسخ گفتم که ارباب سابق هیچ منتی بر من ندارد	I made bold to tell her majesty, that I owed no other obligation to my late master
از روی لطف و مرحمت با من ناهار خوردند.	did me the honour to dine with me.
زن صاحب دکان در کوچک بار را باز کرد و دولا شد و	the landlord's wife, opening the little half door of the bar, and bending down
که ماه پیش از آنکه ما به خانه برسیم	before we came forth again
چگونه یک روز خرسی نزد من بزرگ مقدسی که در میان جنگل در حجرهٔ کوچکی مشغول تزکیهٔ نفس بود آمد.	how once a bear came to a great saint who had taken refuge in a tiny cell in the wood.
که حتی فرزندان خود دکتر نیز در زمان طفولیت از آن برخوردار نبودند.	that no one else in the family ever h ad, not even the children when they were young.
شرح داد که چرا برای گرفتن درجه در آزمایش شرکت نکرده بود.	he began to explain how he had failed in his examination.
اینک شش روز است که او ناپدید شده است	it is three days now since anything has been seen of him
که در مجالس رسمیه با آقایان خود تکلم داشته باشند ایستاده	under such solemn circumstances,
لکن اخیرا در روش خود نسبت به او تجدید نظر کرده بود	but of late years he had begun to think differently about it.
مگر اینکه هر دو شیفتگی متقابل را به صراحت بپذیرند	unless it frankly recognizes a mutual fascination
اسبی که ارباب من بود امر کرد که جائی برای اقامت من معین کنند	the master horse ordered a place for me to lodge in
ولی آرزو داشت به هر قیمتی شده زن او بشود و به عنوان شوهر دوم انتخابش کند.	she would have sold her soul to the devil to marry him.
دزدی را پیروزی خود شمرده و آمده بود تا میدان واترلو را غارت کند.	having theft for his victory, and come to rifleWaterloo.
اما تو موردی بودی که من به خاطرش اونجا توقف کردم.	but you're why I stayed.
با هیجان خاصی به دور و برشان نگاه کردند.	looking around excitedly.
بدین طریق با قیافه و نام مبدل به نزد پزشک شرکت موز رفت تا مورد معاینه قرار بگیرد.	having herself examined under a fictitious name by the banana company doctors.
بلکه هرچه داری را نیز از دست خواهی داد.	but will lose all you have,
می تونم شما رو به خو نه بر سونم	I can give you a ride home
برای شروع فرضیاتمان همیشه مبنایی عینی در اختیار داریم.	we have always some material basis on which to start our speculation.
تمام کاری که ما باید بکنیم این است که دنبالش کنیم	all we got to do is to stick to it
همیشه شاخه کوچکی گشنیز و یک مشت فلفل سبز مجانی.	always a sprig of coriander and a fistful of green chilies for free.
بیشتر از این نیاز به دانستن نیست که ببینید	no more is needed than the knowledge that
امروزم دیدمش که میگ ذره اما بازو شو بجای یه خانم به یه تفنگ داده بود.	to day I saw him pass, and he had a gun on his arm.
در عرض دو روز می تونم یکی رو که مناسب با شه پیدا کنم و برگردم.	I could be back here in as little as two days with a suitable person
امیدوارم که شما با قبول خواهش من موجبات سعادتمندی مرا فراهم سازید.	but I hope,I shall be more fortunate with you, he said with a smile.
با احساس عوض شدن لحن صدای مادر سرش را بلند کرد.	she looked up at the change in her mothers voice.
ساعت شش و نیم صبح آن روز اتاق را گرفته بود.	at six thirty this morning.
وگرنه من در این حفره تاریک بالاخره سرم شکسته خواهد شد.	or I shall knock my brains out against something in this confounded hole.
خوشبختانه اربابم آن روز تمام وقتش را در کتابخانه گذرانده و طبعاً از غیبت طولانی ما بی خبر بود.	my master had not quitted his apartment, and remained ignorant of our prolonged absence.
مربوط به دیروز و امروز نبوده و عمق و عظمتش به سابقه دارد.	is not one of yesterday, nor one I have lightly formed.
متوجه شدم که جزئیات علامت قدیمی را به خوبی به یاد دارم	I suddenly found that I could remember every detail of the old sign
دید که در حیات مربعی است که چهار دیوار مرتفعی او را احاطه نموده	he was in a court surrounded by high walls
ویسکی را توی دهانش ریخت و با کیف مضمضه کرد	sipped the whisky delicately
عوض یک فرزند او را دو فرزندی خواهد بود	instead of one child, he shall have two
اما بی شترش به این علت بود که قاضی پدر او بود.	but mainly because he was her parent.
تاکنون خودداری کرده بود اما اکنون خود را در زیر بار مصیبت فرسوده یافت.	he could not bear solitude shared only by two corpses.
آن روز بعدازظهر نتوانسته بود فکر او را از سرش بیرون کند	she could not get the thought of her out of her mind that afternoon
که اگر کسی کارهای مهم و گوناگون داشته باشد	that if a man's business be very great, and of various kinds
دور تا با شادابی دخترانه و نامزدیش با آن محقق پژمرده و خشکیده	youthful bloom, with her approaching marriage to that faded scholar
کلمات این خواهش بر لبانش به لرزه در آمدند	the words trembled on her lips.
بعد از توی بیشه در امتداد ساحل به راه افتاد	then struck through the woods, following the shore
ولی لذت مصاحبت با ین جوان پر نشاط را به من بده.	but do let me enjoy the society of this delightful young man.
نیمی از عمرش را در چنان مناطقی به خرید و فروش چهارپایان گذرانده بود	who had trafficked through the region for half his life
دهانش طوری کش آمد که قادر به حرف زدن نبود.	her mouth stretched too tightly for speech
به او قول داد که درِ یک بطری ادوکلن دیگر را باز خواهند کرد	she promised him another bottle of cologne
گویی سرنوشت محتوم آن بود که تا ابد دوام آورد.	as if it were destined to endure for ever.
اضافه کرد که در عمرش اتاق به این بزرگی ندیده است.	she had never seen so large a room as this in her life.
من که از زندگیم سیر نشدم اما این قدر فقیرم که می تونم هر چی دارم روی گرده اسبم جا بدم و با خودم ببرم.	I am not exactly tired of my life, though I am so poor that I can carry all I have with myself on my horse's back.
صدای غرش سهمناکی را شنیدندکه از بالای سرشان به گوش رسید.	they heard a distant roar of fury echoing from somewhere above them
خیلی زود کشف کردم داستان عجیبی میان دوستان خانم استریکلند شیوع یافته است	I discovered presently that a peculiar story was circulating among her friends.
زیر لب گفت من همین حالا شم خرابش کردم	I've already ruined this, he whispered.
قوانین آنان به این زبان نوشته شده است .	wherein all their laws are written
اسم بکی و تام با دود شمع روی دیوار سنگی دیده شده بود.	the names BECKY & TOM had been found traced upon the rocky wall with candle smoke
از لبه دیواره کوتاه بام به پائین خم شد.	looked over the low parapet.
که ماهی آب شیرین را هرچه زودتر بعد از صید به آتش برسانند	that the quicker a fresh water fish is on the fire after
اما بی آنکه خود بخواهد ا زا ین کار واهمه داشت.	but it was impossible not to shrink from telling her.
که موجب خرسندی وی و تمجید و تحسین رؤسایش شد.	which pleased him and earned him commendation from his commanders.
که آیا ممکن است دوباره او را زنده ببینم	that I might know whether I should find him still living
اما حالا این مرد تحصیل کرده که تمام زندگیش با کتاب سروکار داشته	yet here's this learned chap, who's lived all his life with books
عجیب بود که این آرامش با وجود از دست دادن سه پسر هنوز چون ستونی استوار برجای مانده بود.	her spirit always calm and her back unbowed, even in the deaths of her three baby sons.
پس در اطراف وظایفی که در برابر خانواده خویش و پایتختی که به وی سپرده شده بود	he began thinking of his social duties to his family and to the city entrusted to him
مثل این است که یک آدم کور بخواهد به یک شخص گنگ کمک کند.	it must be as the blind man would help the lame.
زیرا هنوز صحبتی از باز شدن مجدد کنسروسازی در میان نبود	for there was still no word about the reopening of the canning factory
بعلاوه یک هویج و در صورت امکان در تعطیلات عمومی یک سیب است.	with a carrot or possibly an apple on public holidays.
ام به شکل ناشناخته دیگری آری به شکل ناشناخته دیگری.	but somehow still somehow.
ابری از شن و ماسه به هوا بلند کرد	scattering a cloud of sand
مقصودم اینست که حتماً میان آن دو گفتگوی مهمی در گرفته بوده است.	it had never occurred to me that he would have any reason to avoid HER, or to trouble her with family explanations.
او نیز در اثر روحیه و شخصیت بارز خودش توانست از این شکست در عشق و جامعه با روسفیدی بیرون بیاید	rising above his defeat with a serene dignity.
من مثل پدرش بودم و او فرزند من بود.	I was like her own father, and she was my child.
در آن حس چیزی وجود دارد که مشروع و قانونی نیست.	in the feeling she excites in me.
من خواهم مرد و هیچ کس نیست دلش به حال من بسوزد.	I will die,' she exclaimed, 'since no one cares anything about me.
او یک جام را پر از مایع درون شیشه کرد	pouring out a steaming beakerful
از ای نرو از ارابه بالا رفته و آهسته به طرف چهره من آمده بودند	they climbed up into the engine, and advancing very softly to my face
با دقت آن را از اول تا آخر نگاه کردم.	I read it carefully
به طور غیرمترقبه پیش آمد و من سخت متعجب شدم!	I didn't expect it in the least.
من فقط دستور دادم که چند اتاق از قسمت شرقی بنا را تغییر و تبدیل بدهند و برای اقامت ما آماده کنند.	only redecorating and painting the suite in the east wing, which I thought we would use for ours.
باید آرام باشم و بیشتر به او اعتماد داشته باشم. باید تقصیر را به گردن خود بگیرم.	I want peace of mind and trust, and I will take the blame on myself.
تمام این مدت هم مخفیانه با هم قول و قرار گذاشته بودند.	they have been privately engaged to one another this long while.
امیدوارم به زودی افتخار شناسایی بیشتر ایشان را پیدا کنم.	I hope I shall know her better very shortly.
هنوز نتوانسته است یکی از خدمت کاران را با خودمان همدست کند.	he can't get one of the servants in line.
به این منظور صورت گرفته تا خواننده از احساسات او در مورد انجام وظایف خویش تصویر درستی در دست داشته باشد.	with a view of impressing the reader with a just sense of his qualifications for office.
چنان بزرگ بود که گویی باد را در خود به اسارت گرفته بود.	was so vast that there seemed trapped in it the wind itself.
در انجاتوقف کردیم و آتشی برافروختیم تا شامی بپزیم.	so we called a halt, and made our supper fires.
بارش را به زمین گذاشت و سعی کرد سنگ را به کنار جاده حرکت دهد.	the peasant laid down his burden and tried to move the stone to the side of the road.
اما شاهزاده آندره داستان عشق خود را برای خواهرش حکایت نکرد.	but he said nothing to her about his love.
به نظر من حتماً توانست راه دیگری برای یاد گرفتن آناتومی پیدا کند که از این کمتر وحشتناک باشد.	I should have thought he might find some less horrible way than that.
من بیش از آنکه ناراحت شده باشم عصبی شده بودم.	I was more interested than distressed.
من در آن امر دخالت کردم و کمکی نمودم.	I've been meddling and making arrangements for them.
من باید اعتماد و دوستی او را به دست آورم و بوسیله او از صندوق تعاون مبلغی وام بگیرم.	I must gain his confidence and friendship and through him obtain a special grant.
سرش رابالابرد و به ستا رگان درخشان کویرنگاه کرد.	so that only his eyes and the tip of his nose were visible.
اما همین که خواستم به خاک افتم و سم او را ببوسم	but as I was going to prostrate myself to kiss his hoof
حوایج روحی بیمار و کسانیکه او را دوست دارند اقناع کنند	because they satisfied a mental need of the invalid and of those who loved her
یا همه را ببازید یا شش هزار فرانک برایم بیاورید.	lose it all or bring me back six thousand francs.
پدر شما یعنی ارباب من راه سرای جاودانی را در پیش گیرد	your father, should take his departure for the other world
صدای مصر مردی از تلفن روی میز منشی بلند شد	a man's demanding voice squawked from the phone on her desk.
به حدی که تصمیم گرفته بودم از این کوهستان خارج نشوم مگر اینکه شما را پیدا کنم	so much so that I had resolved not to quit these mountains until I had found you
آنجایی که کسی از ما بعد از ملاقات به جای بماند	where two men having met
زیرا من اگر به شما قرضی دادم شما هم ادای قرض نمودید	I lent you money and you returned it
بی آنکه خود بداند دستش را بار دیگر روی دست کوچک روزاموند گذاشته بود.	she had unconsciously laid her hand again on the little hand that she had pressed before.
اگر هم داشته باشد مثل شمع است در مقابل خورشید.	than a lamp is like sunshine.
به زحمت اگر به نظر رسید که بدان توجه نموده باشد.	she hardly seemed to have noticed it.
سفر ما را که آغازی چنین نیکو داشت انجامی نیکو بخشند.	that we might give a happy ending to a beginning so prosperous.
تردید در آنکه آیا خود تا چشیدن لذت آن میهمان این جهان خواهد بود یا نه	doubts, of her remaining upon earth, to enjoy that new delight
ساعاتی بعد از آن که زنبورها با ظهور طلیعه زیبای روز برای جمع کردن عسل خلنگها قبل از خشکیدن شبنم آمدند	long after bees had come in the sweet prime of day to gather the heath honey before the dew was dried
بعد قفل در گاراژ را باز کرد و سوار شد.	then unlocked the garage door and ran it up.
هنگامی شاهزاده داخل اطاق شد که کار به مرحلهٔ خطرناکی رسیده بود.	just as matters in there had almost reached a crisis.
بیماریش هیچ علاجی ندارد و از دست تو هم کاری ساخته نیست.	it can't be helped.
نخست پست دست راست خود را بخ کف دست چپ و سپس پشت دست چپ را به کف دست راست کالید	he laid the knuckles of the right hand in the hollow of the left, and then the knuckles of the left hand in the hollow of the right
روز دیگر به فرمان حاکم نزد او رفتیم تا زمین ادب بوسه زنیم.	the next morning we returned to pay our duty to the governor, as he was pleased to command us.
که امیدوار بود به این وسیله خود را سفیه معرفی کند اما موفق نشد	who would like to pass himself off as an idiot, but who will not succeed in so doing
حتما به قدری دلخور می شه که ممکنه به فکر لو دادنم بیفته.	so develop an active resentment which should carry her to the length of denouncing or exposing him.
اما اگه اشتباه نکرده باشم تو دیدن من رو به فال نیک نگرفته بودی.	but I think the sight of me alarmed you.
حاضرم سر خودم و سر بچه را هم به همراه آن بخورم.	I'll eat my head, and his too.
تا مطمئن شود که چیزی از قلم نیفتاده است.	till he could find nothing more needing his attention.
مگر مردی سیاه پوست در انتهای آخرین واگن با شلوار سفید که تا کمر برهنه بود	but, on the end of the last flat car, a negro, in white trousers and naked to the waist
فقط وقتی که چند نفر با هم به جانب او بانگ برآوردند	only when several voices shouted at
در این دنیا بسیار کسان هستند که به کار دیگران علاقمندند تا آن را در هم بریزند.	there are too many people in this world ready to meddle in the affairs of others and make mischief between them.
اصلا حالا نمی تونم این حرفا رو تحمل کنم.	I can't afford to care now.
که ناگاه چشمش از دور به صندوق من افتاد	he spied it at a distance
بلکه بالعکس چون دریا بسیار طوفانی بود بندر سعادت و نجات بشمار رفت.	but a haven of safety for our relief, so much had the sea now got up.
برای هرکس و ناکس شرح بدهی که تو و پدرم چک اره هستید.	the work that she and his father were connectedwith
من از اینکه اون رفتار رو با تو کردم متاسف نیستم.	I regret to say that my conscience has not troubled me at all about deserting you.
چون در هر جای دیگر برف یخ زده به قطر ده اینچ به صورت فرش اسفالت محکمی گسترده بود	for everywhere else the congealed frost lay ten inches thick in a hard, asphaltic pavement
یک جا چشمان خود را بستم و به فکر فرو رفتم. به خود گفتم.	I shut my eyes to make the experience more lasting.
از داشتن ریاست آن خوشبخت است و تمام خیالات و افکارش تنها در اطراف هنگ متمرکز است.	rejoiced in it, and that his whole mind was engrossed by it
دوران قدیم را به یاد آورید بداد گاه جنگ جلب شده بود درگذشت.	remember the good old days, gentlemen .
مرا مثل یکی از فرزندان خود تربیت و بزرگ کند.	she would rear and maintain me as one of her own children.
مثل مگسی بود که در بشقاب سوپ افتاده باشد.	as if it were a fly in the soup.
با او دعوا و مرافعه کند و همراه او برای از دست دادن بهشت گمشده گریه کند.	to confront her, to argue with her, to cry with her in rage at the loss of paradise
بعد به سرعت وارد خانه شد و تقاضای کمک کرد.	then darted into the house for help.
میز بازی سی و چهل را یک جمعیت اشراف منش احاطه کرده بود.	a game which could boast of a more aristocratic public, and was played with cards instead of with a wheel.
به این دلیل صبح روز بعد به کنار دریاچه دیگری رفته بودند.	the next morning early they had moved on to another lake.
قویاً اعتقاد دارم که حالات فعلیم بیشتر در نتیجه اوضاع و شرایط زندگیم بوده تا گرایش طبیعی خودم.	but,owing, I verily believe, rather to circumstances than to my natural bent
چون یکی از عموهای ما املاک را خرید و وجه آن را نقداً پرداخت.	for an uncle of ours bought the estate and paid for it down
من به هیچ کس دستور نمی دم که کاری رو انجام بده.	I'm not ordering anyone to do anything.
در آغوش گرفت و خود را روی صندلی ولو کرد	swung her up against his chest and sat down in the chair
بازتابی که سالیان سال شنیدن این حرف از دهان مردم هنوز نتوانسته بود مهارش کند.	a reflex response which years of hearing people say this had not scotched.
من بعد از شام یک چیز خوب برایتان دارم .	I've got a treat for you after supper.
در مباشر حیرتی عمیق برانگیخت به طوری که نتوانست نظر قطعی بدهد	at this the bailiff simply expressed a profound despondency, and offered no definite opinion,
به زودی ناخشنودی خود را با ما در میان نهاد	was soon to tell us why
خو نه به اندازه کافی برای زندگی پیدا نمی شه	there aren't enough for people to live in
وقتی خاله جانش سر و وضع او را دید	when she saw the state his clothes were in
موسیقی هم با آن بسته شد بو به پایان رسید.	the music closed with it.
پیش از اون که از خو نه ما بره همه تاریخچه خانوادگیش رو واسه من تعریف کرد.	I knew his whole family history before he left.
که با او دوست باش و همواره او را از دوستان خودت بدان.	is to retain his friendship
که در اون لحظه فهمیدم حق با ربرتاست و رفتار من نادرست بوده یعنی متوجه شدم	that after all she wasright and I was wrong that it wouldn't be right
او را به اینجا راهنمایی کن و مرا تنها بگذار.	show him in here and then leave me.
ولی اوژن دارای همان خصایص اهالی جنوب فرانسه بود	but his was pre eminently a southern temperament
بر خلاف من قدری که در قوه داشتم سعی هم کردم که نشود	I have done all in my power to oppose it
دست کم حس کنم از انظار مخفی هستم هر چند ممکن است جایم امن نباشد.	feel at least hidden, if not secure.
آرزو داشتم که به اندازه قدرت خود به شما مساعدت کنم!	I should like to help you as far as lies in my power.
من که خادم جوانی نیستم دنبال موقعیت و فرصت و این جور چیزها باشم.	I am no young lady on her preferment.
از او خواهش کرد که چنین افکاری را بر خود راه ندهد	not allow herself to become the prey of such fearful fancies.
که هنگام ظهر میان دریای نیلگون بر آب روانه است	when seen gliding at high noon through a dark blue sea
از آن سوء استفاده نکنید و آن را پاره نکنید.	make no unworthy use of it, she said
از نوعی نیست که عملیات خودش را از صفر برپا نماید. .	not the sort who could set up his own operation starting from scratch.
نمی دونم واسه اینکه حالش خوب بود بهش انعام دادم یا به خاطر اینکه سر کار اومده بود.	I don't know if I tipped him for being very well or for being on duty.
اما بعد از این که ملحفه را روی سر همسرش کشیدم از جایش بلند شد و دنبال ما به طبقه پایین آمد و انگار غرق فکر بود.	but after I had pulled the sheet over her head, he got up and followed us downstairs quietly, in a sort of thoughtful way.
در آن هنگام که وال شناکنان از ایشان دور شد	as the whale swimming out from them, turned
ولی این کار کاملاً به راش آماده شده و دی گه نمی شه این کار و از دو راه انجام داد	but it's all laid out for 'im an' there's on'y one way to do it.
عینکش را برداشت و با یک تکه پارچه مشغول پاک کردن آن شد.	removed her spectacles and began to polish the lenses with a piece of tissue.
زیرا خودش نیز بیش از کورین ملاحظه و پروانداشت.	for he was no longer easily embarrassed.
شاید راستی راستی چیز درستی توی این کار باشد.	suppose there were something to this?
نیازی نیست از آن همه پیچیدگی و لطایف سرشت او چیزی بگوییم	to say nothing of all those contortions and subtleties of temper
احساس خوبی داشتم که در مورد گروه با او حرف بزنم.	it felt good to talk to her about the pack.
به اندازه دو قدم از تیر از لبه قایق بالا آمده باشد.	rising some two feet above the level of the stern platform.
رفتارش در آن لحظه بیشتر از آنکه به میزبانی شبیه باشد به سگ پاسبانی شباهت داشت.	not as a substitute for the host.
چشمم را از روی صفحه کتاب برگیرم و همان طور خیره و ساکت مانده بودم.	I dared hardly lift my eyes from the page before me, that melancholy scene so instantly usurped its place.
بار دیگر رو کرد به کاترین و زیر گوشی گفت	turned again to his sister and whispered
داستانی از آن اتاق و مجلس ختمی که به مرگ پدرم در آن برگزار شده بود و مردمی که با رخت سیاه بودند	about my father's funeral, and the company having their black cloaks put on.
در تالارهای خود بیست و چهار نوکر نشسته داشت	twenty four male domestics sat in his halls
چون کوچه باریک بود خانه مقابل کام لا به اطاق ما مشرف بود	that the street being very narrow, the house opposite commanded a plain view into the room
ناگهان صدای کشیش را که به خواندن دعا شروع کرد شنید	suddenly,at the sound of the service
چیز جدید این بود که در ارکستر یک چنگ هم وجود داشت	whose novelty was a harp in the orchestra
بهتر است بروم خانة خودم و آنجا باشم تا بمیرم.	I had better go into the house and die.
همین که خواست داستان تولد خود را در نوانخانه بیان کند	when he was on the point of beginning to relate how he had been brought up at the farm
ناچار بود میان من و مردمش یکی را انتخاب کند.	he had to choose between me and his people.
او مشغول برق انداختن در و دیوار قایق بود	polishing the brass on deck.
که گفتی در این احساس چیزی بود که مستلزم توجه خاص او بود.	as though there were something in this impression that demanded his special attention.
ناگهان متوجه شدم ریختن آن همه خاک روی مادر چه معنایی دارد	I suddenly realized what it means for your mother to be lying with seven feet of earth on top of her
این دود غلیظ توتون قوی و تند بود که گلویم را سوزاند	it was the acrid fumes of strong coarse tobacco which took me by the throat
به یک دست ملافه بلند روغنی و به دست دیگر نیزه وال گیری بسیار بلندتری گرفته بود.	with a long oil ladle in one hand, and a still longer whaling lance in the other.
در یک لحظه دیدم که صد تیر به بازوی چپ من رها شد.	when in an instant I felt above a hundred arrows discharged on my left hand.
سر آن را بازگشاید و گنجی را که مرد سیاه قطعا در آن جای داده است تصاحب کند.	then to run with great speed to the trench, toopen it once more and to seize the treasure which the black manhas necessarily placed there.
اکنون که فی نیامده بود او وضع نامساعدتری داشت.	put her at a disadvantage.
بلکه از شرق به غرب هم کشیده شده بود	but lay east and west
اما او غیر از محبت و خوشرویی چیزی ندیده است.	but _he_ had never seen anything but affability in her.
اما من متوجه شدم که افکار او مدام نزد زنش بود.	but I saw that his thoughts were constantly with his wife.
حالا اگر درد یا بیماری داشته باشی باز هم عزیز خواهی بود.	in pain and sickness it would still be dear.
کتابش را داد و به جای آن کتاب قطورتری گرفت	he traded his book for one that was thicker,
هنگام بررسی آن باد توفانی معروف به اورقلیدون فرقی عظیم است در اینکه از پشت شیشه دریچه به آن بنگری که همه یخبندان بیرون شیشه است	it maketh a marvellous difference, whether thou lookest out at it from a glass window where the frost is all on the outside
من در این جا تمام مدارک و شواهد لازم را علیه او دارم.	I have all the evidence you need right here.
تا مبادا دیوی بدسگال یا راهزنی بداندیش عیش همه را منغض گرداند	lest they should be attacked by some giant or other malevolent scoundrel
شاگرد مهتر هم برای راهنمایی شما در جاده فرعی خواهد آمد.	the stable boy will guide you through the cross roads.
وی در پایان گفتارش ناسزایی نثارم کرد که اکنون شرم دارم آن را بر زبان آورم.	he addressing me by some elegant term that I don't care to repeat.
چنان که گفتی کار این زن و مرد امری تشویش آور است.	as though that were a disturbing fact.
زهر دهنده احتیاط کرده و برای خود نگه دارد	the poisoner has taken the precaution of keeping for herself
من با انگشت در ظرف یک لحظه این کار را انجام دادم.	I did it with my fingers in one minute.
دیروز سعی کردم زردش کنم بلکه یه ذره جالب به شه	I tried to turn him yellow yesterday to make him more interesting
ولی چون مایل نبود سر از تنش جدا گردد	but, appearing to entertain some unaccountable objection to having his throat cut
واقعاً سعی کردم اما فوراً مرا از روی چهارپایه کنار زد و به من ناشی کوچولو خطاب کرد.	I did try, but was presently swept off the stool and denominated a little bungler.
میل به این کارها آن قدر در او زیاد شده بود	the desire grew to be so intense
از این حیث قدری اعتراف به گناه و قدری خودستایی کرد.	making something of aconfession at the same time, and yet boasting of her deed.
نداشتن شور و شوق برای دست یافتن به هدف	a melancholy absence of passion in his efforts at achievement
آن قدر پشت سرهم زن و شوهر را دعوت کردند که خانم التن کمی بعد با کمال خوشحالی متوجه شد حتی یک روز هم سرش خلوت نیست.	invitations flowed in so fast that she had soon the pleasure of apprehending they were never to have a disengaged day.
با احساس مشترک سختی و دشواری شرایط و یک هدف دائمی که در واقع حفظ شخصیت و ماهیت خدشه ناپذیز و مقدس معدن به هر قیمت ممکن بود.	with one common feeling of a tense situation, with one ever present aim to preserve the inviolable character of the mine at every cost.
یک راست از میان دروازه حلقه تیری پرتاب کرد.	shot right through the twelve rings.
اما ضمناً احساس دوستی نیز در آن دخیل بود.	except that it was determined by feelings of friendship
اما آن یادبود هم مثل خطوطی که توی شن لب دریا کشیده باشند	that record in sand was fast washing out
اما هرگز با هیچ نقاشی آشنا نشدم که مثل تو آینده درخشانی در انتظارش باشد.	but never anyone as famous as you're going to be.
اونها نمیتونن حق منو در مورد این تصمیم انکار کنن	they can't deny that it's my right to agree to this.
هر دو یک آن به لذتی بسیار کودکانه دست یافتند.	both of them had a moment of complete childish joy.
که از بد حادثه به این کار روی آورده و اگر نتواند الوارهای خود را بفروشد از گرسنگی خواهد مرد.	forced by brutal circumstance into a distasteful position, a helpless little lady who would probably starve if customers didn't buy her lumber.
ناچار رئیس ما گفت که به او نیم کیلو سیب زمینی و قدری هم آرد دادند.	our overseer sent him out a pound of potatoes and half a pint of oatmeal.
زیرا که دلم نزدیک است از هم بپاشد که قاتل را جسور کردم	my blood boils at the idea of having encouraged a murderer
از تعدادی که هرروز اضافه می شن میشه حدس زد	I'd guess from the rate they've been coming in more every day
ولی با بام با تفنگ مرد که را راند	but pap drove him off with the gun
من اشتباه کرده بودم و حالا هم از قرار گرفتن باکی ندارم.	I've had my fling, and I don't mind settling down now.
بعد نگران از آن که مبادا متجاوزان و قماربازان یا حتی پادوها حیرت زده شوند	apprehensive lest there might be poachers or gamekeepers or even errand boys to marvel
مدتی در سالنِ آب ماندند و دیدند شلوغی غیرقابل تحمل است	after staying long enough in the pump room to discover that the crowd was insupportable
در حالی که با دست چپش شمع را بالا گرفته بود	holding up the light in his left hand
خارج از گوش رس دیگران با او سخن بگوید.	of speaking to him when no one overheard.
از ای نرو آن غول نتوانست که به زورق برسد.	the monster was not able to overtake the boat.
دست یافتن به احترام و ارزش که همواره کمبودش را احساس کرده بود.	new dignities and an acknowledged value of which she had often felt the absence.
بی دادگرانه بودن این اتهام که ریاکار و متظاهر است دلش را دوپاره کرد.	the injustice with which he had accused her of affectation, of artificiality, aroused her.
بر استی نخستین بار دیدن این منظره سهمناک بود.	indeed was at first very terrible to behold.
من زیر بازوی او را گرفتم و تا گودال کشانیدم.	I helped her, , to the edge of the bank
آن دو تن در شنلی سرخ فرو رفته بود	they were wrapped in a red cloak
با نفرت اندیشید که او هم شبیه آن حشره است.	I'm like that bug, he thought resentfully
همچنانکه در کلیسا مرسوم است مردان از زنان جدا شده بودند.	the men and women had separated as in church.
اما برای یک لحظه اضطرابی گنگ بر او چیره شد	but she did feel a momentary qualm.
مردان تدبیر دیگری برای تعیین اندازه من بکار بردند.	they had another contrivance for taking my measure.
زیرکانه از راه پرپیچ و خمی که برایش آشنا	following a path it obviously knew.
نگذارید پلیس بفهمد او هنوز توی خلنگ زار است.	not to let the police know that he is still on the moor.
به همان گونه نیز پیش از آنکه بدان نقطه برسد	so also, just before reaching that point
ولی طبعشان بیش از آن متفاوت بود که با هم بجوشند.	but they were too different to live together.
در واقع او متوجه دستی که به سویش دراز شده بود نشد	in fact, he did not notice the offered hand.
او به من گفت که در لشکر گاهش یک قطره سرکه وجود نداشته است.	who told me he had not a drop of vinegar in his camp.
