از جمله کسانی که در رأس این جنبش قرار دارند	that there has always been such a man among those who stood at the head of the movement.
خدا نخواسته باشد که من در حضور آقایان محترم خود خلاف واقع بگویم	I assure you I had no idea of insulting the court
بر طبق قول رسمی خویش وی را حاکم آن جزیره گرداند.	to make him governor of, as he had promised.
به جای نام خانوادگی را نیز سفید گذاشته بود به این امید که روزی بتواند نام خود را در کنار آن حک نماید.	a blank left for that which he hoped one day to have bestowed upon her
من بدون اینکه احساسش کنم صدای حبس شدن نفسم را شنیدم.	I heard my breathing stop without feeling it.
بلکه وقتی هم به نزدیکی آسیاهای بادی رسید باز نتوانست به کنه حقیقت پی ببرد.	nor perceived, near as he was, what they were
شخصیت او به وضوح در برابر دیدگانم ظاهر شد.	the analysis of his nature was proceeding before my eyes.
اما نباید هیچ کس را به اتاق او راه بدهند.	but they were not to be admitted to him.
اما به وی مشکین وحشی حیوانی آن را استشمام کند	but only smells its wild animal muskiness
از هرچه تا آن وقت شنیده بود دلپسند تر بود	the pleasantest he had ever heard.
اکنون دکان نانوایی خود را در مرکز شهر تأسیس کرده بودند .	now had opened a bakery downtown.
به هر حال فرصت فکر کردن به این چیزها را نداشتند.	in any case, they had little time for speculating on such things now.
که با آسودگی بر روی قالی قرمز ایستاده است	stood out in relief against the red tapestry
آنجا دیده گشودم و چشمان خود را مالیدم و به خوبی احساس کردم که در خواب نیستم و کاملاً بیدارم.	I opened my eyes, I rubbed them, and found I was not asleep but thoroughly awake.
لکن شهرت دارد که کم و بیش به انسان شباهت پیدا کرد!	but it is alleged that he grew into something more or less resembling a man.
قضات غافل از ین معنی نیستند که باید بر حسب این سوابق حکم کنند.	the judges never fail of directing accordingly.
من بار دیگر فریاد برآوردم که این راز را فاش نخواهم کرد.	while I shouted after her once more that the secret should be kept sacred.
هستی موجود به تمامی در تپش آهستهٔ آن متمرکز گشته است.	in its slow beat the whole creature seems to be absorbed.
خود را برای ابد از همسری با خواستگار دیگر محروم خواهید ساخت	you forever lose the chance of marrying the other
کار ممکن نیست یک قانون بشمار آید بی آنکه یک حق شمرده شود.	labor cannot be a law without being a right.
کاترین در آخرین لحظه برگشت و چنان نگاهی به سویم افکند که قلبم به درد آمد و بسیار اندوهگین شدم.	he casting back a look that cut my heart she obeyed.
باید طوری باهاش تا کنم که خیال کنه مثل سابق دوستش دارم.	be very nice as though he cared for her as much as ever now
در وجودش ندایی بانگ برمی داشت که بیش از هر کس اوست که باید همسر خویش را در سیه روزی یار شاطر باشد و نه بار خاطر.	so strong was the voice within her, representing that it was she of all the world who must uphold him in his misery and not augment it
بلکه محض از برای اینکه اسباب آزادی خودش شود.	but because it would also set her at liberty.
اما بار دوم خاطرنشان مرسده کرد که او را دوست دارد	at the second he reminded her that he loved her
او بانوی بسیار مهم و محبوب و مهربان است و مرا از صمیم قلب دوست دارد.	she is such a grande dame, so kind, and evidently likes me so much.
در آن تصویر آرایش اما تند و غلیظ و نگاهش ملایم و ترحم انگیز آمد.	her toilette seemed to him pretentious, and her languishing look in the worst possible taste.
چون قسمت پیشین آن به زیر درختان ساحل رسید	the bow had struck among the shore side trees
بلکه در عوض نامه را همراه با نیم دلار پول به دست او داد	but instead had handed himthe letter and half a dollar.
گرچه کام لا از فرد خستگی از پای درآمده	though certainly exhausted
اما در مقام اجرا بسیار صعب و سخت است که از قوه به فعل آید	but more difficult to conduct to an end
برای فهمیدن بهتر کاملاً به او نزدیک شده بود	inclining her head to catch the words
گرچه در دورترین کنج میز ایستاده بودم و فاصله من تا او شانزده گز بود.	though I stood at the farther end of the table, above fifty feet off.
پسر این زن با آن نگاه به تصویر ورانسکی استفهام آمیز و خصمانه.	her son with his questioning hostile, as he fancied eyes.
زیرا امکان داشت که ناخدا روزی پس از صرف ناهار به طور شوخی او را تا سرحد مرگ شلاق بزند	the probability being, that the skipper would flog him to death, in a playful mood, some day after dinner
لازم بود که افراد بیشتری به خدمت پذیرفته شوند.	it had been necessary to raise more recruits
من باید پشت در منتظر بمو نم و در رو باز کنم	I'll be waiting to open the door.
بارها پیش من آمده و با من مشورت کرده بود	came to consult me once
گویی که بیشتر با خود بود تا با او.	more to herself than to him.
خاسکتری رنگ با ته رنگی از شامگاه زیر درختان در آن	grey with the hue of twilight under the trees they seemed to be
اکنون چندین و چند دست در لگام اسبان آویخته بود.	there were twenty hands at the horses' bridles.
هری نتوانسته بود از نوشتن جزئیات پیروزیش با شاخ دم بگذرد.	the letter attached to his leg was much longer and heavier than usual
تا روزی که مرور زمان یا مرگ آتش خشم والدین او را فرو نشاند.	for time or death will put an end to the wrath of her parents.
ترتیبی داد تا مریدان او متوجه تغییر حالتش نشوند.	making certain that his pupils would not notice any gesture of his
این نوعی آنفلانزای روسی بود و دلیلی نداشت که مردم نگران باشند. فقط افراد خیلی پیر و خیلی کم سن و سال در معرض خطر جدی بودند.	nothing to really worry about except for the very old and the very young.
من وظیفه شرکت در جلسات و رای دادن در مورد اسب فلان دهاتی را به اندازه هر کار دیگری مهم می شمارم	I consider that for me the duty of being present at the session, of judging some peasants' quarrel about a horse, is as important as anything I can do.
خلاصه آن مانند چیزهائی که پیش از آن گفته بودم برای سایر دوستان ترجمه شد	the sum of my discourse had been interpreted, as before, to the rest of the company
تنها و آزاد و بدون شک حاضر و آماده برای تسلی دادن او.	alone and free and doubtless ready to provide him with the compassion he needed
رون چنان ناگهانی فریاد کشیده بود که صدای بلندش در غار پیچید	so loudly that his voice echoed all around the cave
دادستان مدعی بود که جرم این مرد ریشو و این قاتل سنگدل را به کمک همین مدارک و شواهد کوبنده قطعا به اثبات رسانده است.	where with the prosecution had proved this bearded man to be the red handed murderer that he was.
هر چند که او دیگر بدان گونه که در آیینه به چشمش آمده بود نبود.	although she did not look in the least like what he had seen in the mirror.
سر خود را که با موهای بور کوتاه پوشیده بود فرود آورد	his head bent low into the thick mass of her golden hair.
بدین ترتیب همگی یک دور کامل گرد کشتی چرخیدند.	so that they performed a complete circuit.
یکسره تاختم و اگه زودتر از اینجا نرم پوستمو می کنن.	I've ridden hard and it'll cost me my skin if I don't get out of here quick
پسر جان هر کسی آن درود عاقبت کار که کشت.	so shall you drink, my boy.
زیرا به حکم شرح و وصفی که درباره آنان کرده بودم	as these lawyers, by the description I gave of them
ولی من تقاضا دارم همه به حریم خصوصی خانواده و روند محرمانه تحقیقات احترام بذارن	but I ask that everyone respect the privacy of the family and the confidentiality of the investigation process.
حتی کل سطح آن نیز برای این شعار جای کافی نداشت.	its whole surface furnished very indifferent space for this legend.
من فقط جواب دادم که من هنوز خیلی برای هر کاری جوان هستم و همچنین میل ندارم که هیچ رازی را از تو پنهان کنم و او باید در این باره حتماً با پدر صحبت نماید.	I only said I was too young to do anything about it yet, that I didn't wish to have secrets from you, and he must speak to father.
گرمای امروز باعث شد یه لحظه خوابم به بره.	the heat of the day, you know'I drifted off for a moment
رها از افکار درهم و پریشان بر بستر آرمید و با حالتی آسوده و آرام به خواب رفت.	he lay down to sleep in a calm and peaceful mood, free from all unquiet or disturbing thoughts.
که همه چیز و سنگ بزرگ را هم از ذهنش محو کرد.	that everything vanished from her thoughts, even the stone.
اما سلطه بر کردارش مانند همیشه به یا ریش آمد.	but her habitual control of manner helped her.
آنجا که سه سپیدار بزرگ کنار دیوار تاکستان قد علم کرده بودند.	where three poplars stand near the wall of a vineyard.
رویهٔ سفید کاسکتش به روغن چرخ مالیده شده کثیف بود.	making the white linen cover of his cap oily with cart grease
اما همیشه این احتمال وجود داشت که به پلیس مراجعه کنند.	but there was a chance they could go to the police.
رعایت این احتیاط از آن جهت بود که هم قطارش سانکو در حین برخورد او را نشناسد.	that he might not be known by his gossip when they met
که از چند روز قبل به این طرف همیشه قفل بود	which of late had always been kept locked
در نوع خود همه گونه رفتار و مراسمی را دارند	they have all sorts of ceremonies and artifices of their own
راضیش کردید که بره پیش پدر و مادرش و بعدش هم ترغیبش کردید با شما به یاد سفر تا مثلا عقدش کنید.	you induced herfirst to go home and then later to go away with you on this trip inorder, as you told her, to marry her.
اگر بار اون سورتمه را سبک کن ین خیلی بهشون کمک کرده این.	you can help them a mighty lot by breaking out that sled.
باید خیلی خوشحال باشند که بتوانند کشتی را بردارند و فرار کنند!	they'll be glad to be packing in the schooner.
همه این مناظر دوران جوانی اثر شعری بدون شاعر را بر او داشتند	all these sights of his youth had acted on him as poetry without the aid of the poets
کلاید از دریافت این دعوت نامه شادمان شد و بی درنگ پیش خود نتیجه گرفت	clyde merely gave himself over to extreme rejoicing in regard to it all now
آنگاه با دو دست سر و گلوی او را گرفته	then, grasping her by the head and throat
گویی از کودکی خود را آموزش داده بود که تحت هیچ شرایطی نباید خوشبختیش به خطر بیفتد.	as if she had trained herself from infancy not to let circumstances affect her well being.
بلکه خود هم چون آنان مشتاقانه در بازی شرکت جوید.	but to watch with them in kindred eagerness.
ناگهان دو پیرزن وارد شدند و روی قالی بنای چرخیدن گذاشتند.	suddenly two old women began spinning round on the carpet?
سرانجام حاضر شد حضور کلاید را در آن مجلس تصدیق کند.	she at last condescended to evince awareness of his proximity.
اگر طبیبی یا جراحی یافتی از برای من بفرست.	should you meet a doctor you will do me a favor by sending him to me.
آنچه را که بر او گذشته بود برایش نقل کرد	told the man what had happened
حتی در واقع چندان سریع نبود که چند حباب پرنده را آن آب ممکن بود با تعمید مرگ آسای خود به دب نه او ترشح کرده باشند.	not so quick, indeed, but that some of the flying bubbles might have sprinkled her hull with their ghostly baptism.
تا لااقل از آمیزش کثیف و رنجش بیمارستان در امان بماند.	so that she might at least be spared the sordid promiscuity of a ward.
باز هم اکنون باید از ماهیت آن ماده که با آن نفوذناپذیری تمامی آن زنانگی را پوشانده است اطلاع یابید.	yet, you are now to be apprised of the nature of the substance which so impregnably invests all that apparent effeminacy.
که در ین اثنا دیدم یک کشتی بادی به سوی سمال شرقی رهسپار است	I saw a sail to the north north east
که چون دیدار آن بسیار غیر معمول است این وضع تا آن حد پیشرفت کرده که نوعی اثر شوم بدان بخشیده است.	that a glimpse of it being so very unusual, that circumstance has gone far to invest it with portentousness.
از فکر اینکه نتوانم قبل از فرا رسیدن شب کاترین را بیابم هراس سراپایم را فرا گرفت.	so I began to fear night would fall ere I could reach them.
یاد زمانی افتادم که دیده بودم پرستار واکسن هاری را تزریق کرده بود.	like I remembered seeing the nurse do before our rabies shots.
کلی هم از خوش طینتی و ادب و محبتش تعریف و تمجید کرد.	dwelt a good deal upon his being so very good humoured and obliging
بدون هیچ ارزش انسانی مثل یک حیوان در قفس نابود میشید.	with no dignity, just an animal in a cage!
تا وقتی من بذارم از این ور به یاد او نور.	as long as I can keep him from crossing over
گاه به یاد مادر پیرش و از خود پرسیده است	sometimes he would maybe think of his old mother
در حالتی که تمام ملازمان مشغول گریه و زاری بودند.	amid the tears and lamentations of the whole household
یک لنگه دستکش پوست آهوی بلند و صاف و قشنگ که هم رنگ پالتو پوست تازه عروس بودنش بود.	her beautiful gazelle skin glove, long, smooth, soft, the same color as her newlywed' s skin.
اوراق خود را جمع کنید و آن را به من بدهید شما اینجا در اطاق من خواهید خوابید و قبل از خوابیدن صحبت خواهیم کرد	give me the papers, and go to bed like a sensible fellow.
ارلاندو فهمید که سرنوشت مهت وم او رقم خورده بود.	he knew that his doom was sealed.
خیلی متأسفم که اسباب مزاحمت و بی خوابی شما را فراهم آوردم.	I'm sorry I disturbed you.
بعد با دلسوزی و نگرانی نگاهش را برگرداند طرف شوهرش.	turning her eyes with affectionate anxiety towards her husband.
بعد از پایان مراسم عبادی نیز شهر را ترک کرده بود.	he left town after mass.
با ین علت که به شما علاقمند هستم و میل دارم شما را نجات دهم.	because I like you and want to save you
کوشیدم به خود بقبول انم که احساس سر درگم طغیان آهسته آهسته در ذهن کند او نمو کرده اکنون سر بر آورده بود	I tried to persuade myself than an obscure feeling of revolt had been gradually coming to a head in his slow mind
قرار نیست بابت اینکه بیرون باشی بهت پول بدهم	I'm not paying you to do whatever it is you're doing out here
با یک خیز از چپر گذشت و ناپدید شد.	cleared it at a bound, and was gone.
حتی عقلت نرسید که حروف اول اسم خودتو برای اون دو تا اسم مستعار به کار نبری	what a poor plotter, without even the brains not to use your own initials in getting up those fake names you had hoped to masqueradeunder
من هم ون جا نشسته بودم و منتظرش ون بودم.	I was sitting there waiting for them.
سرانجام چمدان از پنجره بیرون رفت و بر روی صندلی عقب اتومبیل افتاد.	it slid out of the window into the back seat of the car.
زیرا برای وی مسلم شد که همه اطرافیانش امید شنیدن خبر مهمی را از دهان او دارند	for it appeared to be plain that everyone expected something of him
فوراً از جا جست و به اطراف نگریست تا ببیند که صدا از کجاست.	rising up startled, he listened and looked in the direction the noise came from
جدا از دیگران روی نیمکت کوتاهی که پشتی مقوایی سبز داشت نشسته بود.	to the back of which a piece of green cardboard was glued.
بعد صدای سنگین افتادن چیزی به گوش رسید و در پس آن صدای آهی آکنده از خستگی.	then there was the sound of a heavy fall, followed by a weary sigh.
ممکن است در تمام جهان من تنها کسی باشم که حقیقت را دوست داشته و صادقانه بخواهم نیکی کنم	I am perhaps the one man in all creation who loves the truth and genuinely desires good.
هری تای روزنامه را باز کرد و شروع به خواندن آن کرد.	unfolded it, and read it
که جای دور افتاده عاری از تمدن بود و هیچ موجود متمدنی در آن ساکن نبود.	a savage, solitary place where no civilized creature resided.
دوزش را که هنگام خوردن صبحانه به روی پایش گذاشته بود و از سر گرفت.	she had kept on her lap during breakfast.
اما همین که صدای خشمگین مادرشان را شنیدند کز کردند	but as her rage broke over them.
نزد یکی از همکاران خود شتافت و او را با خود آورد.	he ran and fetched a colleague.
برای ارائه دادخواست و چکیده پرونده به دادگاه استیناف یک سال و یا دستکم ده ماه فرصت داشتند.	that there was anentire year or at least ten months before it was necessary to filethe record and the briefs in the case.
از قرار معلوم خودتان از همه چیز خبر دارید.	you seem to know as much as I do already
حتی هرگز میل به انتقام در من نبوده است	I never particularly desired to avenge myself even
پس از صرف غذا فورا به اتاق خود رفت.	retired to his apartments directly after dinner.
بعد از این همه فداکاری که برای ما کرد !	after all she's done for us!
از شاخه غربی خاندان گریفیث ذکری به میان آید.	there lay a deepobjection to bringing on any member of this western branch of thefamily.
باز هم اثری از هیچ والی پدیدار نشده بود.	yet not a single jet was descried.
اونها مثل گرگینه های واقعی نسل خودش ون رو با آلوده کردن دیگران ادامه نخواهند داد	they do not continue their species by infecting others the way true werewolves do.
تا این آپارتمان را برای مستأجر بعدی قابل سکونت کند.	she has to render this flat habitable for the next tenant.
که به نظر او من نه تنها لیاقت همسری بلکه کلفتی پسر او را هم ندارم	that he would think I was not fit to be even a servant to his son, much less wife?
که قبلاً به سبب کم توجهی در نظرش بی اهمیت بودند.	through his frivolous attitude to them, seemed of no importance,
که عبارت باشد از فرو بردن انگشتان مقدس و مبارک خود در قدح شیر نارگیل قبل از آنکه آن نوشباه به دور درآید	that is, dipping his consecrated and consecrating fingers into the bowl before the blessed beverage circulates.
زیرا سر سنجاق از پیراهن و کمربند شلوارم گذشت.	the head of the pin passing between my shirt and the waistband of my breeches.
انتظار نداریم مردم از آنچه غیرعادی نیست عمیقاً متأثر شوند.	we do not expect people to be deeply moved by what is not unusual.
دوست وفادار بود درمیان مجرمین همان قدر نادر است که در میان سایر طبقات مردم.	who could be trusted to stand by any one who was kind to him was as rare among criminals as among any other class of men.
در آن از من خواسته بود به خانه بازنگردم.	telling me not to come home.
هرگاه قصد دیدن جاویدانان را داشته باشم با کمال خشنودی مرا نزد آنان خواهد	he was glad of any occasion to keep me among them
دل و اندرونش را تکان داد تا روی پوست بیفتد	shook out the intestines onto the skin
توسط مرد باریک و لاغری که دستمالی بر چشم خود بسته بود و زیر تختش پنهان شده بود	by a tall man with a black patch over his eye, who had concealed himself under the bed
همین جبن ذهنی و اخلاقی بود که نگذاشت تا صریحا به ربرتا بگوید	from saying outright that hec ould not
شمع از آن بیرون برای آن است که نشان بدهد آذوقه را کجا باید ببریم.	his light out yonder is to show the spot to which to bring it.
بعید است که تا صبح بتواند نحوهی اجرای آن را بیاموزد.	he'd have a real job mastering it overnight.
تحولی رخ داد که سبب شد تا کلاید نزد خود چنین نتیجه بگیرد	a thing happened which caused him to think
کارت رایت هم غالباً تو را زیر نظر داشت تا در جریان همة امور قرار بگیرم.	so that I was able to keep my hand upon all the strings.
در این کت با برای همه گونه اشخاص لباس متناسب به حال ایشان پیش بینی شده است از جمله برای مرد حسود و برای عاشقی که مورد بی مهری معشوق قرار گرفته باشد و مرد فراموش شده و مردی که به فراق مبتلا است لباس وجود دارد و این البسه چنان به قامت ایشان برازنده است که حد و وصف ندارد.	I give the jealous, the rejected, the forgotten, the absent, what will suit them, and fit them without fail.
که لگن ادرار خود را از بالکن روی سر خاطرخواه نامطلوب خالی کند.	who emptied their chamber pots on the heads of unwanted suitors.
بسیار مایلم که اقلاً یک بار ایشان را ببینم.	I should like very much to see her once more.
من سه تا خریدم انتظار چنین واکنش پر شوری را از تو داشتم!	I bought three anticipating your less than enthusiastic reaction
پیش از این واقعه دیری بود که من از ین تصمیم بیم داشتم .	I had been long afraid of this resolution
در آنجا به جز یک پزشک پیر طبیبی نبود.	where there was only one old doctor.
26 نه متکبر و خودخواه است و نه حیله گر و مکار	26. he is not proud and selfish nor ostentation
این باورنکردنی است که او در نظر تو مرد محبوب و دل پذیری جلوه کرده باشد.	that you consider him an agreeable person!
به سنگینی پائین آمد و پاکشان خود را به محل گمرک کشید.	he got out heavily and dragged himself to the customs
از راهرو خود را به پلکان رساند و بالا رفت.	up the corridor, and back upstairs.
ولی توی آفتاب و هوای گرم نمی شه باهاشون راه رفت.	but they ain't no shoes to go walking around in on a hot day.
که برای تأمین امنیت شخصی او ضرورت دارد فلج ساخته است.	men required to secure his personal safety
خود او و رفتار او در خور تماشای غیر معمول بود.	he and his ways were well worth unusual regarding.
کلاید دارو را پراخت و از آنجا بیرون آمد.	clyde paid and went out.
پدران و همسرانشان در پی یافتن کار آواره بودند.	fathers and husbands had gone tramping.
که چگونه و به چه ترتیب خویشتن را در آن وضعیت عجیب یافت.	how he came to find himself in the peculiarsituation in which he did find himself.
مجبور بودم به میز چنگ بزنم تا خودم را روی صندلی نگه دارم.	I had to grasp the table again to keep myself in my seat.
من از این عواطف بسیار خوب آگاهم و آن را گرامی می شمارم.	I understand them so well and have the greatest respect for them.
در اینجا مادرم با گریه افتاد. این گریه ناشی از احساس محبت و مهربانی بود. سرشک بر رخسارة او جاری شد .	he takes,' said my mother, with the tears which were engendered in her affectionate nature, stealing down her face,
هر علت یا سلسله عللی که جداگانه بررسی شود	each separate cause or whole series of causes appears
که با مویی چون موی پدر سیخ شده پا به فرار گذاشت.	that he made off, with his hair as stiff as his father's.
من واقعاً متأسفم که سال آینده او را از دست خواهم داد .	I shall be very sorry to lose him next year,
زیر وزن شیفونی که به ناگزیر خریده خم شده بود.	dragged down by the weight of the crinoline which she had submissively adopted.
گفتم که قطعاً خبر را به او خواهید گفت.	I was saying that of course you will break the news to her.
آنا به نیمکتی که در کنارش قرار داشت نظری افکند و ورانسکی فوراً آنجا نشست.	she glanced towards the sofa beside her, and he instantly sat down.
اومی توانست ازا دانه در مزرعه قدم بزند و از هوای تازه ان استفاده کند.	free to walk around the farm and breathe the fresh country air
این بار سعی کردم بدون نفس عمیق کشیدن خودم را آرام کنم	I struggled to calm myself without the deep breath this time.
دوست جوان را که بر سر میز نهاده و خفته بود تنها گذاشت و رفت.	leaving his young friend asleep, with her head upon the table.
با این کلمات از یکدیگر جدا شدیم و هر کدام به راه خود رفتیم.	with these words we each went our separate way.
هنگامی که نگاه کرد و دید که سایه از آن چه کسی است	when she looked up and saw what caused it
او تاکنون آن را دو بار تجربه کرده بود.	she had watched beside a couple.
متوجه شدم که چشمان آبی همیشه مراقب او به من خیره شده.	there I found myself under the influence of the ever watchful blue eye.
دخترش باید از او فرمان ببرد و اطاعت کند.	he be obeyed.
اما چشم از او برنمیگرفت و منتظر واکنش او در مقابل این خبر بود.	but she did not take her eyes off him, watching how he would take it.
تمام عظمت شاهی را از دست داد و بی آنکه خود متوجه شود	fast his royal dignity instantly forsook him, and without noticing it
همان کسی را که چندین بار در شب از در پشتی خانه پذیرفته بود.	whom she had often received in the middle of the night at the back door.
من خودم حاضر نبودم و از راه شایعاتی که بود به این مطلب پی بردم.	though I personally did not witness her exploits, I learnt of them later through report.
به این دلیل بود که راهش دورتر نشده بود.	it was probably because it was the most convenient.
ناگزیر بود در ساعات مقرر داروی تجویز شده را بخورد.	to know that she had to take medicine at certain hours
به او بگو قضات و دیگر مأموران را بردارد بیاید اینجا.	tell him to pipe all hands magistrates and sich
همین که به شرح و تفصیل چگونگی زندگانی خود پرداختم خواننده را از ین ماجرا آگاه خواهم کرد.	as the reader shall know hereafter, when I come to treat more particularly about my way of living.
در زبان خود لغتی برای این عیب و ننگ ندارند	have no name for this vice in their language
از همان شب اول تو را به جا آورده بودم.	I recognized you at once, that first evening.
همین که متوجه شد که او از سخن گفتن بازمانده است	when he found he had finished
از پا درآوردن یک غول غارنشین سه و نیم متری یکی از همین حوادث بود.	knocking out a twelve foot mountain troll is one of them.
سرانجام همه آنان یکی پس از دیگری بیرون آمدند	the men came out again, one after another, on the road
پس از صرف چای در بستر خواب دراز کشید.	when he had had his tea he went to bed.
ذر تعطیلات آخر هفته قرار است در آنجا از میهمانانم پذیرایی کنم.	I'm having a few friends down for the weekend
از پذیرفتم پولی بیتشر از طلب خودم امتناع کردم.	I declined accepting more than was my due.
لازم نبود تمام جیبم را برای پیدا کردن شش پنس زیر و رو کنم.	I didn't have to put my hand in my pocket for sixpence.
بعد هزار و پانصد فرانک و همه را چنان آسان داد.	then fifteen hundred francs, all with equal readiness.
تا آن موقع باید این دکتر را گول بزنیم	till then I'll gammon that doctor
دریافت که در تنهایی و انزوا گم شده است.	he found himself lost in solitude.
مشارالیه دستمال از پیش چشم دور نمود و به مجلس نظر کرد.	he did so immediately
البته برای آنان در مقابل خدا دعا خواهم کرد	I will pray for them.
به خوبی توجه داشت که زندگی دخترش بسیار دشوار است.	his daughter that her life was very hard
که بدانم او قادر نیست گواهی خلاف واقع علیه هیچ کس بدهد	that he is incapable of bearing false witness against anybody.
از پس صدای موتور ماشین. صدایی از جنگل پشت سرمان به گوش رسید.	I heard a noise over the purr of the engine, coming from the forest behind us.
اما داگو که به یک دست ابزارهای سنگین را به چنگ گرفته بود	but with one hand holding on to the heavy tackles
اما خواهش کرد تا منگولة شبکلاه او را تکان دهم.	but he begged me to shake the tassel on the top of his nightcap,
فقط کتاب را باز کرد و جلوی خود گذاشت و با نگاه خود به دخترک رؤیایی خیره ماند.	but sat with the book open and his eyes fixed on the illusory maiden
او مهربان بود سر او مکان راحتی برای ماندن بود.	she was kind her head was an easy place to be.
به مادر از این بابت چیزی نخواهم گفت اما دربارة تو مدام صحبت خواهم کرد	I shall tell mother nothing _of this_, but I shall talk about you continually
اما اینجا نشستن و خستگی در کردن یا رو زمین خوابیدن	but setting here resting or sleeping on the ground
غیر ممکن است که کسی بتواند تابلویی از این موزه بدزدد.	it is impossible for anyone to steal a painting from this museum.
هرچند چهار تغار جو نیز سرانه به من بدهد!	even if I got four bushels of barley to boot.
اما ذهنش بار دیگر مشغول چیز دیگری شده بود	but his mind was turned away again
اول تصور کردم یک جن قهقهه زن کنار تختخوابم ایستاده	I thought at first the goblin laugher stood at my bedside
آن قدر پول خواهیم داشت که تا پایان زندگی خوش باشیم و با دست و دلبازی خرجش کنیم	to roll in, to play duck and drake with ever after.
فکر تام هم به سراغ روزهای گذشته و یادبودهای خیالی رفت.	his thoughts wandered away to bygone times and dreamy memories.
حدس زدم که بدون قصد از من دعوت نشده بود	I guessed that I had been asked to come at just that time not without intention.
یا بهتر بگویم افکار من تنها آینه کوچکی از دنیای وسیع اندیشه او هستند	or rather, he thinks a whole world of which my thought is but a poor twopenny mirror.
دیروز اینجا بود و یک لیوان از این نوشیدنی سفارش داد اصرار کرد.	ordered a glass of this ale WOULD order it
یک نفر با صدای کش دار و خرسندی از پشت سرش آن گفت	said a drawling voice from behind them.
دامبلدور من نمی دونم تو و استادهات چه خیالی دار ین.	I don't know what you and your staff are playing at
این استنباط از اینجا برایم حاصل شد که با احساسات و عواطف مادری با انگشت به من اشاره کرد تا از دیوار دلیجان بالا روم	I think so, because she beckoned to me to climb up, with quite a new and motherly expression in her face,
شاید آنچه را که درباره او تصور کرده و شنیده است یکسره نادرست باشد.	how all he had thought and heard of her might be false.
برایم دشوار است که بگویم شخصی در آینده چه خواهد کرد.	what a man may do in the future is a hard question to answer.
لیکن تو تمام تعهداتی را که در برابر تمایلات شرافتمندانه من به گردن گرفته بودی زیر پا گذاشتی و	but thou, casting behind thee all thou owest to my true love
در واقع توضیح به نظر خوبی به ذهنم رسیده بود.	I actually had come up with a perfectly sound explanation.
که عمدا او را به دقت تمام پاره کرده بودند	purposely torn in half
تنها در این صورت است که سرداری شجاع و جنگی خواهد بود.	only then will he be a brave leader.
کنت به زن نقاب دار خطاب کرده و پرسید	said the count to the veiled woman
پنداشتی همه ایشان در این انتظار بودند تا بتوانند مفهوم این انعکاس حریق را دریابند.	it was as if they had all only waited for this to realize the significance for them of the glow they were watching.
زیرا پاداش دادن به گروه اول با تفویض مناسب و مشاغلی است	for the former may be remunerated by giving them places
من تا سه روز دیگر نتوانستم کاخ را ببینم.	I was not able to do till three days after.
پنج شش بار درست از برابر کله گربه گام زنان گذشتم	I walked with intrepidity five or six times before the very head of the cat
با این حال زار ناگریز شد خرش را بگیرد	but with all his pains he saddled his ass,
من پیرم و بدون تردید چیزی از عمرم باقی نمانده است.	I am old, and, no doubt, have not much longer to live.
نیروی پرشکوه عشق ورزی را در خود پیدا کن و به کارش گیر	find and use the magnificent loving power within you.
به نظر من هم ون بهتر که دنیا از وجود این جور آ دما پاک به شه.	the world's better off without them in my opinion
کیسه چرمین را چنان جنبانده به صدا در آورد که گویی از سکه طلا انباشته بود.	jingling the leathern bag, as if it were full of gold coins.
من پوستم را هم رویش خواهم گذاشت ولی دوباره خواهم برد.	I cannot rest until I have won back my losses.
آه معجزهٔ جانی که لطف ایزدی در یافته است!	the miracle of the soul touched by grace
که در اثنای یک ماه برای دومین بار بود	for it was the second time within a month
تصمیم گرفت هر چه زودتر خانهٔ آن شخص را بیابد.	the prince decided to go and look for the house he desired to find.
نه مایلم و نه جرئت دارم که به تنهایی مصاحب وی باشم.	I had neither the nerve nor the will to be his companion alone.
هیچ کس جرأت نخواهد داشت وضع نامطلوبی را برای شما فراهم آورد.	if only you will allow me to act as your escort.
من که محال است بتوانم این جا زندگی کنم.	I couldn't live in it for a moment.
اما در اون موقع کار دیگری از دستم ون برنیومد.	but we couldn't do anything more for you at the time.
فقط شور و هیجان سیاسی داریم آن هم فقط گاهی.	we have political passions sometimes.
من بایستی به حکم تجارت ممتد زندگی دانسته باشم	because I ought to have known well by long experience
آن هم نه روی نشیمنی نرم و راحت بلکه روی نوعی زین و با کلاهی مردانه.	not in the chair seat, but upon a sort of saddle, and a man's hat on her head.
سپس کلیدی را از جیب بیرون آورد و در را باز کرد.	produces a key and opens a door.
بلناپ و جفسن ضم نا به طور سربسته مدعی شده بودند	intimating that the undue haste of
تقدیر چنین خواسته بود که آن روز باران دلاک را در راه بگیرد	but as luck would have it, as he was on the way it began to rain
اما سبک آن کسل کننده است و همان بهتر که رهایش کنیم.	but the style is tedious and may well be dropped.
به همین دلیل بود که من قادر نبودم چشم از روی آن امواج تیره بردارم.	the unknown things that lay beneath.
او چهار دست و پا روی زمین نشست و سرفه کرد.	he hit the field on all fours ' coughed
همان قدر از عشق و علاقه به یکدیگر فاصله دارند که هر دو آدم دیگری در دنیا دارند.	they are as far from any attachment or admiration for one another, as any two beings in the world can be.
این رؤیای خوش تا هنگام رسیدن به خانه تابوت ساز او را ترک نگفت.	which served to occupy his mind until he reached the shop of the undertaker.
نمی تونستم جلوی دردی که ناگهانی و آزاردهنده تو وجودم پیچید بگیرم.	I couldn't help the pain that shot through me in a sudden, stabbing burst
یک پنچ دلاری طلا توش هست. ورش دار و برو.	get that five dollar gold piece out and go to town.
زشتی را زیبا سازد به آراستن و مشاطگی وی پرداختند.	firm conviction women have that dress can make a face pretty.
به مردم می گم چرا این کاکا سیاه لعنتی رو نمی برین تو حراج برفوشین.	I says to the people, why ain't this nigger put up at auction and sold?
اما چون صدای اربابش را شنید دامن پا چینش را بالا گرفت و به جای خود برگشت.	but hearing her master's voice she turned back, pulling down her tucked up skirt.
سعی داشت که از دیدگاه مادرش به این پرسش بیندیشد.	tried to think with her mother's mind about the question.
چیزی است که به تنهایی از چهار شهر بهتر است و حتی بیش از مقام و منصب چهار قاضی درباری ارزش دارد.	better than four cities or four judgeships at court.
خب پس با این ترتیب شما و هم شوهرتون باید قدر تأمل کنید.	I think you two should really consider very seriously before you go further in this matter.
چون جاشو ان پارو بزن من برای کشیدن قایق خیلی قوت دارند	for I have a devil of a boat's crew for a pull on a whale line
سپس صندلیش را عقب کشید و از سر میز برخاست.	he ejaculated, and, pushing back his chair, he rose from the table.
دست گرم و نوازشگر خود را روی آرنج کلاید گذاشت.	laid a warm and caressing hand on his elbow.
بعد به همان اطاقی که از آن بیرون آمده بود بازگشت.	he returned to the chamber he had just quitted.
من از زن و پسر و دخترم و ایشان از من اشگ ریزان جدا شدیم.	I took leave of my wife, and boy and girl, with tears on both sides.
به همین خاطر بد نیست با کمی خواندن تمرین را شروع کنی.	to that end it were well to begin with a little reading.
زیرا از این قبیل موارد زیاد دیده شده است	for instance there had been such cases.
من دل به دریا زدم و نام چند چیز را به زبان آنان پرسیدم	I made bold to ask the names of several things in their language
گمونم بهتر جون ورا رو راضی نگه دارم و به را خودم دردسر درست نکنم.	I reck'n I better keep de animals satisfied, en not have no trouble in de house.
در چشمان درشتش علامت ترس و نومیدی ناشی از ضعف و بیچارگی ظاهر شده بود.	his large eyes were wrought into an expression of frantic, powerless fury.
هرمیون این را گفت و با عصبانیت به طرف خوابگاه دخترها شتافت.	she stormed off toward the girls' dormitories again.
اما من در این رضایت با وی شریک نبودم.	but I could not share his satisfaction.
به عنوان مساعدت با پیرمرد به دنبال اولیور راه افتادند.	too, joined in the pursuit like good citizens.
یک گوشه ساختمان است که خود بر آن تکیه کرده است.	decoration of a building againstwhich it was placed.
یک مجلس سنا متعلق به دوران معاصر نیز روبروی آن در تالار دیگر ظاهر گردد.	an assembly of somewhat a later age in counterview, in another.
مطمئنم که به زودی از او با خبر خواهید شد.	I'm sure you'll be hearing from him.
گفته بود که بیماری مریض بسیار شدید و خطرناک است	pronounced her disorder to be one of a most alarming nature
با جاشو ان خود به دریا افتاد و اندکی بعد در کنار کشتی بیگانه بود.	he and his crew were dropped to the water, and were soon alongside of the stranger.
که در پشت میز کوچکی که دورش نرده کشیده بودند نشسته بود.	to a small railed off desk at which sat a short
دیشب رفتم خونه اش راجع به جلسه باهاش حرف بزنم	I went over to tell her a little about the meeting last night
در ناگهان گشوده شد و دو پیکر سر آسیمه به درون آمدند	when his door suddenly opened, and two figures rushed in
ولی همه باید بدانند که این گناه مشترک بوده و تمام عالم بر این اساس قضاوت خواهد کرد.	still we must not fail to see that this sin was mutual and that the world should know and judge accordingly.
که اگر فوران وال درست در چشم کسی بریزد او را کور خواهد کرد.	that if the jet is fairly spouted into your eyes, it will blind you.
که برای اطمینان از چگونگی وضع میدان نبرد به بازدید به جبهه برود.	that they should ride along the line to ascertain the position of affairs.
انسان مذکری که هیچ جذابیت جسمی برایم نداشته باشد.	a male human being without any physical significance for me.
رز ماری هم که مطیع احساسات پاک خود بود	so far as her virginal emotions went
ستمگری فرمانروایان گذشته که هیچ کس در آن تردیدی نداشت خسته کرد.	from the admitted wickedness of pagan despots.
بغضی راه گلویش را بست و چشمانش پر از اشک شد.	, there was a catch in his breath and a lump in his throat, and his eyes began to shine with tears.
آن وقت من چه خواهم کرد از گرسنگی و تشنگی	I am cold I am hungry
دختران نظیر او بسیارند که من هنوز با ایشان آشنا نیستم	many more such girls somewhere whom I do not yet know.
یکی از آن دو شب کلاه سرخی بر سر داشت	one of them with a red cap
آن چیزی را دید که قبلاً به آن توجه نکرده بود	instantly perceived what she had never noticed before
که باران بند آمده است و باید شب را در ارابه خفت وگرنه تمام اشیاء ما را خواهند ربود.	that the rain had ceased and they must go to sleep in their covered cart, or everything in it would be stolen.
به نظرم به جای شعور مغزم پر از آن بود.	I suppose it served instead of sense to fill up my mind?
چون حس کرد که تشخص و لجاجتی بیش از آنچه کلاید در او سراغ داشت	for in saying so much she had exhibited more individuality and defiance than ever he had seen or that
نیمی از کاغذ را هم با این کار از بین برده بود.	taken half the paper with it.
به اتاقم آمدم تا فنجانی چای به راحتی بخورم.	I went back into the drawing room and had another cup of tea which I thoroughly enjoyed now that the burden of entertaining had been taken from me
ببین که از صبح تا به حال چه چیزها سر هم کردی که هیچ کدام سرو ته نداشت!	what a lot of things thou hast strung together, one after the other, without head or tail!
تا احساسات لطیف و نیکوکارانه خود را در آن خواب کنم.	sealed it up, forever, on my best affections.
مثل یک گردباد مرا با خود کشاند و به دایه خانه برد.	swept me like a whirlwind into the nursery
اما بدون دید و در نتیجه خلوت و هیچی محض بود.	but without an object to colour, and therefore a blankness in itself.
فریادی که نظیر صدای نعره گاو یا بوقی قوی بود برکشید.	something between a mad bull and a speaking trumpet.
چند سالی آنجا بودم آب و هوایش برایم مفید بود	I've been down there a couple of years living on the climate.
پدرش رسماً امور خانه را به دست او سپرد	her father delegated to her the authority to run the house
تا راه را خوب و مستقیم بپیماید و به شکار رسد سر خم کرد و به تفکر پرداخت.	who puts his nose to the ground to make sure that he is on the right scent.
لیکن او به زودی بر اعصاب خود تسلط یافت	but next moment he was master of himself.
سپس به آن دو گفت که فوراً به قلعه بازگردند.	insisted that they go back to the castle.
حال به سبب تداعی عجیب معانی سعی داشت او را تبرئه کند.	now by some strange chain of reasoning he was justifying her
مگر از بسیاری غم و اندوه و درد و رنج.	except he were incited by the extremity of grief or torture.
که به پاس آن عشق بزرگ به کلی فراموشش نکرده است.	that because of his great love for her she desired him to know that hewas not entirely forgotten.
عدهٔ کثیری از آشنایان دیگر در پیرامون وی بر روی تراس گرد آمدند.	but several people called to see the prince, and assembled in the verandah.
من خودم برای خودم دم و دستگاهی دارم اما این دیگر در مطبوعات عامه به چاپ نرسید.	I've got a bar of my own, but this did not appear in thepublic prints.
از شما چیزی را که بسیار لازم است برای حفظ آسودگی ملتی	some particulars connected with the public safety
از ماشین پایین آمدم و شروع به قدم زدن کردم.	I got out of the car and walked.
یکی از آنان مشعل را به دست گرفته بود	one held the light
پس معلومه که هنوز می خوان با تو دوست با شن.	still seem to want to know you
اما نتوانستیم آن را کام لا از افکار بزداییم.	we were not able to suppress it entirely in ideas.
فقط باید از یک علف زار سبز کوچک عبور کند تا به پلکان رسد.	she had still to cross a small lawn to regain the steps.
بنابراین باید مجددا یک نمایش مجانی برپا شده باشد.	so it must be a free show again.
اما برای من خیلی جدی است خیلی خیلی جدی است.	but to me it's so serious, so intensely serious.
ناگهان احساس کرد میل دارد با صدای بلند بخندد	he was divided between the impulse to laugh aloud
با لشکری جرار به کشور من حمله خواهد آورد و سرتاسر مملکت را وجب به وجب از دست من خواهد گرفت	would overrun my kingdom with a mighty force and strip me of all,
آن روز صبح را در منزل مشغول تحریرات خود بود تا وقت رفتن به مجلس رسید.	, and had passed the morning in writing letters and in trying a horse
به جای آن مرگ وحشتناک که پیش روی ماست	instead of despatching us by that horrible death
چه طور ممکن است تو از چیزی خوشت بیاید یا خوشحالت کند	I can hardly imagine that any thing which pleases or amuses you
دیگر شما به من ضعف مرا ملامت نخواهید کرد.	you shall not have to reproach me with weakness.
من که دیگر برای همیشه حسابم را از تو جدا کردم.	I'm done with you forever.
زیرا جرأت نداشتم که به همان خشکی که در آن فرود آمده بودم باز گردم.	for I durst not return to the same landing place
اما انقلابیون از حقایق پشت پرده کاملاً اطلاع داشتند	but the revolutionaries knew the truth
ما حتی راجع به مفهوم کلمه عشق با هم توافقی نداریم.	the very name of love is an apple of discord between us.
قیافه سرد و خشمناکی به خود گرفت و به استقبال پدرش از جا برنخاست.	then her face resumed its cold and malevolent expression.
ولی به شرط آنکه این کار فردا انجام بشود.	but on the condition that the thing is settled to morrow.
ولی مطمئن بود که اگر فرصتی به دست بیاورد برای خیانت کردن به او تأمل نخواهد کرد.	but she was sure that given the opportunity, he would not hesitate to double cross her.
کمربندش را گره زدو نفسی عمیق به درون ریه های نیرومندش فرو داد.	tied the tassels in a knot, and, drawing a deep breath of air into his broad, bare chest,
افکار ناتمام و عجیب و غریب و بی موردی	all unfinished ones, and strange, funny thoughts, very likely!
در توانایی کسی جز من نیست و وقت را نباید از دست داد.	is within the power without loss of precious time of scarcely any one but myself, if any one.
لذا خنده کنان بدو گفتم که حاضرم کمکش کنم تا سر و صورتش را تمیز و لباسش را مرتب کند.	so, laughing, as I durst not laugh when the master is by, I offered to help him, if he would, and joked at his confusion.
حتی اگر کسی این میوه را مشاهده نکند یا کسی صدای تو را نشنود.	even though no one has seen or heard you in your solitude.
او رفته بود میان شاگردهای خوب تحقیق کرده بود.	he had been around among the star pupils inquiring.
هرگز کسی دیده نشده است که با چنین نشاطی شکست بخورد.	I've never seen anybody lose a cause with such absolute delight.
اقوام و آشنایان بی شمار من نیز مطالبی را به زبان خواهند آورد که موجب تأسف این آقایان قضات خواهد شد و آرزو خواهند کرد کاش به این دنیا نیامده بودند	so will a wery numerous and 'spectable circle of acquaintance as'll make them beaks wish they'd never been born
سری به من تکان میدهدو ما با هم به درون آسانسور خواهیم رفت.	nod to me, and we'll go into the lift together.
دیری نگذشت که صدای حرکت و فریاد جمعی لوسی را به هراس انداخت	for presently she heard a troubled movement and a shouting coming along, which filled her with fear.
اما بی درنگ فریادی که از طرف دیگر میز برخاست توجهش را جلب کرد.	but his attention was immediately diverted by an exclamation at the other side of the table.
اگر چنانکه حضرتعالی گفتید این شباهت بر اثر سحر و جادو است	if that be enchantment, as your worship says
مطمئن باشید شهرت و نام حتی اگر به اوج برسد	I assure you the utmost stretch of public fame
زمانی که درون انسانی آشفته باشد و جملة شعارمانند خون موجب طراوت است رایج باشد.	when the heart of man is troubled, when the phrase is quoted that blood 'renews,
به دعوت منشی آنجا به پشت نردة گیشه رفتم	by invitation of the clerk on duty, passed behind the counter
با چاپلوسی هرچه تمام تر به منظور همیاری در این استنطاق قدم پیش نهاده	he had come out with great obsequiousness to assist at this examination
اما برای هنرمندی که دروی آن نیرو نیست که بتواند خود را از آن بیرون بکشد کشنده است.	but fatal to an artist who has not the strength to break out of it.
با چنان ابزار کشنده و وحش تبار به درو کردن نفوس آدمی پرداخته باشد.	have gone a death harvesting with such a hacking, horrifying implement.
فوری رفت و این اخباری را که برایتان گفتم به چنگ آورد	he hurried off to where he heard this
ولی هم مادر و هم عمو هر دو با او مخالف بودند	but neither his mother nor his uncle agreed with him
که در حال تبدیل شدن به اشخاص دیگری بودند	halfway through transforming into other people.
ولی نو مسلمان با تمام این پیشنهادها مخالفت کرد	but to all this the renegade objected
پس از آنکه خود را بدینسان مسلح کردم بر رغم تیرهای دشمن بکار خود ادامه دادم.	thus armed, went on boldly with my work, in spite of the enemy's arrows
کشتی را با بیانی هر چه نیکوتر بر او وصف کردم	I described the ship to him in the best terms I could
ممکنست دست خود را به خون بیالاید ولی نه به خون تو.	it's not you he'll kill!
چون کسیکه از مشاهده قیافه این مردم امیدواری پیدا کند	rendered more hopeful by the expression he read on the faces there
تا آنجا که در آمرزش این نجیب زادگان جوان مبنای عنوان کردن مکرر این پند گردید که	which he afterwards turned to account in the training of the young gentlemen
جناب وای کانت و همسرش اطلاعات لازم را در اختیارش گذاشتند.	they were qualified to give.
تا این لحظه در مورد شما در جهل کامل بودم.	I have been in a most complete error with respect to your views,till this moment.
سگان را به دنبال خرگوش هدایت کرده به تعقیبش پرداختند.	calling in the hounds galloped across the field setting the borzois on the hare.
از همه شما برای خدمات دشوار و صادقانه سپاسگزارم.	I thank you all for your hard and faithful service.
رویه مرفته مادام و که و را پسندیده بود.	she considered him to be a very gentlemanly and pleasant looking man.
با سر برهنه اندکی دولا شد و با جوبدستی کلفتش سعی کرد خود را متعادل نگه دارد.	kept his head uncovered and stooped slightly, propping himself up with a thick stick.
آن قدر اسیر شرافت نبود که خودش را هم با قایق غرق کند.	he did not consider himself bound in honour to sink with the treasure.
پس امروز باید خیلی مراقب باشید و حواستان را خوب جمع کنید.	so let us all try to be especially careful and clever today.
در هر صورت همین که آن توده سفید را به طور مشخص به چشم دید	whichever way it might have been, no sooner did he distinctly perceive the white mass
که اجرای این دستورات تاکتیکی که به فرض مشخص بودن مواضع دشمن تنظیم شده بسیار دشوار است	how difficult it was to carry out such a plan in which the enemy's position was assumed to be known
با علائم و اصوات خود به من چنین فهماند	by certain signs and sounds gave me to understand
خاصه از این نظر که عمو ما با بالاشف در تمام دوران خدمت محترمانه و مؤدب رفتار شده بود.	still more this disrespectful, application of brute force to himself.
در این موقع زندانبان دست خود را روی بازوی او گذاشت	when the jailer put his hand upon his arm
هری الان که از همه چیز بی خبره خیلی راح ته!	he's happy not knowing!
متاسفم که تو را درگیر همه این مشکلات کردم.	I'm sorry to involve you in all this.
نغمه چون از دل برآید لاجرم بر دل نشیند.	he who sings scares away his woes
غوغای ناگهانی جمعیت که تازه اواخر دیروز سرکوب شد.	a sudden outbreak of the populace, which was not suppressed till late today.
او را دید که خم شد و بیلش را برداشت و زیر تل خاک فرو برد.	saw the latter bend overand grasp his shovel, which was sticking upright in the heap of dirt.
ولی باید قبل از این که شب از راه برسد حسابی دور بشویم.	but we must be far away before nightfall.
ای کاش فرصتی برای توضیح دادن به من دادی.	I wish you'd give me a chance to explain.
من حاضر نشدم بمانم و شاهد آن عمل وحشیانه شوم	I would not stay to witness the barbarous deed
الحق که این ستایش را از شخص من نیز نباید دریغ داشت	nor should it be withheld even from me
فکر کردم بهتر است تو را در جریان بگذارم.	I thought it right to tell you
دیوارشان را فرو ریخته بود توجه او را جلب کرد.	half the walls torn away stared at her, silent and dark.
دعای خود را تمام کرد و تا زمین خم شد و آهی کشید و روی کاه خود نشست	then bowed to the ground, got up, sighed, and sat down again on his heap of straw.
قبل از اینکه بفهمم چقدر نفسم بند آمده شروع به صحبت کردم.	 I started to speak before realizing that I was so out of breath that I could hardly get the words out.
دقیقاً به خاطر نمیارم که کی خاطرات تبدیل به رویا شدند.	I'm not sure where exactly the memory turned into a dream.
امیدوارم شما موقعیت مرا درک کنید و عصبانی نشوید.	I hope you understand my position and won't be cross.
زیرا که من مرده بودم آن وقتی که یکی از ملاحان از موهای من چسبید	I was lost when one of your sailors caught hold of my hair
چهار پنج تا معتاد هروئین توی اون خو نه هستن.	you've got four or five heavies doing up on heroin.
من که به طورم عمولی کاری با پلیس ندارم!	I never have anything to do with the police!
ژنرال چنان قیافه ای گرفت که گفتی سخنی نغز از مردی نکته پرداز شنیده و کاملاً به آن پی برده است.	the general looked as though he had heard a witty remark from a witty man, and fully relished la pointe de la sauce.
لب پا ینش را فشرد سرش را به سویی خم کرد	he tightened his lower lip and bent his head down to one shoulder.
می دون ستم او ذاتا شریف و با و قاره .	I know he is honorable and a gentleman.
اما این ایده اعتقادهای راسخ آغازین او را سست کرده بود.	but the idea shocked her early convictions.
هیچ کس به خوبی من فرصت تماشای او را نداشت.	no one had a better chance to observe him, as will presently be seen.
اگر درمانی هست با تمام قوا در صدد یافتن آن برآیم.	to search for you with all possible diligence, if search had been necessary.
چه جور ممکن است کسی به او بدگمان بشود	how he could be suspected
سرش را به یک طرف خوابانده و یک گوشش را تیز نگه داشته بود تا به صداها گوش کند.	her head on one side, and one ear pricked up to listen.
امیدی به نیک سرشتی آنان در دل نپروراند مگر اینکه پیشاپیش دلیل موجهی برای آن داشته باشد.	entertaining no expectations but such as were justified beforehand.
من لیاقت هیچ محبتی از شما و پدرم را ندارم.	I could deserve nothing from either.
اما ثروت را صرفا یک وسیله میدانست نه هدفی غایی و فی نفسه.	but he brought it forward as a means, not as an end.
بسته محکم روی پای هری افتاد و ژامبونش را به زمین انداخت.	knocking his bacon to the floor.
چون او نا در هر حال خودشو نو لو می دن.	cuz THEY go back on you anyway
بهتره همین الان بهتون به گم چون نمیخوام درآینده درگیری بوجود به یاد	I better get that up front because it might save a hassle later
اما اگه اون آخرین بار هیولا رو آزاد کرده با شه	but if he set the monster loose last time
این علامت نشانه آنست که وی هرگز نخواهد مرد.	which was an infallible mark that it should never die.
هزارها هزار را نیز با خوشی و سرور به میهن بازآورده است.	brought thousands upon thousands happily back.
اما او تمام پیراهن مرا با برف از بین برد.	but he had spoiled my whole dress with snow.
کمی مبتذلند اما حالا که دور تا عروسی کرده ممکن است هر چیزی بخواند.	they are a little broad, but she may read anything now she's married, you know.
ولی دخترک بدبخت سعی داشت خود را فریب دهد.	but the unhappy girl tried to deceive herself.
که مادیان را با اسب خودش به ارابه به بنده.	to harness the mare and his own horse.
واقعا شما چقدر خوبید که رفتید دنبال بچه من!	how good you were to go and get her for me!
آن زن گفته که تمام تریاکی را که پهلوی بولست رود گذاشته بودم و مقدار زیادی براندی به مریض داده.	she said that she gave the patient all the opium in the phial I left, as well as a good deal of brandy.
مردی که داخل پایانه ایستاده بود تلفن همراهش را بالا او رد و با ان گزارش داد.	a man standing inside the terminal picked up his cellular phone and reported in.
منظورم این است که مطمئن نیستم استعداد هنرپیشگی داشته باشم.	I mean, I don't know if I can act.
وقتی اون گرگینه گازم گرفت خیلی کوچ یک بودم.	I as a very small boy when I received the bite.
در انتهای پلکان پاگردی رسیدند که در آن هیچ چیز نبود جز یک نقاشی بزرگ از یک چمنزار خالی که روی دیوار سنگی نصب شده بود.	where there was nothing but a large painting of a bare stretch of grass hanging on the stone wall.
من به هر کسی که از من بپرسد این داستان واقعی را خواهم گفت.	I will tell anybody who asks me questions,this exact tale.
روز در رسید و هوا کام لا روشن شد و کوزت هنوز در خواب بود.	lt was broad daylight, and the child still slept.
خاموش به کناری رفت و از خود فریبی این آقای سالخورده متعجب گشت.	stepped silently aside, marveling at the old gentleman's conceited stupidity.
هنوز از شرم سرخ بود و لری میدانست برای چه سرخ شده بود.	she was watching what he was doing, and the high color in her cheeks.
چشمش به دو دختر لولی افتاد که آنجا ایستاده بودند	perceived the two gay damsels who were standing there
یه چیزی تو زندون یاد گرفتم که میخ وام بهت به گم	I'm a gonna tell you somepin about bein' in the pen.
احتمال بیماری او ما را به هم نزدیک کرد	the chance of his illness brought us together
ولی در نتیجه گذشت زمان صحتش تأیید نگردید به دست فراموشی سپرده شده است.	but have now been forgotten because the event falsified them.
خدمت آبرومند نیز همانست که انسان به چنین اربابانی بکند.	for that is the advantage of serving good masters
که این حالت از دل سنگ او معهود نبود	from the novelty of the sensation in the iron heart of that man.
خانه را نقد خرید و تعمیرات را بلافاصله آغاز کرد.	she bought the house at once and undertook a complete renovation.
به طور قطع خاطرات گذشته را از خود دور خواهد کرد	he would escape from old memories altogether.
صورتش درست مثل بستنی شاه توتی شده بود که آن را هم زده باشند.	making it look like badly mixed black currant ice cream.
برای هفت روز پیاپی نشانی از زندگی در او نبود.	show any sign of life for seven whole days.
من نمی تونم دی گه وقتمو واسه گریه کردن تلف کنم.	I won't waste no time a cryin
ولی از آنجا که خوشبختانه پیرمردی کم حواس بود	being, happily for himself, was an absent old gentleman
باید طنابی تهیه کند تا بتواند به خود ببندد و به قعر غار فرو رود.	it would be requisite for him to provide himself with ropes, so that he might be tied and lowered into its depths.
شکنجه آرامش سعادت بخشی را که مدتی بود از آن خبر نداشت احساس کرد	enjoyed a blissful feeling such as he had not experienced for a long time.
بلکه مثل کفر است که خائن را به جای دوست گرفت و گناه را مجازات خدمت داد	I said I looked upon it as a sacrilegious profanation to reward treachery perhaps crime
به قدری هراسان شدم که از فرار کردم و به باشگاه پناه بردم	I was so frightened that I ran off to the club room
هر شاهد خلاف آن را هم چه عکس و چه خاطره انکار کرده بود	arguing away any evidence to the contrary, photographs, memories
اینکه مجبور بودند زمستان را بدون پانزده سانت پشم سر کنند و با گرمای تابستان دوباره پشمشان بلند شود.	left to face the winter minus the five and six inch long fleeces they would have grown by the time summer heat arrived.
ممکنه امسال زمستون بتونم چند دفعه دی گه هم ببینمت.	I may be able to see quite a little of you this winter yet.
شاید گزارشی راجع به ان از تلویزیون پخش کنیم	I might do a segment on the air.
که آندو برای صرف قهوه و تمدد اعصاب در آنجا توقف نمودند.	where they stopped for a cup of coffee and to stretch their limbs.
تا جایی که دیگر حتی بر یا یک شیء جا نبود.	until there was no room left for another piece.
ولی او نو مجبور نکردن از برانکار استفاده کنه	but they didn't make him use a stretcher.
پروفسور دامبلدورو هاگ رید بلافاصله شروع به کف زدن و تشویق کرده بودند	who both put their hands together and applauded
او هر چه را که در دل داشت با سیلابی از کلمات بیرون ریخت	pouring out her soul in a torrent of words.
زیرا اکثر ساکنانش را زنان و کودکان تشکیل میدهند.	because the majority of the inhabitants were women and children.
ربرتا را ترغیب کرد که به خانه پدرش برود	he induced her to go home to her father's house
ولی هیچ یک احساس نکرده بودند که حق آنرا دارد که جلوی او رابگیرد.	but no one had felt he or she had the authority to put a stop to it.
رنج آور بود چنان پاهایی کشور را ترک کنند.	that such a pair of legs should leave the country.
در این مورد هیچ شک و تردیدی نداشته باشید!	that's the truth.
واقعاً جای تاسف است که کسی از آنان باقی نمانده است!	I am really sorry there is no one!
پس بجای آن فکر کردی که او را از پا دربیاوری.	so instead you thought you would knock him down.
ولی قبل از تصمیم گرفتن باید نگاهی به دور و برمان بی اندازیم.	but before we make up our minds we ought to look about us.
حاضرم همه چیزم را فدا کنم بلکه بِ بوتانم دلش را به دست بیاورم و او را از خودم راضی کنم.	I'd give anything if I could m make it up to her.
من در این هنگام درست حال یک قمارباز را داشتم.	I myself was at heart a gambler.
چون او برگشت و در آن حال احتضار به او نگاه کرد	as the man rolled up his eyes at him in the last agony
ناخدا در برابر چشمان حیرت زده عموم عقب جست و یکی دو بار روی عرشه به سرعت قدم زد	who, to the amazement of all hands, started back, paced the deck rapidly two or three times
او قبل از مرگ و حتی قبل از مرحلهٔ شدید بیماریش به این شهر انتقال یافت.	he removed just before his death.
به او شخصیتی بخشیده بود که در مقابل آن شاید معدودی بتوانند مقاومت کنند و او را دوست نداشته باشند.	to have carried a spell with him to which it was a natural weakness to yield, and which not many persons could withstand.
سه همنامی هستند که چند لحظه پیش در میخانه به میگساری نشسته بودند.	the three ofone name who had been drinking in the wine shop.
اگر تک ون نخوریم و یک کاری نکنیم که او نا نتونن فرار کنن یکی تو این قراضه بدجوری گیر کرده که ممکنه دخلش به یاد.	if we don't hunt up their boat and set her drifting down the river so these fellows can't get away from the wreck there's one of 'em going to be in a bad fix.
نگاه کردم و دیدم که آب از چندین شکاف به درون اطاق رخنه کرده	I saw the water ooze in at several crannies
بنابراین تصمیم گرفتم به شرق بروم و کار خرید و فروش اوراق بهادار را بیاموزم.	so I decided to go east and learn the bond business.
تبسم کردم و منتظر شدم تا از من بپرسد.	I smiled, waiting to be asked.
صبر کردم تا این که در حدود ساعت چهار اومدش کنار پنجره یک دقیقه ایستاد. بعدش چراغ رو خاموش کرد.	I waited, and about four o'clock she came to the window and stood there for a minute and then turned out the light.
آنگاه نظم و ترتیب کلمات به کلی تغییر یافت.	the whole disposition of the words was entirely changed.
مبادا این کار باعث بشود که خدا صاعقه به سرشان ببارد.	lest they might call down a sudden and special thunderbolt from heaven.
قیافه بسیار موقری گرفت و به اتاق پذیرایی رفت.	put on his most dignified air, and went into the reception room,
اما باید اعتراف کنید که یک در میلیون هم بخت با شما نیست.	but you must confess the chances are a million to one against it.
گوئی عجله داشت که هرچه زودتر آن را به پایان برساند.	he were in a hurry to get to the end of it.
زیرا که مرگ در حقیقت استراحت و آسودگی است	for is not the destruction of the vital principle
بنابراین آن قدر بچه نباش و ناله سر نده!	so don't be a baby and whine about it.
شاید از طنین صدای خود در تاریکی خجالت کشیده بود.	inhibited perhaps by the resonance of her voice in the darkness
من مردی پست هستم ولی از خودم راضی هستم.	I'm a scoundrel, but I'm satisfied with myself.
از اطاق صبحانه بیرون رفتم و از داخل اطاق نشیمن به بهار خواب رفتم.	 I went out of the morning room and through the drawing room to the terrace.
این دفعه نمی تونم ببینم که کجا داری میری.	I can't see where you're going this time.
با اندکی ناراحتی انتهای عصای خود را به دهان فرو برد.	the head of his stick into his mouth, with some embarrassment.
او پی برد که از او خوشش آمده است.	he realised that she liked him
امّا بدبختانه خود بود که این را دریافته بود	but unfortunately it would seem so only to himself
با این همه جناب آقای شاهزاده! بهتر است او را نزد خود نپذیرید.	most excellent prince, you had much better not receive him.
به خاطر این که به چیزهای دیگر فکر نکند.	so that he will not have to think.
من گمان نمیکنم فعالیت اجتماعی بدون مبتنی بودن بر پایه ی سود شخصی دوامی داشته باشد.	I imagine,that no sort of activity is likely to be lasting if it is not founded on self interest,
که آنجا بروید و باید شما را آنجا ببینند.	that you should be seen there
گو اینکه این روح قدرت داشت خود را وقف هدف واحدی ساخته و آنی از آن غافل نشود.	though enabled to fix itself steadily on one object, and resolved not to be turned aside by any consideration.
حالا از دفتر ایستگاه سؤال کن که پیامی برای من رسیده یا نه.	ask at the station office if there is a message for me.
گذشته از این در آن زمان من هنوز بیمار بودم.	but then, I was ill at that time, of course!
تمام خیال او رفته بود به طرف این زن دلیری	but he thought of that courageous woman
از این که یک شکاربان توانسته بود او و پدرش را فریب دهد عصبانی بود.	seemed outraged that he and his father had been outwitted by a gamekeeper.
بلکه چون دوست داشت به هر حال عملی را مخفیانه انجام دهد و از آن لذت ببرد.	but because she associated the pleasure with secrecy.
آنگاه یک پنج کو پیکی از جیب خود درآورد و در دست دختر نهاد.	took out a five copeck piece and put it in the girl's hand.
نیروی زندگی چنان شدت گرفت که او را بار دیگر پیش راند	life being now strong enough to bear her on again
سخنان مردی را باورمی داشت که زندگیش سالیان سال در نظر او متوقف شده	bearing of the man whose life always seemed to him to have been stopped, like a clock, for so many years
ولی پس از آن که برگردد دیگر تمام مدمت زمستان به جائی نخواهد رفت.	but that when he came back he would not stir all winter.
حقیقتش این است که بچه هم برایم اهمیتی نداشت.	I honestly didnt mind the child.
اما بار دوم کند و کاوی چندان در کار نبود.	but, the last spell of work was feeble and fitful.
وقتی برای اولین بار سرگذشتش را برم تعریف کرد.	a long time ago when he first told me about himself.
لبخند ژان وال ژان مبدل به یک قطره اشک شد.	the smile ended in a tear.
دیگر مراقب این بود که زیر دست و پای مردم نیفتد	he even began to avoid being crushed
مطالبی که وقتی کشف شد و آشکار گردید برای فکر و حافظه مردم پشیزی ارزش ندارد.	after they are known and proved, are not worth a farthing to the understanding or memory.
وی چند ماه پس از فرارش صاحب پسری شد	she had a son born a few months subsequent to her escape.
چون بلافاصله حس کرد که چشمان آنا با سوء ظن به او دوخته شده است.	because as soon as he uttered his mother's name he was aware of her intent, suspicious eyes.
بعد هم صدای صحبتی که کاملاً برایش مسموع بود بلند شد.	directly afterwards of voices almost close at his ear.
از پذیرایی گرمی که در خانه شما از من شده است کمال تشکر و امتنان دارم	telling him he thanked him for the kindness and hospitality he had received in his house
با وجود این همین یک کار از او ساخته بود.	yet it was all he could do to help it.
که وقتی با پای ساخته شده از عاج عاقبت به ساحل قدم نهاد	that when with ivory leg he stepped ashore at last
اولین بار که تورور دیدم به نظرم او مد که تو هم یه ذره مث خودمی.	when I firs' met you, you reminded me o' me a bit.
خود را مفلوک دید و از ای نرو چه بسیار گریست.	he felt his pettiness, and many a time he wept.
این با مزایای یک اقتصاد اجتماعی جدید جمع آید	this being combined with the data of a now social economy
هری به سمت در سمت راست رفت آهسته به جلو خمشم	leaned close to it, and muttered the password
در سیمای گندمی رنگش این بار اثری از مضحکه نبود.	she saw in it none of the skepticism, the jeering humor she knew so well.
من با دو دست خود طناب لنگر را که برای اطمینان بیشتر آن را بریده بودم	the cut hawser in both hands for a last security
مانند آن بود که جوهری غیر مرئی بر لب کشیده و اکنون آن را در مقابل حرارت آتش گرفته است.	like a mark in invisible ink brought to the fire.
به جز د رم واقعی که لازم بود چیزی تعمیر یا نصب شود .	except when she needed something mended or installed .
او موافقت خود را به این شرط موکول ساخته است که عروسی زودتر از یک سال انجام نگیرد	has made it an express condition of his consent that the wedding is not to take place for a year.
باید به گم که مجبوری مدت زیادی توی این کلبه به مو نی.	I'm afraid you will be in this cabin for a very long time,
بلند شد و همگی به دنبال او بیرون دویدند.	darted out of the house in pursuit of him.
در را که باز کرد مرا این جا دید!	when he opened the door, at seeing me here!
منظورم ای نه که حداقل باید سعیمون رو بکنیم	I mean, we have to at least try
همین که ناله پدر را شنید آهی عمیق کشیده به خود گفت که هنوز تغییری روی نداده است.	, hearing him groan, said to herself with a sigh that things were still the same.
البته در آن موقع من با زندگی شکوهمندانه و مجلل چندان آشنا نبودم.	but then I was so little accustomed to grandeur.
که مرا بزرگ خانه خودم ندانند و مرا مستولی و غالب بر تو نشمارند.	who has not treated me as the master of the house,
اما عاقبت دامن قبای مرا که از ابریشم آن کشور ساخته شده بود و بسیار ضخیم و محکم بود گرفت و بیرون کشید.	he at length seized the lappet of my coat which being made of that country silk, was very thick and strong, and dragged me out.
هرکس چنین تصمیمی بگیرد از طرف نوانخانه پنج پوند به او داده خواهد شد.	that five pounds would be paid to anybody who would take possession of him.
با خود دو ظرف که یکی پر از شیر و دیگری پر از آب بود برداشتم.	took with me two vessels, one filled with milk and the other with water.
فکر کردم ممکنه صورت جدیدت رو کامل کنه و همین طور هم به نظر میاد	I thought it might complement your new face, and so it does.
البته هری هم حق نداشت در این باره چیزی بپرسد.	of course he was forbidden to ask questions.
در آن لحظه دخترک به زحمت توانست که به دنبال او ندود و با زور مانع از رفتنش نشود.	for the moment it was all she could do to keep from following him and by sheer force, if need be, restrain him.
مامانم هم رفته سر خیابون که به رام چوب دستی پیدا کنه.	mother's up the street looking at wands
هر شش ماه باید آزمایش بدهم تا ببینم سالم هستم یا نه	I have to take a drug test every six months just to make sure I'm clean
اما این اختلاف چهره که او با من داشت در همه اقوام وحشی تعمیم دارد	but these differences are common to all savage nations
کاری کردند که پهلوان مغلوب به صورت دوست عزیز من سام سون کاراسکوی دانشجو جلوه گر شود	arranged that the vanquished knight should display the countenance of my friend the bachelor
که مردم خشن و بی ترتیب اینجا میل ندارند بانوی من از ملک خود خارج شود	that the rude peasants here don't wish to let the mistress leave the estate
خشخش سورتمه های باریک یخشکن و زنگ صداهای شاد مردم به گوش میرسید.	the rumble of the sliding sledges, and the sounds of merry voices.
باد و بوران در تمام طول شب ادامه داشت.	the whirling storm continued all night.
پس به جای آن که سر در پی او گذارند و تعقیبش کنند	for which reason, instead of being followed and persecuted,
چنین کاری در آن خلنگ زار متروک برایش دشوار بود.	it would puzzle him to do so upon the lonely moor.
به نظرم یکی از بهتر تحات محافل سطح بالاست.	I consider it as one of the first refinements of polished society.
ثروت خود را فقط باید از راه کار خود بدست بیاورم.	I will owe my fortune to nothing but my own exertions.
فضا پر از صدای ناآرام موتورهایی بود که بیهوده روشن بودند.	the air was full of the impatient sound of idling engines.
همه می گن اون با یه مرده هیچ فرقی ندا ره.	they say he's half dead.
چون نسبت به تکالیف مذهبی هر کس احترام بسیار قایل هستم و لو اینکه آن تکالیف بسیار مضحک باشند	for I cherish the greatest respect towards everybody's religious obligations, never mind how comical
با یک نظر علمی به بررسی هیکل او از پشت پرداختم.	I got a kind of scientific kick out of studying her back view.
این به واسطه پارگی و پینه خوردگی پارچه اصلی بود که مدت چهار سال در دریا دوام آورده بود	so torn and bepatched the raiment that had survived nearly four years of cruising.
آیا خجالت نکشیدید مرده را هم در قبرش ناراحت ساختید!	were you not ashamed to disturb the dead?
در هر حال و به هر قیمت برای پیشگیری به نحوی از قایق به جایی پرتاب کرد	at all events, be anticipatingly tossed out of the boat
رویم را برگرداندم و دیدم او تنها در آستانة باغ ایستاد و نوزاد را روی دست بلند کرده است.	I looked out, and she stood at the garden gate alone, holding her baby up in her arms for me to see.
دنبال دسته خود دوید و با یک جست آهنگ پای خود را درست کرد و خشمناک به اطراف نگریست.	ran to catch up his line and, falling into step with a hop, looked back angrily
تا مبادا راه خود را گم کرده به دست دشمن بیفتد.	that he may not make a mistake and fall into the enemy's hands.
دهانش را پاک کرد و به او نگاهی کرد	wipes his mouth and looks at her.
واقعا چیزی از آن احساسات که گریبان گیر استروو شده بود به من رسید.	I really felt something of the emotion that had caught him.
به مناظر بی شماری پیوست که ارلاندو تاکنون دیده بود	attaching itself to the innumerable sights she had been receiving
گویی روحش در جست و خیز بود تا هرچه زودتر از قالب تن مفارقت کند.	as if the soul were struggling to free itself.
ولی برای این کار به گواهی شما احتیاج دارم.	but I'll need your testimony.
اما لازم نیست که حتما این کار را بکنی.	but you don't need to.
گفتی تمام بدن لاغر و باریک اما محکمش همچون ساقهٔ متمایل به سمت آفتاب به جلو میگرائید.	his whole body, lean and slender, but powerful, seemed to strive upward, like the stalk of a plant toward the sun.
در اولین فرصت به سمت راست تغییر مسیر بدهد.	go right again as soon as possible.
کمی که گذشت تمام صداها در دادگاه بند آمده بود	in a little while every sound ceased
بگذارید آن عشق دیرین به جای من با شما حرف بزند.	let your old love speak for me!
اجازه یافته است تا وجود داشته باشد یک معجزه بود	had been allowed to exist, was a miracle.
هرگز نخواهند توانست از من چنین اقراری بگیرند که این چیزی است غیر از لگن ریش تراشی و آن چیزی است غیر از پالان خر.	will not make me believe that this is not a barber's basin and that a jackass's pack saddle.
قول دادند که فردای آن شب به آنجا بازگردند.	promising to return the next morning.
فردا هوا بسیار توفانی و برای او نامساعد خواهد بود	it would be too rough for her tomorrow.
نها دو انگشت خود را به لبهٔ کاسکت برد	thrust two fingers under the peak of his cap
چون تعداد کشتگان جنگ خارج از حد و حساب است	that the dead cannot be numbered
وقتی سخن گفت چیزی بی رحم و موحش در صدایش بود.	when he spoke there was suave brutality in his voice.
زیرا فضیلت چندان که مورد بغض بدکاران است مورد مهر نیکان نیست.	for virtue is more persecuted by the wicked than loved by the good.
از جمله بنویس که خود در قفس را به روی شیر گشودی	to wit, that thou didst open for the lion
دریافت که از ساعتی پیش هوای صبحگاهی مه آلود تر شده است.	she saw that the morning had become more foggy there during the last hour.
وقت خودش من هم مثل تو بودم یه ولگرد بودم غیر از هرزگی و خوشگذرونی فکری نداشتم	I was a squirt jus' like you, a fartin' aroun' like a dog wolf.
بر اثر پافشاری بولست رود به هیئت مدیره بیمارستان پیوسته بود	had lately allowed himself to be put on the board of directors in his turn
خانه چون مکعبی از چوب تراشیده بود و انبار گندم به زیر سنگینی بام کوتاهش شکاف برداشته بود.	a square little box, unpainted and bare, and the barn, low roofed and huddled.
واسه این نیم تنه حاضرم از هر چیزی بگذرم!	what wouldnt I give for a coat like that!
از طریق قیاس علت این وضع خاص زندگی دریایی را که ذکر شد در خواهید یافت.	by inference, you will derive the cause of that peculiarity of sea life just mentioned.
فکر کردم شما هم با هم گرم صحبت هستید.	I thought you'd be all right together.
سپس معتقد شده بودم که برعکس خودداری از رفتن به آنجا و عدم دیدار لینتون کاری اشتباه و غیرعاقلانه است.	now it seemed wrong to refrain.
یا اگر هم خوشگل با شن آدم جرئت نمی کنه. باهاشون رلفیق به شه.	he was not interested or with whom he did not dare to develop a friendship.
بنابراین نگاهی کج کی به او انداخت و چیزی نگفت.	she gave him a startled sidelong glance and said nothing.
خاصه از آن رو که ورانسکی در یک لحظه بی خودی بر زبان آورده بود	especially as he had unwarily told her, in a moment of frankness,
زیرا فقط در این موقع دوستی و آشنایی ارزشمند است.	because only then does one get satisfaction from acquaintances.
ماکزیم به من ننوشته بود که با زن هنرمندی آشنا شده است.	I did not know you were an artist.
از راه لطف و احسان از کشیش تقاضا کرد که به وی اجازه دهد تا برود و از یاران دیوانه خود خداحافظی کند.	entreated the chaplain to permit him in charity to go and take leave of his comrades the madmen.
بی آن که دیگر توجهی به وی داشته باشد	without paying any more attention to him.
سر تا ماس فانی را سپاسگزار خود کرده بود.	he left her in a glow of gratitude.
لیکن بهر حال پاهای او از رکاب بدر آمد	the same time, however, he slipped his feet out of the stirrups and
من هرچه زودتر و بیشتر به پول نیاز دارم.	I am badly in need of money.
آنگاه سرش را جا انداخت و تنش را با دست راست کرد.	she had pushed the head back and molded the body with her hands.
سرانجام گفت که البته آن دختر بینوا را دیده است	at last he said that he had indeed seen the unhappy maiden
بیش از آنکه معصومیت یا ناآگاهی را توجیه کند.	too much so to preserve innocence or unawareness.
آنا از او راجع به حالش و کارهایش سؤال کرد و کوشید او را تشویق به گرفتن مرخصی و استراحت در ییلاق کند.	she questioned him about his health and what he had been doing, and tried to persuade him to take a rest and come out to her.
ولی آن را کاملاً و با دقت حفظ کرده بود.	but she had kept it safe
در انتهای حیاط سنگفرش هم خود کارخانه قرار داشت.	another section at the rear of a paved patio, where the factory had been located
من اینکار را از طرف پدر مرحومم که برای شما ارباب خوبی بود	I do it in the name of my dead father, who was a good master to you
مادرش به او گفت که بگذارد به کارش برسد.	she bade him be quiet, and to let her go on with her work.
اما مثل اینکه آشپز جدید هم چندان بد نیست.	but the standard of cooking remains the same.
وقتی این یادداشت تنظیم شد آن را به حضرت اشرف تقدیم کن!	then give it to his excellency.
با لباسهای نو و چهره های تابناک پای پله ی کالسکه در انتظار مادر خود ایستاده بودند.	the children in their new dresses, with beaming faces stood on the step before the carriage waiting for their mother.
من جامه دان کوچکی برداشته و مقداری اسباب و لوازم از نظر احتیاط همراه برداشتم.	I began putting things methodically in my suitcase.
دخترها خیال ازدواج ندارن. مردی هم نیست که به یاد او نارو به گیره.	none of her girls are married or got any prospects of catching husbands in this county
ضمن عبور از برابر پیشخوان دستور داد چیزی آشامیدنی برایش بیاورند	ordering something to drink, as he passed the bar
گسترش آن در جناح راست بیش از اندازه است. نه!	the right flank too extended, he went on.
زیرا فشار احساسات بیش از حد تحمل او بود.	because the stress of his feeling was more than he could bear.
البته لازم به تذکر نیست که شخص اخیرالذکر باخته بود و تا یک شاهی آخر پولش را از دست داده	which it is scarcely necessary to say the latter gentleman lost, and with it, his fifteenth and last sixpence
صدایی در عالم رؤیا در گوشش چیزی زمزمه کرد	murmuring something back into her dream
گویی با پیراهن توری حاشیه دوزی و زلفی دراز آراسته به یک گلسرخ و دو برگ کوچک زاده شده است.	as though she had been born in that tulle and lace, with her hair done up high on her head, and a rose and two leaves on the top of it.
که خواه به شوخی به کار گرفته شود خواه به جد و خواه به خشم و خواه در هر حال دیگر که باشد	that whether wielded in sport, or in earnest, or in anger, whatever be the mood it be in
زیرا اگر پدرم از این ماجرا با خبر شود فوراً مرا در چاهی خواهد انداخت و همان جا سنگسارم خواهد کرد.	because if my father knew it he would at once fling me down a well and cover me with stones.
هر گاه این بذر در روح روستائی افتد نخواهد مرد	drop it into the heart of the peasant and it won't die
پنج فرانک! من که شاخ درآوردم! پنج گو له!	five francs! the deuce, I should think so! five balls!
بلکه چون بار گرانی در دلش عقده شده است	weighed on his heart and poisoned
این بود که راه دهکده درست در سمت مقابل راهی بود که گدای کور در آن از چشم من ناپدید شده بود	it was in an opposite direction from that whence the blind man had made his appearance
پاها را زیر خود جمع کرده بود و سرش در کاسه توالت خم شده بود.	her legs folded under her, her head still hanging weakly over the bowl.
مطمئنم دیشب با اون همه خر و پف درست نخوابیده .	I'm sure she didn't sleep soundly last night, what with all the snoring.
پس دوربین دو چشمی برداشته و مشغول تماشا به سمت دیگر گردید.	he sat down, drew out his opera glass, and looked another way
این مسئول به نگهبانان گفت تا دروازه را بگشایند.	directed the guard to open the barrier.
ولی چون فرمودید که جادوگران موجب آزار و اذیت شما هستند	but as you say enchanters persecute you
یک زن چهارشانه جوان با صورتی که از خشم سرخ شده بود.	a heavyset young woman with a face made blotchy by rage.
که اگر دختری چون سوندرا به او دل ببازد	since she had troubled to recall herself to him
گاه نثر را آزموده بود و گاه درام را.	sometimes she had tried prose and sometimes she had tried drama.
دو خانم ما به هر زحمتی که بود با سقلمه راهشان را باز کردند.	the two ladies squeezed in as well as they could.
از صف بیرون آمده به فرمانده کل نزدیک شد و خبردار ایستاد.	stepped forward from the ranks, went up to the commander in chief, and presented arms.
در همان روز در ساعت دو بعدازظهر به آنجا رسیدم	I arrived the same day at two in the afternoon
با این همه مثل این بود که اصرار دارد راهش را از راه گذران نپرسد.	but he seemed bent upon not asking the way of the passers by.
نهً نرم و براق است سری که به شکل گلوله.	not something long and sleek and streamlined, furry and bullet shaped.
آنگاه از زیرکی و کاردانی شاگرد خود به وجد و نشاط درآمد.	chuckled with delight at his pupil's proficiency.
آنگاه انگشت خود را با وضعی خیلی رسمی به سوی ژاندارم گرفت	shaking his forefinger with great solemnity of manner
در اتاق مجللی از عاج پشت ارگ نشسته بود	sitting at the spinet in a huge ivory room
مطمئن نبودم چطور تغ یی رمی کنی و وقتی جادوت به کار بی فته چه کاری انجاممی دی.	I wasn't sure how you'd change, what the magic would do when it surfaced.
زیرا گناه او چنانکه گفتیم قبل از هوس ارتکاب آن برملا شد.	for, as I have already said, her misconduct was known before her passion.
زیرا آن دو روزی را که در ییلاق با وی گذرانده بود کسل کننده یافته بود	for he had found his two days with her in the country somewhat tedious
کیسه های مواد منفجره را بین پانزده نفر از افراد توزیع و شروع به کار کردیم.	I served out the explosives to the fifteen porters, and we started.
که تمثال پوشیده از خزه اسقفی قدیس با تاج اسقفی از آن محافظت میکرد تمثالی که در کمال تواضع رسوایی شکستگی بینیاش را تحمل میکرد و دستان زیبای سنگی اش روی سینه اش در هم قفل شده بود.	guarded by a moss stained effigy of some saintly bishop, mitred and staffed, and bearing the indignity of a broken nose meekly, with his fine stone hands crossed on his breast.
بلکه به خاطر ترس از این که مبادا کسی به راز او پی برده باشد.	but because of his overwhelming astonishment that anyone knew his secret.
شب کلاهی کوچک و سرخ رنگ و روغنی بر سر داشت که متعلق به میزبان بود	on his head he had a little greasy red cap that belonged to the host
گری گوری بارانی خیس خود راکنار بخاری آویزان کرد	. regor hung his wet raincoat to dry on the stove
روی گاری جز یک صفحة آهنی چیزی نبود که بر روی دو چرخ قرار گرفته بود.	which was nothing but a large wooden tray on wheels
دو برگ کاغذ پستی سراسر با خط ریز پر شده بود.	two large sheets of note paper were covered with very small handwriting.
بلکه حواس و فکر من کام لا جای دیگر بود.	I think I began to muse about something altogether different.
پس شاهزاده عینکش را به چشم زد و به خواندن نامه پرداخت.	putting on his spectacles he began reading.
یه دفه به چشم خودم دیدم که دو تا مرد دو ساعته هفتاد و پنج تا ماهی گرفتن.	I've seen a coupla men bring back as many as seventy five fish in two hours.
من با زحمت بسیار توانستم معنی هر یک از ین کلمات را بر او بیان کنم.	every one of which terms I was at much pains to make him understand.
برای این افراد که عادت واقعاً طبیعت ثانوی شده	men, to whom custom has indeed been second nature
گانیا به عجله شاهزاده را ترک کرد و از اطاق خارج شد.	who hastily left the room
آن هم با مردی که رابطی به القابش نداشت.	even worse, with a man who was not.
امیدوار بودم تا پایان این ماجرا پیش من بمانید.	I hoped that you were going to see me through this business.
بقیه هم با این مکان فاصلهء بسیار خواهند داشت.	the rest will soon be far from here
تا به حال چیزی به این حیاتی به گوشم نخورده.	I've never heard anything so vital.
زیرا توجه داشته باشید که در غیر این صورت کار از کار خواهد گذشت.	or mind me, it will be too late!
میتواند در هر چیز ارتباطی با حال و هوای آن لحظه خودش مشاهده کند.	whatever the thing observed, one could find a connection with his experience of the moment.
باید مطمئناً بدانم که آیا باقیماندنم در اینجا مفیدتر از ترک آن نخواهد بود.	I will know for certain whether I cannot be of greater use by remaining in it than by leaving it.
آرکادیوی سوم را به عنوان فرزند خودم خواهم شناخت	I will recognize him
در یک دست خردل دان و در دست دیگر سرکه دان گرفته بود.	with a mustard pot in one hand and a vinegar cruet in the other
از کنارشان رد شدم و به اینکه حضور من را حس کنند توجهی نداشتم.	I shoved past them, not caring if they realized my presence.
راجع به این که از بدرفتاری و بی محبتی خانه فرار کند	a resolution to escape from hard usage and lack of sympathy at home
بغض کنان گفته بودند که این خانه شاید آخرین خانه هرکدام تا آخر عمرمان باشد.	chokingly they had saidthat it might be the last home either of them would ever have.
سرش را بلند نکرد ولی دستش از کشیدن باز ایستاد.	she did not look up, but her hand missed a loop in the design she was drawing, making it unbalanced.
بیا این جا و گردنبندت را به پدرت نشان بده.	come here, show papa your necklace.
پس از آنکه همه جای آن را گشتند و زیرورو کردند	rummaging it all over
در حالی که فقط پانزده لیره به من بدهکار بود.	he owed me but fifteen.
برادر این مرد خواهر مرا دید و از او خوشش آمد.	that man's brother saw her and admired her
زندگی این زن و شوهر ملایمت و آرامشی بیشتر یافت.	that their life began to go more smoothly.
تا ساعت یازده صبح در انتظار باقی مانده بود	he had waited until eleven o' clock
در این فکر فرو رفت که از تمام مردم ده فقط و فقط او تا ابدال آباد از دست رفته است.	realizing that he alone of all the town was lost, forever and forever.
آن شخص قدری سرخ شده و با تلجلجی جواب داد	replied the stranger with a slight hesitation, and blushing
مارتین پاسخ داد سلامت و قدرت تخیل را به درآمد ترجیح می دم.	I'd rather have good health and imagination, he answered.
که اسمش را با حروفی طلایی روی بدنه نوشته بودند	for its name could be seen on the poop in gold letters
درباره هیچ چیز بجز اصطلاحات پزشکی و انجام کشفیات عقاید رادیکال نداشت.	he was no radical in relation to anything but medical reform and the prosecution of discovery.
در هر یک از طرفین من پانصد تن که نیمی از آنان مشعلهائی فروزان و نیم دیگر تیروکمان داشتند به پاسبانی ایستاده بودند.	were with five hundred guards on each side of me, half with torches, and half with bows and arrows.
من بچه اولمو سقط کردم وقتی دیدم گاو یکی از سیاهامونو شاخ زد	I lost my first when I saw a bull gore one of our darkies and
وسط راه ایستادن و خستگی انداختن چه خوب است.	I must admit this is nice, to stop and give ourselves a little break from the track.
اما این داخل عمارت است که مرا مشغول دارد	I care for, it is the interior
اما آرامش فکری نداشت و دچار ناراحتی ذهنی بود.	but he had not complete freedom of ideas, because he was in an agony of embarrassment.
سپس کیف دستی را در ساحل گذاشتند تا چند دقیقه دیگر هم گردش کنند و چند عکس هم از درون قایق بردارند.	then having left the bag on shore for a few moments while they rowed out and took some snapshots in the boat
رویم را برگرداندم و وانمود کردم مشغول خواندن پوستر ایدز هستم.	I turn away and pretend to be studying a poster about AIDS.
در اولین شبی که فرصت یافتم بعد از فراغت از کارها ساعتی در اتاق بنشینم	on the first occasion of my sitting up in the evening
به خوبی از تأثیر خود بر ژنرال آگاه بود	he was well aware of his effect on the general
او را مردی پاک دل اما بسیار کودن و نادان پنداشته بود.	as a well meaning man, but of a low contemptible understanding.
مشار الیه استشمام هوای سنگین و ناسازگاری کرد و خود را در زندان دید	he air he inhaled was no longer pure but thick and mephitic he was in prison
در این احساس گیج کننده وصیت نامه دوم را یکسره از یاد برد.	possible revocation shrinking out of sight in this dazzling vision.
پنج دقیقه طول کشید تا صفحات آخر را هم خواند و آن را بست.	in five minutes more she shut it up.
بلافاصله تمام آثار شادی از صورت او محو شد	all gladness left him
امیدوارم که از طرف من جسارتی به سرکار نشده باشد.	I hope I have not hurt you!
زن پس از این که سر تا پای او را ورانداز کرد	looking at him with great complacency from head to foot
سرم رو به ابرهاست و مرد ولگرد در کنارم است.	head facing the clouds, the tramp by my side.
تا دم غار دنبالت کردم اما تا پایین نیمدم باهات. هم ون جا صبر کردم.	I trailed you to the cave, but didn't follow you down
به مدت سه روز در اطاق من جیوه بسوزانید.	burn mercury in my room for three days.
کم و بیش چون کودکی گم شده و گریان در تالاری بزرگ	almost like a lost child crying in the degraded grandeur of the noble hall
بلکه گل و لای از سر و روی خود نیز بزداید	but to wipe the mud from his face
دانست در آن گوشه جهان که ما هستیم از دست مردم چها برمی آید	in our parts of the world, is capable to perform
به اعلی حضرت امپراطور التماس کردم تا دستور دهد که هرچه زودتر آن را به من برسانند.	I entreated his imperial majesty to give orders it might be brought to me as soon as possible.
تا نفس آلوده خود را از آنان که طرف صحبتشان بودند دور نگه دارند.	to divert their polluted breath away from those whom they addressed.
اولین سؤالی رو که تو اون صفحه دیدم ازش پرسیدم.	I put the firstquestion that I came across.
برای عمل قدیم بعدها مورد دادرسی قرار خواهد گرفت.	later on he will be judged for the old crime.
اینان نیز آنچه از ربرتا دیده یا شنیده بودند به قید سوگند بازگو کردند.	each swearing to what she or he alone saw or heard.
با خود گفتم بهترست به طبقه سوم بروم و ببینم آن زن محتضر حالش چطورست.	I bethought myself to go upstairs and see how the dying woman sped
حالا هم که این سر لعنتی غیبش زده است	now this head is not to be seen anywhere about
نمی دونست کی باید ده نشو به بنده و ساکت بمو نه.	she never knew when to keep her mouth shut.
که من خودم حبوبات و سبزیجات خود را پاک و اصلاح نمایم.	to prepare my own meals
چقدر پدربزرگم خوشحال خواهد شد اگر شما دوست بدانید.	you will overwhelm my grandfather with delight if you play whist.
که برای سرو صورت دادن به این وضعیت تحمیلی	which obviously was being forced upon them and themselves
پشت سرش مرد عجیبی به درون کلبه قدم گذاشت.	he was followed by a second, very odd man.
زیرا این قسمت و آن طرف صورتش سرزمینی بود که آبیاری نشده بود	below and beyond this line there was a dark expanse of unirrigated soil
بیست جاروی پرنده در یک ردیف کنار هم چیده شده بودند.	so were twenty broomsticks lying in neat lines on the ground.
کم مانده بود که از بوی او و ملاحانش بیهوش شوم.	I was ready to faint at the very smell of him and his men.
باید یکی از ای نا نامه رو به بره.	I've got to use one of these.
ریش و موی سرش رنگی مایل به زرد گرفته بود.	yellowish beard and hair
فکر نکنم پدرم وقتی که یه نفر اینجا باشه سعی کنه بیاد تو	I don't think my dad would try to come in while someone else is here
او نم موقعی که دی گه امید ندارم دستم بهش بر سه.	maybe never have another chance.
نتوانستم در هیچ جای چشمانش اثری از خداحافظی ببینم.	I couldn't see a goodbye anywhere in his eyes.
بعدش شاید بد نباشد فکری به حال خودم بکنم.	afterwards I may probably be glad to dispose of myself.
دلیل آن هم دستپاچگی او به هنگام دادن یادداشت بود.	because of her unmistakable agitation when she handed him the note.
این صدا از زنگ معروف اوست و او مار زنگی است.	that the noise was the famous rattle.
اما پا فشاری خود او در این مورد ممکن بود حمل بر تحکم بی جایی شود.	but for her to urge this might seem an undue dictation.
بگذار فردا همدیگر را در خانه معینی ملاقات کنیم تا حرفم را قبول کنید.	let them meet at a certain house on the morrow and make a test.
همچنان که برگشتند و به سمت خانه به راه افتادند	he continued, as they turned towards the house.
مسی و آ به شما مرا از وحشت هلاک کردید.	you will make me die of fright!
اگر من کشته شدم و از من پسری ماند شما او را از خود جدا نکنید	if I'm killed and if I have a son, do not let him be taken away from you
که امروز مجلس عقد و امضا صورت نخواهد گرفت بماند به وقت دیگر.	, the affair would necessarily be deferred for some days longer
از راهرو کنار من رد شد که به سمت میز معلم برود.	walking down the aisle beside me to get to the teacher's desk.
صبر کنیم تا طوفان فرو نشیند و ما بتوانیم در خشکی پیاده شویم.	wait till the subsiding tide permitted us to land.
به هیچ ترتیب ترغیب نخواهم شد که چنین چیزی را باور کنم.	nothing will persuade me to believe in such a thing.
او هم به زودی از این کار منصرف شد.	she soon dropped off.
از آن دود آبی رنگ غلیظی به هوا رفت.	engulfed them all in a cloud of blue smoke
عزم جزم کرده بود از این پس به زنان به شیوه ای علمی برخورد کند	henceforth he would take a strictly scientific view of woman
می دونم که جسما به من وفادار بودی .	I know you've been physically faithful to me.
همیشه میل من ای نه که دخترامو با تقوی تربیت کنم.	I mean to bring them up virtuously, and they shall be honest, and nice
اعلی حضرت امپراطور که اعتماد بسیار به دلیری و نیرومندی تو دارد	his imperial majesty, placing great confidence in your valour and strength
بهتر است خداوند بزرگ همین حالا به دادش برسد.	it might come to him now
این صدا را چنان شنیدم مثل اینکه زیر گوشم گفتند.	I heard that just as plain as if the man was by my side.
به محض این که پیش آمدی شد که به تریج قبایش برخورد دختر ما را به باد فحش و دشنام بگیرد و او را پست و فرومایه خطاب کند و پدرش را دهاتی احمق و خشن و عمله بیل زن بنامد و خود او را نیز دخترک دوک ریس و بیسروپا بخواند.	would abuse her and call her clown bred and clodhopper's daughter and spinning wench.
قبلا به شما اطلاع می دم تا بدون ین.	I warn you so that you may be prepared.
رئیس پلیس انجام مأموریت خود را به عرض رساند و اطلاع داد	the superintendent of police, after reporting that he had executed the instructions he had received, informed
همهٔ آن بنای سعادت محقرشان دیگر ویران گشته بود.	all their humble happiness was henceforth disturbed.
هرکس هم یک جزء کوچیکی از این روح داره.	everybody's a part of.
باز سه گلوله دود دیگر و متعاقب آن چهار گلوله دیگر بو جود آمد	three and then four more appeared and then from each
بعد نفسی تازه کرد و از ته دل جیغی جگرخراش کشید.	gasped for breath, and let out a hoarse shriek.
آن دو از این بابت از او سپاسگزار بودند	for which they were both grateful
او پا سست کرد و مو به تنش سیخ شد.	he stopped short, his hackles rising.
وضع مضحکی پیش آمده بود و من ناچار شدم از تعاقبش دست بردارم.	rendering it ridiculous for me to pursue.
بدین قصد که آن زوبین انداز مدفون آن را به چنگ بگیرد و بدان وسیله بیرون کشیده شود.	meaning that the buried harpooneer should grasp it, and so be hoisted out.
رنج حرکت و معاینه زخم در بیمارستان سیار حاصل شده بود	the jolting while being moved, and the probing of his wound at the dressing station.
بدون آنکه کسی او را ببیند از خانه بیرون رفت.	out of the house without being seen.
آرام بودن هوا باعث شد که من از بابت سلامت و آسودگی شما در موقع سفر نگران نباشم.	the calmness of the air and sky forbade apprehensions respecting your safety or comfort on your journey.
گذاشت که حرارت تسکین بخش آب درد و رنج را از وجودش بزداید.	letting the soothing water wash away the pain.
پای عاج خود را در سوراخ مته که آنجا بود فرو کرد و با یک دست شراع را به چنگ گرفت	inserting his bone leg into the auger hole there, and with one hand grasping a shroud
پنجاه قدم سربالایی رودخانه رفتم و بعد همان راه را گرفته برگشتم همان جایی که کرجی را گذاشته بودم.	I went up the bank about fifty yards, and then I doubled on my tracks and slipped back to where my canoe was, a good piece below the house.
در همان لحظه صدای چند ضربه بر در کلبه به گوش رسید و هاگ رید با عجله به سمت در جلویی کلبه رفت.	he strode back into his cabin as someone knocked at the front door.
آشکار شد که وقایعی در جریان بوده که موجب ناراحتی روحی دختر جوان و یکی دیگر از افراد خانواده گردیده است.	it became evident that something was in progress which affected the peace of the young lady, and of somebody else besides.
کلاهش را از سر طاس برداشت و سه بار روی سینه صلیب کشید.	lifted the hat from his bald head and crossed himself three times.
وقتی به آن رسیدم آسمان در مشرق خاکستری شده بود.	when it did show it looked like it was a thousand mile off.
تا خود نزدیک کوزت باشد به هیچ چیز محتاج نخواهد بود .	so long as he had her near him, he shouldneed nothing except for her
برای یک آن همگی از تماشای جانی دست برداشتند.	the immediate attention was distracted from the murderer, although the universal eagerness for his capture was, if possible, increased.
من خیلی خوشحالم که این کار را کردید و به من هم گفتید.	I am very glad you did, and that you communicated it to me.
اما حالا خیلی مشغول است. من باید گزارش بدهم.	but all alive now, I must turn to.
آخر من که گفته بودم ما باز به هم خواهیم رسید.	I told you we should become friends
از این مرگ متعاقب و نظیر همدیگر که همه را گیج کرده	these two sudden deaths, so quickly following each other, astonished every one
احتمالاً آن طور که فکر کرده بودم واضح و خارج از کنترل نبودم.	I must not have been as transparently obvious and out of control as I'd thought.
به چشم خود امتناع او را از کمک به ربرتا دیده بود!	had seen that he had not sought to aid her!
در او اشتیاقی به تجدید ارادت نسبت به شخصی شخیص جان گرفته بود.	whether he desired to show a little attention to an eminent man
ما نمی تونیم تو رو توی دسته راه بدیم.	we can't let you into the gang
روز دیگر به دستور ملکه آن را برای شام من آماده کردند.	I had him next day for dinner, by the queen's command.
قول داد که خود او با دکتر وارد مذاکره شود.	readily undertook to hold solemn conference with the worthy doctor himself.
انرژی پر شور پسر بر ضعف اسفناک پدر چیره شده بود.	mastering the energetic spirit of the son as it had mastered the lamentable weakness of the father.
شماره تلفتش را که در دفتر ثبت نشده است برایت پیدا کردم.	I have her unlisted number for you, if you want it.
با کنجکاوی حریصانه تمام توجه خویش را به صحنه تآتر معطوف ساختند.	turned their whole attention with eager curiosity to the stage.
با محبت و مهربانی به درِ اتاق غذاخوری اشاره کرد.	she humanely pointed out the door.
بوی پرندگان و بوی اجتناب ناپذیر فاسد شدن به مشامش رسید.	the smell of fowls, and the inevitable smell of decomposition.
اما او را مجبور کرد تا اجرت سرویس او را مانند بقیه بپردازد.	but she made him pay for her services so strictly
راهی را که چوپان رفته بود در پیش گرفتیم	we followed the same road which we saw the shepherd take
امروز من او را از خانه خود بیرون کردم.	I turned him out of my house this morning.
هرچه را که میدانست به خودی خود یاد گرفته بود.	everything that he knew, he had learned by himself.
چطور است دست همدیگر را بگیریم و اندکی بدویم تا گرم شویم.	let us take hold of hands and run.
ولی هیچ انعکاسی از تصویر خودش در آینه ندید.	but see no reflection again.
اما بعداً با آقای رمزی به خوبی کنار آمده	but afterwards she got on perfectly
زیرا کامی با چنان ترشرویی و خش نونتی با او رفتار کرده است	for she had answered him so angrily and harshly
با همین معاذیر یا بهانه دیگر به اینجا نخواهد آمد	so be perwented, or anything for an excuse
ولی حواسش جای دیگری بود آنهم در این فصل از سال.	but his thoughts were elsewhere at this particular season of the year, too of all times.
هنگامی که در شورای سلطنتی در ین باره سخن رفته بود خردمندترین وزیرا با من هم رأی شده بودند.	when the matter was debated in council, the wisest part of the ministry were of my opinion.
ترسیدم که اگر آتشی برافروزم بومیان از آمدن من خبر شوند.	not daring to kindle a fire, for fear of being discovered by the natives.
من باید بروم و زود درها را ببین دم.	I must go and bar the doors quick
موهایش در یک طرف سرش فرفری و در طرف دیگر صاف بود.	her hair frizzy on one side and flat against her head on the other
از میان دو خیابان بزرگ شهر به پهلو گذشتم	sidling, through the two principal streets
از روی چهره مضطرب او کاملاً معلوم شد که واقعاً نیازمند فشار است	plainly showed, by the alarmed expression of every feature, that he did want a little rousing
اگر محکوم شود و با محاکمه مجدد او هم موافقت نکنند	he was convicted and a new trial refused then,well then
گفت که من مرد شجاع و جسوری هستم و سپس به راه افتاد.	said I was a brave fellow, and went away.
از اون به بعد دی گه نزدیک شدن به اون درخت ممنوع شد.	we were forbidden to go near it.
لیکن به عقیده من بسیار مشکل است که حضرتعالی بتوانید با او صحبت کنید	but I think it will be difficult for your worship to speak with her or see her
چنان وحشت کردم که ناچار شدند شبانگاه مرا از رختخواب بیرون آورند	I am so frightened that they are afterwards obliged to take me out of bed
به من امکان داد قدمت این سند را مشخص کنم.	enabled me to fix the date.
باز هم فقط اختیار یک سر طناب در دست من است.	I only had the management of one end of it.
ولی آخر این وظیفهٔ هنرمند است که جائی که آفتاب نیست آن را بیافریند.	but it is the artist's business to create sunshine when the sun fails.
خوب و وفادار هستم که من همان بنده درصحرا آب بوجود آورد	I am the good and faithful servant who brings water in the desert
همه به فکر جایی برای خوابیدن بودند که دیوارهای سمت چپ و راست آنان ناپدید شد.	all were thinking of a place where they could sleep, when suddenly the walls to right and left vanished.
چنان بنای ناله و شیون و زاری گذاشتم که	I raised such a lamentation that
من اول کمی نگران بودم و خیال داشتم آن را به تو بگویم.	I was worried at first and meant to tell you
در ین جا باید به زنان نیز همان حقی را داد که به مردان دادیم و خود باید معین کنند که تا چه حد زیبا و در دوخت و دوز هنرمندند.	wherein they had the same privilege with the men, to be determined by their own judgment.
محیطش هم ساکت و برای یک ادیب واقعا الهام بخش است.	the surroundings quiet and conducive to a literary life.
من دیگر میل ندارم دربارهٔ این موضوع سخنی بر لب جاری کنم.	I don't want to just now!
عاقبت مورد تعقیب قرار گرفتند و با دقت و توجه دنبال شدند	were finally gone in quest of, systematically hunted out
از حالا به بعد باید حواسمونو حسابی جمع کنیم.	we can't be too careful as to how we move from now on.
به یقین بدان که سر و کارت با خود اندوه و افسردگی است.	rest assured that it is to woe itself and affliction itself you come.
همان وقتی که شما اینجا بیمار در بستر افتاده بودید.	I was here when you were lying ill in bed
کمربند سرخ را دور کمرش بست و در کار تدارک جزئیات سفر به خانه شد.	knotted the scarlet sash about her waist, and began arranging the details of the journey home.
زمانی که پدر او به خانه رسید خیالم راحت شد.	I was relieved when her father arrived home.
سعی کردم آن را فراموش کنم و حتی زحمت نگاه کردن به خود ندهم	I'm tempted to leave it behind and not even bother looking at it
آن موسیقی آرام و صوفیانه اصلاً با آشوب درونی او هماهنگ نبود.	for the mystic music seemed so innocuous compared with the state of his soul
برای این کار باید شش ماه به این کتاب مهلت داد	to which end let them be allowed the over seas term
به امید اینکه تا موقع بازگشتم جای استراحتی برایم ترتیب دهد از آنجا بیرون آمدم.	but I retired, confiding in her energy for a resting place against my return.
هرچند که این قول و قرار را با خودِ قهرمانِ مردِ داستان گذاشته بود.	though it was made with the hero himself.
چون تمامی این معنا نی و پندارها از نظر اهب گذشت جبین او مخطط و چین خورده به جا ماند.	without being able to drag the firm thing from its place.
سپس با پای چپ همین کار را کرد و خود را در رود افکند.	then her left and threw herself into the canal.
بعد مثل اشخاص جنایتکار با ترس و وحشت به اطراف نگاه کردم.	looking over my shoulder like a criminal.
به شرط آنکه در کاروان شما یک استاد فلسفه ما بعد الطبیعه هم سفر کند.	if your caravan happen to be supplied with a metaphysical professor.
ولی توافق کرده بود که این تنها راه عملی است.	but she had agreed it was the only practical solution.
اما بلافاصله شکارش نیز با سرعت بیشتری حرکت کرد.	but as he moved faster, so did his quarry.
تا هر قدر ممکن باشد وضع اتاق را بهتر بداند و	trying as far as possible to notice and
چه از او نا تعریف کنم و چه کاری کنم که گداها زیادتر به شن.	either to brighten the record of patriotism or to increase the roll of paupers.
اما آنچه بیش از همه توجه دار نی را جلب کرد این بود	but, what he most noticed in the two figures was
از ای نرو شرایط تحقیق در من جمع نبود.	that I was not qualified to make any inquiries.
اما معلوم بود که پشت در چند نفر بودند	but it was evident that there were several persons at the door
موهایش در گره دستمال گیر کرد و او را آزار داد.	catching some hairs painfully in the knot.
بلکه مردی که به کلی بی باک باشد از مرد بزدل هم سفر بسیار خطناکتری است.	but that an utterly fearless man is a far more dangerous comrade than a coward.
زمانی که به این فکر کردم که بعداً چطور باید آن را بالا می او ردم آه کشیدم.	I sighed as I thought of how I would have to choke it back up later.
یک قسمت از ذهن وحشت زده و بد ذهن ما باشد.	the scared, bad part of all of us.
اما چیزی آن را سر جایشان نگه داشته بود.	but something was holding them down.
باز بغض گلویش را گرفت و از سخن بازماند.	cried my mother in another burst of distress, and breaking down again.
سعی کردم خودم رو خونسرد نشان دهم. با شه.	OK, I say with a little shrug.
با این بیداری در پس خود خط مواجی از کف سفید و غلیط به جا نهد.	leaving wavy lines of thick white scum in its wake.
من علاقه دارم که خود را فدای دیگری بکنم.	for devoting myself to some one else.
ناگهان به سرش زد که دیگر در اینجا نماند حتی امروز.	she must not stay here could not even this day
این است که کارهای فکری بر کارهای بدنی رحجان دارد	is, that the labours of the mind are greater than those of the body
به قلب کشور بیشتر از او خشمناک و برآشفته بودند.	were retreating into the depths of the country.
اما برای بچه بیرون رفتن با مردک شادمانی بزرگی بود.	but the child's delight was to go out with the good man.
که اعمالی را که او در آن لحظه کرد به یاد من آوردی	to remind me and recall what she then did,
درخت دیگری را شکستم تا خودم را همین جا نگه دارم.	I broke another tree trying to hold myself here.
بی آن که منظورش را انجام داده باشد بند آمد.	died without accomplishing its object.
از میان شکاف ابرها فضای لاجوردی بیکران را مشاهده کرد.	between them gleamed blue infinity.
شتابان به سوی پله دویده دمش را بالا برد و خود را به کنار پای نیکلای مالید.	rushing headlong toward the porch with lifted tail, began rubbing himself against his legs.
اما شاید در بین قصه اسمی از پدرم ببرد	but perhaps she will allude to him of her own accord in the course of the recital
به این نتیجه رسید که استنباط اولیه او مبنی بر مست بودن دخترک صحیح بوده است.	that his original impression of her being more than a trifle in liquor, was confirmed.
که او را حسابی ترسانیده و زانوانش را به لرزه انداخته بود.	that he frightened her so much her feet chattered on the floor
آه! مثل اینست که منالان او را در برابر چشم خودم دارم .	I think I see him now
در را با ناراحتی بستم و باز هم بدون مقصد به راه خود ادامه دادم.	I shut the door softly, and went uncertainly along the corridor
گناه جدایی زن از پسرش نیز به گردن ورانسکی بود.	again, it was his fault that she was forever separated from her son.
ممکن است تأثیر زی انباری بر مزارع همسایه بگذارد.	was liable to have an unsettling effect in the neighbourhood.
عینکش را پاک کرد و به کار اصلی صبحی پرداخت.	cleaned his spectacles, and settled down to his main job of the morning.
غبار صحرا خورشید را پوشانده بود و کودکان آبادی از شادی ورود بیگانگان در پوست خود نمیگنجیدند.	dust obscured the desert sun, and the children of the oasis were bursting with excitement at the arrival of the strangers.
این کتاب بهترین اثر پهلوانی است که تاکنون تألیف شده	this is the best of all the books of this kind that have been written
اربابم به همان ده دوازده ضربه شلاق اکتفا کرده	my master would have been content with giving me one or two dozen lashes
قسمتی از اندام خود را با شالی پوشانده بود.	her figure was partly enveloped in a shawl
امیدوارم آن وقت قوای تو با شدتی که دارند بار دیگر تو را گرفتار رنج و زحمت کنند.	I hope your energies will then once more trouble you with their strength.
راه مقدر خویش را تا این مرحله پیموده بود.	he had travelled thus far on his last way.
که او غیر از من کسی را دوست ندارد	that he would be forcing my wife from me
مانند یقه روی سر من نهاد و به گردنم افکند.	throwing it over my head like a collar.
این صمیمیت و یاری او را امروز در اینجا با رسانیدن آسیبی به او پاسخ نداده باشم.	I may not repay him by doing him harm to day.
من آنقدر نمک ناشناس نیستم و چندان هم مته به خشخاش نخواهم گذاشت	I am not so ungrateful nor so grasping
در آن صورت ندای هیچ جارچی دیگر بدان نخواهد رسید.	in that case no town crier would ever find her again.
او را هم به زور روی یک صندلی نشانید.	thrusting her into a chair, held her down by force.
باز هم شیفته و دلباخته به سوی بنای ماند رلی نگریستم.	I turned again to the house
من حاضرم سوگند یاد کنم که این طفل صادق و راست گو است .	I'll answer for that boy's truth with my life!
با نگاهی حاکی از ملامت و سرزنش وی را نگریستم و سرم را تکان دادم.	I shook my head reprovingly
نل از او پذیرایی کرده و او رفته است	she has served him and he is gone
که هر یک فآنوسی به دست دارند که سبز یا طلایی رنگ است.	each carrying a minute lamp of gold or green.
انتظار مرا داشته باش که به تو اطلاع خواهم داد	I will give you the signal
مثل خانه خودمان به اندازه کافی راحت خواهد بود.	I daresay it will be homelike enough.
سؤالات خود را منحصر کرد به وضع علوم ریاضی در آن ممالک	confined his questions to the state of mathematics
چون تو خیلی خوشگل بودی و دل همه رو برده بودی .	because you were so much prettier and had so many beaux.
آنگاه زورق را تا آنجا که ممکن بود به ساحل کشیدم	I drew up my canoe as close as I could to the shore
بگذارید من هم به تنهایی راه خود را در پیش گیرم.	let me go my way alone.
از شدت دستپاچگی زیر لیوانی کاغذی را ریز ریز کردم.	I start to shred my paper coaster into little bits.
او قادر است مرا به هر جا که بیشتر در بندگی و عبادت او بکوشم بفرستد.	to send me wherever it may be most to his service
این عشق منبع شادمانی و امید در زندگی من بوده است و خواهد بود.	a source of little visible delight, but necessary.
به او نگفت که موجبات غلبه بر او را شوهرش برای وی آماده کرده است.	nor that he had afforded him the opportunity of attaining such a result
من هم در پایین ماندم که مواظب او باشم.	I remained downstairs on guard
در سایه نمناک که یک پشته د رخت بید کنار نهر کم عمقی	. in the shade of willows growing close to a stream
چراغ بزرگ اتاق خواب را هم از دم در خاموش کرد	he turned out the overhead light, using the switch next to the door
سراپا سرشته شده از دقت حسودان نسبت به اطرافیان	so far as her neighbors were concerned, with theinquisitiveness peculiar to envious persons
شاید من اولین کسی بودم که پس از ناپدید شدن صاحبش آن بارانی را به تن کرده بودم.	I must have been the first person to put on that mackintosh since the handkerchief was used.
من تا حالا در این جور اتفاقات یک دختر خان وم رو نجات ندادم.	I've never rescued a maiden in distress.
به پنجره و پرتوهای مواج انعکاس یافته نگاه کرد	she glanced at the window with its ripple of reflected lights
بله روسری زن در پارو گیر فلزی قایق گیر کرده بله یک روسری قهوه ای رنگ	yes a veil caught in one of the rowlocks yes a brownveil yes sure, that's all
فکر کردم که سود من در این است که فرمان برم.	I thought it my part to obey.
که بسیار در مراجعت بناپارت یاری کرده بود و یکی از اشخاص با عزم و خطرناکی بود	one of those who had contributed the most to the return of the usurper in 1815 a very resolute and very dangerous man
در این جزایر هیچ دختری را به خوبی او ندیده.	that he hadn't met a nicer girl in the islands.
به خانواده خود که برخاسته بودند زیر لب چیزی گفت	muttered something to his family, who rose
درست مثل تیر شکسته کشتی که پس از پیروزی در نبردی دریایی بی توجه به حوادث پیرامونش بر آب شناور و دور و دورتر می شود.	as a broken spar is suffered to float away disregarded after a naval victory.
زیرا پوشش تن من با پوشش یاهوهای همنوع من فرق داشت.	because my body had a different covering from others of my kind.
اما وقتی که پالتو پوست بره اش را که آورده بودند به تن کرد	but when he had put on the sheepskin brought for him,
خانم گولد کنار در سالن خالی و پر نور بر جایش خشک شد.	stopped her with a start at the door of the lighted and empty sala.
در مخفی سالن عمومی اسلایترین که در دیوار پنهان بود باز شد.	a stone door concealed in the wall slid open.
آن وقت است که دیگر شمامیرضب نیستند بلکه محکومید.	you would cease to be the executioner, you would take the victim's place.
با چیزی بیش از جرأت با نوعی احساس پیروزی قطعی با من به مخالفت برخاسته.	with more than courage with a stern triumph.
من هنوز نمی دونم چه کسی می خواد ملک رو بهره.	I don't know yet who it is wants this place.
وی با این قیاس خود توانسته است نشان دهد که دوستی این دو حیوان بی آزار تا به چه پایه محکم و صمیمانه بوده است تا هم نظر تحسین و تعجب عالمیان را به چنین مهر و صفایی جلب کند و هم اسباب شرمندگی آدمیان را که تا به این درجه از حفظ دوستی و محبت خویش غافلند فراهم آورد.	it may be perceived, to the admiration of mankind, how firm the friendship must have been between these two peaceful animals, shaming men, who preserve friendships with one another so badly.
تا با پناه بردن به وضعیتی مطمئن و غیر قابل تهاجم آن شرایط را با خونسردی تحمل کند.	that unassailable position of strength surveyed the scene impassively.
خود من هم صبح زود از همان جا با دلیجان عازم سفر بشوم.	whither I myself was to repair at an early hour the next morning to meet the coach.
اولین نور چراغی که دیدم بلند شدم جیم را بیدار کردم و کلک را برای اطراق روز به ساحل بردیم و قایم کردیم.	the first cabin light that showed I rousted him out, and we slid the raft into hiding quarters for the day.
ولی زود مرا صدا زد و گذاشت نگاه کنم.	she called me back presently, and let me look too
اما عقیده ندارم که همین طور ادامه بدهی .	but you ought not to keep it up.
که در یک ساعت اخیر بیش از ده بار از خاطرش گذشته بود.	through which he had passed ten times already during the last hour
من نیز چنان نمودم که به این امر کاملاً اطمینان دارم.	I expressed myself quite sure of that
این کمک تو و لا دی احتمالاً چیزی است که به آن نیاز دارم.	its probably what I need.
اما من آزاد هستم در باور کردن و اعتقاد نمودن و در عدم اعتقاد بر آنچه فرمودید	but added he with a bitter expression of countenance one is free to believe them or not as one pleases
به او تکیه داد و پیکر مادر را در عطر مطبوع گرم و خواب زده خاص کودکان پیچید	with the delicious sleepy warmth and fragrance that is only found in children
اما در مورد کشیشی بیمارستان وانمود کرد که بجز به خاطر چهل دلار سالانه علاقه زیادی به آن ندارد.	as to the chaplaincy, he did not pretend that he cared for it, except for the sake of the forty pounds.
مثل این بود که او هنوز هم پزشک کشتی است	as if he were still ship's doctor
من فکر کردم مقصودش ناخوشی خانم است و حرفش را تأیید کردم.	I thought he meant for missis's sickness, so I answered, yes.
به خاطر یک کار ضروری به کمکت احتیاج دارم.	I want your help in something urgent.
حالا اسکار لت حتی یک سنت هم نداشت .	so now she could not even hire a rig.
خاطره جنایت فجیع خود را با قدرتی تمام به یاد آورد.	there returned, with ten fold force, the dreadful consciousness of his crime.
به مبل و سور بری قدری آب سرد بر چهره مرد پاشیدند	so they threw a can of cold water over him
شما نفعی در پنهون داشتن بعض چیزها دار ین.	you have some interest in hiding something.
من نمی تونم تو چند هفته چنان جنگ دهی قوی ای از تو بسازم.	I can't make you that strong a fighter in a few weeks.
چه حالا بخواهند بروند و چه یک ساعت دیگر.	either now or an hour hence.
اما از من خواستند هر موقع شما برای بردن بچه امدید به دنبالشان بفرستم.	but he asked me to send for him when you came for the baby.
ممکن نبود از آبش برای ظرف شویی یا حمام استفاده کرد.	so that there was no water to be pumped up from it to kitchen or bathroom.
دوباره به ایوان رفت و ایوان را به سمت در ورودی دور زد.	went out again along the continuous terrace toward the front door
حالا نوبت توست! هفتاد و پنج سنت دیگر طلب دارم	I want seventy five cents more.
که این کار را مثل تمام شده تصور نمایید.	but consider it a settled thing
حتی نیازی نداشتم از جادو استفاده کنم اون با میل و رغبت خودش عاشق من شد.	I didn't even have to use magic on him he fell in love with me of his own accord.
منظورم ای نه که تا حالا شده اشخاص دیگری زیردستت کار بکنن	I mean have you ever had any people work under you
فکر کرد بهتر است آنرا بسوزاند ولی میدانست که قدرت چنین کاری را نخواهد داشت	thinking he should burn it knowing he never could
اما واسه سی هزار دلار در سال که داره حسابی از بین می بردش خودشو از زندگی محروم کرد.	but he robbed himself of life for the sake of thirty thousand a year that's clean wasted upon him.
قلب ورانسکی بر او نهیت زد تا از آنا بخواهد شوهرش را ترک گوید و او چنین کرد.	his heart had prompted him to beg her to leave her husband.
این جانب افتخار دارد که کشفیات جدید خود را در زمینه هندسه به عرضتان برساند.	I have the honour to report fresh explorations in the field of geometry.
در آن لحظه عذاب وجدان غم و یا خشمی احساس نکردم.	I didn't feel the remorse or the guilt or the rage in that second.
آنگاه به امید اینکه شاید کاخی اعیانی و یا کوخی چوپانی بیابد و در آنجا مأمنی برای استراحت و قضای حاجت جستجو کند به هرسو نگریست تا	when, looking all around to see if he could discover any castle or shepherd's shanty where he might refresh himself and relieve his sore wants
نیم ساعت پیش رئیسشان چه قدر شبیه یک پسر بچه ی شیطان بود !	what a guilty little boy their president was half an hour ago.
زیرا خودت بهتر از هر کس دیگری از آن باخبری.	because you know better than anyone.
لیکن مدتی بعد که هر اقدامی تابع قانون خودش شود.	but not now, for every process has its law.
دور تایی که بهترین بخش وجودش را زندانی کرده بود	shut her best soul in prison
بیم آن را داشتم که اگر هویت خود را فاش کنم ممکن است ضربه روحی بخورد.	I was afraid of occasioning some shock by declaring my identity.
تمام گوشت و پوست و استخوان او متع لق به فلگ بود.	he belonged to the dark man lock, stock, and barrel.
سر به عقب میگرداند و با چشمان زیبایش به سوار خود خیره میشد.	bending her head back and gazing at him with her exquisite eyes.
ولی متوجه شدم که حال او هم مثل من دگرگون شده است	but I can see, she's just as freaked out as me.
که کمی قبل از سی سال زندگی زناشویی به موجودی واحد تبدیل شده بودند که از وسط دو نیم شده باشد.	that by the time they had been married for thirty years they were like a single divided being
بعد دالان سوم را هم تا آخر نخ بادبادک رفته بود	he followed a third to the fullest stretch of the kite line
نمی تونم بیش از این واسه رهایی صبر کنم	I can't wait to let go.
گرچه این دو حقیقت کام لا جدا از هم بودند.	although the two facts were quite unconnected.
آنگاه یک دنده بزرگ را برداشت و بی سر و صدا خارج شد.	staggered off speechlessly hugging a huge unpicked rib in triumph to its breast.
که به موقع به محل خود برسد. حقیقة نیز هنوز شکارچیان به محل خود نرسیده بودند	the huntsmen had not yet reached their places when
تا بدان وسیله از شرکت در مراسم جشن عذر بخواهند.	so they would be excused attendance at the ceremonies.
بعد ناگهان صدای چند تیر و فریاد بلند شد.	then all of a sudden there was an explosion of fire arms and a cry.
پس ممکن نیست که او را دوست نداشته باشم.	splendid, and I could not help loving him.
صرفا از روی جوانی دختر نادانی را به مخمصه انداخته است.	also that this was one of those youthful affairs which spelled license and future difficulty for some unsophisticated girl.
امر را در نظرش چنان جلوه داد که گمان کرد	he could perceive something
می تونم به گم این فکر چون الهامی که از آسمان نازل شود به ذهنش رسید	of course he might say the thought came to him as an inspiration
سعی و کوششم در این است که با قوت قلب و اطمینان خاطر حرف بزنم.	I'm always making efforts.
از تماشای این منظره. غمی ناگهانی بر دلم نشست.	not the gay sparkling sea I had looked on first.
با خونسردی تمام در برابر آبشخور به قدم زدن پرداخت.	began with a stately air to march up and down in front of the trough
دستش را گرفت و با وی به صحبت نشست.	took him by the hand, and spoke to him.
در اینجا همه وسایل رفاه و آسایش برای مردانی نظیر تو فراهم است.	I have all the convenience for young men like you.
نیازی نبود به صفحه نگاه کنم تا ببینم چه کسی پشت خط است.	I didn't have to look at the screen to know who was calling.
پا را بی جوراب در گالش کرده بود در اتاق انتظار ایستاده بود	with galoshes on his bare feet, stood in the anteroom.
آن را با چنان خشمی به صورت بزچران کوبید	sent it full in the goatherd's face
اما شوهرش درست از همان اولین شب زناشویی متوجه این قضیه شد.	until her husband realized what she was doing on their wedding night.
هرگاه ما خود موفق به کشف حقایق شدیم دیگر به سایرین اصلاً کاری نداریم.	if the truth is once elicited, they shall go scot free.
زیرا برای اینکه رنج خود را به پایان برم دارم	I have found a better remedy for my grief
من درخواستم را تکرار کردم و او این بار خیلی خشک تر تکرار کرد باید صبر کنم.	I ventured to remind the good man of my own business also
بیانیه تزار و آخرین اخبار قشون را بگیرد و برای ایشان ببرد.	both the appeal to the people and the news from the army.
من مطمئنم که اون برای تو حاضره هر کاری بک نه.	I bet he'd do anything to help you.
یک ایده خوب تنها چیزی است که به آن احتیاج دارید.	one good idea is all you need to start a fortune.
سرداری و کلاه خود را که در مدخل تالار آویخته بود برداشت.	went and took down his hat and cloak, which were hanging by the door.
من در تختم به سمت جایی که او در کف زمین دراز کشیده بود غلت زدم.	I rolled in my bed toward where he lay on the floor
من تمام جریان را برای او تعریف خواهم کرد!	I shall tell him all about you!
کاغذهایم مثل پرندگانی بی روح پخش شدند و به زمین ریختند.	my notes fluttering to the floor like listless birds.
صفیر زیر سوت در فضای گرم جنگل طنین انداخت.	blew upon it several modulated blasts that rang far across the heated air.
من پوستم را هم روی آن خواهم گذاشت ولی عاقبت باید ببرم.	I cannot rest until I have retrieved my losses.
با معاذی ری از قبیل اینکه دخترش هنوز بسیار جوان است	with the tender age of his daughter
من تصمیم گرفتم بوسیله روزنامه از او سپاسگزاری نمایم.	I made up my mind to write to the papers to thank him
البته نه از این لحاظ که من او را لایق این سعادت میدانم	not that I think he deserves it
حاضر نبود در این مورد با پسرش هم رأی شود.	was not inclined to share his son's opinion.
لیکن این ماجرا آن قدرها به طول نکشید و نیازی به آنان پیدا نشد.	but the fighting was too petty for that call.
او این مطلب را با چندین آزمایش توجیه کرد	as he demonstrated by several experiments
روحیه ی عالی و هیجان ذهنی همیشگی بعد از تحرک جسمانی را به همراه آورد.	excellent spirits, and that keen, intellectual mood which with him always accompanied violent physical exertion.
به خاطر اوقاتی بود که به جای حاضر کردن درس ریاضی نامه نوشته بود.	for the moments stolen from arithmetic to write her letters
آن بانو کاری کرد که متوجه این موضوع بشوم.	the lady made me feel it.
سپس مدتی دراز جلو یک مجسمه که سرش از خزه سیاه شده بود و یک کفل کم داشت به تماشا ایستاد.	then he remained for a long time in contemplation before a statue whose head was perfectly black with mould, and one of whose hips was missing.
توضیح داد که اگر دیرتر از این خانه برود والدینش بر او خرده خواهند گرفت.	her parents would object to her staying out so late.
نمی دونم دولت این چیزارو چطور درست می کنه!	I don't know how the government arranges that
اما بزودی خودداری کرد و با صدای آهسته شروع کرد به حرف زدن.	but she controlled it soon, and spoke in whispers
به قدری از ماندن در اینجا خوشحالم که حد ندارد.	I am so glad to be here.
اگر روزی تقدیر تمام وجودم را از شما دور کند و من برای همیشه از حضور شما محروم بشوم قلبم همیشه با شما خواهد بود.	with you it would remain, were fate to exile the rest of me from your presence for ever.
به گمونم بهتره من عمل دزدی رو انجام بدم	I think I'd better do the actual stealing
بعد ارقام و اعدادی را از مغزش بیرون کشید و جلوی او جمع و تفریق کرد.	to prove it she ran up a long column of figures in her head and gave him an estimate then and there.
به وی گفت که امروز یا فردا بی شک پیکار آغاز خواهد شد	explaining to him that there would probably be an engagement that day or the next
او با بیم و امید چشم به راهش بود	for herself to which she looked forward with trembling hope
معمّائی که شاید تنها برای کسی که بخواهدمعنائی در آن بیابد معما باشد.	an enigma which perhaps is no enigma except for those who seek some meaning in it.
سوال بفرمایید و من نیز با کمال صحت جواب خواهم داد	ask me and I will answer with the utmost exactitude
با قیافه پر طمطراقی که بسیار مؤثر بود اعلام کرد که خانم ارباب فرموده	announced, with an air of majesty, which was highly effective, that it had pleased his mistress
آخر امر بر خودش مشتبه شده و بیش از شوهر خودش را تسلی خاطر داد	she ended up by consoling herself with her own lies.
ه دسته سواران که از زیر سم اسبانشان گرد و غبار بلند میشد و در جاده سلطنتی پیش میتاختند خیره میشدند همان جاده ای که به دست پدران برده آنها ساخته شده بود	to the cavalcade raising the dust of the crumbling camino real made by the hands of their enslaved forefathers.
چین کوچک روی بی نیش برای دگرگونی آماده بود.	the little ripple in his nose was a preparation for metamorphosis.
سایه مردی نمایان شد که پان چویش را تا گردنش بالا کشیده بود.	arose the figure of a man wrapped in a poncho up to the neck.
هر کسی که برای آدم مهم باشد از این جا رفته.	everybody one cares for is gone.
گویا حادثهء آن روز بعدازظهر که برای اسکار لت رخ داده بود آنان را عصبی کرده بود.	there was a difference due to their alarm and shock at what had happened that afternoon.
که در اطراف آن ده هزار نفر موضع گرفته بودند	around which tens of thousands fell
تا ابدالاباد کار کنند و بجنگند و پیروز شوند و به دار آویخته شوند سیصد میلیون آدم هم چهره.	perpetually working, fighting, triumphing, persecuting three hundred million people all with the same face.
به هر حال من قبلش در مورد گرگینه ها بهت گفته بودم	I already told you about the werewolves, anyway.
که دورش را از همه طرف خشکی گرفته با آن توهمات مربوط به دزدی دریایی که میان ساکنان خشکی کنار رودخانه درباره اقیانوس رواج دارد بار آمده بود.	had yet been nurtured by all those agrarian freebooting impressions popularly connected with the open ocean.
