اما چون دخترک را زشت یافته بود زود و با احتیاط توجه از آنان برگرفته بود.	but, finding the girl homely, he had speedily and carefully kept out of the way.
بار دیگر با ذره بین به وارسی آن پرداخت.	he looked over it again with a convex lens.
چون به آنجا رسیدم به فاصله هشتصد گز از کرانه چیزی در دریا دیدم که مانند زورقی واژگون بود.	I observed, about half a league off in the sea, somewhat that looked like a boat overturned.
یا کسی را بفرستد تا زاغ سیاهش را چوب بزند.	or to ask someone else to do it for her.
می خوام روحم و با روحت پیوند بزنم و ببینم چه چیزی باعث این تغییر شده.	I want to join spirits with you and see what inspired this change.
احتمالاً برای ذهن بسیار منطقی تو به هیچ وجه جالب نیست.	will probably be very uninteresting to your severely practical mind.
کلیسا تنها ساختمانی بود که به غیر از عمارت گرینج پای کاترین تا آن زمان بدان رسیده بود.	the chapel, the only building she had approached or entered, except her own home.
اما در نیمه راه متوقف شد چون مارتین برق فلز را دیده بود.	which he stopped midway, for he had seen the glint of metal.
اما وقتی جلوتر رفتم متوجه شدم شخص دیگری در اطاق است	but, on advancing, I saw a second person in the chamber
زیرا در آن صورت هردو طفل دارای یک سرشت خواهند بود	for then, and not till then, when both children were equal
جرأت نکردم که لبه تیز را بر وی فرود آوردم	for I durst not strike with the edge
من هم پاهایم را به هم جمع کردم و آن را روی زانویم گرفتم و زنک به حرف زدنش ادامه داد	I clapped my legs together on it and she went on talking.
به شرح جزئیاتی پرداخت که منجر به مرگ آن دختر بچه و فرار او شده بود	which led up to and included the death o fthe little girl and his flight
از یک شیر دیگر بخار ارغوانی معطر و غلیظی بیرون آمد و در سطح آب شناور ماند.	a third sent heavily perfumed purple clouds hovering over the surface of the water.
ولی از آرامش و خوشبختی سابق بسیار دور بود.	but she was far less tranquil and happy than before.
سپس برای اینکه به رزمین نیفتد دو دستی دیگ را چسبید.	then clung for support to the copper.
سریع کمی بیش از حد سریع ولی هیچ کس آنجا نبود به طرف دفتر رفتم.	I walked swiftly a little too swiftly, but there were no witnesses across the tiny campus to the office.
یک روز که سرزده وارد اتاق رود لف شد او مثل کسی که با این آمدن مخالف باشد ابرو در هم کشید.	that one day, seeing her come unexpectedly, he frowned as one put out.
آنقدر شکمتونو پر کن ین تا به ترکه. بعدش هم بمیرین.	fill your dam bellies till dey bust and den die.
سعی کردم تا راه مودبانه ای برای پرسیدن این مساله پیدا کنم.	I tried to think of a polite way to ask.
اما به هر حال دیگر آرامش صرف برای من چندان مهم نیست.	but anyway, I never cared much for just plain peace.
دو لنگرگاه داشت که اطرافشان را خشکی فرا گرفته بود	had two fine land locked harbours, and
اما عجب این بود که همه با یک خط نگاشته شده بود.	but the singular thing about these letters was, that all four were written by the same hand.
اِما امیدوار بود باز با هم دوست بود کمکی به از سر گرفتن دوستی و رفاقت کند.	she hoped it might rather assist the restoration of friendship
خودت گفتی که نمی خو ای با من دوست باشی	I thought you didn't want to be my friend.
آن را به نوبت به دیوارهای ادارات و مؤسسات مختلف آویختند	it was displayed on the walls of all the public and private institutions
از اسبش پیاده شد و تا هنگامی که گله گاوی نگذشتند او را تنها نگذاشت	had got down from his horse to walk by her side until he had quite protected her from a passing drove
در آن لحظه احساس کردم که در آن جمع زیادی هستم و باید هر چه زودتر از آنجا خارج شوم.	I began to feel unmistakably out of place in that pleasant family circle.
مهمانان منطقی و آرام با یکدیگر بگفت گو پرداختند.	the guests began to converse sensibly and quietly with one another
هر کدامتان کاردش را در آورد و تیغه را میان دندان بگیرد و پاروب بزند.	every mother's son of ye draw his knife, and pull with the blade between his teeth.
دی گه اینکه شما پونزده فرانک جریمه نخواه ین داد.	that you will not haveto pay fifteen francs.
در این امید که راه گذران بر قبرش آن دهان اندازند.	in the hope thatpassers by would spit on his tomb.
که گویی با لعاب به سرش چسبانده شده است مرتب کرد	that it seemed to be made of one piece with her head and covered with varnish.
قبل از این که باران شدت بگیرد برگشتم منزل.	reached home before the rain was much.
ممکنه یکی از همین روزها به دردم ون به خوره	they might come in handy one of these days
بنابراین شب که شد به حیوانات هنوز غذا نداده بودند.	so that when evening came, the animals were still unfed.
من در ین جیب یک جفت عینک و یک دوربین جیبی و چند چیز کوچک سودمند داشتم.	wherein there was a pair of spectacles a pocket perspective, and some other little conveniences.
چون بیشتر مایل بود فکری را که در سر داشت پی بگیرد.	more intent on pursuing the thought in his mind.
همان قدر که این احتیاج را در من بیدار کند که جای دیگر هم آن را دیده ام.	long enough to leave me with the unsettling feeling that maybe I'd seen it someplace before.
یاوران فنی ناچار خواهند بود بهر حال خودشان کارا به انجام برسانند.	the technical assistants would have to do all the work themselves in any case.
بگذارید لااقل چیزی همراه خود ببرد که نماینده دخترهایش باشد.	he shall at any rate take one thing that may represent his daughters into the grave with him.
تا یک نکتهء نهایی را هم به تنهایی به هم صحبت کنیم.	let us have one final word alone.
رفتار ربرتا بسیار طبیعی و دور از تصنع شده بود.	manner was now that the ice between them had been broken.
بلکه از این رو که خیلی بدان نزدیک بود و فاصلهٔ کافی نداشت.	he was not near it, he had not recoiled from it.
حلقومی که چنین صداهایی از آن خارج گردد باید بریده شود.	nothing could excuse it, unless you were having your throat cut!
قاضی چنان نگاهی به پیرزن کرد که دوباره باعث اضطراب ذهنی او شد.	he looked at her keenly and almost made her feel uncomfortable again.
باز هم نتوانید یقین کنید که درست چه هست.	yet be undecided as to what it is precisely.
با مردی ازدواج کند که او از پدرش متنفر است	marry a man whose father he detested
حسد را با سلاح جوانمردی و بزرگی روح مغلوب سازیم	envy by generosity and nobleness of heart
در این حال باید وقار و ابهت او را تماشا کرد.	you should see his gravity!
اما یک ماه و سپس یک ماه دیگر گذشت و سکوت همچنان بر دوام بود.	but a month passed, and a second, and still there was silence.
به اون و همسرش اجازه دادن که در بستر مرگ پسرش ون حاضر به شن.	he and his wife were allowed a deathbed visit.
که مرگ یک فرد ممکن است در منظر دنیا چه تغییرات شگرفی ایجاد کند.	what enormous changes the death of any given individual may produce in the very aspect of the world.
از ای نرو ناگزیر بود سراسر موعظه را با تنگ خلقی گوش کند سخت از او نفرت پیدا کرده بود.	had been obliged to sit through with an inward snarl.
دم در رفتم. سپس برگشتم و تمام قوایم را جمع کردم.	I walk to the door, then turn round with a stern face.
از این حالت او استفاده کردم و به تمرین نفس کشیدن پرداختم.	I used her momentary distraction to experiment with breathing.
گردن کلفت خود را به زور برمی گرداند که خود را بهتر تماشا کند.	how he looked at himself, clumsily turning his powerful neck.
قول بدین که دی گه از این کارها نکن ین.	that you won't do anything like this again.
قبل از این که بپرسم اینو می دون ستم.	I knew before I asked.
چون حداقل بیک نفر نیاز داشت که سر تفنگ را از ته آن تشخیص بدهد.	because he needed at least one man who could tell one end of a gun from the other.
که حاضر نشده بود با دختر احمقی ازدواج کند.	for refusing to marry a girl who was a fool.
شخصا کیف دستی کوچکی را که همیشه کلیدش را با خود داشت زیر بغل گرفت و نخواست آن را بدست دیگری دهد.	he took in his own arms the little valise the key to which he still wore on his person, and would permit no porter to touch it.
بهتره زودتر اینکا رو بکنیم تا اینکه بذاریم دیر به شه.	I'm thinking sooner rather than later for that.
ولی آخر با کدام صبر و شکیبایی بتوانم این ظلم را تحمل کنم	but how am I to take it patiently when your worship wants me
اما همین که با نگاهی سریع جائی را که آن همه در آن خوشبخت بوده به نظر آورده بود به گریه افتاده بود.	but a sob broke from him as with a rapid glance he took in the place where he had been so happy.
سعی کردم افکارم رو رو هم بذارم تا قانع کننده با شن	I tried to put my thoughts together so they would convince him.
باید به شما بگویم که او در رشته حقوق تحصیلات عالی کرده	I should say that he was bred a lawyer
ولی وی هنوز سر جایش ننشسته بود که بار دیگر گریه را سر داد.	but he was no sooner seated than he began to cry afresh.
متوجه شد که سرنوشت با آن زمین خوردن به پشتکار او جایزه داده است.	he had more than enough reasons to believe that destiny had rewarded his perseverance with a providential fall.
باز هم اینکه این اتفاق به طور مسلم او را وال گیر بسازد یا نه خود قابل بحث است.	still, whether that strictly makes a whaleman of him, that might be mooted.
فرشتگان نیک و بد همه شرکت داشته باشند گستاخی و جسارت بیش از دلاوری و شجاعت دخیل است.	with angels, good and bad, to help them it is rashness, and not valour
دژ هم آنجا در طول آن باریکه آب کثیف اخم کرده بود.	there the fortress scowling across the strip of dirty water.
می دونم که نمی تونی سر از همه چیز دربیاری.	I know you can't catch everything.
ولی بعد از مدتی بوی بد قطع شده بود.	but after a while it had gone away.
به درهای چوبی خانه ها ضربه میزد درهایی چنان سست و فکسنی که در وقفه های سکوت میان ضربه های تندرآسا و پی در پی او صدای خرخر و نجواهای خواب آلود ساکنانشان به راحتی به گوش میرسید.	at the wooden sides of dwellings so flimsy that the sound of snores and sleepy mutters within could be heard in the pauses of the thundering clatter of his blows.
من نام او را در شمار اسامی مهمانان ثبت خواهم کرد.	I'll put his name down.
با چشمانی آتشبار بیمار خود را رفته رفته به حال آورد و سر او را بر شانهء خود تکیه داد.	staring, recovered her charge by a regular series of gradations, and coaxed her to lay her drooping head upon her shoulder.
حال که نمی تونم به اور کنم باید برم.	I can't believe, and therefore I must go.
از شدت تقلا کردن از آب بیرون افتاده بودند.	had broken out in boils.
ضمن سایر موشوعها فصل بسیار جالبی نیز درباره وال گیری داشت.	among other subjects, contained a very interesting account of its whale fishery.
آن وقت از مسیر پر پیچ و خمی راه افتادند.	then they wandered down a sinuous avenue
تابلوی سبز شبرنگی نظرش را جلب کردو ایستاد تا آن را بخواند.	a green reflectorized sign loomed ahead and he stopped to read it, slightly amazed.
قرار شد در آنجا تحت بازداشت به سر ببرد تا سرنوشت وی را دادگاه نظامی انقلابی تعیین کند.	he was being held until a revolutionary court martial decided his fate.
از پنجره نگاه کرد و دختر جوانی را که کلاهی بنفش رنگ بر سر داشت دید	looking out of the window she saw the carriage, from which a young girl in a lilac hat
اما سفیدی دست آن زن و النگوهایی که به دست داشت این فرض را باطل کرد.	but the whiteness of the hand and the bracelets we had perceived made us dismiss that idea
اما وسیلهء بستن هرچه بود رنگ آن همیشه همان رنگ خون بود.	ligatures various in kind, but all deep of the one colour.
بلکه بدتر شده و چنان شدت یافته بود که هر لحظه بیم آن داشت که در زیر این فشار تحمل ناپذیر از درون منفجر شود.	but was intensified, and reached such a pitch that she was afraid every minute that something would snap within her from the excessive tension.
زیرا بر حسب اتفاق در محاسبه خود یک رقم اشتباه کرده بود.	quite out of shape, by happening to mistake a figure in the calculation.
اما با وجود این نیم نگاهی هم به اطاق من نینداخت که من با زحمات بسیار دلپذیرش کرده بودم.	but he never gave a glance at the room I had been at pains to make pleasing to the eye.
به علاوه اطمینان داشتم به موقع خود همه چیز را خواهم فهمید.	besides, I was sure to hear in time.
من که فقط با همان دیدن همه روزیش خوشبخت بودم!	I was so happy at the mere sight of her!
از بعضی مطالب کلی که از آنان استراق سمع کرده بودم	as I gathered from some general words I overheard among them
با این همه ممکنست بر اثر ضربت ناگهانی شکاف بردارد	might happen to crack by too great a shock
درست در همین آن تیری صفیرکشان به طرف او آمد و از کنار بازویش رد شد.	at the same time a bullet whistled close by his arm.
فکر نکنم اون رایحه تا حالا به مشامم خورده با شه	I don't think I've ever smelled that fragrance before.
چون آن را در طبقه بالا جا گذاشته بود.	for it was upstairs
بار اول یک خواروبار فروشی و بعد تعمیرات دوچرخه.	once a grocer's, and once a bicycle repair shop
به یاد ندارم که چنین چیزی را دیده باشم.	I do not remember seeing it.
من نمی تونم روی خودم حساب کنم و چنین قولی بدم .	I could not count on myself to keep such a promise.
مثل ترسی که باید از نگاه مردم پنهان بماند	like fear that cannot be shown in public.
جهان جمله برای او و به نیت او ساخته شده بود.	the world was made for them.
من یک پشیز برای این زن ارزش قائل نیستم.	I don't care a twopenny damn for her.
من یا باید با واقعیت سر و کار داشته باشم یا اصلاً با چیزی سر و کار نداشته باشم	I must have the real or nothing.
هیچ کس از این بستگی حتی در صومعه آگاهی نداشت.	no one in the town nor in the monastery
از لحاظ هوش و فراست و دلاوری و شجاعت در جهان طاق و یگانه خاهم شد.	so that I shall be unmatched and unequalled in wisdom and valour.
همه ملتفت این امر شدند. البته بعدها این نکته را بیادآوردند	all noticed it and recalled it afterwards.
بگذارید شما را نجات بدهم و آتیه بهتری برایتان بو جود آورم.	let me save you yet, for better things.
خون دن افکار تو برای من خیلی سخت بود.	I find you very difficult to read.
زیرا بر طبق اطلاعی که او از تشریفات آیین پهلوانی دارد	for, as he understood the ceremonial of the order
مثلاً اختلاف در اینکه گوشت باید نان شود یا نان گوشت گردد	for instance, whether flesh be bread, or bread be flesh
من در خانهٔ خودم و در حضور او نخواستم جزئیات را با شما درمیان نهم.	I didn't like to go into it in our mansion before him.
خود را آرام یافت و از اندیشه زندگی دشواری که در برابرش قرار داشت آزاد و فارغ دید.	for the first time for many months she felt calm and not oppressed by the thought of the life that lay before her.
پس با چشمان فشرده در کناره بیرونی منطقه خطرناک که مرکز دایره آن سر پیرمرد بود مانده بودند.	they remained on the outer edge of the direful zone, whose centre had now become the old man's head.
به همین جهت وضع خانه و خورد و خوراک خیلی بد شده بود.	the dinners had been rather meagre.
انتظار نداشتم که او را با آن سیمای درهم شکسته ببینم.	I had not expected to find her so.
احساس کرد از صدای آن بدنش از درون مثل یخ منجمد شد.	left a frozen echo inside of him.
که این هر دو در نظرش یک مفهوم داشت به بالاشف بنمایاند.	he was in his perception the two were one and the same
باز هم یک موی ابروان خود را بالا نخواهید کشید.	you would not elevate one hair of your eye brow.
مؤدبانه خود را به آستانه در فشرد و سر را خم کرد.	respectfully pressed close to the doorpost with bowed head.
در اجاق را باز کرد و با عصبانیت شروع به سیخ زدن خاکسترها کرد.	slamming the stove door open, and poking vigorously among the cinders.
همه چیز خود را در طبق اخلاص خواهم کرد.	I will throw all on the altar heart, vitals, the entire victim.
همچنین دوست دارم خود را در قلمرو شما معالجه کنم.	I like being doctored too
لیکن چون برای گوادیانا ممکن نیست که علیه سرشت طبیعی خویش سر به طغیان بردارد	as he cannot help following his natural course
بعد هم خیلی عادی و بدون تشریفات و رودربایستی بچه را از بغل اِما گرفت.	to take the child out of her arms with all the unceremoniousness of perfect amity.
شاید او را برای مدتی به جایی دور از اینجا ببرم.	I may take her away somewhere.
بعد با کیسه به جان هم میافتیم و ضمناً اسلحه ما نیز یکسان است.	we will fight at bag blows with equal arms.
چه با خودی نشان دادن در عموم و چه با گاز گرفتن کسی.	either through shifting in public or through biting someone.
با لباس سواران و دلاوران و با کمربند و شمشیر و موزه و مهمیز.	now receive me in the dress of an officer, with a sword at his side and spurs to his boots?
وی آن را به یک چشم به هم زدن باز کرد	she had turned it and thrown back the lid in a twinkling.
پریدم تو کرجی و پارو زدم و دور شدم.	I didn't wait, but shoved out and paddled away easy.
ضمناً دهقانان را از سایر مردم جدا میدانست و به طور کلی با دیگران مخالف بود.	so too he knew the peasantry as something distinct from and opposed to men generally.
موجود دم انفجاری هر لحظه ممکن است از جایش برخیزد.	the skrewt would be regaining the use of its legs at any moment.
هیچ معلوم نبود مالک جدید برای چند جفت پا جوراب ابریشمی نیاز داشته باشد.	there was no knowing how many pairs of legs the new proprietor might require hose for
این بار هم بر روی دو جلدش ایستاده بود.	still scuttling on its covers.
چون میان خریدار و فروشنده روابط دائمی برقرار است	since it is necessary that there should be a perpetual intercourse of buying and selling
که به خاطر اتفاقات پیش آمده در آن وقفه افتاد.	which was thus naturally interrupted.
بهتر است هرچه زودتر قبل از ان که بفهمد چه اتفاقی در شرف وقوع است گورمان رااز اینجا گم کنیم	let's get the hell out of here before he finds out what's been going on.
کمر خود را در میان حلقه بازوی راست او رها کرد.	allowed him to put his arm about her waist, an easy
برای تصادفی چنین غیر قابل انتظار حیرت انگیز بود	filled with surprise at an incident so unlooked for.
من آن تپانچه را فقط برای آن همراه برده بودم که اگر مورد حمله قرار گرفتیم از خودم دفاع کنم	I had brought it only to defend myself if attacked
چهارپایه نخست را با چوبی که قلابی داشت از دنبال خود برداشتم.	drew up the first after me with a hooked stick.
در حالیکه قبلاً از ماجرای بدبختی وی مطلع شده بودند	who had already ascertained his misfortune
گمانم خیال داشت پررویی و سماجت را به جایی بکشد تا همه از رو بروند و بگذارند بروند و او و دوک بتوانند فرار کنند.	I reckon he thought he'd keep the thing up till he tired them people out, so they'd thin out, and him and the duke could break loose and get away.
به هیچ قیمت حاضر نبودند جای خود را به ایشان واگذارند.	these officers would on no account yield their position.
آن هم در روز روشن و درهای گشوده بر آفتاب.	loved her in full sunlight and with the doors open
بعد انگشتانش را خشک کرد و چای را در فنجانش گرداند.	then wiped her fingers, and washed the tea round in her cup.
ولی اربابم نیرو و سلامتی خود را باز نیافت.	yet my master gathered no real strength
از آخرین شیفت گشتم نخوابیده بودم و الا نم می دون ستم که خوابم نمی بره.	I was tiredhadn't slept since my last patrolbut I knew I wasn't going to sleep.
بعد شنید که آن را در دنده ۳ و بعد ۴ گذاشت	heard her switch to third as she dropped behind the first rise.
از درد وحشتناک که به واسطه حمل وی بر تخت روان بود	he lost consciousness from the terrible pain of being lifted onto the stretcher
یک دست زیور برلیان و یک دست هم مروارید.	a set of diamonds and another of pearls
دوباره هر دو علائم حیرت از خود آشکار کردند.	they both looked with new signs of wonder.
چون توقع و انتطار این پسر از بابت ارث بردن از قبل به رسمیت شناخته شده بود.	whose rights as heir expectant had formerly been so tenaciously regarded.
به همان اندازه درخور اعزاز و احترام خواهم بود	I shall be all the more honoured
از وقتی که چشمم کور شد بغل هیچ زنی نخوابیدم	I ain't been out with a woman sence I los' my eye.
از صندلی برخاست و بیرون زد و پا به گریز نهاد.	she was up out of her chair and fleeing.
که گویی خود شیطان در دل شب به زور وارد اطاق من شده بود.	as if it was the devil himself who had thus broken into my room at the dead of night.
با دقت توسط یک معمار خوش فکر ساخته شده بود.	but circumspectly, by a single architect with one idea in his head.
چرا از طرف پول برای بازی ورق یا اعمال زشت دیگر متأثر است	why though he grudged spending money on cards or anything harmful
فقط اسکار لت حس کرد که آه کوتاهی کشید.	but she thought he sighed slightly.
ساعتی بود سنگین و مفت وش و پر لز کنده کاری . با زنجیری زیبا و طلایی .	heavily embossed, from which dangled a chain with many fobs and seals.
به شکل و صورت او درآمده باشد تا او را مغلوب و من کوب نشان دهد	some one of these may have taken his shape in order to allow himself to be vanquished
این طوری می تونستم در یک ساعت سر چند تا کلاس حاضر به شم.	that's how I've been doing several lessons at once, see?
این را گفت و دنده را زد و کامیون روی جاده دور شد	he put it in gear and pulled away down the highway.
به مادرانی با نوزادان کوچک به پیرمردان بیمار در هر سه روستای پیرامون معدن.	of the mothers with the young babies, of every sick old man in the three villages.
هر دو خواهر مثل گل سوسن سفید و لطیف بودند.	both sisters were fair as lilies.
سپس شتابان از در تاریک حیاط گذشت و از خیابان شنی باریکی خود را به در ساختمان رساند.	I may be right back, hurried along in the shadow through the gate and up a walk which led to the front door.
این یک قمار مرگ و زندگی است باید آن را بسیار جدی گرفت.	it life or death, and a close run.
ترکیبی از دو ویژگی که برای اندوختن دانش درباره داروها مساعد تشخیص داده شده بود.	conditions of texture which were also held favorable to the storing of judgments connected with drugs.
ذخیره اضافی از آب اضافی برای استفاده بعدی در چهار معده مکمل خود دارد.	just as the camel crossing the waterless desert carries a surplus supply of drink for future use in its four supplementary stomachs.
سپس برخلاف انتظار و بی آنکه بدانم که چرا و چگونه چنین شده است	when I least expected it, I know not how
همان ترس و بیم که هنگام فشردن لب خود به گونه پدر و یقین حاصل کردن به اینکه آنچه در تابوت است دیگر او نیست	the horror that had seized her when she touched him and convinced herself that that was not he
یا زنی از همان محله که ماموریتش چندان هم معصومانه نبود.	or some woman of the quarter whose errand was nothing so innocent.
این خطر وجود دارد که دخترش عشق مردی شود که قصد ازدواج ندارد یا شوهر خوبی نخواهد شد.	her daughter might fall in love, and fall in love with someone who did not care to marry her or who was quite unfit to be her husband.
به شما خواهم آموخت که چگونه باید رفتار کرد.	I will teach you to behave yourself.
من نمی گم اون ها مجبورن با ما بجنگن	I'm not saying they have to fight with us.
من جرأت کردم که از آن درخت دور شوم و راه خود را در پیش گیرم	at which I ventured to leave the tree and pursue the road
چون معلوم نبود کشتی چه موقع حرکت خواهد کرد.	for there was no telling how soon the vessel might be sailing.
اشتیاق بسیاری داشت که امتحان کند آیا تلفظ آن کلمات همان اثر مشابه را دارد.	he had the curiosity to try if his pronouncing them would have the same effect.
اما به قدری ناتوان بود که نتوانست حیرتی از خود نشان بدهد.	but he was too far gone to express surprise.
در حالی که باز یل را در بغل گرفته بود	took him in his arms
میل دارم با او آشتی کنم و دوستش باشم.	I want to be friends.
این دخترها حاضر بودند در ازای دستمزدی ناچیز کارمزدی کنند	girls who were willing to work for the very little they could earn at the current piece work rate until
از هر دو قایق ریسمان زیاد به آب انداختند	they paid out abundance of rope
آن وقت دخت ره با او مثل سگ رفتار کرده بود.	he had been treated like a dog.
که کی و چه وقتی شما را میل و دماغ باشد که به من جواب خواهید داد.	the time of again being received into your good graces?
تمام مقدمات لازم کفن و دفن پیرزن را هم شرح دادیم به سراغ دادیم	have made all necessary preparations for the old woman's funeral
می خوام تو همین خو نه بغل به بینمش.	I want to see her right next door.
تا زمانی که به آخرین راهروی خلوت رسیدند نایستادند.	until they turned a corner into the last, deserted passage.
که هرچه به فکر ضعیف بشری خود کمتر میدان دهیم	let us be persuaded that the less we let our feeble human minds roam
چهار شکاف برای بیرون آمدن دست و پایش داشت.	with rips for arm and leg holes.
انسانی بدون نام و نشان و بازیگری خرده پا در این نمایش وحشتناک.	a spear carrier, third from the left, a bit player in this terrible play.
ولی بیایید تا به اتفاق این حضرات که همه خیرخواه شما هستند به ده خود بازگردیم.	let us return to our village with these gentlemen, who seek your good
آقای لینتون پسرک را که از خواب بیدار شده بود از آن پایین آورد و روی زمین نهاد	the sleeper being roused, was lifted to the ground by his uncle.
به اطراف دویده دور خود چرخید چنانکه پیراهنش چون بال نی باد کرد	whirled round it at full speed with her dress puffed out like a balloon
در حالیکه آب داخل سه چهارم دایره که با بازوهای شنی محدود گردیده بود.	while inside the three quarter circle enclosed within the arms
حضور من در آنجا به حد کافی مایه گفتگو بود	my presence often gave them sufficient matter for discourse
اضافه کرد ضمناً این پیش آمد فایده کلانی نیز در بردارد	said there was some comfort in that too
زن من معتقد است که هرکس باید با همسر و هم شأن خود ازدواج کند	for she won't hear of anything but each one marrying his equal
با یک حرکت موجی دیگر صدها کیسه خواب ارغوانی رنگ پدیدار شد.	another wave, and the floor was covered with hundreds of squashy purple sleeping bags.
او محکوم به فرورفتن در ریگ روان شده است.	he is condemned to be engulfed.
اما چنین توضیحی هرگز به ذهن من خطور نکرده بود.	but just that explanation had never occurred to me.
نگهبان را نزد خود خوانده دست او را به دست گرفته بدو گفته بود	when the day was just breaking, and taking his hand, said
او نیز از مدرسه اخراج شده بود اما به او اجازه داده بودند در مقام شکاربان در هاگوارتز بماند.	expelled but allowed to stay on as gamekeeper.
آن اینکه اموات پاسخ راست و درست به من خواهند داد	that they would certainly tell me the truth
اما معمولاً تام گرفتارتر از آن بود که از در استفاده کند.	but as a general thing he was too crowded for time to make use of it.
چنین احساس کرد که شبح خود را به روی او افکنده	felt that it stood above him
یک به یک به گواهی تای توس شناسائی شدند.	held up and identified in turn.
اما سپس آن تکان مبدل به حرکتی نرم شد.	but afterward the motion was easy enough.
عموی من پس از معامله کردن آن کشتی که از آمریکا در آن حرکت کرده بود آن را خریده بود.	purchased by my uncle after bartering away the vessel in which he sailed from home.
امیدورام مرتکب اشتباه بزرگی نشده باشم که او را با خودم به اینجااوردم	 'I hope I didn't make a terrible mistake bringing him here.
اما دیگر هیچ کس در آن سوی نهر نبود.	but there was no one beyond the ditch now.
خلاصه آنکه من هم ممکن است دل ببازم و دوست بدارم	in a word, that I am capable of being attracted and falling in love
آن موی زنده این شخص بود که بافته شده گرد سرش انبار شده بود.	the living hair braided and coiled round and round upon his head.
که دیگران از کارهائی که در کذشته انجام داده بود بو برده باشند	the caution of it as well as the possibly impending resentment in case it should turn out that any one suspected him of a practice of this sort
وسائل آسایش مرا تا آنجا که از دستش برآمده بود آماده ساخته بود.	made everything as convenient as she could.
پیوسته مفتون این هوس بود که خود در مسابقه شرکت کند.	he had longed to ride a race himself.
آمدن من باعث شد که او از مرکب خیال به زیر آید.	cloth under water, when my entrance put her meditations to flight.
داشت که سرش به بزرگی و خوش قوارگی بالاتنه ی خوش ترکیب و نیم برهنه اش مینمود .	that her head was equal in size to the elegantly rounded bust, of which so much was exposed in front.
چیزی رو که دخترشونو کشته از بین به بره	the thing that killed their daughter is slaughtered
زیرا که ترسید از اضطرابی که در صدا دارد زندانبان چیزی درک نماید	he feared that the emotion of his voice would betray hiM
در این صورت چیزی که باید بگویم یا بیندیشم این است که	what wouldst thou have me say or think
مثل این که اون در و از مو نده.	you believed the door was open
ورجه ورجه کردنش را در چمن بی که جرئت کند انگشتی بجنباند.	flit in the grass, without daring to move a finger.
چند تام از این کبری تا که هر جا بزنی می گیره.	some of these new fangled things they call lucifer matches.
چنانچه دشمن حقیقة بخواهد به جناح ین ما حمله کند	that if the enemy were really going to outflank it
سایر خبرنگارها نیز که همگی متأثر شده بودند هر یک به سهم خود داوطلب کمک شدند.	others as well offering to do anything theycould and all greatly moved.
ولی باز آن جرأت و شهامت را نداشت که حرف بزند و آنچه را در دل دارد بر زبان آورد.	yet could not summon courage to speak out.
حق نداشتند بخش بالای بدنشان را بپوشانند یا با خود چتر حمل کنند.	not allowed to cover their upper bodies, not allowed to carry umbrellas.
اما چوبدستیش را به سمت بخاری خاموش گرفته بود	but she merely pointed it at the empty fireplace
آن خانم و دیگران فقط در آینه بودند و وجود خارجی نداشتند.	she and the others existed only in the mirror.
شتابان به گردش برود دستورات درهم برهمی به مباشر خود داد و خاموش شد.	blundered in his talk while giving orders to the steward, and at last stopped
از پشت میزهاشان به سوی میز بلند به حرکت درآمدند و رای گیری شروع شد.	from their tables to the high table, and the election began.
در این فکر بودم که نکند این همان چیزی بود که بلوند شرور در تمام این مدت انتظارش رو داشت.	I wondered if that's what the poisonous blonde had been hoping for all along.
که شاهزاده طرح آن را کشیده بود ضرورت داشت.	had to be of a special shape the prince had himself designed
در آن هنگام باد فرو نشسته و آرامش کامل برقرار شده بود	the wind ceased, and it was a perfect calm
جایی که این بار غیر قابل تحمل را از پشتم پایین بگذارم.	someplace to put this unbearable weight in my chest.
از تناقضاتی که در رفتار او دیده بودم متحیر شدم.	I was puzzled by the contradictions that I saw in her behaviour.
با آنکه دمیدن روز هنوز امری مربوط به آینده بود دیدم بهتر است از نو برخیزیم.	we felt like getting up again, though day break was yet some way down the future.
قولش درباره همه چیز حجت بود مگر درباره نوزادان و آشپزی و موتور.	the authority on everything in the world except babies,cooking, and motors.
شنیدم که یکی از بانوان بزرگ درباری که چندین بچه داشت	I was told that a great court lady, who had several children
بعدها هم اگر چنین تدبیری کارآمد نبود تدبیر دیگری خواهم اندیشید.	if one expedient loses its virtue, another must be devised.
با حالتی گرفته و رسمی این دختر را همراهی کردند	attended her with a stiff formality.
این تب مدت چندین هفته طول کشید و او را به نحو خطرناکی ضعیف کرد.	which hung about him for many weeks, and reduced him sadly.
قدرت دو پیاده همیشه از قدرت یکی بیشتر است	two pawns are always stronger than one
بنده یک راز بزرگ را در تصرف خود دارم که مربوط است به یک شخص	I am in possession of a secret concerning an individual.
جالب آنکه دکتر به محض شنیدن این حرف نفسی به راحتی کشید.	now, interestingly enough, at mention of the fact that she was married, he breathed easier.
پس بیایید تا در اینجا لباس خود را عوض سازید.	you must change your clothes
در اثر یکجا نشستن طی آن مسافت طولانی کرخت شده بودم.	I was stiff with long sitting
در نخستین احساس دوست داشتن و دوست دات شه شدن اندوه جایی نداشت.	the first sense of loving and being loved excluded sorrow.
لکن این عقیدهٔ من نیست بلکه احساس من است.	not conviction, but feeling.
برای آگاه شده اعلی حضرت سخن را از اینجا آغاز کردم که سرزمین ما عبارتست از دو جزیره	I began my discourse by informing his majesty, that our dominions consisted of two islands
به خاطر همین باز گوشزد کرد که مدت دیدارش از آن ربع ساعتی که قرار گذاشته بودند بیشتر نشود.	which determined her not to allow the visit to exceed the proposed quarter of an hour.
وقتی به هم گفتن باید برم حالم تغییر کرد.	when they told me I had to get off the place
منتها نمی دونم چطور باید خودمو از شرش ون خلاص کنم.	yet I don't see how I am going to get out of it so soon.
که خودش با او دوست شده و اینک از معاشران نزدیک اوست.	friend of him and that he was now chaperoning him locally.
سپس دست بر زورق نهادم و بار دیگر آن را به پیش راندم.	then gave the boat another shove.
به مأمور گمرک صورت بارها و امتعه تجارتی را دادم و به مأمور بهداری نیز تذکره مرور را تسلیم نمودم	I gave the custom house officers a copy of our bill of lading and as to the other papers they sent a man off with the pilot to whom I gave them
با آرامش و وقار رخوتآمیز در آن خانه های بزرگ با دیوارهای بلند و کور و درهای مشرف به مراتع و کاکل های ژولیده از بادشان.	dispensed with a sort of slumbrous dignity in those great houses presenting long, blind walls and heavy portals to the wind swept pastures.
به امید آنکه هوس را در دل او بر انگیزاند	concerned with the only facet of him which interested them
به افتخار میهن عزیز خود و همچنین به خاطر اینکه شگفتی دربار را برانگیزم بیش از حد معمول طعام خوردم.	ate more than usual, in honour to my dear country, as well as to fill the court with admiration.
معمار لوله بخاری موفق شد با مفرغ چیزی کوچک بو جود آورد.	the architect of the stove has succeeded in making a pretty thing out of bronze.
قادر نیست از این بیشتر بار اندوه تنهایی را در ماند رلی تحمل کند.	he can't bear that great empty house,
مجبور شدیم آن را با یک پاکت سیگار معامله کنیم.	we had to give him a whole packet of fags for it.
گفتم که تو شانس نداشتی. حرفات اینو ثابت می کنه.	dee! I said you'd had bad luck and what you've just said proves it.
اگر شما را ترساند فقط مرا صدا کنید تا بیایم تو.	if she frightens you, just call and I'll come in.
تا به قول خودتان رفیق و دوست شما بشود .	as you call him, to make a friend of!
با این حال قیافه آن زن به نظرش آشنا رسید.	but her face seemed familiar.
چون مطمئنم که مقدار زیادی از این عصبانتی ها به علت نامعلوم بودن وضع تو است.	because I am certain that the greater part of your irritability comes from the indefiniteness of the position.
اما این برای خودش بهتر است. سعی کنید راضی شود.	but for her sake try to persuade her to go home.
من آن قدر احمق نیستم که وقت خود را به هد دهم و از دست زور بنالم.	I am not so foolish as to waste my time in vainly moaning and groaning in protest against force.
نباید خودتو مثل یک مادر مهربان و سر به زیر جلوه بدی .	matronly dove grays and lilacs tonight.
هنگامی که در کوپهٔ خود را باز کرد زن هنرپیشه را در آنجا نشسته یافت.	as he opened the door of a compartment, he saw the actress sitting there.
در حالی که گفته بودند نهایت همکاری را با ما خواهد کرد.	but the inspector had been asked to cooperate fully.
بیش از این روا ندارم تو را زحمت بدهم.	I will not detain you
باید به چیزی ایمان داشت و ایمان هم داریم و	something we must believe in and do, and whatever that something may be called
به همان شکلی که کیت نخستین بار او را دیده و در نگاه اول عاشقش شده بود	the way he looked when she first fell in love with him
دابی که به سکسکه افتاده بود مثل عروسک بزرگ و زشتی روی تخت نشست.	he sat hiccoughing, looking like a large and very ugly doll.
بنابراین از اینکه تا تنگ غروب به تعویق بیفتد چیزی از دست نخواهد رفت.	not much the forlorner for being delayed till dark.
اگرم منو دار بزنن حاضر نیستم دی گه به این بیمارستان برگردم!	I won't go back to the hospital if they hang me!
من تنها معشوقهٔ تو نخواهم بود بلکه زن وفادار و کنیز تو خواهم شد و برای تو کار خواهم کرد.	I won't be your mistress, I'll be faithful to you, I'll be your slave, I'll work for you.
هرچه باشد امّا تند باشد و به مقدار زیاد!	so it's strong, and plenty of it
بار دیگر فرو ریخت و از پهلوهای بی حرکت وال در دریا سرازیر شد.	falling back again, ran dripping down his motionless flanks into the sea.
فعلاً بیا زخم گوش مرا ببند زیرا درد آن بیش از حد تحمل است.	for the present let us see to the dressing, for my ear pains me more than I could wish.
من هفت دهه را صرف این کرده بودم که چیزی به غیر از آن باشم	I'd spent seven decades trying to be something other than that
یادم رفته بود که تو هم مثل خودمی و ممکن نیست بدون هدف کاری رو انجام بدی.	I should have recalled that you are just like me and that you never do anything without an ulterior motive.
معذرت میخ وام که بیش از حد احساساتی شدم	I'm just a bit overcome.
از گیاهان گسترده بر آن حتی یکی جا به جا نشده بود.	they had not displaced a leaf of the herbs with which it was strewn.
یقین بدانید که دیگر برای من هیچ امیدی باقی نمانده است.	I am past all hope, indeed.
خوشوقتم به اطلاع شما برسانم که تهدیدی که ما به شذت نگران ان بودیم در شرف بر طرف شدن است.	I am happy to inform you that the threat with which we have all been so deeply concerned is about to be eliminated.
اما پیش از اینکه آویزونت کنند یکی دی گه میاد پشت تراکتور میشی نه	but long before you're hung there'll be another guy on the tractor
شمشیر و سپر به دستش دهد تا در پناه آن به سوی فیروزی برود.	provided that they could be turned to sword and buckler, and that, sheltered by them, they could march on to victory.
یا تا آخرین نفر صفوف دلاورشان در عرصه افتخار و شرف شربت شهادت بنوشند.	or till the last warrior in our valiant ranks has perished.
هر موقع دلم بخواد می تونم به هر کدومشون زنگ بزنم	I could call him up tomorrow if I wanted to.
ولی چند قرارداد را که باید با خودش ببرد در دفتر جا گذاشته است.	he left some contracts at the office that he needs to take with him.
حالا یه کمی بهترشدم ولی هنوزم همه جام پرازخلطه.	I took some aspirins and it's gone back some, but I'm still full of snot.
به چیزی نیاز دارم که همه توجهم را به خودش جلب کند.	I need something to focus my attention.
در حالی که تنها جلیقته کوتاه خود را پوشیده بودم	only in my short waistcoat
حالا آن طور که باید و شاید ارضا نشده است.	would yield its proportion of pleasure.
تو هم هرچه را دلت بخواهد در گوشم نجوا کنی.	you can whisper in my ear any crap you can think of.
با آن که هرگز آن قدر مست نمیشد که اختیار از دست بدهد	though indeed he was never so drunk as to lose all control of himself.
سپس به ملایمت چفت را بلند کرد و در را به جلو راند.	then raised the latch timidly and opened the door.
قبل از چشم پوشیدن از صد هزار روبل میل دارد که با و اجازه دهم به من امیدوار باشد.	he wants me to give him hopes of myself before he lets go of his hundred thousand roubles.
غریدم و رگباری از ناسزا از گلویم خارج شد.	I roared, and a volley of snarls erupted from my throat.
لذا آن مواد سائیده شده را روی بستری از شوره در حال گرم شدن در کوره رها کرد	he left the material warming in a bed of manure
نشاط من با غمخواری تو به همین حد که اندوهم بر اثر جنونم رسیده است بازگردد.	that thy care will give me happiness in the same degree as my own folly has caused me misery.
بهداشتی بود و راحت و در قلب دنیای مدرن.	was sanitary, convenient, and in the heart of the fashionable world
امیدوار بود کمی که از روز بالا آمد پیش او بروم و بگویم نزد او خواهم ماند و متعلق به او خواهم بود.	hoping I should soon come to say I would stay with him and be his.
لکن انگلیسی بالصراحه گفت که با شخص مورل مخصوصا کار دارم و با دیگری سؤال و جواب ندارم	but the stranger declared that he had nothing to say to MEmmanuel and that his business was with MMorrel in person
اگر اظهار دوستی نماید با کسی که در باطن کمال دشمنی را به او دارد	he feared it would be hypocritical to accost in a friendly manner the man whom he was tacitly opposing
بعداً برای یکی دو تن از دوستانش با صدای بلند بخواند.	he would read aloud, to one or two friends.
از آشنایی و خصوصیت با کسی که این قدر مکنت و ثروت دارد	with the ideas of order and economy which ruled this man
هیچ انسانی نیست که به اصلی از اصول اخلاقی اعتقاد نداشته باشد.	a man can't live without a moral code.
اما غالباً چشم خود را به سوی من برمی گرداندند	but often turning their eyes towards me
وضع عادی جسم او را چنان با اثر ناتوانی پیری دگرگون ساخته بود	impressed on his bearing such senility
با اعتماد به نفس کامل قدم برداشتم و در وسط سرسرای عظیم سنگ مرمری بودم که سر جایم منجمد شدم	I step confidently across the floor, and I'm right in the middle of the huge expanse of marble when I freeze.
همه را برای وارد شدن در این یکی هم به انجام رسانده بود.	he had made inorder to gain entrance into this one.
پنداری در این عالم هیچ فکر و دل مشغولی ای نداشت	as though he had no care in the world
گفتی که امر ازدواج این دو تن با دو خواهر میانشان رقابتی انگیخته بود تا ثابت کنند که کدام یک زندگی بهتر و به سامان تری دارد	as though, since they had married sisters, a kind of rivalry had sprung up between them as to which was ordering his life best
والاّ امروز باید زن شخصی شوم که رسوا شده باشم.	or I should this day have been the wife of a dishonored man.
کتاب قانون پاستور را به دست یکی از شاگردانش داد	gave the zither to one of his pupils
دود غلیظی محل سقوط و انفجار آن را نشان داد.	a little smoke showing the spot where it burst.
ولی حالا که آن لباس را به دور انداخته و یک پیراهن دهاتی به روی بلوز چرمین خود پوشیده بود	but as he had discarded the coat and badge, and wore a short smock frock over his leathers
تا بدانم که در گفتارم عیب و نقصی هست یا حشو و زایدی وجود دارد.	to know whether I am adding or dropping a letter or so in my words.
که آنان ملوانان به اصطلاح آب شیرین و آرامند	that they were just the sort of fresh water swabs
که به خاطر دختر شما موقتاً از القاب و عناوین اشرافی خود چشم پوشیده بود نخواهد زد.	when he gives his ancient name and boundless wealth in return for the beloved hand of this fair lady, now my wife.
همین قدر مسلم است که حریف او قصد شوخی نداشته است.	he rather thought it was no joke to the opposite party.
آن گاه سوار شد و به اتفاق حرکت کردند.	then clambered into the trap, and they drove off together.
اما این حرکت تو جلب دقت مرا به طرف او کرد	but you have, by the step you have taken, called my attention to the paragraph in question
حتی به خاطر داشت که گویا او را هم دعوت کرده بودند.	he fancied, indeed, that he had been invited
به زودی دو زن به تبادل تعارفات معمول پرداختند	soon the two ladies were exchanging compliments
پاهای لطیف تو روی رد پاهای بی قواره من حرکت خواهد کرد.	wherever I stamped my hoof, your sylph's foot shall step also.
اما بزودی وحشت بر من مستولی شد و دست از ین قصد برداشتم.	but I soon rejected that project with horror.
تصمیم داشت اگر راننده سفید پوست بود از او خواهش کند و سوار شود.	determined to beg a ride if the driver was a white person.
هرچه بین شماها بگذرد من با خبر خواهم شد.	I shall hear of every thing that is going on among you.
ولی حال که به اینجا آمده و این چنین دلباخته یکدیگر بودند	but still, now that they were here and in love like this
من بهشون گفتم که نیازی به این کار نیست.	I said I didn't need any electricity
تا آنکه بار دیگر در جریان اصلی سیل قرار گرفتند.	until they were in the raging flood once more.
من فرصت را غنیمت شمردم چند سؤال از او کردم.	I took the chance to ask him a few questions.
محیطی که بیش از اندازه تیره و متراکم بود اما حالتی اثیری و روحانی و تفکر آمیز داشت.	which he felt as dense yet ethereal, unspeakably holy, brooding.
قصد داشتم به طور ناشناس آن را به او برسانم تا با هم بی حساب شویم.	I would deliver something anonymously and call us even.
او گفت در این صورت وی هم به آنجا نمیرود.	he had said that in that case he should not go either.
من یه داداشی دارم که از داداش تو گنده تره.	I've got a brother that's bigger than he is
آنکه به شما گفتم تکلیف من بود زیرا که بعضی چیزها هست که تابع به متبوع و خادم به مخدوم خود باید بگوید و پنهان ندارد اما از دیگران باید به سختی پنهان نماید	I am too well aware that though a subordinate like myself is bound to acquaint the shipowner with everything that occurs there are many things he ought most carefully to conceal from all else
به خود لرزید و گلوله پشم از زانویش به زمین افتاد	the ball rolled off her knees.
پرده ضخیم سرخی را که تقریباً نزدیکم بود کشیدم	having drawn the red moreen curtain nearly close
چون نه در علم تشریح دستی داست و نه زیاد در این موضوع دقیق بود.	much posted in anatomy, and not hypercritical, anyway.
دوست دارم به آن بیشه کاج در آن بالا برسم.	I should like to get into those pine woods up there.
آنچه دارم پس از مرگم برای او به ارث بگذارم.	bequeath her at my death whatever I may have to leave.
هنگام که نوبت ما در رسید به یاریمان بشتاب.	when our times come, help us.
اما اجازه نیافتند دست به تعمیرات داخل خانه بزنند.	but they could not get any authorization to continue the work inside.
تا آن هنگام که آن را از زبان خود او شنید	until he had heard of it from herself
در قلب زمستان چنین سربازی برای دفاع از خودش در برابر ناملایمت هوا در میان دشت و صحرا جز بخار نفسش چیزی ندارد	in the depth of winter he has to defend himself against the inclemency of the weather in the open field with nothing better than the breath of his mouth
زیرا آن بیچاره تقصیری و گناهی ندارد و سزاوار مصسبتی نیست	for she deserves not even the shadow of the misfortune
پس از آن سربازان باز هم تفنگهاشان را پر کردند و دوباره به شلیک کردن پرداختند.	after which they reloaded their weapons and began again.
بن ابر این به صلاح خودتان است که پیرامون این موضوع کنجکاوی نکنید.	so keep your noses out if you know what's good for you
به خصوص از آن رو که پیدا بود له وین گفته وی را نپذیرفته است.	especially because he evidently did not believe what she had said.
بیگانه مورد بحث دست خود را از عقب قایق خود تکان داد بدین معنی که این کار به کلی غیر لازم است.	the stranger in question waved his hand from his boat's stern in token of that proceeding being entirely unnecessary.
به خاطر این نیست که او در گذشته چه بوده	is not what he was
باعث شده بود یک مرتبه آینده را پیشگویی کند.	had allowed her that clairvoyance
اما ارلاندو زمانی آن را تزئین کرده بود که برای این فلز شوری در سر داشت.	but she had furnished it when she had a passion for that metal.
خوشحال بودم که لازم نبود جوابش را با صدای بلند بدهم.	I was glad I couldn't answer her aloud.
در عین حال صورتش را بالا نگه داشته بود تا اگر رت تمایل داشت او را ببوسد.	but remembered to turn her face up slightly so he could kiss her with no difficulty.
بنابراین بروم تو و ببینم مگ چه کار کرده و کلی تفریح خواهیم کرد .	I'll go and hear the fun, and have a good laugh over it.
دانکلار که اصرار داشت در دادن این لقب به او	who persisted in giving the young man that title
ولی نامه آن قدر صریح و رک بود ک	but the letter was so explicit
تو باید نیمه دیوانه باشی که خواب من را ببینی	you would have to be half mad to dream me up
ضربات سخت خشم خود را بر سر و روی او فرود آورد.	the whole weight of his wrath fell on her.
هویدا بود میل دارند با یکدیگر سر صحبت را بگشایند.	both were evidently anxious to start a conversation.
سرش را بلند کرد و چشمش به گربه افتاد	he looked up suddenly at the cat
اما برای ادامه حرکت به بیش از یک یا دو واحد انرژی نیاز ندارید.	but then you only need one or two units of energy to keep moving.
این بگفت و شروع بچرخان دن توپ بر روی زانوی خود کرد.	she said tenderly, and at once began wheeling the cannon to and fro on her lap again.
شما خوب می دونید که چرا من نمی تونم	you know why I can't!
به این شرط که اگه صدای خر خر بند آمد	with the understanding, if the snoring stopped.
جایی که حتی یک روز هم در آن کار نکرده بود.	where she had never worked a day of her life.
با خشونت مرا عقب زد و پیراهنش را بست	pushing my fingers out of the way and hastily rebuttoning his shirt.
خرسند بود همان جا بماند و مجذوب تماشا کند.	was content to stay there watching, fascinated.
با آن که علاوه بر آن زن اشخاص دیگری هم آنجا بودند به خود جرأت داده	. though others were there besides the woman I ventured the
لذا به همان ضربات اول پشت به میدان کردند	so they speedily made their escape from the fray
همه شادمان و تحت تأثیر تمایلات روا نبخش گوناگونی قرار داشتند.	everyone seemed to be in high spirits and under the influence of a variety of exciting sensations.
اما ممطئن نبود که آن روز بتواند سر صحبت را درباره این مطلب خطرناک باز کند.	not at all sure that on this first occasion he would be able to broach the dangerous subject.
به عقیدة من کار بسیار جوانمردانه و بزرگوارانه است	I think it handsome.
سر صحبت با آقایی که چای تعارف کرده بود باز شد.	this introduced a light conversation with the gentleman who offered it
بیشتر از این کاری از دستم بر نم یاد.	damnedest in mysumming up, and that's all I can do.
تا نهایت سعی اش را برای نابودی داروندارتان به کار برد و شما را به جلوی میز قاضی صلح بکشاند.	he'll do his best to do you a mischief, and then bring you up before the justice of the peace.
این حرکت کاملاً به مرد بلندقامت و باوقاری چون او برازنده بود.	the gesture sat well on a man as tall and graceful as he was
اما این جوان پرت حواس چنان بر اثر آمیختگی زی رو رو شدن امواج با افکار خود دچار ناآرامی تریاکی مانند رؤیاهای میان تهی دور از هوشیاری شده است	but lulled into such an opium like listlessness of vacant, unconscious reverie is this absent minded youth by the blending cadence of waves with thoughts
خشم بی افسارِ شاهی ربوده شده در آن چشمان راه یافت.	into them came the unbridled anger of a kidnapped king.
در جوهر فرو بردش و باز نگاهی به نوک آن انداخت	dipped it in the ink and examined it again
مطمئنم دل تو دلت نیست که کمد رو ببینی.	I'm sure you're dying to see the closet.
بلکه قربانی مردها و فدای یک مرد رذل و فاسد شده است	that she is the victim of circumstances the victim of a wicked libertine.
این بود که تند تند مشغول ورق زدن کتاب شد.	so she began to turn the leaves.
پنج تن از ایشان را در جیب قبا نهادم.	put five of them into my coat pocket.
من ساک و چمدانت را داخل می او رم.	I'll bring your bags in.
اما همه ناراحتی خود را در فریادی نشان داد	but they betrayed themselves only by an exclamation.
خود را به جای او گذاشت و احساس ترحم کرد.	she felt for him, put herself in his place, and was sorry for him.
جانور وحشتناک انگل مانندی را که در شهادت گاه او لانه گزیده بود.	the terrible parasitic animal that had incubated in his martyrdom.
دریافت که این حربه سلاحی خطرناک است و نباید بار دیگر به کار برده شود.	saw that this weapon was a dangerous one, and that it could not be used a second time.
مصممانه تصمیم گرفت به هر قیمتی شده ثروتمند و مشهور شود تا لایق او باشد.	he made a fierce decision to win fame and fortune in order to deserve her.
به همین علت هم موقع ورود اِما سکوت و آرامش برقرار بود.	which accounted for the previous tranquillity.
که ظاهرا به علت خستگی مفرط دیروز از پا افتاده بود.	who had been unmistakably overworked on the previous day, was off his feed and out of sorts.
اما همین که پشتش را به طرف پسر تازه رسیده کرد	as soon as his back was turned
یا کاری را که با سه حرکت انجام داده بود با دو حرکت انجام دهد.	or in three motions what could be done in two.
تصمیم گرفتند در ظرف سه روز دیگر حرکت کنند.	it was arranged that their departure should take place three days thence
نتوانستیم او را در این دنیا به هوش بیاوریم.	never recovered consciousness in this world.
موقعیتی فراهم شد تا این کار را هم انجام بدهم.	have had the opportunity of doing that as well.
از میان لوله هایی که با سوراخ کردن تنه درختان ایجاد شده و بر روی پایه خرکها سوار شده بود به توربینها میرسید	sent its water rushing along the open flumes of scooped tree trunks striding on trestle
درست یک سال پس از آنکه مادرم مرا به دنیا آورد و سر زا رفت.	just one year after my mother died giving birth to me.
لکن دو روز به خودم مهلت دادم زیرا پاهایم هنوز قادر بحر کت است.	but as my legs can still carry me, I put it off for two days
که خبر به سرعت فراوان در میان مؤمنان و دیر پراکنده گردید	that the news swiftly reached all the monks and visitors in the hermitage, promptly penetrated to the monastery
من با حالتی گوش به زنگ سرم را بالا کردم.	I look up, alert.
از قهرمانان مبتذل و احساسات معتدل که نظیرشان در طبیعت زیاد است بیزارم.	I detest commonplace heroes and moderate sentiments, such as there are in nature.
حس میکرد در سینه اش چیزی مانع تنفس میشود	something within oppressing her breathing,
حدس زدم که در آن اتاقی کسی یا چیزی هست. به آهستگی به آن اطاق انبار رفتم .	I went slowly to the door of the store , and looked round the edge of the door.
ولی به نظر من بهتر است از دوئل چشم بپوشیم .	but it would be better for you not to fire.
لذا با عجله خودش را شست تا زودتر از حمام خارج شود.	she bathed herself more quickly than usual so that the man would not be in danger.
خوابی که هرگز با بی خودی کامل همراه نبود.	, during which she never quite lost consciousness.
عجب ادم بی شعوریه که نمی فهمه من کوکتل صورتی میخ وام	can't he tell I want a pink cocktail?
من می دونم که این زمین آن قدرها به درد بخور نیس.	I know this land ain't much good.
با این اختلاف که آنان به آخر رسیده بودند و او سعیش را به آخر رسانده بود.	with this difference, that they were finished and he was completed.
عمو ورنون مثل همیشه با او سلام و احوال پرسی کرد	greeted him in his usual fashion.
مانند جوانهائیکه امیدهای زیاد در سر میپرورانندتبی عارضش شده بود.	he had fallen a victim to that fever of the brain that accompanies the too vivid hopes of youth.
مگر اینکه آن مرد سر به سرشان بگذارد که این رابطه. به معنی دوست داشتن آن زن است.	if he can kid her that he's in love with her.
معلوم بود دخترک فنجان مادرش را شکسته و آنقدر ترسیده است که از همان دیشب فرار کرده	that the child had broken a cup of her mother's and was so frightened that she had run away the evening before
حال آنکه دیده است چه دوست باوفا و آسایش بخشی بوده است	seeing what a faithful friend and comforter it must have been
به خصوص دست چپش که رو تحتی بیرون مانده بود.	about him, and especially about the left hand that lay outside upon the coverlet.
او بعضی از اطلاعات خصوصی خودش را در اختیار من گذاشته است.	but the professor happens to have some inside information.
چرخهای ارابه تان را با مشروب معاوضه میکند و میلهای در دستگاه خرمنکوب میتپاند تا از کار بی اندازدش	barters the tires of the wheels for drink, drops bits of iron into the thrashing machine, so as to break it.
پهلوان هنوز از شنیدن این صدای دهشت خیز فارغ نشده است	then the knight, almost ere the awful voice has ceased
چمدان قهوه ای رنگی در دست داشته که به چمدانی که در دادگاه نمایش داده بودند شباهت داشت.	carried a brownbag, something like the brown bag there and then exhibited to him.
تمام راه آنچنان تند و یک نفس حرف زده بود که فرصتی نگذاشته بود .	she asked when they were finally home and were seated on the front porch.
در حالی که دمش را لای پاهایش نگه داشته بود	tail between his legs.
او نم از جوونی که ظاهرش مثل یه دختر بچه بود!	she exclaimed to the portresses of the quarter, a young man like that, who had the air of a girl!
آن را برای وی فاش سازد با ازدواج ایشان موافقت نخواهند کرد	for this there were secret reasons he could reveal only to her
موهایی که تک تک از دم اسبی او بیرون زده بودند را درون خود کشید	catching the individual flyaway hairs in her ponytail
همین کافی است که در یک چشم بر هم زدن به مقام امپراتوری برسید.	wide enough, however, to make you an emperor in the twinkling of an eye.
دست پوشم را برداشتم و به رفتن ادامه دادم.	I took up my muff and walked on.
آنگاه به دنبال آقای سفیدپوش به درون اطاقی رفت.	followed the gentleman with the white waistcoat into the room
من به طرز خطرناکی نزدیک به شکستن در چیزی بودم که نه انسان بود و نه گرگ.	I'd been so dangerously close to fracturing into something that was neither human nor wolf.
برای همین بغلش کرد و پاشنه و رکشید که راه بیفتد.	so he picked her up and turned on his heel to leave.
یک نفر سروان ارتش خود را به بالای پشت بام ایستگاه قطار رساند و جای ستوان را گرفت.	a captain took the place of the lieutenant on the roof of the station and with the horn he signaled that he wanted to speak.
یعنی نوعی دام شیطانی آن هم درست در مرکز معصومیت خودش.	a diabolical trap at the center of her innocence.
مادر شما نیز که من افتخار آشنائی با او را دارم از این شایعه آگاه است	I have had the honour of making your mother's acquaintance
ولی بلافاصله با غریزه یک روباه پیر همه چیز را به وضوح درک کرد.	but then, with the instinct of an old fox, he saw everything clearly.
اداره امور کشتی را به دست خود گرفته بودند.	took the government of the ship to themselves.
در واقع نه به اون سختی که در نظر داشتم.	easier than I planned to.
که ظاهرا در دو مورد مصرف داشت هم مغز دشمنان او را پریشان کرده هم خاطر او را آسوده ساخته بود	which, it seemed, had in its two uses both brained his foes and soothed his soul
تقریبا به همان اندازه بدبخت و به طور کلی همچنان ممتنع است که یک زن بچه نداشته باشد.	quite asimpossible, as a woman without children.
جانوریست در آن سرزمین که اندامی بسیار ظریف دارد و بلندی آن در حدود دو گز است	an animal in that country very finely shaped, about six feet long,
متهم است به اینکه معشوقه کارگرش را مضروب و سپس در دریاچه غرق ساخته است.	is alleged to have stunned and then drowned his working girls weetheart
به نظر من وی دست خوش عشقی آتشین و شاید هم خطرناک بود	but it certainly did seem to me that the man was full of passion, and not, perhaps, quite healthy passion.
سعی کردم لبخندی بزنم اما دهانم خشک شده بود.	I try to smile but my mouth is suddenly dry.
هر طور بود ظاهرش را حفظ کرد و لبخندی زد	even managed a natural smile
غم و خشم ترکیب عجیبی در ذهنش به وجود آورده بودند.	grief and anger choking utterance
سعی کردم پوزخندش رو برگردونم. اما فهمیدم لبخند روی صورتم ماسید	I tried to grin back, but I could feel the smile mangle on my face.
غافل از آن در تاریکی مطلق با این تصور که خودش در مرکز بحبوبه و ماجراهاست.	utterly in the dark, and imagining himself to be in the thick of things.
بیش از شش فوت قد و احتمالا بیش از صد کیلو وزن داشت	well over six feet tall, she must have weighed three hundred pounds.
تا فردا مملکت از جریان دستگیری او باخبر خواهند شد.	by tomorrow night there'll be a cry all through the country.
آن را به حبس مؤبد با اعماق شاقه مبدل کرد.	his penalty to that of penal servitude for life.
از پشت پرده دود هیکلی که شولا پوشیده بود و کلاه به سر نداشت نمایان شد.	amid the smoke appeared the figure of a bareheaded man in a peasant's coat.
خود بر پهلوی او بر عرشه نشستم تا از او مراقبت کنم.	I sat on the deck at his side to take care of him.
در حالی که ملزم به داشتن آن ابزارها نیستند	though in no wise obliged t o furnish them even so
از خواسته سگ اطاعت کردم و به طرف مسافر رفتم.	I obeyed him, and walked down to the traveller
یک دست که شمع توی آن بود از پشت یک سنگ پیدا شد!	a human hand, holding a candle, appeared from behind a rock!
به خاطر دارم که در آن وقت حتی به نظرم بیشتر به یک لباس سواری شبیه بود تا به یک لباس معمولی.	I remember that I thought it, in form, more like a riding habit with the superfluous skirt cut off, than anything else.
در این میان نگاه گذرایی به سقف سحرآمیز آن انداخت که امشب ابری و تیره بود	but had barely glimpsed the enchanted ceiling, which was black and cloudy tonight
گوش ظریفش را برای شنیدن اعترافات ناگوار آماده کند.	finely modeled ear presented for the sullying.
دست پوست و استخوان او را در دست گرفت.	took his thin, parchmentlike hand in hers.
همین کنجکاوی شدید سیری ناپذیری را به قوت در خود احساس کرد.	he always felt the same keen feeling of tremendous, insatiable curiosity
که صدای زنگی از پله اتاق وی لفور شنیده شد.	when a ring was heard at the door bell
تقریبا دو ساعت و نیم از ظهر گذاشته بود.	IT was late now, nearly half past two
تا آنکه به ته همان محوطة صاف و هموار و وسیعی رسیدیم	until we came out upon the dull waste
که شخص محترم کلاه گیس بر سری که تاکنون به سقف داگاه خیره مانده بود	when the wigged gentleman who had all this time been looking at the ceiling of the court
اما این جا هوا هنوز مثل شب تاریک بود.	but here all was still dark as night.
با این علاقة وافر به گیاه شناسی و جانور شناسی در اینجا زمینة نامحدودی برای کار در اختیار دارم	with my strong tastes for botany and zoology, I find an unlimited field of work here
یعنی وقتی که همه گمان می کردن هیچ خطری او نارو تهدید نمی کنه.	just when everyone thought they were safe.
آن هم فقط به شرطی که کاملاً تسلیم بشوی و ساکت بمانی	it is only on condition of perfect submission and stillness
باتلاق عاقبت آن حیوان را به کام خود کشید.	it sucked him down at last.
من راحت اینجا لم داده بودم و منتظر بودم به پام بیفتند.	I was sitting here complacently, waiting to be kowtowed to
دی گه حاضر نیستم بیشتر از این صبر کنم.	hervoice had sounded excited and distressed.
اما قسمت خوبش این بود که از دست من عصبانی نبود.	but the sweet part was that he wasn't furious at me.
هر گرفتاری از این ماجرا به بار بیاید نتیجهء خرابکاری توست!	if any trouble comes of this, it's your doing.
جغدهای قهوه ای رنگ وارد شدند و ولوله کنان بیرون رفتند	the brown owls flew shrieking in and out again.
ولی مثل گذشته کثیف و گره خورده و چرب نبود.	but it was no longer dirty and clotted and tangled.
زیرا هنگامی که بیدار شدم تازه سپیده دمیده بود.	for when I awaked, it was just day light.
با بازوان در هم گره شده در نور مهتاب.	a tangle of arms in the moonlight.
به خاطر دارم که از مشاهدة کراوات او به یاد پرهای سفید قو افتادم.	reminding my strolling fancy I call to mind of the plumage on the breast of a swan.
بطری نوشابة لیمویی و گازدار مجانی ترس را تا ته نوشید.	finished his free bottle of fizzed, lemon flavored fear.
ولی نباید فکر کنند برای من هم لزوماً شادی و لذتی دارد.	but that they shall not chuse pleasures for me.
اما او از کشف اسرار درونی قلب این زن عاجز بود.	but he was unaware of the secret designs of that indecipherable heart.
هرکس چیزی نداند ولو خان و شاهزاده باشد باید در شمار مردم عامی محسوب گردد.	for everyone who is ignorant, be he lord or prince, may and should be included among the vulgar.
هنوز وجودش از خشم و جوش و خروش بود	anger still surging through him
هیچ نمی شه من یه ماشینو تعمیر کنم و زخمی نشم	I never fixed no car in my life 'thout cuttin' myself.
روی هم رفته کار عاقلانه اینست که اعلی حضرت با نخستین فرصت مناسب عذر مرا بخواهد.	it would be advisable in the emperor to take the first fair occasion of dismissing me.
آن وقت بود که فهمیدم ساعت از ده گذشته.	that I realized it was after ten o'clock.
بیش از این کسی حق ندارها چیزی به گه.	that's as far as any man got a right to say.
طبعاً من جا خوردم ولی چیز واقعاً تعجب آوری این بود که چنین اتفاقی قبلاً نیفتاده بود.	I was startled, naturally, but the really surprising thing was that it hadn't happened before.
مادرش در خانه حسابی روی تلفظ و معنی کلمات با او کار کرده.	his mother had worked hard with him at home on spelling and reading.
تا وقتی که همه چیز برای سفر دریا آماده شود.	but leaves her to the owners till all is ready for sea.
تا در تسلی و هم نوایی با مسئولان تشییع شرکت کند.	to confer and condole with the undertakers.
از کنار زمین تنیس و علف زار گذشتند و به بریدگی پرچین ضخیم رسیدند	past the tennis lawn, past the pampas grass, to that break in the thick hedge
لحن آرام او آکسینیا را از کوره بدر برد.	she cried fiercely.
به نظرم یه نفر داره به این سمت میاد.	I think someone is walking down the corridor right now.
ممکنه زیاد سواد نداشته باشم چون تا سال دوم هنرستان درس خونده ام ولی وحشی نیستم	I may never have gone any further than one year of vocational technical school but I'm no fucking barbarian
وقتی که از خو نه گذشتم به عقب نگاه نکردم.	I didn't look behind me as I passed the house.
یکی از آن استادان خشمگین سئوالاتی از منطق از وی پرسیده بود	some fellow in an outrageous collar was asking him questions in logic
آیا دلایلی دارد که با ابراز آن علیه حاکم قتل خود اعتراض نماید.	he was asked if he had anything to say why sentence of death should not be passed upon him.
اما همین که از مشاهده چهره دخترش دریافت که قصد شیطنت و مزاح را دارد	but seeing by her daughter's face that it was only mischief
باید از این جا بروم و کاری انجام دهم.	I've got to take care of something on the outside.
زیرا که حرکت جان انسانی و خفقان زندگی در آن محسوس بود با نظر دقت نگریست.	for the human soul could be felt fluttering there, and life was palpitating there.
او نیز دیگر بدون معطلی با شتاب تمام حرکت کرد.	he started off, without more delay, at the greatest speed he could muster.
بی شک تعداد حریق آنجا بیدرنگ افزایش خواهد یافت.	the number of fires in that district immediately increases.
هر لحظه آماده آنم که بر او نیز بشورم.	ready at any moment to rebel against him.
یه گربه خورشید و باورداشتن اینکه هیولایی درآسمان بولینگ بازی میکنه و به خاطر اینه که رعد وبرق اتفاق میفته	thinking monsters are rolling bowling balls across the sky when it thunders
با حرکت سر به او هشدار داد و به سوی نیمکت بعدی رفت.	they moved another bench further down the road.
زیرا دختران مجبور شدند از صبح زود در صف نوبت بایستند تا بتوانند لگن خود را در توالت خالی کنند و آن را بشویند.	because from dawn on there was a long line of girls, each with her pot in her hand, waiting for her turn to wash it.
لباده بلند کشیشان را در برداشت و بی شک شماس بود.	wearing a shabby blue cassock probably a church clerk and chanter
که اگر به وال سر زا پس از آنکه یک بار زوبین خورد فرصتی داده شود	that, if the sperm whale, once struck, is allowed time to rally
حالا در این فکر بود که چه راه درازی را باید طی کند تا به مقصد برسد.	before he recollected how much he must undergo ere he could hope to reach his place of destination.
یعنی از همان وقتی که او نوزاد کوچکی بود و پدر و مادرش در یک تصادف اتومبیل جان سپردند.	ever since he'd been a baby and his parents had died in that car crash.
زیرا در غیر آن همه ما محو و نابود خواهیم شد.	unless we would all go to pieces in company.
بلافاصله مواد منفجره را در محل مناسبی دربیرون سیلندرهای موتور لوکوموتیو قرار دادم.	I now put them in position on the outside cylinder.
درست مثل آنکه شاهد ریز بار تند و حیاتبخشی باشند.	it was like seeing the start of a good drenching rain.
من و مادرم خود را در وضع بسیار دشوار و خطرناکی یافتیم.	we saw ourselves at once in a difficult and dangerous position.
حق با تو است. من هیچ توجهی به احساسات تو نسبت به این بچه ندارم.	I feel no interest in your infatuation over this girl, that's true
در نتیجه لطف و مرحمت مادرش و از شدت شرم احساس بیماری کرد.	courtesy of his mother'and he was sick with shame.
ا زخود پرسید گفتار و احساسش در گفتگویی که به فوران خشمش منتهی شد تا چه اندازه صادق بوده است.	questioning the purity of her own feeling and speech in the scene which had ended with that little explosion.
نشستم و موهایم را از روی صورتم کنار زدم.	I sat up and pushed my hair away from my face.
من آن کسم که تو مرا فروختی و به دست دشمن دادی.	I am he whom you sold and dishonored
که مادرتان را منع نمایید از اخذ حق خود و رد نمایید تقدیم کسی را	to refuse the life of your mother at the hands of a man
داخل به ظلمات گذشته شده و زمان ماضی را نفوذ کرده	that you have penetrated into the darkness of the past
اما صدای زنگ از شمشیرش برخاست و شمشیر کما نه کرد و از دست لرزانش به زمین افتاد.	but his sword rang, glanced aside, and fell from his shaken hand.
اما او که نخست پلک برهم زده و آنگاه چشمانش را بسته بود.	but he had at first blinked and finally closed his eyes
معلوم بود که کاغذ و کارت را به آ به داده است.	he saw that his note had produced a good effect
آیا از روی عمد آن دختر را به دست مرگ سپرده بود یا از روی تسامح.	whether intentionally or unintentionally he had left herto die.
حتما به خاطر خواب عمیق بود که قبلا متوجه آن نشده بود.	he must have been mostly asleep before to have missed it.
من 37 خون آشام باقی مانده را ارزیابی کردم.	I evaluated the thirty seven vampires that stayed.
در حالی که شوکه شده بودم پلک زدم و بعد خودم را کنترل کردم.	I blinked in shock and then composed myself.
که دیگر وقت رفتن به خانه فرا رسیده است.	it was time they were starting home.
طبیعتا اولین اقدامات خود را از اینجا شروع کردند	they had naturally directed their first inquiries there.
او را دید که آهسته یک قدم دیگر برداشت	she saw him take another step in slow motion
که هرقدر ناله و زاری نمایم هرگز تسلی نخواهم یافت	I am indeed to be pitied I can never forgive myself
اعراب را تهدید کردند که اگر اندک صدایی از هر کدام از ایشان بلند شود	threatening them that if they raised any kind of outcry
اصلاً هم برای آرایش ساخته شده بود نه برای استفاده.	were built for style, not service
اما اینجا که تار عنکبوت پیدا نمی شه ولی شاش همیشه دم دسته	but there ain't no spider web, an' you can always get piss.
هرگاه مایل باشید در انظار عموم از شما پوزش خواهد خواست.	he will ask your forgiveness before every one if you wish it.
این زن پست و فرومایه و منفور چیده است.	the infamous, vile woman!
تمامی قسمت بالایی او و نیز قسمت زیادی که به طور معمول زیر آب قرار دارد به نحو آشکار پیدا شده بود.	the whole upper part of his form, with much of it that is ordinarily submerged, was plainly revealed.
اما دقیقاً به سبب شدت خطر قدرت عمل از او سلب شده بود.	but precisely because of the extremity of his danger he had lost the power to act.
که او وضعیت خود را زمین تا آسمان بهتر کرده است.	the rather admiring look she cast upon her that she was thinking of her as one who had vastly improved her state.
هم احساس خرسندی کرد و هم انصاف پیدا کرد.	the sense of pleasure and the sense of rendering justice
در داخل ارابه زیر پالتوی سربازی دراز کشیده بود.	lay covered with his greatcoat in the wagon.
اگه پدر و مادرش جادوگر با شن باید تو رو به شناسه.	if his parents are wizardin' folk.
بیم آن داشت که روزاموند را اندوهگین ساخته بشد.	her unhappiness was a power which he dreaded.
اطمینان یافت که برداشت نخستین درباره او نادرست نبوده است.	was convinced that her first impressions had been just.
مثل قطعات یک پازل که در جای خود قرار دارند.	like bits of a jig saw puzzle.
در تاریکی ماشین صورتش رنگ پریده و روح مانند بود .	his face pale and ghostly in the darkness of the car.
آنا پیش خود به این نتیجه رسیدند که مصلحت نیست همراه با هم به لیکرگس برگردند.	were dubious on the instant about the wisdom of riding back together.
که به هم بسته شده باشند و یکی از آن دو خوابیده و دیگری برپا باشد.	seemed yoked together like colossal bullocks, whereof one reclines while the other remains standing.
من بیشتر دوست داشتم دراز بکشم و فکر کنم.	I preferred lying still and thinking.
دیوانه دست احساسات پرشور عاشقانه غیرقابل کنترلی شده بود.	she had been carried off her feet by an ungovernable desire.
تا ببینند که آیا این بار شوهرانشان خیلی دمق هستند.	to feel whether this time the men would break.
راه را برای مراسم تشییع پیکر خوزه آرکادیو بوئندیا باز کنند.	rakes so that the funeral procession could pass by.
از پس موسیقی احتیاج به مدتی درنگ داشت تا بتواند دوباره به کار پردازد.	he always needed a certain time in which to shake free of the music before he could apply himself seriously to his work.
اما ا زر وی بو یقین داشت که پرنده آن جاست و بیش از پنج قدم فاصله ندارد.	but by the scent she knew it was sitting not more than five paces off.
اما چون به یاد آورد که سر میز شام نشسته است	but recollecting that he was at a dinner
ما یک ساعت قبل در حضور تمام این گواهان با هم ازدواج کردیم.	we were married an hour since, in the presence of all these witnesses.
که شاید عملی را مرتکب شده که سزاوار سرزنش است و به اطراف خود نگریست.	he had done anything reprehensible, looked round with a blush.
پانسیون رها از مشاهده این وضع به هم نگاه کردندو خنده را سر دادند.	burst out laughing at the sight of him.
روش او این بود که با یک آلت اعمال متناقض انجام دهد.	by contrary operations from the same instrument.
ای کاش به جای ده لیره فقط یک لیره به تو داده بودم.	I wish I had only offered you a sovereign instead of ten pounds.
نه یک جانی بالفطره سنگدل بلکه دچار ضعف ذهنی و اخلاقی است همین و نه بیش.	no more and no less not a downright, hardhearted criminal by any means.
چندین بار بی اراده کلاه از سر برداشته به خاریدن سر پرداخته بود.	several times, to take off his hat to scratch his head.
کودک را در خم بازویش از یاد برده بود.	with the baby forgotten in the crook of his arm.
با این حال حس باصره و سامعه او را در همین لحظه کاملاً گرفتار مصاحبت کسانی بود که تا آن روز با او آشنایی و شناسایی بهم زده بودند.	yet the self same senses were mentally engaged, at the same time, in busy action with almost everybody he had ever known.
بنابراین لازم نیست دیگر به مقر فعلی خود برگردید.	so there is no need for you to return to your present parish.
عیبی ندا ره یه دفعه دی گه بیایم اینجا	it won't matter to come here once more.
اما حالا قصه را دنبال کن قصه بازو را.	but go on go on with the arm story.
منتها این چند روزه به قدری حالم خراب بود که اصلا نای فکر کردن نداشتم.	only so tortured had he been for these last many days, thathe could scarcely think how to think.
رای نر او را در آغوش فشرد و بوسیدش.	he had her in his arms, and was kissing her.
تا آخرین وداع خود را با بستگان پیش از صبح روز بعد تمام کند.	before the following morning, asClyde later learned, last farewells, if any, were to be said.
اما با دیدن تغییر حالت شوهرش دفع تا ساکت شد.	but she stopped suddenly, noticing the changed expression on her husband's face.
دستش را دراز کرد و با همان یک دست ردا را روی سر اربابش انداخت و آن را پایین کشید.	got to his feet, reached up, and pulled them onehanded over his master's head.
زیرا این محل با آن جلوخانهایش خیلی اسرار انگیز و تماشایی بود.	because it was a mysterious place, with those dark arches.
دو بطری شراب غلیظ و یک شیشه خیار شور را در کیسه گذاشت	put two bottles of port and a jar of pickles in a shopping bag
در طول سفر هم فقط ماکارونی سرد همراه با پنیر کرم گذاشته خورد.	eating cold macaroni and wormy cheese.
خیلی خطرناکه چون ممکنه کسی نامه رو مخفیآنه بخونه.	it's too risky in case the owl is intercepted
ولی من فرصت تردید و ادامه ناراحتی به او ندادم و بلافاصله گفتار او را تصدیق کردم و با کمال تعجب در تأیید گفتار زن اسقف از زبان خود شنیدم که بلی.	but I agreed with her at once to save embarrassment, and I heard myself saying boldly, brazenly
با آرنج راستش روی یک سنگ قبر زیر یک بید مجنون تکیه داده بود	she was leaning pensive on a tombstone on her right elbow, under a weeping willow
ما را بگو که چقدر برای این مسافرت پول خرج کردیم	we've been at the expense of travelling
گاه به گاه به تندی برگشته بود تا مطمئن شود که کسی دنبالش نیست.	returning on his track at times, to make sure that he was not beingfollowed.
او حق داشت که بیش از این انتظار داشته باشد.	more than he had any right to expect.
لذا چنان به کوبیدن او پرداختند که کاروانسرا دار بدبخت مجبور شد کمک بطلبد.	so they began to lay on him in such a style that the poor man was forced to cry out, and call for help.
البته منظورم این نیست که پدران فرزندان خود را در انتخاب خواستگاران ناباب آزاد بگذارند	I do not mean that they ought to leave them to make a choice of what is contemptible and bad
دو سال بدین منوال گذشت و ما در خانه مثل سابق بودیم.	for two year going on, and we was just the same at home here as afore.
آیا آن شرکت به کارهای نادرست مشغول بود یا نبود	was that business or was it not a thoroughly dishonorable one nay,
شوهر خودباخته برای نخستین بار دریافت که وضعش چگونه است و به وحشت افتاد.	that for the first time he clearly comprehended his position, and was appalled by it.
من به زودی خود را با این نوع زندگی آشنا خواهم کرد. من تا امروز نوع دیگر بود	because this sort of life is new to me, I've lived rather differently.
نمی دونم اگه من توی گریفندور نیفتم او نا چی به هم می گن.	I don't know what they'll say if I'm not.
وظیفه شما آنست که با او بروید و قلبش را آرام کنید.	you must go off somewhere again to soothe and pacify her.
جز یک کپه خاکستر سرخ و آتشین بر روی زمین	but a smoldering pile of ash on the floor.
فروشنده مطلب را به اطلاع می سون رسانده بود.	this salesman chanced tosee it and recalling him at once made haste to communicate withMason
به طرف خود کشید و سیگاری از آن برداشت.	she pulled closer a tortoise shell cigar case and took a cigarette.
حالا صدا کم شده بود و از دور میامد.	now mercifully faint with distance.
در حالی که از کوتاهی مدت استراحت کمی گیج بودم.	a little giddy from the shortness of my night's rest
نگاهی اجمالی به صورت آدم گیج و مبهوتی انداختم که مرا مخاطب ساخته بود.	I caught a glimpse of the astonished face of the drummer who had announced me.
گویی سعی کرد چیزه ناخوشایندی را به خاطر بی آورد.	as though trying to remember something very unpleasant.
دستور دادند که بامداد روز دیگر درزی ای بیاید و اندازه مرا بگیرد تا یک دست رخت برایم آماده کنند.	ordered a tailor to come next morning, and take measure for a suit of clothes.
چاکران امر شاه را گردن نهادند لیکن من نتوانستم به سبب تنگی جا دو پاروی کوچک خود را در آنجا بکار برم.	by way of trial, where I could not manage my two sculls, or little oars, for want of room.
او تصمیم گرفته بود بلوایی به راه اندازد و من بر حسب اتفاق به زیر دست او افتاده بودم.	he was in a towering rage and happened to come upon me.
با توجه به احساسی که دارم مسلما نمرده ام و کل این ماجرا خانه شب تیره و تار بچه های ساکت در این اتاق تاریک حضور خود من در این جا	feeling for you is certainly not dead, and the whole thing, the house, the dark night, the silent children in this dim room, my very presence here
شهامت آن را خواهد داشت که برخیزد و در جایگاه قرار بگیرد.	he wouldhave the courage to rise and go on the stand
فقط ضعف و تب و لرز و هذیان آنی است!	it's simply the weakness of fever, a moment's delirium,
در دنیا بهیچکس حق داده نشده است که تا ابد پایدار بماند	one has not the right to cling eternally.
لنگ لنگان با آخرین سرعتی که در توانشان بود به پیش شتافتند.	they hobbled forward at the best pace they could manage.
هم ون دختر کوچولوی قبل از جنگ قبل از اینکه فقر و آتش و جنگ و الون روزهای بد از راه بر سه و تو رو در خودش غرق کنه .	a little girl again, before the war and poverty had done things to you.
با دست و بازو راه خود را به قلب جمعیت باز کرد.	shoved, butted, squirmed his way forward into the heart of the crowd.
به مادیانی که خدمتگار او بود فرمان داد که در اطاقی را بگشاید	ordered a mare servant to open a room
آنچنانکه انتظار داشت از برتری علمی شوهرش چندان نصیب نبرده بود.	she had not, as we know, enjoyed her husband's superior instruction so much as she had expected.
اثبات اتهام قاتل واقعی در واقع غیر ممکن است.	for really it would be almost impossible to make a case against the real murderer.
اگر رابطه با زن را به مرخصی سالانه دور از قلمرو خود محدود کند شاید برای همیشه موفق شود.	forever if one limited women to the yearly vacation away from the parish.
آنگاه هردو با هم این سرزمین مخوف را ترک خواهیم گفت	let us both leave this dreadful place
دکتر که حرف او را شنیده بود سعی کرد در کمال آرامش حرف بزند.	the doctor, who overheard the last word, made an effort to speak calmly.
در حالی که انتهای گسیخته طنابی که بدان سلاح بسته بود	while the free end of the rope attached to that weapon
روی سر او که از در جلویی بیرون آمده بود متمرکز شدم.	focusing on her head poking out of the cracked front door.
به حکم محیط زندگی و یا طبع خویش به دام جنون یا شهوت افتاده بودند.	had responded to some heat or lust or misery ofhis nature or his circumstances.
با احتیاط زنبور را در جریان باد قرار داد	carefully drove the bee into an air stream
فکر کرد وقت مطرح کردن آن مشکل رسیده است.	she felt that that particular source of worry had been placed.
در دنیای تجارت آدم باید برای اشتباهاتش تاوان زیادی به پردازه.	there are penalties in the business world for crooked dealing.
به هیچ وجه گناهی ندارد که قیافه من متأسفانه مورد پسند شما واقع نشده است.	is not at all to blame that my face has the misfortune to displease you.
به طوری که همسرش اورسولا با هزار مکافات توانست با یک چاقوی آشپزخانه ریش وی را کوتاه و مرتب نماید تا شبیه آدمیزاد گردد.	with a wild beard that 'rsula managed to trim with great effort and a kitchen knife.
روبه روی زن جوان قرار گرفت و در چشمان او چشم دوخت.	stood looking down into her face while she sat looking up into his.
با چند تا از دوستام صحبت کردم البته نگفتم چه کسی تو دردسر افتاده	I've talked with several fellows without saying who it's for, of course
فقط قدری اماج جلویش بگذارند و این برنامه را در تمام دوره کارآموزی ادامه دهند	keep him on gruel all through the apprenticeship.
خیابانی که خانه و محل اقامت وی در آنجا بود نام برد.	the street where the house was.
با همان اندازه خشونت در دیرهای دیگر بو جود نیامد.	with the same severity in other convents.
به عمرم نقشه به این خوبی به فکرم نرسیده بود.	I never was better pleased with a notion in my life.
پیش از آن که به چنگ عنکبوت بیفتد یک نظر چنگک تیزش را دید.	razor sharp pincers before it was upon him.
مطمئناً الآن هم یک فهرست درجه یک درست کرده.	I dare say she may have made out a very good list now.
طبیعتا منم مجبور شدم هم ون روز عذراونو بخوام و اخراجش کنم.	I got rid of her the same day as I found it out, naturally.
او را مشاهده کرد که در صندلی خود نشسته	he saw him sitting up in his chair
چنان یکه خورد که تعادلش را از دست داد	started so violently that he missed his footing
که اینک از رفقای همرزم دیروزش بسیار دور شده بود	whom he had been fighting side by side only the previous day
برای آن است که در جهان پراکنده شود و جزئی از دستاوردهای انسان باشد.	was meant to be spread over the world and become part of the human gain.
در این اندیشه بودم که این دو را به عنوان پیک به آنجا بفرستم	these two I had thought to send back there as messengers
تو برو پایین او را بیدار کن و به او بگو.	go thou down, and wake him, and tell him.
بلکه در را از جا کنده و به زور به جای ما نشسته است.	they have burst in and seated themselves in our seats.
این سه خانه را چنان خیس کند که آتش نگیرند.	keep those three homes so wet theyd never catch.
که عنایت و استعانت خود را از شما دریغ ندارم.	which is none other than to give aid to the weak and needy.
چون فورا منظور او را از آن همه خوش خدمتی حدس زد.	for she saw through all his devices, the object of his kindnesses.
اکنون تاکجا از او دور شده و فاصله گرفته بود.	how aloof and remote from him she had become now!
با مراقبت کامل که بچه را فشار ندهد و مجروحش نسازد.	taking care that it should nothurt the child
آسانسور و گوشه کنارهای اتاق ناهار خوری خصوصی را پر کردند.	they packed the elevator and the corners of the private dining room.
آن هم با توجه به اینکه ما واقعا معتقدیم پول ریشه همه خبائث روی زمین است	considering that we so earnestly believe money to be the root of all earthly ills
حال که او صادقانه تمامی حقیقت را بیان کرده بود	as now honestly and truly as he was trying to show
ناخدا را دیدم که دراز بدراز بر کف تالار افتاده است	beheld the captain lying full length upon the floor.
اگر معنیش ای نه که باید باز هم مارو ترک کنی.	if it means that you must leave us again.
وی آنچنان به گریه و زاری افتاد و آنسان به سر و روی خود کوفت که به شدت هراسانم ساخت و فکر کردم حتماً دیوانه شده است.	it terrified me. I thought she was going mad
چون زیاد هم همراه یک جنتلمن جوان به سواری رفتن کار صحیحی نبود.	not to drive too often with the young gentleman.
تا این که چشمان درشتش برقی زده و دهانش به لبخندی گشوده شد.	as the big eyes brightened and the mouth began to smile.
همه به حساط رفتند و زیر چنار گرد آمدند.	they went out under the plane tree
این قبیل شوخی و تفریحات در میان ملاحان رواج و شیوع کامل داشت.	both pastimes being, as is pretty generally known, very favourite and common recreations among gentleman of that class.
ولی احتمال هم دارد که در مواردی از پاسپورت خودش استفاده کرد باشد.	but the probabilities are that she also uses her real identity.
پیشخدمتی درست سر ساعت پنج شام را اعلام کرد.	which was announced at exactly five o' clock by a waiter
تکانش داد و نا امیدی را یکسره از قلبش بیرون راند.	thrilling her from despair into expectation.
سپس از اعلی حضرت تمنی کردم که فرمان دهد تا برای مجهز کردن کشتی مصالحی برای من فراهم آورند و خود جواز خروج مرحمت کند.	begged his majesty's orders for getting materials to fit it up, together with his license to depart.
که اینان دو دژ مستحکم دارند که در حداکثر امکان بشری تا ابد نفوذناپذیر خواهند ماند.	they have two firm fortresses, which, in all human probability, will for ever remain impregnable.
برای همین چیزهاست که کسی نباید تنهایی به دیدن مسآبقه به یاد!	is why you should never go for looks alone!
مجبور شدم از ماشین بگیرم تا خودمو سر پا نگه دارم.	I had to grab the car to hold myself up.
گویی اسبی است که بر دو پا ایستاده است.	like a rearing horse.
من از شما ممنون شده و شکرگزار شما خواهم بود.	I will bless you I
دستم را گرفت و سرش را برایم تکان داد	took my hand, and shook her head at me
خیلی سعی کردم راضیشون کنم که اجازه بدن یه ذره دندونامو کوچ یک کنم	I've been trying to persuade them to let me shrink them for ages
که در همین حال درختی جلو چشمش به حرکت درآمد.	but presently a moving object came into sight.
در اتاق او به کلی باز بود و در آستانة آن مردی کاملاً ناشناس ایستاده و با دقت مشغول تماشای او بود.	his door was flung open and a man whom he had never seen stood in the doorway watching him intently.
همه اختیاراتم رو سبک سنگین کردم و تصمیم گرفتم صبر کنم.	I weighed up all my options and I decided to wait.
خودش پنج شش میلی طول و نیم میلی عرض داشت.	it might be five or six miles long and more than half a mile wide.
بگذار اگر قرار است بمیرم باز نزد تو باشم.	he'll let me die with you!
پرستار بچه یا ماشین نویس و کتابدار هم نیستم.	I'm not anybody's nursemaid or typewriter or bookkeeper
آن عطش سوزان عشق مهیج و آمیخته به حق شناسی که میل دارند در طبق اخلاق نهاده و تقدیم کنند	they would only multiply their torments
لباس بعضی از کارگرانی بود که به فکر چیزهای شیک و ظریفند حرف او را برید.	as some workingmen dress who have instincts for finer things.
باید آب و هوایم را عوض کنم یا چیزی مثل این.	I need a change, or something.
او از آن فریاد وحشیانه شرمسار شود و دیگران از آن تعجب کنند	everyone else would have been amazed at it at any other time.
این وضع از روزی پیش آمد که او مرد!	he's looked like that ever since she died.
در صورت پهن او آثار همدردی و تأثر ظاهر شد.	his broad face expressed pity and sympathy.
چند لحظه بعد صدای تاخت اسب به گوش رسید و دوباره سکوت همه جا فرو افتاد.	that they could hardly realize he had been there at all until they heard the spattering of gravel and the mad pounding of a horse going off at full gallop.
به آهستگی روی خود را برگرداند تا با آن بیگانه خداحافظی و از زحماتش تشکر کند که او را تا خانه رسانده است.	turned to thank the gentleman for taking so much trouble as to bring her home.
بدون اینکه برای فهم او سخنی بگوید یا تقلایی کند	without extorting a change of countenance
در آنجا به روی پاهایش بر زمین نهاد تا به پایتخت برگردد.	until he put him down on his two feet on the swamp road.
نگاه انداخت و لبخند زنان برای او سر تکان داد.	he nodded to him, smiling.
بخار در جایی رقیق و در جایی دیگر غلیظ بود	thicker in one place and thinner in another
برای آنان در پیرامون خانه من چاد رهائی بسیار مناسب برافراشتند.	tents built for them very conveniently on each side of my door.
فرمینا داثا گذشته بود که یکی از آن مسائل محال پیش آمد.	an impossible coincidence occurred
که دیدند که آن جوان همان طور در محل خود ایستاده است	upon the menacing figure which pursued them and now stood out with a distinctness still.
لب خود را چنان گاز گرفت که خون افتاد.	bit her lip till the blood came.
گذشته از این جزئیات را برای تو فاش نخواهم کرد	I won't tell you everything.
لبخندی که مخاطب بزرگش آن را به پای تأیید هوشمندانه و تحسین آمیز سخنان خودش گذاشت.	which his big interlocutor took for a smile of discreet and admiring assent.
امّا کسی پاسخ نداد و چون به ساعتش نگاه کرد متوجه شد تازه ساعت نه و نیم است	but no one answered, and looking at his watch he found it was barely half past nine
من دیگر اینجا نیستم که به قول تو سر او کولی بازی در بیاورم!	for I am not likely to come soon again, as you say, to make scenes.
ممکن است اشخاص دیگری هم که با ما ارتباطاتی دارند لو بروند	it might be up with a good many more
خدا کنه زودتر برن سر اصل مطلب چون خیلی چیزهاست که باید یاد بگیریم.	I do hope they start right away, there's so much to learn
آشپز دستش را به علامت ادای احترام به طرف پیشانی خود برد	answered the cook, and touching his forelock
آهنگی که مشغول زدن آن بودم را با پایان نامطلوبی رها کردم و با عجله بلند شدم.	I let the song I was playing trail off to an unsatisfying end, and got hastily to my feet.
بساط اعدام یک مکانیک بی جان نیست که از چوب و آهن و طناب ساخته شده باشد.	the scaffold is not an inert bit of mechanism constructed of wood, iron and cords.
با این وصف اگر راستش را بخواهید تاکنون چنین نام و عنوانی به گوش من نخورده است.	though, to tell the truth, no such surname has until now ever reached my ears.
زمانی را به یاد آورد که در اوج ناامیدی آن شمشیر به کمکش آمده بود.	remembering how it had come to his aid when he had thought all hope was lost
هیرتن نیز تنها راه تلافی را در تنبیه بدنی وی یافته بود.	a physical argument was the only mode he had of balancing the account, and repaying its effects on the inflictor.
جمعیت تماشاچیان از دور به سوی زمین کوییدیچ سرازیر شدند.	the rest of the school spilling onto the lawn in the distance .
او را راهنمائی نکنند آن جوان در تنهائی خویش به چه وضع غیرعادی و دشواری خواهد افتاد.	here unless the family chose to show him at least some little courtesy or advise him cordially from time to time.
باز هم هواپیما تکان شدیدی خورد و بر اثر این حرکت من بالا و پایین شدم	I draw myself up short with a jolt.
که هر کدام مشخصات بنیانی یکی از 450 شرکت عامی را بر رویشان ضبط کرده بودند	each bearing the basic details of one of the forty five hundred public companies
به محض دیدن گدای کور سستی از سرش پرید	at one look the rum went out of him.
در واقع ما اکنون با آتش اردوگاه در یک سطح قرار گرفته بودیم.	indeed, we had already fetched up level with the camp fire.
توی دالان به عقب دویدم تا دورخیز کنم اما باز هم خانه صاحب خانه مرا گرفت	was running down the entry a little, for a good start, when the landlady caught at me
بلکه از فلزی شبیه به طلا یا از حلبی است.	but only brass foil or tin.
بعد پیرمرد میر سه و با گلوله کارشو می سازه.	the old man he rode up and shot him down.
او را با این فکر بزرگ کند که پدرش مرده است.	by rearing her in the belief that her father was dead
در تابوتی که مدت بیست سال در آن خفته بود دفن خواهد شد.	the coffin inwhich she has slept for the last twenty years.
که به اصطلاح کاکل آنان را در دست داشته باشیم	to take time by the forelock, as the saying is
زیرا که هرقطعه از او در دست دیگری فتوای قتلی بود برای تو	for that letter must have led to your condemnation
زیرا شما اکسیر یکی و عقل دیگری را دارید.	as you have the philosophy of the one and the wit of the other
من هم گرفتار عواقب نامطبوع فشار ذهنی زیاد هستم.	I also am feeling some unpleasant consequences of too much mental disturbance
گزارش خبری تو را از مراسم تشییع جنازه تماشا کردم.	I saw your broadcast of the funeral.
پیش از برخاستن فراموش نکردم که از او تمنا کنم در مرحله بعدی به من کمک کند	not forgetting, ere I rose, to implore aid on my further path
آن وقت شاید مرا از دفتر بیرون کنند تا شب را هم در خارج از آن محوطه به روز آورم	or should I be turned out every night
چون که خیلی مغرورتر از آن بودم که نزد کسی به ضعف خود اعتراف کنم.	for I was too proud to confess my weakness to anyone else.
تصور این هم که انسان در موقع عصبانیت چه کارهایی ممکنست انجام دهد	what a man will do, when his blood is up.
باید قبول کند خیلی کار کردم تا توانستم مدرکم را بگیرم.	she ought to acknowledge that I have worked in order to pass.
اگرچه آتش بخاری اتاق را اندکی زیاده از حد گرم کرده	though the room was a little overheated with the fire
از دیدن لباس کثیف به و نی زیاد خوشش نیامد .	I really must get her another habit, she thought.
در میان همهمه صدایی بم برخاست و دستورهایی صادر کرد.	amid the clamour a deep voice was raised in command.
در حالیکه پیش آمد که آند را را از چنگ این شخص خلاص نماید	endeavoring to rid his master of the troublesome intruder
من خودم هنگامی که با او آغاز دوستی کردم با ین صفات پی بردم	I was the first to show, when I very nearly made him a present of my friendship.
حالش طوری بود که انگار نه شک و تردید دارد و نه رحم و انصاف.	looked as if he had very little doubt and very little mercy.
در حالیکه پوزخندی روی لب داشت دهانش باز بود.	his mouth opening in a grin.
به رام مهم نیست که مردم چی می گن .	I don't care what people say
باید وقتی اینجا رسید ببینید چه قدر راحت است.	he'll see how restful it is when he gets here.
همان طور که بی سر و صدا وارد اتاق شده بود همان طور هم اتاق را ترک کرد.	left the room, as quietly as he had entered it.
از شیفون پیش از آن که شوهری داشته باشد	the crinoline being blushed for before the husband
پس از مختصری جستجو. نامه را در میان صدها کاغذ دیگر در کشوری میزش پیدا کردم.	I found the letter in a pigeon hole in her desk
از آن به بعد به عنوان یک همسر خوشبخت زندگی کن.	live henceforth as a happy wife.
قشون ما را دور بزنند و نیروی ایشان زیادتر است نیز صحیح و منطقی بود.	might outflank us, as they had larger forces.
دامن را زیرش جمع کرد و انگشتان را در هم افکند و بر روی یکی از زانوان گذاشت	the skirt of her dress tucked up, and her hands folded on one knee.
اگه این بچه بره به من صدمه خواهد خورد. من اینو از اول بچگیش دیدم.	I shall miss that child. I saw her first when she was atiny thing.
ولی اگر پهلوانانی برای کمک و دفاع از ایشان بیایند	if any knights come to their aid and defence
عطر کف دستش هم شکر و هم روغن و هم نمک مرا به یاد زندگی دیگری انداخت.	the scent on her palm, all sugar and butter and salt, reminded me of another life.
تهدید کرد که اگر حسابش را نپردازد به نحوی که دلش بسوزد از حلقومش بیرون خواهد کشید	threatened if he did not pay to compel him in a way that he would not like.
به قدری خسته شده بود که ناچار روی چهارپایة پشت میز تحریر دکان نشست.	though he still panted hard, and was so exhausted that he was obliged to sit on the stool of the shop desk.
من در مورد سوابق شما اطلاع دارم و خیلی متأسفم.	I know about your background, and I'm really sorry.
تا نشان دهد که او هرگز وجود نداشته است.	in order to perpetuate the certainty that he had never lived.
شوهرش نیز مانند مردهای دیگر او را بدبخت ساخت.	HE did what they all do made her wretched.
این جادوگر مشهور همچنین موفق به کشف دوازده کاربرد جدید خون اژدها شده	for the discovery of the twelve uses of dragon's blood
اما ما همه با چشم و گوش باز مراقب بودیم.	but the remark had set us all on the alert, straining ears and eyes
هیچ کس نمی تونس آن قدر به کاره که بتونه باهاش سوراخ مورچه رو پر کنه.	a man didn't get enough crop to plug up an ant's ass
هیکل او را دید و حالتی از سراسیمگی و حزن بر چهره اش نشست.	caught sight of her, and into the expression of his face there passed a shade of embarrassment and dismay.
من میرم ماشین رو روشن کنم تا هیتر گرم به شه.	I'll go start the car and get the heater going.
برای حفظ آبروی خود و ربرتا سفرش را با آن دختر پنهان نگاه دارد.	of course, but only to protect her name and his from notoriety.
اما امری لازم و مهم مرا امشب در پیش است	but an urgent and important affair
از این حرف یک دانشگاه با همه علم و دانایی تعجب خواهد کرد.	this is a thing that would astonish a whole university, however wise it might be!
ناگهان همه با هم دست به یکی کرده و به او حمله کرده بودند.	all attacked at the same time.
حالا دیگر احتیاجی نیست به امید لبخند بخت بنشینم.	I have no need to hang on the smiles of chance now.
مطمئنم که خیلی بهتر از من ماجرای خودش را تعریف کرده.	I am sure she tells her own story agreat deal better than I can tell it for her.
تا از اقامت همیشگی در یک محل کمتر جلب توجه کند	in order that he might attract less attention than if he were to remain always in the same quarter
دیگران نیز هنگام خوردن و نوشیدن باقی شب را ساعت به ساعت بین خود تقسیم کردند.	the others allotted hour long spans among themselves as they talked and ate.
همان عشق بود که این سرنوشت را برایش رقم زد.	the real reason for all this!
بلکه به جهت طبع پلید و آزمندی آن حیوان فرومایه است.	but by the nastiness and greediness of that sordid brute.
مثل کسی که مدام صدای خروش امواج دریا را بشنود.	as one listens to the sound of the sea.
تصمیم به فرار گرفتند تا پیش از آنکه شیران از قلس بیرون آیند از ارابه دور شده باشند.	all striving to get away from the cart as far as they could before the lions broke loose.
با این همه توانستم خونسردی خود را حفظ کنم.	but I kept my head, for all that.
باور کن حتما از رختخواب پریده بیرون و از پنجره هرچی جلوی دستش بوده طلسم کرده.	I'll bet he leapt out of bed and started jinxing everything he could reach through the window,
ابتد از طرف سرنوشت و بعد هم از پاسبانان.	first from destiny, and then from the police officers
جلو خواهرش شاید تند تر از آنچه لازم بود جوابش را دادم.	I answered him rather more hotly than I should perhaps, considering that she was standing by.
این دو رفتند و شکارچیان کار خود را از سر گرفتند.	they went away, and the hunters started afresh.
من یکی از دوستای قدیمیم با رفیقش و دیدم	I met this old friend and his buddy.
حتی نیمی از توانایی گربه ولگردی را هم در دفاع از خود نداری!	not half as capable of defending yourself as a stray cat!
آن دیگر که کمر اسب تناوری را در زیر فشار هیکل خود خم کرده است	the other, who burdens and presses the loins of that powerful charger
به قول شما تقصیر خودم بود که این موضوع را مطرح کردم.	I am aware, as you say, that I am in fault in having introduced the subject.
بدینسان هر دو موفق شدند لحظه به لحظه به هدف مشترک خود نزدیکتر شوند.	they contrived in the end to reach it.
اگرچه زندگی روزمره کوتاه مدتی آن را مختل کرده بود.	but it was still untouched within him.
دوست دارم پام را روی شکم گرم و نرم یک خوک بگذارم	I love a warm pig belly for my aching feet
زیرا اربابش به او دستور داده بود که هر وقت در صحرا به سر برند و شب را در زیر سقفی نیاسایند	as his master's express orders were, that so long as they were in the field or not sleeping under a roof
بهتر از همه چیز همین که که دی گه از سر نگیریم	the best thing we can do is to let it go at that.
آن چیزی نبود که با یک لحظه اخبار بپیچند و به کشتی دیگر بفرستند.	a thing not to be rigged and shipped in any other vessel at a moment's warning.
هنگامی که برگشت و به سمت شوهرش به راه افتاد	when she turned round and walked towards him
من در دستمال یک نامه و صد اشرفی طلا بدون پول خرد در آن یافتم.	I found another paper and a hundred crowns in gold, without any other coin.
که همیشه برای نظامیان پس از توقف طولانی در اردگاه بسیار دلکش و فریبنده است.	which is always so attractive to a soldier after camp life.
تمام اهل پانسیون درباره این پیرمرد متفقا دارای عقیده واحد و ثابت بودند.	every one in the house had come to have a very decided opinion as to the poor old man.
مشاهده این حال مرا در ین عقیده که از دیر بار وجود داشته است راسخ کرد	confirmed in me the old observation
چرا این همه مدت ما را تعقیب کرده است.	why he had dogged us so long.
اما احساس کرد که در کلمات نامفهوم وی قصد و غرضی ناشایسته و نابجا نهفته است.	but she felt that his incomprehensible words had an improper intention.
اما در عین حال با گذشت زمان دریافته بود	but he also knew her by this time
در هر دو قبول شدم و دیگر نگرانی ای ندارم.	I passed them both and am now free from conditions.
بگوی کالسکه را بیرون آورند و دربان را بفرست	let the porter get the post chaise from the coach house
چون دختر جوانی شد سخن گفتن با او را در این باره محال یافت.	when she became a young girl, it was impossible for him to do so.
من اطلاعات زیادی راجع به زندگی و رفت و آمد ثروتمندان اینجا دارم.	I know the comings and goings of the rich.
سگ کوفته دمش را روی کو لش گذاشت و زوزه کشان دررفت.	the dog slunk away, bruised and howling.
حالش را اندکی جا آورد و به او اطمینان داد که دخترک را از دست نداده است.	caused him to feel better and that all was not lost.
کسی با صدای بلند او را صدا زد و او به طرف صدا برگشت.	someone yelled his name and he turned.
خانه عبارت بود از اطاقی بزرگ که کف آن صف و هموار و گل اندود بود	it was a large room with a smooth clay floor
فعلاً تا وقتی که کار کندن قبر تمام نشده است فرصت باقی است.	for you will have time enough for that while we are waiting for the grave to be dug.
به هر حال اگر شعر و ادب علم محسوب شود	if that can be called a science
در عین حال گاه نیز از احتمال اینکه کلاید	that he would make some beginning
در خانه از اعتبار و احترام برخودار بودند و در خارج از خانه مورد توجه همگان قرار داشتند	they were of consequence at home and favourites abroad
دستش داغ و حیات بخش و پر از هیجان بود.	as always, there was something hot and vital and exciting about his grip.
اما در حقیقت مانند دیگران است و او خود دیگر از او بیمی ندارد و هیچ کس هم نباید از او بیم داشته باشد.	but was really just like all of them, and that she was not afraid of him and no one else ought to be.
اما ناگهان متوجه شد که مبادا این عمل شایسته نباشد.	but all at once he felt that this would not do
اما بذر رویش این یکی در مغز برادرت پاشیده شده و همین برای موافقت خالصانه تو کافی است.	but the seed of this one has germinated in your brother's brain, and that will be enough for your devoted assent.
بهتر از هر کس و آشنای دیگر شام داده بود	he had given better dinners than anyone he knew
عمو ورنون مرد قوی هیگلی بود با گردن بسیار کوتاه و سبیل پرپشت.	a large, beefy man with very little neck and a lot of mustache.
با دیدن تصویر خودم در شیشه اتاق متوجه شدم عین تاجرهای درست و حسابی هستم.	as I glance at my reflection in the window, I look just like a top businesswoman.
مثل قبل مشتاق و مصمم بودم که خود را به جاده اصلی برسانم.	as eager and as determined as ever to reach the road.
به آرامی از پشت در رد شدم. به طرف پلکان دویدم.	I slipped away from the door to the stairs.
ایشان را به جای خود و دنبال کارشان فرستاد.	caused them all to relapse into their former places and pursuits.
آن قدر جا خوردم که فقط رویم را بهش کردم و گفتم	I was so astonished I just turned to him and said
تو تنها سی ثانیه وقت داری که تصمیم بگیری!	I give you thirty seconds to join me in.
پس باید در حال حاضر شکیبا بود و برای آینده درس عبرت گرفت.	it is only to have patience and take warning for the future.
برای حمل کردن او به کمک نیاز دارم .	I need help carrying him.
برای او ارزش آن دو برابر این رنج بود.	to him it was worth twice the suffering.
دکتر هم برای کار مهمی به چند میلی مهمانخانه رفته بود	the doctor was suddenly taken up with a case many miles away and
اما با زمین خوردن پسر ماری از رفتن منصرف شدند	when they were stopped by the eldest boy's being at that moment brought home in consequence of a bad fall
اما درباره مطلب عمده آن باید باز هم به نحو آشناتری به تفصیل سخن گفت تا آنچنانکه باید فهمیده شود	but the leading matter of it requires to be still further and more familiarly enlarged upon, in order to be adequately understood
از روی گولی و نادانی به کوتاهی قد او و درختان سیب اشاره کردم.	by a silly allusion between him and the trees.
بر حساسیت خود بخندد و تأسف بخورد با لبخند تأثر در آنجا نشسته بود.	as if stirred to his heart's core himself regretting and laughing at his own sensibility, .
نیز بالاپوش بلند سیاهی که چاک خورده و پاره پاره شده بود.	also a long black cloak, slashed and tattered.
باید به شما بگویم که به خاطر همین موضوع چه اتفاق بدی برایم افتاد.	I must tell you what an unlucky thing happened to me, as to that.
آلپاتیچ اشیایی را که خریده بود در این اتاق گذاشته بود.	where he had left his purchases.
دوباره راست شود و پیوسته دست بر دیوار بمالد.	then to rise, and to feel incessantly of the wall.
ولی ترس از اینکه مبادا چند پنی دیگری که برایم مانده بود نیز به مصرف برسد	but I was afraid of spending the few pence I had
یک چیز بیش از همه مرا رنج داد و دلم را سوزاند	what gave me most pain was
ولی مستخدم پس از آن که به دقت گوش فرا داد باز تأیید نمود که به این نام کسی در بنگاه وجود ندارد.	but the man listened attentively, and repeated that no one of that name was known in the place.
اسقف اعظم متقاعد شد که معصومیت نابی در او نهفته است.	with it he began to be convinced was a genuine innocence.
اما ترسید که باری خود دشمنی مانند وزیر پلیس بسازد	but he feared to make for himself a mortal enemy of the police minister
هرگز محیط کار را به این بی و سرو صدایی ندیده بودم.	I've never known the office this quiet.
به همدیگر چسبیدند و زانوهایشان کیپ هم چسبیده بود	squeezed into the seat, crowded against each other, their knees cramped
ولی من مطمئن بودم که در تمام آن مدت و پیوسته با من بود	I was sure she was with me
پس متوقعم بلکه یک خواهشی دارم و از من مضایقه نکنید	refuse me not one final satisfaction
هرگز کسی را ندیده بودم که پودینگ را با این اشتها و لذت میل کند.	I never saw anyone enjoy a pudding so much
اما در واقع انگیزه گفتگوهایشان احساس عشق بود احساسی که میتواند به دل هر موضوعی رخنه کند و در جملاتی هر چند در ظاهر نامربوط به عشق در نهایت شور و تب و تاب به هستی خود ادامه دهد.	but in reality they discussed it because the sentiment of love can enter into any subject and live ardently in remote phrases.
به او مشت زد و بعد از شدت خستگی بیهوش شد.	punched her and then passed out from the effort.
رفتن من به داخل محوطه که اشکالی ندا ره	I'm allowed to walk across the grounds,
جوانمردانه دست آشتی را به سوی او که مجروح افتاده است دراز خواهد کرد.	as he lay wounded and would magnanimously extend the hand of reconciliation.
کاش که اقلاً زیر این آلونک یک خندق بود	I wish there was a moat to this cabin.
که بر اثر سقوط کابل برق فشار قوی در جاده دچار برق گرفتگی شده بود.	electrocuted by a high tension wire that had fallen on the road.
که ناگاه از جای غیر منتظری به او کمک رسید.	when help would come to him from some unexpected source.
پس آمدم از شما بپرسم که او چه شده	I come therefore to ask what has become of him
تا موقع خداحافظی دیگر کلمات چندانی رد و بدل نکردند.	scarcely another word was said by either during the time of their remaining together.
هنوز وابسته به زمین بوسیله تقوی و به تازگی پیوسته به آسمان در سایه تقدس.	attached to the earth by virtue, already possessingsomething of heaven through holiness.
عقلم کام لا در سر جای خود باقی است.	I'm perfectly in possession of all my faculties.
ما لباس خود را بیشتر یا کمتر به احتشام داریم	some more splendid than others
شانس آورد که کامیونی رسید و مجبور نشد نیم میل راه را با دوچرخه پا بزند.	was lucky enough to be picked up by a truck after he had pedaled a scant half mile.
هر چند که از درد انگار داره کنده می شه.	although that feels like it's about to fall off.
ولی این کار برای جنگجویانی با تجربه تر از شما هم غیر ممکنه	but that would be impossible for more experienced fighters than you are.
این بار به اسم و رسم و نام فامیل فقره مزبور تحریر یافته بود.	the family name was fully given
هر روز داد و بیداد می کنه و می خواد که اجازه بدن حموم کنه.	every day he's been insisting that he wanted a bath
ولی کسی بود که بعد از تصادف سعی کرده بودم با او تماس بگیرم	but it was the one person I had been trying to contact since the crash.
میزی بسیار دراز و چندین بشقاب و کارد چنگال.	an infinitely long table and plates and knives.
من در صحبت او چیزی بیش از شور عشق یافته بودم.	I had noticed in it something more than passion.
از خر پیاده شود و قاشقی پیدا کن و یکی دو مرغ از میان دیگ بردار و مشغول شو.	get down and look about for a ladle and skim off a hen or two, and much good may they do you.
یک تکه از این کیک را هم میل کرد.	she had taken a piece of cake
حالا امیدوار بود روان کودک را با زهر افکار خود آلوده ساخته و برای تمام عمر رنگی سیاه و کدر بر آن نمودار سازد.	he was now slowly instilling into his soul the poison which he hoped would blacken it, and change its hue for ever.
شاید دیگر عضلات نیرومندش زور و قوت سابق را نداشته باشد.	that perhaps his great muscles were not quite what they had once been.
اسب نیز این حرکت پهلوان را در دل سپاس گذاشت زیرا دیگر قدرت حرکت نداشت.	for which his horse was very grateful, as he was already unable to go.
که آن دو به جر و بحث مشغولند گوش تیز کرده بود.	noticing that they were evidentlyquarreling she had paused to listen.
آخر تمام مطلب به وضع اجتماع و عادات و سنن آن است.	it was all due to 'your social position and the habits associated with it.
پشیمانی و افسوسش بیشتر از پشیمانی و افسوس من در این موقع نیست.	he would not have rued his bloody blunder more than I now rue mine.
سربازان به سینه صلیب کشیدند و بر اسبان سوار شدند.	the soldiers crossed themselves and mounted.
حتی توی شهری به این کوچیکی که حداکثر سرعتش 20 کلیومتر در ساعت بود.	even in the thirty mile an hour speed trap towns.
فورا به یاد مشکلاتی افتاد که مراوده با کلاید برایش در برداشت.	the difficulties that contact with him seemed to prognosticate.
ضمناً در نظر داشته باش که تو باید شوهر من بشوی	remember thou art to be my husband
به ویژه برای آنکه پیر پس از خواب آرام و ممتد قوای جدیدی یافته بود	for on that evening of his life after his deep sleep in the day he seemed suddenly to have found new strength
مثل کودکی برآشفته به کندن موی سر و کوفتن پای بر زمین پرداخت	he tore his hair, and beat his feet upon the ground, like a distracted child
با کمک عادتی که در حرف زدن با پدر بزرگش داشت	thanks to her habit of conversing with her grandfather
نه با وجود اتفاقی که امشب برایش افتاده بود.	not with what she'd just been through.
که از محوطه طاق داری که سطحش محاذی سطح باغ بود	which received no light except through a vaulted cloister on a level with thegarden
من به خاک افتادم تا دست اعلی حضرت و دست ملکه را ببوسم	I lay on the ground to kiss his majesty's and the empress's hands
خانم در پی او بیهوده کوشش داشت تا به او برسد.	the lady beside him, matching his stride effortlessly.
چنانکه گویی از همین مختصر تعارف هم یک دنیا مسرور شده	as if he were relieved by even this concession.
از همه بدتر اینکه دست به جادوی بزرگی زده بود	the worst of it was, he had just done serious magic
بعد یکی یه برقک بردار ین و آماده باشین که هر وقت گفتم آزادش ون کن ین.	an' choose a niffler, an get ready ter set 'em loose.
ازیه جاهایی شنیدم که ممکنه یه نفربخواد اونجا شیطنت کنه.	I heard one way and another that somebody might try doing some mischief up there.
اثبات حقیقتی که بر صاحب دلان روشن است نه مستلزم صرف وقت زیاد است و نه سخن گفتن بسیار.	for will not take much time or many words to bring the truth home to persons of sense.
که تمام مدت خود را از نظرها پنهان کرده بود	who had carefully kept himself out of sight, during the interview
اما وی را متنبه ساخت که دیگر نباید پیش چشمش بیاید.	but warned her not to dare to let him see her.
من دستور داده بودم چایی مرا در زیر درخت بلوط حاضر کنند.	I rather fancied my tea out under the chestnut tree.
صداهای خشمگینی از آن سوی دیوار به گوشش رسید	when he heard angry voices through the wall
اما به یاد داشته باشید که به عقیده من در این مورد نه به شما اهانت شده است	but don't forget that I do not regard either myself or you as having been at all insulted
اصولاً برای شرح آنچه باید بگویم آوردن کلمات معمولی کافی نیست.	some strong words shall express what I have to say.
کلاید پیش خود حساب کرد که چنین دیداری با ربرتا مانعی نخواهد داشت.	anyhow, a reunion would be acceptable.
یک طرف صورتش به اندازه سر طفلی آماس کرده بود.	one cheek was swollen to the size of a baby's head.
ممکن بود دوباره یاد کتک زدن هری بیفتند.این کار سرگرمی محبوبشان بود.	wouldn't fall back on their favorite hobby of hitting him.
به رام فرقی نمی کنه چه کار کنم چه کار نکنم.	I never care what I do
همان حس رشک و غبطه بر معرفتی بود که برادر محترمش دارا شده و حال آن که این معرفت از وی دریغ گشته بود.	it was envy for the knowledge the dying man had now that he could not have.
ناگهان در کنجی کنار گنجهٔ ظروف چیزی دید که از آن یکه خورد.	when near the dresser he saw an object which made him start.
مرتکب گناهی شدم که ممکنست تا حدی بر من خرده بگیرند.	for which it is probable I may incur some censure
تا از سفیران و دیگر بلند پایگان دیدار کند.	to call upon the other ambassadors and dignitaries of state.
اما دل و جرأت این کار را پیدا نکردم	but my limbs
او تا ابد در آنجا ماندگار شد و فکر کرد که آنجا اطاق اصلی است.	he stayed there forever, thinking that it was the real room.
اما چشم دیگرش در حدقه به سمت پشت سرش چرخیده بود.	the other one was pointing into the back of his head.
امیدوارم این هدیه مورد پسند و علاقه شما واقع شود.	I hope this is the sort of thing you like,
با این همه چون آن را به چشم دید	but, when he saw it
چنان که گفتی امید دارد بدین طریق درد روح و قلب او را تخفیف دهد.	as though hoping in this way to soften the hardness of her position for her.
او و رفقایش با از دست دادن کشتی ناچار بودند به آب خالی و گوشت شکار قناعت کنند.	he and his mutineers, deserted by the ship, must have been driven to subsist on clear water and the proceeds of their hunting.
ناگهان عنان را به دست گرفت و شلاق کشید.	clutched up the reins and whip and laid them both over the horse.
صدای کشیده شدن ناخن و پارس سگی از داخل خانه شنیده شد.	they heard a frantic scrabbling from inside and several booming barks.
به ناچار تمام مدت دست به سینه نشسته بود تا برآمدگی آن جلب توجه نکند.	he had to keep his arms folded to hide the lump.
چون واضح است که موضوع مهمی در میان بوده	since the matter was evidently important
چون امروز تنخواه زیاد برای من لازم شده بود.	for I am much in want of money to day.
وقتی که به حد کامل از این مقولات صحبت کردند	when those topics were exhausted
من فقط تطابق آن شرایطی را که در هر پدیده حیاتی موجود است	I see only a coincidence of occurrences such as happens with all the phenomena of life
به همین جهت به امید آنکه چنان ترتیب کار را بدهد که قبل از شروع پیکار همگی مسکو را ترک گویند	so, hoping to arrange to leave before then
انگار این ترافیک روز به روز بدتر می شه.	that the traffic here grows worse all the time.
وارد خو نه شدم و پشتم رو به دیوار کردم.	I sidestepped into the house, keeping my back to the wall.
اما او قادر نبود حتی یک کار را منظم انجام دهد.	he was quite incapable of working steadily
اگر او بازرس نباشد حاضرم سر خود را بخورم.	or I'll eat my head.
آنگاه بر زن بیوه و فرزندان یتیم خویش ماتم گرفتم	I bemoaned my desolate widow and fatherless children.
این کیف به زندانی آهنین شبیه بود و از مچش با زنجیری محکم آویخته بود.	she kept the purse in a very jail of a bag which hung upon her arm by a heavy chain
ناچار بزرگی آن در خور جثه عظیم من خواهد بود و ناگزیر ادواتی بسیار خطرناک بشمار خواهد رفت و گفت که او خواهش دارد که این کار به من برنخورد.	which must needs be dangerous things, if they answered the bulk of so prodigious a person.
از ای نرو از کسانی که ممکنست سر موئی از ین صفت مذموم در آنان باشد تمنی دارم به خود جرأت ندهند که در برابر نظرم آشکار شوند.	therefore I here entreat those who have any tincture of this absurd vice, that they will not presume to come in my sight.
البته ناچار بودیم نخ خودمان یا قیر را هم درست کنیم.	of course, we had to make our own string, or tar.
اشتباه کرده بود که قبل از خروج از خانه مقوایی کف کفشش نگذاشته بود و سوراخ آن را نبسته بود که آب به آن نفوذ نکند.	wishing she had thought to put a piece of cardboard over the hole in the sole of one slipper.
زیرا به فرض اینکه پیشرفت علوم روزی به جایی برسد که مردی بتواند سر خود را بخورد	because, even admitting for the sake of argument, the possibility of scientific improvements being brought to that pass which will enable a gentleman to eat his own head in the event of his being so disposed
تا به خودش یادآوری کند که باید در طرف ترافیک قرار بگیرد.	to remind him to get over on the outside.
اما من به نیت اینکه عین دفتر را با صندوقچه و کتابهای محتوی آن به کسی که آنها را در این کاروانسرا بجا گذاشته است بازگردانم	meaning to return it to the person who forgot the valise, books, and papers here,
سر را به زیر افکند و راه خود را پیش گرفت.	she went away looking down
میکروسکوپ را گرفتم و نگاه سریعی میان چشمی آن کردم.	I grasped the microscope and stared briefly into the eyepiece.
آخرین فروغ از شعله چراغ مانند این بود که	which in an inanimate object have been so often compared
چون بمیان تن که رسیدم نزدیک به بیست و هشت گز شنا کردم تا اینکه پایم بزمین رسید.	swam in the middle about thirty yards, till I felt ground.
چون احتمالاً دختر یکی از این کشاورزهاست که تربیت و سواد درست و حسابی ندارد.	who will probably be some mere farmer's daughter, without education.
چون سر و صدای زنجیر لنگر از خواب بیدارش کرد.	because the noise of the anchor chains awakened her.
اما هنوز بیمناک بودم که مبادا با یک جسد روبرو شوم.	I still recoiled at the dread of seeing a corpse.
کار معاملات ملکی حومه شهر پیش این کار دو پول سیاه هم در آمد ندارد	makes suburban real estate looklike two cents!
باعث به شه من با یک بدن ابتدایی ضعیف نقل مکان کنم که مال خودم با شه	which would return me to a rudimentary, weak body of my own
گاهی راجع به مرد تاریک و گاهی راجع به پیرزن.	the dark man and the old woman.
فکر کردم دنیا برایم به اخر رسیده واقعا متاسفم.	I I felt as though my life was over.
که به من اعتماد کامل دارد و غیره ..	that she had complete trust in me
که در آن هشت یا ده نفری به دور میزی نشسته بودند.	where eight or ten fat gentlemen were sitting round a table.
از آنجا برای آنکه کار صوابی انجام داده و خدمتی به کرده باشی	thence, to do me a favour and a service
همیشه نگران این بودم که در آن دنیا کسی نیست که از پدرت درست و حسابی مراقبت کند.	I've always been worried that there was no one to take proper care of your father.
البته یک بار با یک درشکه همراه با زنش به دیدن مراکز استخراج سنگ مرمر رفتند	though they went together in a carriage, once, to see some marble quarries
در نتیجه بدنش به شدت سوخت و تاول زد	suffered burns which turned into sores
همان خبر ناگهانی بود که از تعجب ما را به آن وضع و حال انداخت.	it was the sudden surprise of it that knocked us so kind of cold.
من شب و روز به درگاه خداوند دعا کرده بودم و امید داشتم که تو بار دیگر به صراط مستقیم برگردی چون این تنها راهی است که تو را به توفیق و سعادت حقیقی خواهد رساند.	I had hoped and prayed that you wouldreturn to the straight and narrow path the only path that willever lead you to success and happiness of any kind
چون این کلمه را گفتم تو تیشه را فرود آر.	 then strike boldly.
اما معلوم بود که برادرش از روابط واقعی آن دو آگاه است	, but it was understood that his brother knew their real relations
در این اطاق کوچک یک تخت خواب سفری داشتم و یک تخت خواب معلق یا ننی که از سقف آویزان بود	I had, in this closet, a field bed and a hammock, hung from the ceiling
اگرم موندنی شد ین راحت و آسوده کنار جاده نی گر دار ین تا ما برسیم	if you break down, why, jus' camp 'longside the road till we come.
میدانم که چه چیز شما را به بیزاری انگیخته است	I perceive that I shock you.
چون هم اکنون تأثیر حضور مهر ظهور علیا حضرت جانی تازه در قالب من دمیده است.	for I already found my spirits revive, by the influence of her most august presence.
بدون این که مجبور باشند برای او صبر کنند.	without any obligation of waiting for her.
حق خاص روحانیان را درباره تدفین مذهبی یعنی دفن شدن زیر محراب برس میت شناخت.	expressly recognized the right of nunsto be buried in religion, that is to say, beneath the altar.
این مرد آهنین نیز تا اعماق وجودش به لرزه افتاده است.	he, the man of iron, was shaken to the soul.
در مقابل گرسنگی و سرما و کار کمرشکن و کابوس زنده نا امنی.	beside hunger and cold and back breaking work and the living nightmare of insecurity.
کیتی لهوین را دوست میداشت و قراربود به پدر و مادرش بگوید که لهوین روز بعد به خانه ی آنها خواهد آمد.	it had been said that she loved him, and that she would tell her father and mother that he would come tomorrow morning.
آنگاه آزادی ایشان از آن بندگی جز به مرگ میسر نخواهد بود.	from which they cannot expect to be released except by death.
از میان هوای آبی شکافته به طور ثابت و آرام پایین به روی عرشه آورده شد.	was steadily lowered through the cloven blue air to the deck.
شخصیت رئوف و سخاوت فراوانش علاقه و احترام همه کسانی را که با او سر و کار پیدا کرده بودند جلب کرده بود.	his amiability of character and extreme generosity had won the affection and respect of all who had been brought into contact with him.
در هر صورت دیروز در بازجویی به او این طور گفتند.	they told him so yesterday at interrogation, anyhow.
زمین صنعتگر زیر پا همچون دستگاه بافندگی بود که قالی شکوهمندی بر آن بافته شود.	the industrious earth beneath was as a weaver's loom
ولی باز در دیدگان زیبای وی چیزی جز نیکی و صفا مشهود نبود به این حقیقت اطمینان کامل دارم.	I am sure, but what was meant for goodness and for happiness, and what was on a good and happy course.
شما همان وقت اسکناس صد روبلی را هم از روی میز برداشتید	you took up from the table a hundred rouble note
بنابراین اگر همین حالا از هنرپیشگی دست بکشم آب از آب تکان نخواهد خورد.	so I wont inconvenience anyone by deciding to bow out of acting.
به او بگوید که با موفقیت از سد اژدها عبور کرده و صحیح و سالم است.	telling him that he had managed to get past his dragon unscathed.
میل داشت او را در این کار هرچه بیشتر تحریک کند	wishing to interest him in the scent as much as possible.
با آن کس که روستایی بوده برابر شده است.	is the equal ofhim who was a peasant.
نان برشته را داخل دهانه گشاد فنجان فرو کرد تا برای جویدن به اندازه کافی نرم شود.	dipped her toast into the wide mouth of her coffee cup until it was soft enough to chew.
چون دروغ گفتن به مادرش به این شیوه برایش آسان نبود.	for lying to his mother in this way was not easy.
ابزار کشاورزی را برای استفاده انسان طراحی کرده بودند نه حیوان.	the implements had been designed for human beings and not for animals
آن هم با ستون فقراتی خرد شده در هشتاد و یک سالگی با سقوط از روی یک درخت انبه در تلاش برای قاپ زدن یک طوطی.	had died of a broken spine, at the age of eighty one, when he fell from the branch of a mango tree as he tried to catch a parrot.
او را نزدیک سنگ به خاک خواهم سپرد نزدیک سنگ خودمان.	I'll bury him by the stone, by our stone!
من این آواز را در دریا بارها شنیده بودم	I had heard it on the voyage more than once
در حالی که شاید شاعران و مردان اندیشه و عمل آرامش روستا را ترجیح داده بودند	while poets, perhaps, and men of great mind and breeding had preferred the quietude of the country
این دو مرد در زمستان آن سال خصایص یکدیگر را پسنیده و با هم صمیمی شده بودند.	they had seen a great deal of one another that winter, and had taken a great liking to each other.
به دنبال او افسر جوانی که صاحب آن صدای مردانه بود بیرون آمد و به طرف گروهانش شتافت.	rushed out of the shed followed by the owner of the manly voice, a dashing infantry officer who hurried off to his company
من از ترس نزدیک بود سر جا سکته کنم.	I most dropped in my tracks I was so scared.
رد پاها را تا انتهای گذرگاه سرخ دار دنبال کردم	I followed the footsteps down the yew alley
با خوشحالی اعلام کرده بود در مدت تعطیلاتش فقط از توی آن آب خواهد خورد.	vowed to spend her holidays drinking only from a thimble.
بالاخره دسته تقسیم شد و هرکسی به راه خود رفت	in short, they all separated and went their ways
هرگز به یاد نداشت سیمای انسانی چنین بدبختی ژرف و نومیدانه ای را نشان دهد.	she had never seen a human face express such fathomless, hopeless misery.
می دونم که سخت خواهد بود اما این چیزیه که من می خوام.	I know it will be hard, but this is what I want.
اما این سعادت از این راه رسید و من هم نتوانستم که مسرور نشوم این بود که اظهار مسرت نمودم	it has happened and I really cannot pretend to lament it
یکی از استادها رو از کام ماهی مرکب دریاچه نجات داده	he saved a teacher from the giant squid.
شاید درد دل خود را فراموش کرده و تسلی یافته است	no doubt fortune and honors have comforted her
آن را در پاییز به یکی از هم کلاسانش نوشته بود.	he saw that it was one which he had written in the autumn to a fellow student.
لبانش جمع شده و چشمانش چون سنگ به کف سیاه و خاکی زمین دوخته شده بود.	his lips pursed up, and his prominent eyes glaring stonily upon the floor of black earth.
جایی که سعادت را به او عطا کرده بود.	where she had been happy.
من از صحبت کردن در باره روزهای خوش قدیم لذت بردم.	I've enjoyed talking over the good old days.
که آن را در شیشه بگذارد و محکم سر آن را ببندد	which were to be put in phials hermetically sealed
فکر نکنم هاری از یه حیوون مرده به حیوونای دی گه سرایت کنه	I don't think other animals can catch rabies from a dead animal.
بعدازظهر روز بعد هنگامی که هری و هرمیون جلوی در رختکن برای هری آرزوی موفقیت کردند	when they wished him good luck outside the locker rooms the next afternoon
که او را در طول مذاکرهٔ مفصل خود با دوستانش نگاهداشت.	which kept him up through this long conversation.
از دیدن او به آن ریخت وحشت زده شده بود.	dismayed at seeing him in such a state.
همین که خود را آزاد یافت بر سر کلانتر که از پا درآمده بود تاخت	unfettered, and who, attacking the prostrate commissary
در همان حال که گیلاس نزدیک دهانم بود او را نگاه کردم و حرفی نزدم.	I watched him over the rim of my glass. I did not say anything.
برای کسری از ثانیه به سوال او فکر کردم.	I thought about her question for a fraction of a second.
ولی تصور اینکه چشمانی در آن زیر به حرکت درآمده	but it was worse to fancy the eyes
حالا لازم است در این باب به من اطلاعات کامل بدهی	you must assist me by the most minute information on every point
یک چشمش را که تار بود گشود و به تلفن لعنت کرد.	opened a bleary eye and lay cursing it, vowing
گفتم گذشته از مطالبی که مربوط به شغل ایشانست	that in all points out of their own trade
با نگاهی آکنده از تحسین به او چشم دوخت.	he contemplated her from the height of his long legs with a visible appreciation of her appearance.
یک دقیقه بعد شنیدم که در باز شد و کسی از اتاق بیرون آمد.	I heard the door of the library open.
