من کتاب را گشودم در هر صفحه آن تصویر زیبایی دیدم.	I opened the book, and on all the pages there were excellent drawings.
با اشک و داد و فریاد جنجالی بپا کرد.	she burst into tears, wailed so that she could be heard all over the place and caused scandal.
چیزی نیست که به شه در موردش حرف زد.	it is not something which can be discussed.
محال و رفتن به هر کجا بدون خطر دیدن او ناممکن بود.	he could not go anywhere without risk of meeting him.
نفری یه اژدها! باید از جلوی اژدها رد بشیم!	one for each of us, and we've got to get past them.
بایست پیاپی دست خود را در آن لگن خون و آب فرو ببرم	I must dip my hand again and again in the basin of blood and water
هر جای پالانش پاره و در رفته است بدوز و جل و افسارش را مرمت کن	see to the pack saddle and other harness
من بیک جرعه آبی که در آن بود نوشیدم	I drank it off at a draught
به شرط این که هرگز بادمجان به خورد من ندهید.	if you promise not to make me eat eggplant.
در آن زمان فتنه و انقلاب که ما متولد شدیم	in the midst of which we were born
یکی دو بار در سطح کتابخانه بالا و پایین رفت.	up and down, up and down.
چنان که چند تن از نگهبانان پارک با سؤظن به او نگاه کردند	so that several park keepers looked at her with suspicion
که دخترش یکی از همین روزها برود مهمانی شام و تمام شب را از پدرش دور باشد.	of his daughter's going out to dinner on a day now near at hand, and spending the whole evening away from him.
روستاییان کار را متوقف کردند تا او را نظاره کنند.	the peasants suspended their operations to look at him.
کشمکش در چنگ عنکبوت باعث کوفتگی تمام بدنش شده بود	he was aching all over from trying to throw off the spider
آن کلمات را با قدرت جنون آسایی بر زبان آوردم.	I pronounced them with such frantic energy.
این همه مال بالتمام به شما منتقل خواهد شد	that all his fortune will come to you, and justly too
گر نه محال بود به این سرعت این همه کمک کنن.	or they would not choose to do all this for him and so speedily.
ناچار مراد از آن عقلی است که هوس و نفع شخصی با آن در نیامیخته و آن را تیره و تار نکرده یا به رنگ دیگر در نیاورده باشد.	where it is not mingled, obscured, or discoloured, by passion and interest.
البته اولش برای یک لحظه از این پیشنهاد ذوق رده شدم	for the moment I was intoxicated by the idea
به او گفت که خود نسخه را برده و در داروخانه در حضور خودش دوا را بسازد.	go in person to a chemist's to get the prescribed medicine
که لیدی چتام پنداشت دکتر با نظر من موافق است و به مهارت پزشکی او سخت نظر خوشی پیدا کرد.	that she formed the most cordial opinion of his talents.
به سوی تنها صندلی راحت آشپزخانه که کنار آتش بود رفت.	he went to sit in the only comfortable chair the kitchen possessed.
در پی آن فریاد صدای شکستن و افتادن چیز سنگینی را در کنار خود شنید.	then a cracking sound and the ring of something heavy falling close beside him.
در مقابل آنچه دست آخر به چشم دیدیم هیچ نبود.	was nothing to what at last met our eyes.
هر چه بیشتر به قصد و نیت خود عادت میکرد و اکنون اجرای آن را کاملاً عملی میشمرد.	he had grown more and more used to his own intention, and by now distinctly perceived the feasibility of its execution.
از او تمنی کردم و او را به تمام مقدسات سوگند دادم که مرا از آن زندان برهاند.	begged, by all that was moving, to be delivered out of the dungeon I was in.
شک دارم از این که بتوان آن را در شمار کارهای قابل ذکر به حساب آورد.	I don't know that I can count it for much.
علیرغم احساسات شما معلوم شد که او واقعاً موجود شری ری است	that, if, from what he says, we judge, and I can show to the satisfaction of your cool reason, that he is a real and thorough bad one
از تماشای آثار نقاشان معاصر هدفی ندارند جز این که بعدا بگویند که نقاشی چیزی مربوط به گذشته است	of looking at the works of contemporary artists with the sole object of being in a position to say that art is a thing of the past
اما کاملاً مشخص بود که از حرف او نرنجیده است.	but not as though he were annoyed with her.
دست مقتدری که کالبد تو را آفریده و به آن حیات بخشیده	the sovereign hand that created your frame, and put life into it
او تازه از بیماری برخاسته و سخت لاغر و رنگ پریده بود.	he was pale and sunken from the illness from which he had only just recovered.
با محبت و احترام و همیشه آماده به خدمت.	courteous, respectful, anxious to be of service.
بهتر است بگوییم درک متقابلشان که هنر اصلی کلام است	understanding, which has become the main art of speech in an age
من تا به دست آوردن حقایق بیشتری که بتوانم به آن اتکا کنم نظرم را ابزار نخواهم داشت.	I think that I will reserve my opinion till I have more facts to go upon.
این زیردامنها به علت نامعلومی بیش از حد کوتاه بود.	although they were extraordinarily short
ولی این نیت خیر مانع نشده است از اینکه مرا هم به جایی ببرند که هرگز امید بازگشتم نیست.	but my good intentions were unavailing to save me from going where I never expect to come back from
آن را طوری اداره خواهد کرد که آرزویش بود.	make it what he had dreamed
پس از آن رخت و پخت انداختند و برای نخستین بار به عمرشان مزة خواب راحت را چشیدند.	after that they settled down for the night and slept as they had never slept before.
بلکه احتیاج دارم بر اینکه بفهمم که در دست دشمن هستم یا دوست.	I need to know whether I am among enemies or friends.
مطمئن بودم که به طرف اطاق خودش دویده است	I felt sure that she had returned to her own room
تا برای مرتب ساختن جامه خویش به رخت کن برود	go to the dressing room to rearrange her dress
اما دیر رسیدم و نتوانستم جل وشان را بگیرم.	I was too late to stop them.
ولی زنهار که او دست به چنین کاری نزند	but he had better beware of that
با بی میلی خود را عقب کشیدم تا او بایستد.	I reluctantly moved back so that he could stand
در این میان فقط دو چشم خشک و آرام وجود داشت	there was only one calm face, one dry pair of eyes.
همان طور منتظر برخورد ماندم ولی حالت او تغییری نکرد.	I kept waiting for the collision, but his expression never changed.
با خود گفتم که باید این نقاشی چیز گران بهایی باشد.	which I considered to be one of the most enviable possessions that the world could afford.
من قریب پنج ماه با زن و فرزند خود در منتهای خوشی به سر بردم	I continued at home with my wife and children about five months, in a very happy condition
زیرا دوستش ندارم ضمن صدور این حکم غیرقابل استیناف ابروانش را بالا کشید	I don't like him, she added in a tone admitting of no rejoinder and raising her eyebrows.
از نزدیک محلی که ما پنهان شده بودیم گذشت	passed close to where we lay
نمی خوام این جوری با او نا روبرو بش م.	I don't want to face them like this.
که به محض ورود کلاید گردن کشیدند و با نگاههائی نافذ و کاو نده او را برانداز کردند.	as clyde entered, leaning and craning and examining himwith sharp keen eyes
دست داد و ما مور گمرک را به کابین ناخدا هدایت کرد.	shook hands profusely, and led the customs man to the captain's cabin.
اما پس از این نبرد نسبت پنجاه هزار به صد هزار را پیدا کرد	afterwards little more than fifty thousand against a hundred thousand.
در طول روایت اینجا و آنجا از قلم افتاده است.	have slipped in here and there in the course of the narrative.
حالا هم چقدر متأسفم که آن جوان خودم نیستم	I wish I were a young fellow, that I might avail myself, on the spot
منظورم این است که باید خودش طبیب خودش باشد.	I mean, his own doctor.
هر چند غم و اندوهی که از عشق و محبتی بجا و مناسب به وجود آید باید جزو نعمت و سعادت به شمار اید نه جزو رنج و مصیبت.	though the ills arising from well bestowed affections should be esteemed favours rather than misfortunes.
در میان زنان برخی کارد و بعضی دشنه به کمر داشتند.	of the women, some wore knives, some daggers
در آن موقع بسیار بسیار خوشبخت و آزاد و شادمان بودم.	I was so happy, so free, so lighthearted!
پس در آن لحظه پرمخاطره بر آن شدم که هیچ نشانی از اضطراب آشکار نکنم	so I resolved, in this dangerous juncture, to show no manner of concern.
من مایلم در ساعت ده صبح فردا او را ببینم.	I'd like to see him at ten tomorrow morning.
با صدای ضعیف و لرزانی از او درخواست کرد که آن را فورا برایش تلگراف بزند.	he asked him, nervously andweakly, if he would see that it was sent right away.
از در بیرون رفت که آن را دور بریزد.	went outside to empty it.
دریافت که آن دو این مسائل علمی را به امور معنوی ربط میدهند و از این امور چندین بار به اختصار گذشتند	he noticed that they connected these scientific questions with those spiritual problems, that at times they almost touched on the latter.
مثل این بود با نفس خود بلور شفافی را مات کند	would be like breathing on the crystal that you want to see the light through.
باور کن و بدان که من بسیار خوشحال بودم	I should gladly
وضع او را بهتر کند و دل بر احوالش بسوزاند.	advance him, and reward him.
تا توانستم به ستمدیدگان کمک کردم و دردمندان را تسلیت بخشیدم.	I have succored the oppressed, I have comforted the suffering.
میان خود و دنیای پوچ و بی ارزش سدهای قابل اطمینانی ایجاد خواهد کرد.	place safe barriers between herself and a frivolous world.
زیرا منظور من مخصوصا آنست که او را خجالت دهم و وظایف پدری و مقام ژنرالی وی را با و تذکر دهم.	for I think it will be a good lesson, to put him to shame by catching him with the widow.
هنگام مغرب دفن کنند زیرا که این زمین سابقا متعلق به دیر بود.	at night, the plot of land having formerlybelonged to their community.
من به فکر آن نیستم و خیال شستن آن را هم ندارم.	I am not thinking of it and I am not thinking of expiating it
هیچ کس هرگز دست مهر و نوازش بر سرش نکشد.	pitied by none.
بی آنکه کاوش بیشتری بکنند به شتاب دور شدند.	made off without waiting to ascertain anything further.
اما میدانست که این موضوع را بایستی خیلی با دقت و محتاطانه با مادرش در میان بگذارد.	but he knew he would have to broach the subject to his mother very carefully.
به این دلیل که ناگهان با مشکلی بسیار جدی و غیرعادی مواجه شدم.	because I am suddenly confronted with a most serious and extraordinary problem.
آنچنان که با همه تحصیلات دانشگاهیش نتوانست بر خود تسلط یابد.	his share in the higher education of this country did not seem to help him.
شرط ببندم که آنجا هیچ کس نباشد جز محکومان سابق و جبر کاران آزاد شده.	that there will be no one there but returned convicts and released galley slaves.
پرواز کن عزیزم. آنقدر بالا برو تا جریان باد عوض شود. آن وقت فریاد کنان با مخ به زمین شیرجه خواهی رفت.	fly, baby, up into the sky until the wind goes somewhere else, leaving him to scream all the way down in a helpless power dive.
کسی هم به نشست و برخاست من کاری ندارد.	so nor does anyone else.
فقط امیدوارم وقتی خودت صاحب پسری شدی پاداش زحماتت را بهتر بدهد.	I only hope, when you have a son of your own he will make a better return for the pains you spend on him.
تا از خواب بیدار شود و زحمت را کم کند.	so that he would wake up and leave.
زیرا تا آن دم هیچ خبر رسمی از آن نداشتم.	because I had hitherto no regular information of it.
در اثر آغاز مراسم دولتی از رونق افتاده و ناتمام مانده بود.	went awry because of the jubilee.
فقط گرد و غباری از خود در پشت سر باقی گذاشت.	left only a cloud of dust behind.
که چگونه او سراپا گداخته در آتش هیجان خود را فراموش ساخته مانند طوفان بر آرایش شطرنجی قشون دشمن تاخته است	all aflame with excitement, he had flown , like a storm at the square
البته لگام از دهان اسب درآوردن و به قربوس زین آویختن مانعی نداشت	the ancient usage established and observed by knights errant being to take off the bridle and hang it on the saddle bow
مادیانی دید به درخت بلوطی بسته و به بلوطی دیگر نیز جوانی را بسته یافت	when he saw a mare tied to an oak, and tied to another
بخواهید به دنبال چیزی بروید که به قول شما ماجرا و به قول من بدبختی و مصیبت است	looking for what they say are called adventures, but what I call misfortunes
او هم در همین زمان به او گفت چه اتفاقی افتاده است	he at the same time told her what had happened
اما این برای اصولی بود که بکلی با هم مخالفت و مناقض بودند که هردو به این سیاستگاه دعوت شدند	but bear in mind if you please that our respective parents underwent persecution and proscription from diametrically opposite principles
پاره کاغذ خود را به روی میز در برابر چشم او گذاشت.	he laid the scrap of paper before him.
خیلی وقت پیش یاد گرفتم که به دخترهای هوسباز توجهی نکنم.	I learned long ago not to take any notice of love sick girls.
ولی باید ثآبت کنن. مثل این که خسارت مالی و جانی نداشته.	but they'll have a job proving it, there aren't any casualties.
ما چند ملوان در آن بندر برای کار کردن در کشتی هیسپانیولا استخدام کردیم.	we got a few hands on board
تقاضای اجازه برای خرید و صدور میزان معینی اسلحه را بنمایند.	for permission to purchase and export a quantity of arms.
همان طور که روی پایم ایستادمو چند قدم کوتاه به جلو برداشتم سعی کردم عقب ننشینم و به کندی حرکت نکنم.	I forced myself not to hold back, not to move sluggishly, as I got to my feet and walked the few short feet to the corner.
در حالی که با پاهایش جارو را نگه داشته بود	he was now only gripping the broom with his legs
ترجیح داد که هدف احتمالی نیز رفیقش قرار گیرد تا اینکه به طور قطع اسیر دشمن شود	preferring the chance of being shot by his friend, to the certainty of being taken by his enemies
من تصمیم گرفته بودم در آن سوی قصبه که زیاد به اینجا دور نیست به زندگی خویش خاتمه دهم. ساعت پنج بامداد را برای خودکشی معین کرده بودم	I meant to shoot myself not far from here, beyond the village, and I'd planned to do it at five o'clock in the morning.
دو سر قرمز در این که کنار هم باشند اصرار داشتند.	the two curly red heads refused to be parted.
بنابراین زیرزمین قرارداد و بکمک آن یک صندلی حصیری را زیرپنجره خارج شد	she was boosting herself back through the cellar window from the seat of a wicker chair she had pulled over
از آن به بعد دیگر نتوانست شطرنج بازی کند.	could not play it again.
به معنای بازگشت به سوی مادر نخستین او است.	it signifies, to retire to his first mother.
حتی فکر این که خبرها را برای او ببرم تحمل ناپذیر است.	I can't bear to think of bringing the news to him.
این پس مانده را با خود به بیرون کشیدند	drew even these last dregs after them with such a force of suction
پدر بزرگوار را دست به کار گشودن آن یافت از آنجا که این منظره برایش تازگی داشت چنان ئحشت کرد که بار دیگر فرار پیش گرفت	saw his honoured parent about to wrench it open, he was so frightened, being new to the sight, that he made off again
احساس کردم حلقه عروسیش داره از انگشت لاغرش در میاد.	I felt the thin band of her wedding ring riding loose on her skinny finger.
به خوبی معلوم بود که از آن سخنان به شدت خشمگین و آزرده خاطر شده است	he laboured under a severe sense of mortification and wrath
بازگشت این افراد تا ساعت هشت به طول انجامید.	that it was nearly eight o'clock
ولی زندگی او دیگر یک شاهی هم ارزش ندارد	but his life is not worth a farthing
حالا خیلی پکر است که خوشگل و سر حال نیست.	she resents losing it.
چند تن از دوستان همسایه را نیز با خود همراه کرد.	got several of his neighbouring friends to accompany him.
بعد افتخار این را پیدا کرد که مدت کوتاهی با صدای آهسته مورد خطاب دکتر قرار گیرد	was honoured with a short whispering conference with the doctor
راه منحصر به یک راه بود و دزدان بسیار در سر راه بودند.	a man was sitting reading at the only outlet to the cell
بایست بروم ببینم تو این جزیره غیر از من کیست.	I'm a going to find out who it is that's here on the island with me
تمام این تغییرات را در زندگی یک نفر سیاستمدار باید مقدمات خوبی دانست.	these sudden shiftings and changes are no bad preparation for political life.
در ساعت هفت غروب هنوز بالاتر از 37 درجه بود.	at seven in the evening it was still well over a hundred degrees.
در آن تصادفی که اتفاق افتاد من تقصیری نداشتم.	I didn't do anything wrongthat time, myself.
شما عقیده و نظر خودتان را داشتید و از داشتن آن نهراسیدید.	you have an opinion of your own and are not afraid to have it.
مراقب بود او را از هرگونه خصلت انسانی عاری کرده	he was careful to strip him of any human attributes
پس بگذاریم تمام این فقرات مسکوت عنه بماند و خاموش شویم و بگذریم	so let all such feeling be buried with him
تیغه چاقویی که بر لوله طپانچه نصب شده بود بسته شد و مچ هیندلی در میان آن گیر کرد.	the knife, in springing back, closed into its owner's wrist.
وقتی ساعت هشت شب شد با اینکه مرا صدا نکرده بود بهتر دیدم شمعدانی را با ظرف شام برایش ببرم.	till, at eight o'clock, I deemed it proper, though unsummoned, to carry a candle and his supper to him.
لباس طلا دوزی شده فقط به اندازه دو طول قامت اسب با بالاشف فاصله داشت	gold embroidery, who was galloping toward him with a theatrically solemn countenance
قبلاً هم واضح و آشکار این را به تو گفتم.	I've told you so pretty plainly before this.
پایین را نگاه کردم و از شدت ناراحتی سر جایم میخکوب شدم	I look down, and freeze, aghast.
اما توده بزرگی از خرده سنگها به داخل ریخته و در حیاط پشت دیوار قرار داشت.	but great masses of crumbling stone had fallen inward and lay in the courtyard, heaped against the wall.
سپس با عجله شروع کرد به تمیز کردن زمین.	hurrying over and starting to clean up the mess.
آنگاه آنان را مخیر کنند تا خود از میان آن خوبان یکی را به میل دل خویش برگزینند.	then allow them to make a good choice as they please.
در نتیجه برای ختم غائله لب به اعتراف گشود	his chair before it was over.
اما به زودی دوباره روابط حسنه برقرار گردید و مانند همیشه عودا نسبت به ما محبت و صفا پیدا کرد.	but this was easily healed, and after a day the old chief was as much with us as ever, and as kind and difficult.
از وی پرسید که چه موقع عزیمت خواهد کرد.	asked when he was leaving.
شاید از نیت کردن و دست به دعا برداشتن علیه خود بازدارد.	she might be prevented from meditating any petitions to his disadvantage.
دو ساعت تمام کار کردن دستگاه راهنمایی کشتی را برایشان شرح داد.	the next two hours explaining the controls and the general operation of the ship.
روح یک مرد قوی هیکل به میز نزدیک شد	a portly ghost approached the table
آن همه جمعیت از کجا به آنجا آمده بود.	I wondered how the hell they could all have got there until
روی دست چپش که به زمین قرار داشت نهاد و کف دست را رو به هوا گرفت.	spread it on his left hand, which he placed flat on the ground with the palm upward.
لگام و سپر را از قربوس زین باز کرد	taking the bridle and the buckler from the saddle bow
اما یقین کرد که امری به تازگی اتفاق افتاده که او را اطلاعی نیست.	foreseeing some new catastrophe.
چون پیکر صاحب دشنه را بر فراز فواره افراخته بودند	also, that when that dangling figure was hauled up forty feet above the fountain
انتقام بلایی را که بر سر من آورده است از او بگیرم.	I can safely take satisfaction for the affront he has offered me
من دوست جوانی دارم که در شهرستان دبیر دبیرستان است.	I have a friend who is a school mistress in the provinces.
چون ممکنه توجه همه رو به خودم جلب کنم.	I'd draw attention to myself.
امروز میل دارم برای ما غذای گرمی تهیه کنید!	I should prefer something hot today.
گر چه او این همه جدی حرف زده بود.	yet, she had spoken them with great seriousness.
فعلاً به جستجوی مکان راحتی بپردازیم که امشب را در آن بیاسایم.	let us go and look for some place to shelter ourselves in to night.
چرا که عشق بر داده بود و پروازکنان رسید	, for love lends wings to our desires
هر چند در نظر او آشکارست که به سبب هوادارای از آنان بسیاری از مطالب را مکتوم نهاده بودم	although he manifestly perceived, that, in order to favour them, I had concealed many particulars
درست به همین وسیله در جریان نتایج تحقیقات مهم باقی بماند.	by that very means keep himself in the track of far reaching investigation.
در آن نقاط بود که سنگرها برپا شده بودند.	it was at such points that the barricades were situated.
به علت هزینه دعاوی بسیار تقلیل یافته بود و در عین اشرافزدگی بسیار فقیر بود.	for the cost of the lawsuits had been prodigious, that, though she was infinitely noble again, she was also excessively poor.
اما در ضمن که همه برای برخورد با وال شتاب داشتند	but while yet all a rush to encounter the whale
از آن گذشته هیچ در آن خانه کمبود مار نبود.	there warn't no real scarcity of snakes about the house for a considerable spell.
سر خود را با نگاهی غضب آلوده بلند کرد	he looked up with an angry scowl.
در این ژست و سر و وضع درست قیافه مردی را داشت که به شکل مطبوعی تحت تأثیر نفوذ و اهمیت و مقاوم برجسته خود قرار گرفته باشد.	looked like one who laboured under a very agreeable sense of his own merits and importance.
حتی یک بار هم به فکرش خطور نکرده بود که چنین سخنی را از لبان او خواهد شنید.	that if he ever spoke those words she would humble him and make him feel her power and take a malicious pleasure in doing it.
حتی پیش از آنکه بازار هفتگی هنوز کام لا آغاز شود	even before the fair had well set in
آن را بر روی کاغذی نوشت و با یک مینی تاکسی از ساختمان جلوی فرودگاه رهسپار آنجا گردید.	wrote it down, and took a minicab from the front of the airport building.
که جریان فکر خود را از این وضع وحشتناک موجود منحرف سازد.	were unconsciously bent on avoiding the contemplation of the horrors of their situation.
تقریبا! چهار ماه در بستر بیماری از من نگاه داری کرد.	nearly four months lying in her hut, raving like a mad thing at intervals
دادستان با لباسی که پوست قاقم بر شانه و کلاه بی لبه داشت او را سرپایی پذیرفته بود.	the magistrate receiving him standing up, ermine on shoulder and cap on head.
جزء هفتصد و هفتاد و هفتم نباید زیادتش باشد.	the seven hundred and seventy seventh wouldn't be too much, would it?
ولی اگر در آن وقت هم فکرش را کرده بود حتماً آن را به صورت اتفاقی که در انتهای زنجیره اجتناب ناپذیری از حوادث پیش آمده بود تصور کرده بودم.	but if I had thought of it at all I would have thought of it as a thing that merely HAPPENED, the end of some inevitable chain.
این یک موضوع مردانه بود و لازم نبود چیزی بگوید و یا حتی احساساتی از خود نشان دهد.	as though this was an exclusively masculine affair and one to be handled with a minimum of words and emotions.
قبر او را هم نیافت که اقلا در سر قبر او نشسته و گریه نماید.	his tomb had disappeared
تسلیم شده بود چون فرصتی که در جلوی پایش قرار گرفته بود گیجش کرده بود	rather, she was stunned by the fear of an opportunity slipping away
سپس وقتی دست و پای ناجور هیپوگریف به زمین رسید	then felt a heavy thud as the four ill assorted feet hit the ground.
کیت خندید و انگشتانش را در میان ریش تونی فرو برد.	kate laughed and ran her fingers through it.
باید اقرار کنم برای هر دو طرف احترام قائلم.	I confess I have feelings on the other side also.
بامید اینکه بر دارائی خویشتن بیفزایم راه سفر در پیش گرفتم.	in hopes to improve my fortunes.
من امیدورام بتوانم این مشکلش را به نحوی حل کنم	I hope to be able to solve that.
از این گذشته عشقی که به وطن خود دارند	their love of their country
زیرا وقتی که به آنجا رسیدی ابدا باکی نداشتی.	on the contrary, you were in excellent spirits when you arrived at the count's
وقتی به خشکی پیاده شد کارد مرا هم با خود برد	took my knife ashore with him.
من چیز زیادی از این ماجرا به یاد ندارم.	I don't know so much about that.
فقط محتوی ماهیتابه که مختصری از آن باقی مانده بود	though in his heart he took them with him, and their now nearly finished skimmings that he carried in the bucket
این غذای اخیر میان برخی از ابی قوریان بسیار خوشمزه شناخته شده است	in flavor somewhat resembling calves' head, which is quite a dish among some epicures
در اینجا بود که خواهرت تو را گاز گرفت و به رویت کارد کشید.	she bit and stabbed you here.
توشه مختصری که داشتم برگرفتم و به عرشه کشتی برآمدم.	got on board with all my little cargo of provisions.
خاصه در میان طایفه ملاحان که خواهش واپسین کاپیتن فرمانی است که باید اطاعت کرد	but with a sailor the last requests of his superior are commands
وقتی از تو خواستم به اینجا بیایی هیچ منظور خاصی نداشت.	I shouldn't have asked you to stay here on any other condition.
یک نسیم کافی شد تا او را از پا در افکند.	a puff of wind was enough to lay it low.
که مفهوم عبارت من نگهبان منافع شما خواهم بود چیست	still less what watching over his interests meant
همه چیز را همان گونه یافت که ترکشان کرده بود.	found things going on much as he had left them.
بلکه به خاطر ارتباطشان در کارهای خلاف قانون بود.	based not so much on kinship as on complicity.
در نقاطی که پر از کثافت و تعفن و هر نوع پلیدی باشد.	where there is most dirt and smell and all sorts of nastiness.
برای من خواندن ذهن و حافظه تو کار مشکلی نبوه است.	it has not been hard for me to read your mind and memory.
من که شلاق زدن را در همه معادن قدغن کرده بودم.	I ordered a stop to flogging at all the mines.
یک امتحان دیگری در حق من به عمل آور.	make one more attempt try me once more!
که در دنیا اوراقی هم غیر از اوراق روزنامه هست.	that there are other leaves in the world besides leaves of paper
من یک سد دی گر اطراف سوراخ درست کردم.	I established a second barrier around the hole.
این حقیقت را کام لا به ذهنت فرو کن!	I have waited for you with the greatest impatience not that you were worth it .
بهتر است از ملاقات خود نتیجه بگیریم زیرا من کار زیاد دارم.	so to business, prince, for I must be setting to work
اما من به دوستی قوی محتاج بودم که آخرین لحظات عمرم به من لبخند بزند	but I require a strong mind to smile on my last moments.
میفهمیدند که راه را درست میروند و به زودی به آبادی و آب و نخلستان و سرپناه میرسند.	they knew they were on the right course toward water, palm trees, shelter, and other people.
همه خاصیت آهن ریایی آن خنثی شده به نحوی که عقربک که از آن پیشی مغناطیسی بوده از آن پس بیش از سوزن خیاطی زنان ارزش نداشته است.	all its loadstone virtue being annihilated, so that the before magnetic steel was of no more use than an old wife's knitting needle.
نشانی پزشگی را از او خواسته بود که بتواند همسر آن کارگر را مورد عمل کورتاژ قرار دهد.	had asked him if he knew of a doctor who could aid a young married woman
آنگاه در آن هوای پشت گلی چنان حال شیرین و چنان حال شکوایی چنان دعا و نماز درهم پیچی برخاست	then, such a sweetness and such plaintiveness, such inwreathing orisons curled up in that rosy air
با وجود اینکه مدت درازی است که در راه است	although it is a long time on the road
همین طور چوب ماهیگیری و بوی اسپرسها به یاد دارم	I remembered my fishing rod and the smell of sainfoin
مردم که به خاطر گل روی ما به ما پول نمی دن!	folks don't pay us for our lovely beauty!
تو حق داری مست لای عقل! بسیار خوب مانعی ندارد.	you're right, tipsy spirit you're right!
شاید در آن موقع بود که فهمید چه گناه بخشش ناپذیری کرده و با دست خود چه دام مهلکی برای دوست و ارباب خود پدید آورده.	I believe then that some faint idea of the truth began to force itself to his conscience
یک جوان خوش قامت از حیاط وارد اتاق شد.	a good looking young fellow came across the yard into the room.
من دو فهرست از تابلوهای نقاشی را در اختیار دارم.	I have two lists of paintings here.
من بودم که زندگی او را زیر و رو کرده بودم.	I've turned his life around!
آنگاه خودش انبر را برداشت و دو هیزم گداخته را از هم جدا کرد	seizing the poker and raking a couple of logs together.
پیش رفت تا وقتی که یک سرباز کت آبی دکمه بسته جلوی او را گرفت.	walked forward until a sentry, his blue overcoat buttoned high against the wind, stopped her.
من پهلوان سرگردان نیستم و هرگز هم آرزو ندارم بشوم	for I am not a knight errant and never expect to be one
این پیرمرده که یه چیزی به انگش تاش بسته.	that old cove who has something the matter with his paw
اما یک جانور نبود که شکم تهی داشته باشد.	but not a beast of them all had an empty stomach.
اگر از این جنگ و از این سقوط مدهش جان بدر بردید	if you should survive this encounter and fall
هر چند در آن هنگام حرکت او متوقف شده بود.	though for the present her headway had been stopped.
این خود کاری است که امروز از برای منفعت بردن بهتر از آن چیزی نیست.	the only industrial enterprise which in these days promises to make good the fabulous prospects
اما در عین حال بسیار ممکن است که یکی از نزدیکان شما را هم دوست نداشته باشم.	I may at the same time, very well indeed, be able to dislike some member of your family.
ولی همین خلوت بودن و ناگهانی بودن رقص باعث شده بود	but the rarity and the suddenness of it made it very delightful
برایش یقین حاصل بود که چه پیش خواهد آمد.	he was sure of what he was going to hear.
وقتی بیدار شدم شب شده و سخت تاریک بود	I was in utter darkness
خوب معلوم بود که با وارد شدن به این تالار بزرگ خودش را گم کرده است.	he was manifestly out of place in the spacious hall in which he found himself.
از حالتون پی داس دلم نیمخواد شما که با ین خوبی هست ین غم داشته باشین.	I do not want you to be grieved.
به تخته سنگ سیاهی که صورتی بر آن نقش شده است رسید.	ten fathoms south of the black crag with the face on it.
لیکن به هر حال این اتفاق هم برایمان مفید واقع شد.	but luck was hostile.
با همین فکر نشست و یک ساعت و نیم حسابی تمرین کرد.	sat down and practised vigorously an hour and a half.
تا من باید خودم را برای خشنودی تو به خطر اندازم	that I should hazard myself to gratify thee
ضمناً به من پندهایی داد و کلماتی حاکی از محبت و دلگرمی گفت.	gave me the kindest words and the best advice.
چوب بیلیارد را انداخت و به دنبال من از سالن بیرون آمد.	threw down his cue and followed me from the room.
تو حالا به راستی مثل یک خانم زیبا و آراسته هستی.	you look like a lady now.
بزرگ تره شصت سال و دو نفر دیگر سی سال و کمی بیشتر داشتند.	the oldest, gray and about sixty, the other two thirty or more
که هرچی کمتر با هم دیده بشیم برامون بهتره.	that theless we were seen together any where, the better.
همه کس را به زور از مسکو بیرون خواهند کرد.	everybody was to be ordered to leave.
در را از روی عصبانی بستم و به راه خود ادامه دادم.	I came out, a little defiantly
در ساختن آن بوریا هنری به کار رفته بود	not unartfully made
در این وقت صدای خستگی آور یک سوسک قرمز بلند شد	now the tiresome chirping of a cricket, began.
شاید که مکتوبی به تو بدهند که دیگری برسانی	perhaps they will give you another letter and charge you with a commission
این مرد هم اندکی پس از آغاز کارش در آنجا از این قانون آگاه شد.	shortly after coming there, this man had beeninstructed as to that rule.
با تعارفات بسیار از هر دو طرف از یکدیگر جدا شدند.	with many compliments on both sides, they parted.
همان طور که قبلاً گفتم او مرد و فقط این تکه کاغذ را در دست داشت.	as I tell you, she died with the scrap of paper, all worn and tattered, in her hand.
این بود که رفتم بالا به اطاق خودم در طبقه سوم و تا توانستم در کندن لباس طول دادم تا وقت بگذرد و آهی تلخ کشیدم و به بستر رفتم.	so up stairs I went to my little room in the third floor, undressed myself as slowly as possible so as to kill time, and with a bitter sigh got between the sheets.
اما گوش به حرف من بده و وقت را فوت مکن زودتر برو و از او دیداری کن و امید کاپیتن شدن خود را به وی بگوی	but never mind that my boy go and announce your arrival and let her know all your hopes and prospects
یه سری خرت و پرت توی خو نه دارم	I have a few items at home
صدای امواج که سایر صداها آن را خفیف یا مخفی کرده بود ناگهان همچون رعد در گوشش طنین انداخت	this sound which had been obscured and concealed under the other sounds suddenly thundered hollow in her ears
خانم در حالی که روی زمین خم شده بود بانگ برآورد	the man cried, leaping to the ground
دلیلی ندارد همین دوروبرها چند تا دوست و آشنا برای خودم دست و پا نکنم.	I see no reason why I shouldn't make a few acquaintances hereabout.
با سر به درون بشکه بزرگ هایدلبرگ سقوط کرد و با غرغر وحشتناک روغن آلودی ناپدید شد.	with a horrible oily gurgling, went clean out of sight!
سرنوشت آن را آن گونه پیش پایش نهاده بود.	but fate had given him no choice.
زانوبندی از چرم داشت که زنگ نسب تا بزرگی از آن آویخته بود.	a leat her knee cap, whence hung a moderately large bell.
ناچار شده بود که در 44 درجه عرض و 143 درجه طول جغرافیائی بس وی شمال شرقی براند.	driven north eastward to the latitude of 44 degrees, and longitude of 143.
اونیفورم کتانی به تن داشت که از نوک پا تا کلاهش بسیار منظم و با قاعده بود.	he wore a white linen uniform that was absolutely correct, from the tips of his boots
پس از توجه کامل و تحقیق در باب ماهیت امراض مختلف و طریقه علاج هرکدام روز چهارم به مجلس سنا بازگردند	after which, having maturely considered and consulted upon the nature of the several maladies, and the methods of cure, they should on the fourth day return to the senate house
یا فقط تظاهر به تسلیم کرده است تا مرا بیازماید	or if she sought to try me
بلکه بیشتر از همیشه از تحرک و کار آیی خود خرسند بود.	he was positively more satisfied than ever with his own activity.
دست را کنار نقاب کلاهش گذاشته به جانب او رفت.	with his hand at the salute rode up to the general.
من عاقل خواهم بود و کار بدی نخواهم کرد.	I'll not do anything.
از اینجا بیرون برد و در گودالی پنهان کرد	should be thrown into or deposited in some dry well
متنفر بودم که او فکر بدی راجع به گروه من بکند.	hating for her to think badly of my pack.
اتاق با آن فر گرم و سوزان اتو بخار به صورت یک کوره در آمده بود.	the room, with its red hot ironing stove, was a furnace.
که به عقیده وی دفاع از آن هم ممکن و هم ضروری بود	he considered that it could and should have been defended
ولی همین که کارم تمام شد فورا خواهم آمد.	but as soon as it is over, I will come.
در روشنایی صبحدم به دور و بر خود نگاه کردند.	gazed round them in the clear morning light.
تام را از سر نو خوش و سرحال شد.	made him lighthearted and happy again.
من یک لحظه ایستادم و به او نگاه کردم.	I stood looking at him a moment.
من در مخصوصی برای بیرون رفتن از حیاط دارم.	I have my servicedoor which opens on the courtyard.
که برای آدمی با عادات او حتی کفاف یک سالش را هم نخواهد داد.	which would not last a year for a man of his habits.
از همان جا که بودم توانستم عنوان کتاب را بخوانم.	from where I stood I could see the title
با تحقیر گفتم من نمی دون ستم برای موجودی که تو هستی اسم دار ین	I didn't realize they had a special name for what you are, I spit.
گذشته از آنکه به دستور او با دقت جیب مرا جستجو کردند	besides a diligent search into my pockets
اما همین طور سه ورقه اعتبار غیرمحدود ابراز کرد.	he has three unlimited credits
جوان همراه سوندرا دراز و باریک اما بسیار خوش پوش بود.	a tall, gangling, but very smartly dressed individual.
نظر به تحقیر و خواری افکند و به سراب رستگاری خود چنان چسبیده باشد	that he clung, as to his one salvation
اما من دیگر مایل به انجام این عمل نیستم!	but I don't want to do so anymore!
فقط خودمو روی صندلی پرت کردم و در حالی که زانوهام هنوز زیر فرم ون خم شده بودن موتور رو روشن کردم.	I just threw myself into the silky leather seat and cranked the engine while my knees were still crunched up under the steering wheel.
به دقت و چالاکی بندبازی یک پا به عقب پرید	leaping back a yard with the speed and security of a trained gymnast.
امروز دیگر با تبر و نیزه کار نداشته باش.	no more gaffs and pikes to day.
خطی از بالا به پایین در وسط آن کشید.	drew a line down the middle of it from top to bottom.
باید معیشت خود را از قمار و کارت بگذراند	, by shuffling cards
برای آنست که تمام کلاسش از این قبیل محصلین پر شود.	paid to talk down to the level of his audience.
اما بعد که خوب فکرش را زیر و رو کرد	under the attrition of thinking them over
دقت کرد که دمش لای در آن گیر نکند.	she had to be careful not to trap its tail in the lid when she slid it closed.
ناخدای ناشناس را با این رد بلا شرط و کامل تقاضای مصرانه او به جای خود میخکوب کرد.	leaving the strange captain transfixed at this unconditional and utter rejection of his so earnest suit.
حیرت زده بود چرا فقط پانصد نسخه از اشعارش به فروش رفته بود	that it confounded him to think that he had only sold five hundred copies of his poem
من که سخت دست خوش ترس و کنجکاوی بودم لرزان	trembling and listening, in the extreme of fear and curiosity
تناردیه شمعدان را برداشت و مرد غریب بقچه و عصایش را بدست گرفت.	the man picked up his bundle and cudgel
هرچه باشد بهتر از این تردید و دودلی است.	anything but suspense!
که از سی سال پیش با او آشنایی داشت توقف کرد.	where he had been in the habit of putting up for the last thirty years.
این حالت برای بعضی مرتب و برای برخی نامرتب است.	in some women its as regular as the phases of the moon, in others its not so predictable.
که به دمش نخ ببندی دور سرت به گردونی	to swing round your head with a string.
که هنوز اثرات جنگ از بین نرفته بود چنین اوضاعی بود و	when some of the effects of the war had worn off
آخه در اون دوران مردم عادی از سحر و جادو وحشت داشتند	for it was an age when magic was feared by common people
برای اینکه کاغذ را به شخصی که نوشته شده است برسانم البته لازم است که اسم او را بدانم	I was forced to read the address to know to whom to give it
کدوی آتشینی که برای حمل آن به دو مرد گردن کلفت نیاز بود.	a fiery red thing so enormous that it took two men to lift it.
روی آن چهار پایه حالت آرام و استواری به خود گرفتم.	took a firm stand on the stool.
به یاد چند عضو با نفوذی افتاد که از قضا در آنجا باقی مانده بودند.	some dusky potentates who happened to be staying there.
در زمانی که شلوار پاچه گشاد باب روز بود	though wide trousers had been a long while in fashion,
اما از وضعش دانست که از مون فرمی نیامده است.	but she perceived plainly from his air that he had not come from there.
نخی را که از پوست مار زنگی درست شده کرده و به قوزکش بسته بوده از پایش انداخته است.	he had kicked his string of rattlesnake rattles off his ankle
از این که دیگر مسئول زندگی مردان ده خود نیست	that he would no longer be responsible for the lives of the men from his own village.
حال من در موقع بیان این جملات عیناً نظیر حالت یک زن رانده از محیط اجتماع بود.	I added, as a wretched anticlimax.
ولی بعدها از حیث سرعت و مهارت با دیگران فرقی نداشتم.	I soon became at least as expeditious and as skilful as either of the other boys.
راسکلنیکف مجدداً مشت را به روی میز کوبید و فریاد کرد.	he shouted, bringing his fist down on the table again.
چنین حس کردم که چندین طپانچه و ضربت در عقاب فرود آمد.	I heard several bangs or buffets
اما به ندرت امکان دارد حتی خردمندی سالخورده از تصور اینکه دل کسی برایش تنگ نشده است احساس شادمانی کند.	but perhaps not even a sage would be gratified that nobody missed him.
یکی درست در روبرو به سمت شرق و دو تای دیگر در طرفین.	one straight before them eastwards, and one on either side.
از من اجازت خواست که آنچه را گفته بودم بر آن انجمن بیان کند.	desired my permission to explain to the company what I had spoke.
در حالی که نیروی کامل این تماس را درک کرده بود	while the full force of it came home to her.
اگه بتونم باهاش دوست بشم طوری که نه اون تو دردسر بیفته نه من	how and where they might go be do from now on
مشروب خواری پدرشان بر اثر زندگی تنها در مزرعه چای افزایش یافته بود	their father's drinking, aggravated by the loneliness of tea estate life
قسمت بعد از این را آهسته اما شمرده و واضح خواند لکن ترسندگان و بی ایمانان و خبیثان و قاتلان و زانیان و جادوگران و بت پرستان و جمیع دروغ گویان نصیب ایشان در دریاچه افروخته شده به آتش و کبر ین خواهد بود.	was slowly, distinctly read, the fearful, the unbelieving, &c. , shall have their part in the lake which burneth with fire and brimstone
یا اصلا از دادن هرگونه توضیحی به آنان امتناع بورزد.	or better yet to refuse to give any information whatsoever.
روی یک کاغذها همه کلمات زبان خودشان را از نظر وجوه و حالات افعال و صرف اسماً و ضمایر نوشته بودند	on these papers were written all the words of their language, in their several moods, tenses, and declensions
ایستادم و دسته گل را روی صندوق پست دروازه گذاشتم.	I stood up and put my bunch of primroses on the gatepost.
که در پهلوی او نشسته و مشغول تلاوت ادعیه است.	who was praying by the side of the corpse
شب کام بخش و تب آلود با حجاب خود از راه برسد.	that the concealing, rewarding feverish night were at hand.
اما ممکن بود برای دیدار مادرش امروز صبح به آنجا بیاید.	but he might come along in the morning to visit his mother.
شاهزاده خانم برپا جست و غضبناک در را به شدت به هم زد و آن را بست.	with a gesture of desperation slammed the door with all her might.
که با چشم تشخیص دقیق و کامل آن مقدور نبود.	but it was impossible to see it clearly with the naked eye.
شبیه آن گروه از افسران سواره نظام شده بود که لباس نظام را در آورده و حال به کسوت ملاکان در آمده بودند.	he suggested an officer of cavalry turned gentleman farmer.
گوشه خیابان بایستد و از خجالت آب شود گوشه خیابان!	when he would have been glad tohave been anywhere else in the world than out there on the street!
ولی تمام کلمات آن همیشه به روشنی در مغز و ذهنش بود.	but every word in the article was emblazoned on his mind.
من خواستم داخل شوم لکن او در مقابل در ایستاده و راه مرا سد کرد	I would have gone in, but he stood in the way to prevent me passing.
ولی به محض اینکه خواستم اولین جمله خود را ادا کنم مرا تهدید کرد که اگر ساکت نشوم در اتاق دیگری به طور تنها و مجرد زندانی خواهم شد.	I was rendered dumb in the middle of the first sentence, by a threat that I should be shown into a room by myself the very next syllable I uttered.
اگه باهاش ازدواج کنم همة این چیزها رو تغییر می دم!	if I married him, I'd change all that!
در هر صورت خدا لعنت کند بر کسی که این کار را کرد	I only hope the mischief will fall upon the head of whoever wrought it
به جای بازو دو دکل کشتی عظیم داشته باشد	whose arms are like the masts of mighty ships
کنار سر او تکیه دادم و او کنار دراز کشیده باشد.	I leaned back against her headboard and let her lie by my side
می دونم که تو زن و بچه او نو زیر بال و پر خودت گرفتی با وجودی که خیلی برات سخت بوده.	I know that you have even put up with having his wife around, which must have been a strain on you.
دنیا اگه هر از چند گاهی چند میلیون انسان هم از دست بده می تو نه ادامه پیدا کنه.	the world can afford to lose a few million humans every now and again.
بگویم چه پیش آمدی سبب شده بود که مرا در آن صندوق عظیم چوبین بگذارند و دست خوش امواج دریا کنند	by what accident I came to be set adrift, in that monstrous wooden chest.
باید از اون خو نه شروع به شلیک کردن کنیم!	it is from that house yonder that we must fire.
خوشحالم که فرصتی دست داد تا با او خداحافظی کنم.	I'm glad I had a chance to say good bye.
صدای هری تنها صدای فریادی که در اتاق پیچید نبود.	except that his wasn't the only voice that shouted.
دیوارهای آن تا آرنج آدم از چوب هزاره کشیده شده است.	the wainscot rises to elbow height
که هر چند به دقت با بی بند و باری تنها هوای نفسانی هم نوا نبودند	though not so strictly according with the wildness of his ruling passion
فقط به قدر کافی نیرو داشتم تا آنجا دراز بکشم و بی حرکت منتظر زغال شدن خود بمانم.	I had just enough strength to lie there unmoving while I was charred alive.
به من بگویید که کیستید و چه چیز باعث شده است که در این نقاط خلوت همچون درندگان به سر برید و با مرگ دست به گریبان باشید	to tell me who you are and the cause that has brought you to live or die in these solitudes like a brute beast
چه آن را سر و ته گذاشته بود تا در جنگ تن به تن بتواند از آن به عنوان چماق استفاده کند	for he reversed the stick so as to make the gold handle a club in case of closer fighting
درهرحال مردی شرافتمند و فعال است و ما بهتر از او کسی را نداریم.	honest, practical man and we have nobody better.
من باید ازت چیزی بخوام. اگر لازم با شه التماست کنم	I have to ask you for somethingto beg, if I must.
که بی آنکه برای گذاردن ظرف روغن و روغندان به کشتی درنگ کند	that without pausing to put his oil can and lamp feeder aboard
فکر کردم که اینبار این ماجراجو به دنبال چه چیزی است.	I wondered what the lure was for the adventurer.
ولی می شه تقریبا مطمئن بود. حدس من درس ته.	but we can make a pretty good guess that figure's in the ballpark.
که در اینجا در برابرش قد علم کرده بود پیوند بخورد	that was here laid out before him.
بعد با خونسردی و آرامش پادری را که ورودش باعث شده بود کنار برود دوباره سر جایش کشاند و در را محکم بست.	towards which he again coolly pushed the mat which his entrance had deranged.
هری تقلا کرد و از آن وارد شد اما ردایش شکافت.	he struggled through it, tearing his robes, and
مدتی بی آنکه درست دلیل آن را درک کنم درباره آن فکر کردم.	I pondered some time without fully comprehending the reason for this.
اما دبیر امیدی به پیدا شدن چنین شغلی را نداشت.	but the secretary held out no hope of getting him anything of the sort.
شگفت آنکه در میان اهالی محل هیچ کس تحمل فانوس شب افروز را نداشت.	it was remarkable that nobody in the neighbourhood could endure a lamplighter.
اما آن افسر این فرامین را ندیده گرفته و با مسئولیت خودش به اورسولا اجازه داد تا یک ربع ساعت با پسرش دیدار و گفتگو نماید.	but the officer assumed the responsibility of letting her have a fifteen minute stay.
این بود که از او خواهش کردم که به من رخصت دهد تا شکل و طرح آن را مطابق تصویر ضمیمه رسم کنم.	the form and contrivance of which I desired leave to delineate on paper, as in the figure here annexed.
سعی کردم این کلمات را طوری ادا کنم که او مرا نشناسد.	 I said, feigning to speak roughly to her.
همه خود را زیر سایه درخت بید جا دادیم.	we all cut ourselves willow switches from the tree
تمام شب را به تعمیر و پاک کردن اسلحه مشغول بودند.	cleaning all night long without closing their eyes
گویا تمام این خانوادة فقیر اکنون فقط وابسته به شماست.	I believe the whole of this poverty stricken family depends now entirely on you?
در مورد سرقت یک خردل دان نقره نیز تهمت دروغ به او وارد شده بود.	he had been maligned respecting a mustard pot
این نشان قاطعی از هیجان وی بود شروع به قدم زدن در اتاق کرد.	a sure sign with him of mental agitation.
معلوم نشد چرا این عنوان او را به خنده انداخت	but it would be difficult to say exactly why.
اما بی درنگ خاموش شد و دستور داد تا افسر ارشد را به حضورش بخوانند	but checked himself immediately and sent for a senior officer.
در نر هری همچون هیولای مخوفی بود که بر سر راهش کمین کرده و راه عبورش را بسته بود.	he felt as though it were crouching ahead of him like some horrific monster, barring his path.
می تونم از زمانش واسه ی مطالعه آزاد استفاده کنم	I could use the period for independent study.
همیشه از این واهمه دارد که روزی دوباره به سراغش بیاید.	was afraid would be coming back to get him one of these days.
در آنجا چنانکه دلخواه منست عمر خود را به انزوا بگذرانم.	pass my time in a manner as recluse as I pleased.
من امروز خیلی بدخلق هستم و امروز اصلاً توی جلد خودم نیستم.	I'm cross and have been out of sorts all day.
عقیده نداشت که این امور به حال بیمار مفید باشد.	he did not believe it would be of any good to the patient.
زیرا شاعران مجازند که در نکوهش رشک و حسد نغمه سرایی کنند و حاسدان را در اشعار خود بکوبند و نیز در هجو سایر عیوب و قبایح انسانی داد سخن بدهند	for it is legitimate for a poet to write against envy and lash the envious in his verse, and the other vices too
که مشارالیه آسوده و با کمال وقر ایستاده بود	who remained motionless in his place, as calm as ever, and pursuing his interrogation
یکی از جنس ارزان برای استفاده روزانه در اداره	one of cheap materials for daily use at the office
برای گرفتن علوفه با دستهای از هم گشوده شتاب میکرد و آن را به سرعت در ارابه میریخت.	opening his arms to clutch the bundle and lay it in the cart.
اما پس از اون خو به در مریضخونه با شه.	but after that it'll be more convenient for us to have him at the hospital.
در جنگ شرکت کرده و در اواخر جنگ یک چشم و یک پایش را از دست داده است .	that he had been in the army and had lost both leg and eye shortly before the surrender.
پاک یادم رفته بود که او حسابش را نپرداخته است!	I hadn't forgotten my score!
به دور این آتش عظیم شش دیگ بزرگ به ردیف چیده شده بودند	six stewpots that stood round the blaze
حیوانات مجبور بودند به همین پاسخ سربسته اکتفا کنند.	the others had to be content with this cryptic answer.
سپس به سرعت از پلکان به انبار بالا آمد	in all haste returned to the hole
که مفهوم آن این بود که چابک سوار غروب داشت از راه می رس ید.	that still and golden hue that means twilight's outrider has arrived.
وضع چنان بود که هر دو سخت آشفته و منقلب بودند	so that they were both uneasy
به عقیدهٔ من بهتر است بیش از این صحبت نکنید.	you'd better keep quiet
هر چند رسم ما این نیست که بیگانگان را به سرزمین خود راه دهیم.	though it is not our custom to lead strangers through our land.
که من امروز چه صبح مکروه و با زحمتی دارم که هیچ وقتی این قدر گرفتار زحمتی نشده بودم.	I am finishing the most execrable morning's work
خودش پا پیش بگذارد و خواستگار مناسبی برایش پیدا کند که او را سعادتمند سازد.	he would be the first to help her find happiness with a worthy suitor.
پشت سرش یک پسربچه و یک زن سیاه چشم بود	a light haired woman by his side
زن خائن و مرد خائن چه قانوناً و چه عرفاً یکسان مجازات نمیشوند.	the infidelity of the wife and infidelity of the husband are punished unequally, both by the law and by public opinion.
که همراه با هم تا چند قدمی آن خانه پیش بروند.	their walking within a few feet of the house where they stopped.
زیرا دیگر حاضر نیستم یک دقیقه بیش از این صبر کنم و شاهد لجبازی و یکدندگی احمقانه تو باشم!	because there is no reason for my lingering another minute, if you persist in your stubborn ill nature!
توان حرف زدن نداشت اما به یقین بازویش را از زیر رواندازها بیرون آورده بود	but he had certainly lifted his arm off the coverlet
سرانجام از اصرار من به ستوه آمد و ناراحت شد و از جای برخاست	till he grew irritable, and got up
زیرا این دختر باید از همه دختران دیگر خدمت بگیرد و دختران دیگر نیز در سایه او معزز و سربلند شوند.	she must avail herself of the help of all, and all derive their lustre from her.
زیرا امپراطور در گذشته نیز همیشه برای لیاقت و شایستگی او ارزش قابل بوده است.	for our sovereign appreciated him so highly before.
پهلوان در جلو چشم کاروانسرا دار و مسافران بر زمین افتاد	down he came to the ground in the sight of the landlord and the travellers
وانگهی مغرورتر از آن بود که خوی حسودش را آشکار سازد.	partly because he was too proud to betray
هیچ بعید نیست کارش بالاخره بکشد به این که فکر کند عاشق او هست.	I should not wonder if it were to end in his being so at last.
هیچ کس نباید بدون اجازه از مدرسه خارج به شه.	I must make it plain that nobody is to leave school without permission.
احساس مینم وقت خوبی باشد که من و گرو بز با هم کمی گپ بزنیم.	we felt it was a good time to have a chat.
اوه پناه بر خدا من گفته بودم چیزی نمی گم که شما دلواپس به شین	hell, I says I wasn't gonna fret ya.
چون اگر سر زیری ریسمان به نحوی به قایق بسته باشد	for were the lower end of the line in any way attached to the boat
من هرگونه مسئولیت وجدانی را از خود سلب کنم	I clear my conscience
من صد بهانه برای سرزنش و تحقیرش پیدا کردم	I had a hundred opportunities of setting him right and putting him down
تنها از آن دم که از میان ما رفت کم کم به درک او نایل شدم.	I only began to understand him from the moment when he passed away.
بعلاوه یقین داشت که این جوان تنها برای نجات وی خود را آشکارا به سخت رین مخاطره انداخته است	that he had exposed himself to terrible and obvious danger to save her
هر جا رو نیگا کن ین نشون می ده.	everything shows it.
چون دید که عزم راسخ من بر آنست که به زاد و بوم خود بازگردم با خشنودی به من اجازه حرکت داد	finding me absolutely determined to return to my native country, was pleased to give me his license to depart
ولی متأسفانه قبل از این که حواسم را جمع کنم قضیه را به او هم گفتم.	but, unluckily, I had mentioned it before I was aware.
باید هر طور هست خودمان را به هواپیما برسانیم!	I'm not missing that plane!
تا آن جا که کیتی گفت له وین هیچ توجهی به او ندارد	so that she said he did not care for her
اسب خاکستری را در ازاء اسب کهرش و سی پوند پول نقد به دست آورده بود.	had got possession of the dappled gray, at the price of his old horse and thirty pounds in addition
موهای سیاه و نامرتبش به سقف کلبه برخورد کرد.	his shaggy black head grazing the ceiling.
اکنون آن قبر نظیر دو قبری که پهلوی آن واقع است از چمن سبز و لطیفی پوشیده است	at present it is as smooth and verdant as its companion mounds
همان کشوری که با آن طرز شگفت انگیز از آنجا نجات یافته بودم.	from which I had been so strangely delivered.
آخه می دونی بعضی از ماها که مثه آدم درست و حسابی بار نیومدیم!	as there isn't SOME of us wasn't brought up respectable.
سعی کردم حواسم رو با صداهای دی گه مشغول کنم.	I tried to listen to other sounds
در واقع مثل خرس غران در غار خود ناپدید شدند.	growlingly disappearing, like bears into a cave.
سورای یا گردش و حتماً خیلی بهمان خوش خواهد گذشت و اوقات خوبی خواهیم داشت.	driving or walking, and we'll have capital times.
با اصلاح فوری وصیت نامه پرداخت آن را پس از مرگش تضمین کند.	by an immediate alteration of the will, should be secured at his death.
صندوق را از دریا برگیرد و در کشتی و سپس در اطاق ناخدا بگذارد.	take the box out of the sea into the ship, and so into the captain's cabin.
مادرش سیصد فرانک برای او فرستاده بود که در قبال آن تعهدی نداشت	his mother had sent them three hundred francs which he had no longer expected
البته تو راضی نخواهی شد که من زکام بشوم.	you would not like me to risk taking cold?
لیکن چنانکه خواهد آمد تنها از شر وجودش راحت شدیم نه از شر کارهایش.	though not, as you will see, of his affairs.
عده ای را به دور خود جمع کرد که عمدتاً از اعضای خانواده ی خودش بودند و در بخش دامداری سهیم شد.	collecting together a gang of workers to help him, principally of his own family, became a partner in the cattle yard.
در شیشه را باز کرد و آن را برگرداند.	unscrewed it, and turned it over.
همه لحظات این شب برای او با یک شادی نشان شده بودند.	every instant of that night was markedby a joy for him.
4 حاضر است خود را به زحمت بیندازد تا دیگران در آسایش باشند	4. he is ready to bear pain for the comfort of others
ناگهان خود را در آن جمع غریبه احساس کرد.	suddenly feeling very much out of place and alone
آن موقعی بود که دزدی را به دلیل وارد شدن زورکی به خانه با شلیک گلوله کشته بود.	was when with one shot she killed a thief who was trying to force the door of her house.
با عجله از رستوران امدم بیرون. از بدشانسی باران شروع شده بود.	I hurry out of the restaurant to discover it's started to rain.
آنگاه ایثار بی دریغ ربرتا او را محذور اخلاقی دست و پاگیری بیندازد.	considering her exclusive devotion to him, might prove embarrassing.
در این شرایط هر نفوذی هم که ممکن بود داشته باشم کاملاً از بین رفته است.	at this stage any influence I might once have had is completely gone.
این را هم باید بگوییم که بین اشیاء نادری که در میدان چیده بودند	we ought even to add that, among the curiositiesdisplayed in the square
تو نباید برای خاطر آن دوستان لوس احمقت مرا از اینجا بیرون کنی.	don't turn me out for those pitiful, silly friends of yours!
موی سرش نامرتب و موهای صورتش زبر و ژولیده بود.	his thick brown curls were rough and uncultivated
به هوسارها دستور داده شد برای پوشش توپخانه به بالای تپه حرکت کنند.	the hussars were ordered up the hill to support the battery.
من از صمیم قلب حاضرم بیست دوکا بدهم و ترا از این مجازات معاف بدارم.	I will give twenty with pleasure to get you out of that trouble
باید توجه داشت که از لحاظ حقوقی این کار بسیار بغرنج است.	I must observe that from the legal point of view the case was far from clear.
چگونه در اندیشه آراستن سپاه و آموختن انضباط نظامی به مردم خود برآمده است.	came to think of armies, or to teach his people the practice of military discipline.
در میان سکوت و ظلمت محض به خواب رفتم.	amidst silence and complete darkness I fell asleep.
بر آن شد که در ظرف سه یا چهار روز دیگر باز از خانه بیرون زند.	he resolved to make another sally in three or four days from that time.
نمی تونم نمی تونم بدون اون زندگی کنم .	I can't I can't live without her!
وقتی دهان کجش باز شد جای خالی چند دندان در دهانش نمایان شد.	his lopsided mouth revealed a number of missing teeth.
بگو تا همه با هم عذاب جانکاه خود را به جان من بریزند	all into this breast transfer their pains
طوری که انگار جفسن جواب این سؤال را یادش نداده بود.	quite as if hehad not been instructed as to all this before hand
او به زودی متوجه حقایق گشته و مانند من از تو متنفر خواهد شد.	he'll soon detest you as much as I do.
دیگر ممکن نیست هرگز این عادت را ترک کنم.	I can never grow out of that.
با هم ون ماشینی که قصد نداشتی ازش استفاده کنی	in the car you weren't intending to fly!
یک نظری بیشتر به من نکرد و در آن یک نظر من مرگ خود را معاینه دیدم.	I have but exchanged with him one look, yet that look convinced me that we were doomed.
که تاکنون هرگز کسی چنین چیزی نقاشی نکرده است.	that no one had ever painted a picture like it.
منظورم ای نه که از محیط مدرن بازاریابی ما احتیاج داریم به ائتلاف راهبردی و بینش آینده نگری توجه کنیم	I mean, in a modern marketing environment, I think we need to be looking at a fusion of strategy and forward thinking vision
به محض اینکه موقعیت مناسب به دستش آمد آن را از گرو درآورد.	so that if anything came of it, it could still be redeemed.
چون با جوابهائی که جفسن به رام نوشته می دونم چی به گم.	which he was to explain with this listof answers
اسلحه را در گودی آرنجش که تکه پاره شده بود نگه داشت.	keeping the gun in the shadowed hollow of one lacerated and shredded elbow.
اما در لحظه آخر خود را خم کرد و سرش به برف رسید.	but at the last instant swept low to the snow
اصلا به کلاید معرفی نشوند و هرچه کمتر او را ببینند.	as little of him as possible not be introduced at all.
من هم خوشحال میشم شوهری داشته باشم که فکر نکنه من زن احمقی هستم و انتظار داشته با شه که بهش دروغ به گم و	it would be nice having a husband who didn't think me a silly fool and expect me to tell lies and
امیدوارم که همه چیز با خوشی و خوشبختی برایش همراه باشد.	I hope things will go happily with her.
توفان سهمگین خشم شاهزاده پیر بر وی وزیدن گرفت.	her father's fury broke over her in a terrible storm.
چنان متوحش شده بود که نه قوه التماس و نه حالت فریاد داشت.	he neither supplicated nor exclaimed.
بی هیچ حرکتی جلوی پیشخوان تکیه دادم و سعی کردم خودم را کنترل کنم.	I leaned motionlessly against the counter, trying to control myself.
در حالی که دست بر شانه مو رل نهاد	placing his hand on the young man's shoulder.
مجبورم اونجا بشینم و وانمود کنم کارمند خوبی هستم	I have to sit there and pretend to be a good employee.
وقتی دیدند که مردی از چنین عقل سالمی برخوردار است	to see a man of apparently sound sense
سرش را روی سینی درختان صنویر سبز روشن خم کرد.	looked down at the tray of bright green trees.
دلش به حل او سوخت و ایمانش به بی گناهی دوستش متزلزل شد.	she felt sorry for him, and her faith in the innocence of her friend began to totter.
یک آن هری گمان کرد روآبطشآن به حالت عادی برگشته است.	for a moment, it felt as though everything was back to normal between them
اینجا از برادری گذشته و به یگانگی رسیده است.	it is more than fraternization, it is equivalent to addressing each other as thou.
یکی از ملاحان نگهبان را صدا کرد و او را دنبال سه پایه عاج و پیپ خود فرستاد.	calling a sailor of the watch, he sent him below for his ivory stool, and also his pipe.
زمانی که متوجه شد ارتش شروع به نصب آتشبارهایی در اطراف میدان کوچک شهر کرده است	when he noticed that the army had set up machine gun emplacements around the small square
واسه این که صورتحساب ما هر روز بالا بلندتر می شه.	all because our bill's mounting up the whole time.
از آنچه گفتم اصلا غرضم این نبود که مدعی آن بشوم.	I had no intention, in the words I used, to claim it yet.
از ای نرو مرا به یکی از دوستان خود سپرد تا به اتفاق من آنجا برود.	but recommended me to a friend of his, to bear me company thither.
اما هیچ کدام از این نظرها با هم یکی نبود.	but no two theories were alike
پس نامه را در جیب خود گذشت و از انبار بیرون رفت.	putting the packet in his pocket, left the shed.
بعد هم سالن دیگر را با قدم اندازه گرفتند	then in taking the dimensions of the other parlour
حتی ادب و فروتنی را بجایی رساند که از مادر شوهرش دستور تهیه خیار ترشی را پرسید.	even carried her deference so far as to ask for a recipe for pickling gherkins.
خود دور تا سرانجام به همه خواستگارانش پاسخ رد بدهد.	even might lead her at last to refuse all offers.
حتی اگر لازم افتد که به عنوان مهتر در رکاب حضرتت باشم	were it requisite to attend your magnificence as squire
مردی که تا آن روز ندیده بودمش وارد شد.	a man stepped in on whom I had never set my eyes before.
میز و صندلی را چنان پس زد که صندلی افتاد.	knocking over chair and table.
درحالیکه به علت وحشتی که برایش قابل درک نبود نیمی از مشاعر خود راازدست داده بود	half insane with fears she didn't understand
ولی در سایر موارد و قضایا ذهنش کاملاً روشن بود.	but on every other point his wits were as sound as mine.
گفت که به نظرش به غیر از خودشان دو نفر یک نفر دیگر هم در قایق بزرگ هست.	he declared his belief that there was somebody else besides themselves upon the lighter.
خودت که می دونی جادوگرها از کشورهای مختلف دنیا دارن میان.	remember, wizards are coming from all over the world.
آقا درباره این موضوع من در خدمت شما هستم.	I am at your service, sir, in the matter
پیش از آن معنی کلمه قانون را شرح داده بودم	I had already explained the meaning of the word
من در پی شخصی حساس و تحصیل کرده هستم.	but I am looking for a man of feeling and education.
من هم میل دارم بختم را در بازی ورق بیازمایم.	I'll stake something at faro, too, he he!
وگرنه یقین دارم مطالبی را که انتظار دارد از من بشنود سخت بر او ناگوار خواهد بود.	because I was very certain that the account he expected from me would be highly displeasing.
من هر دو تا دست سردش رو تو دستام گرفتم و با دقت نوازشش ون کردم.	I took both her cold hands in mine, rubbing them carefully.
چون این دفاع و این انتقام به او مربوط است.	for this defence and vengeance are his affair and business.
من که حاضر نیستم از این بیشتر بابتش پول بدم.	I wouldnt pay more than that for it.
چنان که گویی اکنون از صحبت کردن در این باره ابایی نداشت.	as if he did not mind talking about the affair now.
برای خانم انگار نه انگار که فرانکی وجود داشت.	she had not so much as deigned to admit he existed.
هزاران بار عزم جزم کرد که سخنانش را تکذیب کند.	was a thousand times on the point of telling him he lied
مانند کارشناسی آزموده و کهنه کار آن را برداشت و آهسته آهسته نوشید.	he drank slowly, like a connoisseur, lingering on the taste.
اندیشیدم که حتماً قبر مادرم هم زیر همان درخت خواهد بود که بدان دلبستگی و آشنایی کامل داشتم.	of my mother lying there beneath the tree I knew so well.
مرد یا زن باید کسی را داشته باشد تا از او حمایت کند و خود نیز حمایت شود	each man and each woman has another allotted to it for life, whom it supports, by whom it is supported
امید داشت که شوهر دانشمندش درمواقع عصبانیت خود دقت نماید	she wished her volatile scientist husband would be careful with his outbursts
در آنجا راهی جز گذشتن از خار زارها نبود.	a man often had to walk through the scrub.
به فکرم رسید که آن قدرها هم بدهیکل نیستم.	I was passing, and it struck me that really I wasn't such a bad figure of a man.
اون وقت باید برای این پول صد تا معلق بزنی.	you can whistle for the money.
با احتاط نشستن آن سه را سر میز نگاه کردم.	watching carefully as the three of them chose which table to sit at.
بهترست به پیشوازش بروم تا چند دقیقه زودتر از این بلاتکلیفی نجات پیدا کنم.	to meet him will save some minutes of suspense.
من راز شما را برای خود نگاه خواهم داشت.	I will keep your secret for myself alone.
حاضر بودند برای شنیدن یک سخنرانی زیبا شلاّق بخورند.	they pitched on some beautiful legend or fairy story, and turned it upside down.
صرفاً این مباهات را مدیون این واقعیت است که از نظر تاریخی این بی باکی را در اسبها و سوارکاران خود ایجاد کرده است.	it is simply owing to the fact that she has historically developed this force both in beasts and in men.
چه آن مرد که مورد عنایت شاه بود در مزاج او تسلطی تمام داشت.	who was, indeed, too much governed by that favourite.
محکومم کرده بود به این که تنها غذا صرف کنم	condemning me to take my meals alone
ظرف چهار روز گذشته به بارها به آن نگاه کرده بود وهربارازاحساس اندوه ودلتنگی که از نگاه کردن به آن به اودست داده بود شگفت زده شده بود.	coming back to it over the last few days again and again, constantly surprised by the strong ache of sadness and nostalgia.
ولی شما به یاد داشته باشید که مجرم شناختن متهم به هیچ وجه مستلزم اثبات انگیزه نیست.	but you are to remember that proof of motive is by nomeans indispensable or essential to conviction.
تنها چند بار برای تجدید نفس سخن خود را قطع کرد.	in broken sentences, and with many drawings of breath.
ولی کاترین مخفیانه و آهسته آنقدر سر به سرش گذاشت که وی چند دفعه نزدیک بود عنان اختیار را از دست بدهد و با صدای بلند بخندد.	yet she went on teasing, till he was twice on the point of being provoked to laugh.
دی گه مایل نیستم در مورد این مزخرفات صحبت کنم.	I have no intention of discussing your soul's welfare any further.
یک راز خانوادگی رو می خوام برات به گم.	I'll tell you a family secret, she whispered enthusiastically.
اما بزودی حتی فراموش کرد که برای چه پول را از جیب بیرون آورده بود.	but he soon forgot with what object he had taken the money out of his pocket.
کام لا سرحال بودم وتوانستم محلی را که در آنجا بودیم شناسائی کنم.	I awoke fresh, and recognized our place.
زیرا او هنوز آن سیاست را نداشت که بتواند وضعی را بسنجد و مشکلات کار را از نظر بگذراند و محاسبه دقیق بکند.	as yet, indeed, he was not sufficient of a diplomatist to sum up a situation, to see its possibilities at a glance, and calculate the chances in his favor.
به خصوص در کسانیکه مثل این آقا بنیه خوبی داشته باشند.	then syncope sets in, and more especially with people of strong constitution like this man.
در اشتیاق به سینه فشردن چهرهء پریده رنگ او	trembling with eagerness to lay the spectral face upon her warm young breast
به محض اینکه برایم امکان داشته باشد هم غذا خواهم خورد و هم استراحت خواهم کرد.	I'll do both, as soon as I possibly can.
هنوز سه روز از یک هفته باقی مانده است.	I've still got three days left.
در عمرم ساخل به ان سفیدی و زیبایی ندیده بودم	I've never seen such incredible white beaches.
من زمان رو به عقب برمی گردونم که دوباره از وقتم استفاده کنم.	I've been turning it back so I could do hours over again
کتاب بخواند و به سیاهان بگوید که چه بکنند.	read books of poetry and tell negroes what to do.
پلکان مارپیچی که در همه طولش از طبقه زیرین عمارت تا طبقه زیر شیروانی شکافته شده است	the spiral of thestaircase, cracked from the ground floor to the very roof
من امیدوار بودم بتوانم قسمتی از آن را گوش کنم.	I was hoping to hear a bit of it.
پیش از آنکه کسی پشم مرا بچیند من ریش و پشم تمام کسانی را که بخواهند دست به سر یک تارموی من بزنند خواهم تراشید و خواهم کند.	ere they shear me I shall have plucked away and stripped off the beards of all who dare to touch only the tip of a hair of mine.
گفتند که این درس عبرت را به جزای موهبتی که ما با جواب ندادن به سؤالاتشان به ایشان کرده بودیم به ما دادند.	telling us that this had come to us through our incivility in not giving them an answer.
خیلی وقت پیش خود من هم تو هم چین هچلی افتادم.	I was once in such a scrape myself.
به عقیده حقیر به هیچ وجه در خور تعصب و غیرت و حمیت و شجاعت ما نبودند و سودی برای ما نداشتند.	I did humbly conceive, they were by no means proper objects of our zeal, our valour, or our interest.
پس از آنکه وضع اربابان خود را مرتب ساختند شام خوردند	after attending to their masters, had supper
دیدم پنجرهٔ سمت چپ اطاق فیودور پاولوویچ باز است.	I saw the window open on the left into the garden
ربع ساعتی در بسترم دراز کشیدم و ترسان و لرزان گوش به زنگ و منتظر ماندم.	I lay a quarter of an hour listening and trembling.
وقتی بر اثر یک طبقه بندی آزاد و مجدد پروانه شناس ان نظر دادند	when, as a consequence of a radical taxonomic reshuffle, lepidopterists decided
اما اکنون تصمیم گرفته بود صبح زود خانه را ترک کند.	but he now determined to go home early in the morning.
به نظر من حسابی گلویش پیش آقای التن گیر کرده بود.	I dare say she was very much attached to him.
شاهزاده از سالن خارج شد و به اطاق خود رفت و در را بروی خویش بست.	THE prince now left the room and shut himself up in his own chamber.
یه خواهر شیرین و قشنگ برای تو که باهاش بازی کنی .	a sweet little sister for you to play with
تا افرادی که شاید در صدد انجام عملی مشابه عمل کاظم برآیند را بترسانند.	to terrify any person who should attempt the same thing,
به عمرم این قدر از دیدن کسی خوشحال نشده بودم.	I never was more glad to see anyone in my life
ایستاد تا به چیزی که روی زمین بود فش فش کند.	pause to sniff at something on the floor.
البته یاد گرفته بود که چطور به نحو دل پذیری وحشی باشد.	although she had learned to soften it.
آنقدر صبر کردیم تا جزر و مد دریا فرو نشست	waiting till the tide was out
نخواست داخل اتاق شود تا در نبرد قهرمان خود با دشمنش حضور پیدا کند.	would not go in to witness the battle between her champion and her opponent.
که همین که به ندای کشیک پیش از ظهر به عرشه رفتم و نگاهم به طرف نرده دنباله کشتی افتاد لرزش شومی تنم را فرا گرفت.	that as I mounted to the deck at the call of the forenoon watch, so soon as I levelled my glance towards the taffrail, foreboding shivers ran over me.
نیکلای نیز متعهد شد که پنهان از پدر و مادر به هیچ عملی اقدام نکند.	while he on his side promised not to undertake anything without his parents' knowledge.
تا شعری را که او قرار بود حفظ کرده باشد بشنود.	to hear him recite
اما در کیمیاگری به جایی رسیده بود که ظاهراٌ دیگر نمیتوانست از آن حد پیشتر برود.	but his studies had taken him to a point beyond which he could not seem to go.
اصلا آدم نباید برای هر بیسروپائی کار بک نه.	I think it's so much better to work for refined people than just anybody.
فرقش را باز کرده بود و موها را شانه زده و روغن فراوان مالیده بود.	with his hair parted in the middle, well combed and pomaded
جغد بزرگ و زشتی از پنجره وارد سالن غذاخوری شد	when a huge barn owl swooped through the dining room window
این زحمت را به خود هموارساخته بودند که دربارهٔ هنر خود به تعمّق پردازند و شخصا فکر کنند.	who had taken the trouble to think about their art, and to think for themselves.
جزئیات سفرش را نوشته بود و احساسات خود را بیان کرده بود.	giving the particulars of his journey and of his feelings
فکر کنم به شه چیزی که دیده رو سر همین بی اعتبار کرد	I don't think it will take much to discredit her account.
چشمهاشان به دستی که ساندویچ را گرفته بود خیره شده بود.	their eyes followed the hand that held the sandwich.
انتخاب شدن به عنوان یکی از اعضای مجموعه بزرگی مثل این برایش شانسی بسیار بزرگ بود.	it had been such an immense piece of luck for him at his age to get appointed on the staff of a big thing like that.
لکة کوچک و زرد رنگ نور همچنان پیش رویمان روشن بود.	the yellow speck of light burning steadily in front.
از حد تناسب با ثروت ما در رفته بود.	a squandering altogether out of proportion to our means.
وجود خویش را به عنوان اعتراضی خاموش در برابر وهمی که بر او چیره شده یا در کار چیره شدن بود به کار گیرد.	as a silent protest against the delusion into which he had fallen, or was falling.
من از این که او بدون گفتن حتی یک کلمه به کلی غیبش زده بود خیلی به هم برخورده بود.	I was feeling hurt because he had just disappeared into blankness without a word.
جز اینکه سردم بود و روحاً ناامید و تنها بودم.	except that I was conscious of being cold and dejected
از عمق سکوتی که قبل و بعد از آن برقرار شد	a profound silence seeming to precede, accompanyand follow it,
بعلاوه پاهای حیوان طبعاً کوتاه و مزاجش بلغمی بود.	moreover, slow paced and sluggish by nature.
در این مورد هیچ عذری مگر تنبلی و کاهلی نداشتیم.	there was no excuse or reason
او در سال 1807 نتوانست هیچ کاری را از پیش ببرد	who was unable to do anything in 1807
غرب میانه به جای آن که قلب گرم جهان باشد اکنون بسان لبه زنده عالم بود بنابراین تصمیم گرفتم به شرق بروم و کار خرید و فروش اوراق بهادار را بیاموزم.	west now seemed like the ragged edge of the universe so I decided to go east and learn the bond business.
مسأله بسیار مهمی بود که گذاشته بودم تا در بستر راجع به آن فکر کنم.	very important, that I was keeping till I should be in bed.
او فقط توانست خانواده و اشیاء گران بهای خویش را از دهکده بیرون برد.	had barely time to remove his own family and valuables from his estate.
که شش سرباز ولتی ژور از فوج اول سبک سلاح که بدرون آمده و نتوانسته بودند بیرون روند	that sixlight infantry men of the 1st, having made their way thither
این خوشبختی که شما برایم آوردید بم نزله پیروزی عزت نفس است.	is surely more than a triumph for self love?
بلکه فقط باید کاری کنیم که رؤسای خودمان بگذارند زندگی کنیم.	but to make our own chiefs let us live.
اواسط روز بود که بارکش برای بردن باکسر آمد.	it was in the middle of the day when the van came to take him away.
اما یادش افتاد که ساعتش بعد از بیرون آمدن از دریاچه دیگر کار نکرده است.	then remembered it hadn't been working since it had spent over an hour in the lake.
عین کلمات را بیادندارم اما لب کلام آن بود که زودتر و بدون رنج گنج به دست آورد.	 I don't remember the exact words, but the upshot was that he wants money for nothing, without waiting or working!
پیش از اینکه دست به کاری بزنی فکر کن.	to think before you do.
سگش و دیگر خریدهایش را برداشت و با تبختر وارد بنا گردید.	her dog and her other purchases and went haughtily in.
به فرض آنکه چیزی از این گونه انقلابات در او وجود داشته بوده است در ورطه فراموشی افتاده بودند.	if hehad ever had any, had fallen into an abyss.
به من فرمان داد که شمشیر را غلاف کنم.	he ordered me to return it into the scabbard.
من حاضرم که شاهزاده پیر را چون پدر اوست شاهزاده خانم ماریا را چون خواهر اوست دوست داشته باشم.	so ready to be fond of him for being his father of her for being his sister
زیرا این بار نرفته بود که ممکن است یک ستاره بتواند لیره طلا تهیه کند و آن را برای کسی بفرستد.	he had not admitted that a star could coin itself into louis d'or.
فکر کردم اگر این موقع سال در شهر بودم نانم تو روغن بود	I reckoned I would have great times now if I was over at the town.
به جای اون همه آدم مریض که مجانی پذیرایی کردیم.	instead of free boarders.
ولی حاضر نبود که او را با آنان در یک پایه بگذارند.	but he would not suffer her to put him on the same level with them.
اون برای یاد گرفتن جادو به من پول نمی ده.	he won't pay for me to go and learn magic.
آن هم به کسی که بیش از هر فرد دیگری شما را دوست دارد	for one who loves you beyond all else.
حتی اگر برای یک لحظه هم شده جانی را تماشا کند.	only for an instant see the wretch.
شاید علتش آمادگی ما بود که او را متحیر و گیج کرده بود.	astonished perhaps at our preparedness.
یرا او فقط به نوک عصایی که بردوش گرفته بود در میان یک دستمال معمولی مقداری اسباب و اثاث ریخته و گره زده بود	as there merely dangled from a stick which he carried over his shoulder, a small parcel wrapped in a common handkerchief
حکومتی که پانزده سال تمام به بهانه استبداد و بیدادگری صلح و آرامش را در کشور حفظ کرده بود	which had kept peace in the country for a whole fifteen years
اما به خاطر هیچ به سوی خطر شتافتن بسیار کودکانه است.	but it is childish to run into danger for nothing.
به اینجا تعلق داشت و حالا تنها بانوی خانه من بودم.	she knew it all, she belonged here more than I should ever do.
قالبی به شکل انگشتانم روی بقایای آن حک شد.	leaving the shape of my fingers carved into the remaining wood.
اما کافی نیست. با این رشدی که تو اشتهای بلا به وجود اومده تا یه روز دی گه تمام این منبع رو تم وم می کنه.	but it wasn't as much as he was hoping forBella will use up this supply in another day the way her appetite has grown.
در این کار آشفتگی و شتابی چندان نشان داد که معلوم شد اشارهء آقای کر نچر به او بوده است.	with sufficient haste and trepidation to show that she was the person referred to.
کج شد و نایب کشتی را که ایستاده بود به دریا افکند.	keeling over, spilled out the standing mate.
لااقل کسی به یاد ندارد که در آن کشور ابرها بیش از این ارتفاع اوج گرفته باشد.	at least they were never known to do so in that country.
که کم کم مثل مطالبی شد که محقق و مبرهن است.	but which now assumed the garb of reality
پس از آنکه خارج شد به فکر فرو رفتم.	I pondered this sentence painfully, after he was gone.
اگر به راستی مسلمی که هر چه میگویی بکنی.	if you have revolved to do what you say
صبر و حوصله لازم است که از شما به امتحان رسیده و از بنده نیز به امتحان گذاشته خواهد شد	as for patience you have abundantly proved yours you shall now see me prove mine
اما هیچ وقت به صرافت انجام این کار نیفتاده بود.	but had never quite got to the point of doing it.
اگر از این دستورات سرپیچی کنی ترا جداً تنبیه خواهم کرد.	 I will punish you very severely if you disobey these instructions.
به خصوص که همان اهمیت و احترامی را برایش قائل شدند که خودش دوست داشت.	given all the consequence she could wish for.
سپس اندکی در میان مزارع کج و معوج رفت	then wandering up and down in fields
ناگزیر بودیم دربارة موضوعات پیش پا افتاده حرف بزنیم.	so that we were forced to talk of trivial matters
در آن لحظه به شدت هراسان و وحشت زده شده بودم.	I was horrified.
حمله کردن به یک کشور بعد از این که مردم آن کشور از قحطی و گرسنگی از پا در آمده باشند	to invade a country after the people have been wasted by famine
بدین منوال حامد را مجبور کردم در شکاف تنگ و نمناکی که پر از درخت بود وارد شود.	I made him enter a narrow gully of the spur, a dank twilight place overgrown with weeds.
به اندازه تو نیاز ندارم که خودم را جا کنم.	being more independent in circumstances.
با این همه نتوانستم بیش از شانزده دنده را بکار بردم.	yet I could not strike above sixteen keys.
من بعدا لیست آن را بت و خواهم داد.	I'll give you the list later.
کوشش برای ادامه راه در شب بی ثمر بود.	it was useless to attempt to move further by night.
سپس بلافاصله به مرکب خود مهمیز زد تا از ایاشن بگذرد	spurring his mare was passing them without stopping
تنها احساس ساده جذب و کششی که این دو مرد و زن جوان زیبا و سالم به یکدیگر داشتند مورد توجه بود	that society had entered the simple feeling of the attraction of a healthy and handsome young man and woman for one another.
که حامل نامه شفاها برای او بیان خواهد کرد انجام دهد.	which would be explained to him by the bearer of the letter.
سوتی خواهم کشید و بدا خل اطاق خواهد پرید.	if I whistle, he'll run in.
عبارتی که با آنچه در گذشته روی داده بود پیوند و مفهومی نداشت	a line which did not scan and made no sense with what went before
بلکه تنها میل دارد شما در آستانهٔ اطاق او نمایان گردید.	but only that you would show yourself in his doorway.
چون خودت رو بند این گنجی کردی که گم شدنش هیچ فقیری رو فقیرتر نمی کنه.	since you let yourself be bound to this treasure whose loss would make no poor man poorer.
یکی به سبب آنکه ممکنست خطائی در مقدار تعفین یا ترکیب تعفین روی داده باشد	partly by some error in the _quantum_ or composition
گروهی از دریا نو ردان معتقدند که آن بومیان جاسوسان مزدور و کارگزاران خفیه و محرمانه آب شیطان هستند	by some honest white mariners supposed to be the paid spies and secret confidential agents on the water of the devil
زبانش از خشکی مثل یک تکه چوب شده است.	that he 'wished he might be busted if he warn't as dry as a lime basket.
بین سواران و پیادگان محصور شدند و ناگزیر از آن بودند که رو به مه سو داشته باشند.	by infantry and cavalry, had to face all sides.
به او لبخند زدم و نفس اش بند آمد	I smiled at him, and his breathing stuttered.
از آن به بعد تا ابد در مغز من نمودار سکوت و آرامش شده است.	have ever since, by association, been symbolical to me of silence and retirement.
آنچه را به پوشیدن به او دادند پذیرفت و پوشید.	put on the cloak and other wrappings, that they gave him to wear.
همچنین راه و رسم زندگانی جاوید را اندیشیده و این نکته را با خود سنجیده بودم	upon this very case, I had frequently run over the whole system how I should employ myself
احتیاجی نیست جزییات امر را ذکر کنم چرا که همه مردم جهان در عرض بیست و چهار ساعت اینده راجه به ان خواهند شنید.	I need not go into details because the whole world will hear about it within the next twenty four hours.
واقعا به خاطر از دست رفتن پول مادرت ناراحتم.	I do care about your mother's money going
که همه کسانی که دوست داشتم مرا ترک کردند	the abandonment of all those who loved me
آنگاه با چشمان شیفته و مجذوب به تماشایش پرداخت.	then he began to watch her, fascinated.
که هشت پا ارتفاع و کف صافش تقریبا همین اندازه پهنا داشت.	it was about eight feet high, and with a level floor nearly as wide.
که شما این قدر جوان تر از تصور ایشان هستید	that you remain so long unsolved
من هیچ وقت نخواسته بودم که گروه را رهبری کنم.	I'd never wanted to lead the pack.
میخ وام بدونم تو خو نه کیه تا گاه به گاه به دیدنش برم	I should like to know with whomshe is living
او اعتماد به نفسی مغایر با آن مخیط و محل داشت.	a self confidence that was alien to this place.
که قبلاً پابند زوجه بد دیوانه و حیوان صفتی شده!	already bound to a bad, mad, and embruted partner!
اما بعدا راجع به طرز خواستگاری مردها حرف زدیم.	but afterwards, about how men make offers.
گویی اکنون در آنجا گردشگاهی است و جمعیتی از زنان عامی آراسته و زنان دهاتی و شوهرانشان و مردم دیگر در آنجا جمعاند.	there seemed to be some kind of festivity going on, there were crowds of gaily dressed townspeople, peasant women, their husbands
یک توبره پشتی کهنه و یک چوب دستی درشت گره دار با دو سر آهن کوبی شده.	an old knapsack, and a huge thorn cudgel shod with iron at both ends.
یا در دو سو به طرزی مبهم و تاریک دهان گشوده بودند.	or running steeply down, or opening blankly dark on either side.
شکایت پیش شاعر برد و مصراً از وی پرسید که چه باعث شده است که نامش از ردیف زنان روس بی دیگر قلم کشیده شده است	asked him what he had seen in her that he did not include her in the number of the others
مردی درشت اندام و فربه به پشت دراز کشیده و سرش به عقب افتاده بود.	a tall well fed man lay on his back with his head thrown back.
فکر کرد شاید همین باعث شده بود آن روز بیرون رفتنش را عقب نیندازد و از دخترش بخواهد این مهمان را نپذیرد.	she found it was implied in his preventing her admittance to his daughter, rather than postpone his own walk a few minutes.
که اگر خدای نکرده در آن سفر هوایی هلاک بشود آخرین جملات او چه خواهند بود.	for his final words in the event he perished during the adventure
یا چه طور راه برود و خرامان دامنش را چرخ بدهد تا هوش از سر بیننده به در شود.	how to walk pigeon toed so that her wide hoop skirts swayed entrancingly
به اتاق عمومی دار التبلیغ در طبقه پائین رفتند	the two made their way to thegeneral mission room below
به دیدن شما امدم چون امیدوار بودن شما به من کمک کنید	I came to see you because I was hoping you could help me.
هنوز ژنرال نمی داست که او رئیس مجلس است.	of whose dignity he was not aware
اطلاعاتی دارم که تو بایستی از آن مطلع شوی.	I have some information you should know about.
من کلمه لایه نه را به پرستو ترجمه کردم	for so I translate the word _lyhannh_
چند بار پایشان به چیزی گیر کرد و لغزیدند	stumbling and tripping
در عشق همه چیز شادی و نشاط و حظ و لذت و خرسندی و رضای خاطر است	for love is all gaiety, enjoyment, and happiness
در آن سال بر همگان روشن بود که پیشرفت شغلی وی به پایان رسیده است.	it had become evident to everyone in the course of that year that his career was at an end.
فقط هنگامی از رقص بازماند که احساس خستگی کرد و برای استراحت معذرت خواست .	she only sat down when she felt too tired and begged for a rest.
قبل از این که بمیرد از او قول گرفته بود که همیشه از من نگهداری کند.	got her to promise before he died that she would always keep me.
اون هم از این وضعی که همه ما گرفتارشیم.	like we're all in now.
به فکر فرو رفت و در مقابل او خلع سلاح شد.	thought about it then, as well as he could, and he surrendered his weapons.
که اگر الان در این مورد سکوت کنم و پلیس بعدها بویی از ماجرا ببرد برای من خیلی بد خواهد شد.	if I do keep quiet about it now and the police find out later, it's going to look bad for me.
من مطمئن نیستم که من چنین پافشاری ای که تو داشتی رو داشته باشم تا نجاتش بدم.	I'm not sure I would have had the persistence, the faith it took to save her.
امکان یافت که بدون صرف پول به اینجا و آنجا برود.	to go here and there without the expenditure of any money.
از این روی جز این حدسی نتوانستم بزنم که	I could only judge that
به خیابان ساکت نگاه کرد وگفت فکر کردم میتونم دوباره زندگی بی دردسری داشته باشم	I thought I could go back to being a private again
کلاید پاکت را برداشت و بی آنکه بتواند هویت فرستنده را حدس بزند آن را پشت و رو کرد.	clyde picked it up and turned it over without being able in any way to fix upon the source.
یا از جای دیگر به وسایلی که خود داشت مطلع نم شد	or by one of those means by which he knew everything
اما اکنون بر آن نبود تا درباره این زن بی اندیشد.	but now she could not force herself to think of her.
تأثیری که امکان داشت بر ذهن پرشور داوری او در مورد شوهرش و سرانجام بر رفتار او در آینده گذاشته شود.	the sway that might be given to her ardent mind in its judgments, and the future possibilities to which these might lead her.
چند فرصت مساعد را برای اجرای پیکار قاطع از دست داد.	missed several chances of forcing an engagement.
شمع کم نور را روی میز بزرگ و سیاه چوب مانم ون گذاشت	setting down the feeble light on the dark mahogany table
با لگدی او را برگرداند تا صورتش معلوم شود.	kicked him over onto his back, so that his face was visible.
من خیال ندارم زندگی تو را به دست او بسپارم.	I'm not going to sign away your life to him.
جلیقه را نیز همچنان از تن به در کردم	I did the same with my waistcoat
منظورم ای نه که این طور به نظر می رسه.	I mean, I guess that's what it's like
بسیار زود آن فکر کودکانه را از سر بدر کرد	he rejected this foolish idea,
روسری سرخ رنگی به سر انداخته بود با پالتوی پوست سموری که روی دست گرفته بود بیرون دوید	wearing a red shawl, ran out with a sable mantle on her arm.
با یک دست پنج شش جن خاکی را گرفته بود	seizing five or six gnomes at once.
من حتی نمی دون ستم دلیلی واسه بهتر کردن حال تو هست تا وقتی زانوی غم بغل گرفتی.	I didn't even know there was a reason to make you feel better until you started being all miserable.
اما چون خود خلق و خویی از این گونه نداشت	but having very little corresponding fibre in himself
اکنون هم که فرصتی پیش آمده بود نتوانسته بود از آن سودی ببرد.	here for the first time there had come a chance which had set him at a disadvantage.
اما تفصیل صعب و سختی در حق او مطالعه خواهید کرد	but you will find terrible charges
هر حیوانی که دانة ارزنی به مرغی برساند مجازاتش مرگ است.	decreed that any animal giving so much as a grain of corn to a hen should be punished by death.
اختراعش را عملاً در مقابل مقامات نظامی به معرض نمایش بگذارد	he could put on some practical demonstrations of his invention for the military authorities
آرزوی صادقانه تأمین و استقرار صلح محرک آن بود	were carried on with a sincere desire to attain peace
مزرعه اربابی را از کلون بالایی در قلم گرفت و به جای آن نوشت مزرعة حیوانات.	painted out MANOR FARM from the top bar of the gate and in its place painted ANIMAL FARM.
هرچی با شه تقصیر منه که دی گه موش ندا ره.	as it's my fault he no longer has a rat.
از من هم خواسته بود با او بروم و من نرفتم.	he asked me to go with him and I didnt.
مرا محکوم خواهند کرد و من به ریش همهٔ آنان خواهم خندید.	I would go up and they would censure me, and I would burst out laughing in their faces.
از همینرو به عنوان میهمان دار شاهزاده انتخاب شد.	that was how he came to be put in charge of the prince.
ولو یقین کند که از این نبرد کوفته و مغلوب بیرون خواهد آمد.	though he perceived he was to come out of it wearied and vanquished.
این رویداد تمام وقت و آنرژی اساتید رو به خودش اختصاص می ده اما من مطمئنم که همه تون از این رویداد لذت زیادی خواهید برد.	taking up much of the teachers' time and energy but I am sure you will all enjoy it immensely.
از سلامت او جویا شد و با حرکت سر ابراز همدردی و غمخواری کرد و در کنارش ایستاد.	asked about her health, and, swaying his head from side to side to express sympathy, remained standing beside her.
تصمیم داشت وقتی به خانه بازگشت این مطلب را به او گوشزد کند.	when he came home tonight and she had him alone, she would certainly tell him so.
این را نگه داشته بودم که شاید عمویت پیش از من بمیرد.	I was keeping it in case your uncle died before me.
احتیاج داشتم نفس بکشم تا بتوانم نقشم را درست بازی کنم.	I needed to breathe so that I could play my role correctly.
اما مهتر من به شما خواهد گفت که من کیستم.	but my squire will inform you who I am.
اندوهی که این قدر تلخ و ظالمانه و در عین حال این قدر ناچیز و تحقیرکننده است	that is so endlessly bitter and cruel, and yet so sordid and petty, so ugly, so humiliating
وسط مسابقه متوجه شدم که بیرون از خو نه و بین مردمم.	I found myself out in public, in the middle of the match
از آنجا رفتند و او را چنان به تله انداختند که برای وی ممکن نشد دست خود را باز کند.	leaving him fastened in such a way that it was impossible for him to release himself.
سرش را روی بالش گذاشت و به خواب عمیقی فرو رفت.	he slumped back onto his pillows and fell asleep.
درست در همان لحظه ای که زنگ اعلام پایان مسابقه به صدا در آمد	almost at the very moment when the bell rang at the finish of the race,
اگر از برای تو کاغذی از وی نرسیده از برای من کاغذی آمده.	if you have not received any letters from the count, we have received one.
به درخواست مادرش تصمیم گرفته بود که برای عمویش نامه بنویسد	later at her request was about to writehis uncle
که با دیدن من و گریخت و پنهان شد.	who wouldn't let me kiss her when I offered to, but ran away and hid herself.
من دی گه نمی تونم اینجا به مو نم	I can't stay here no more.
تا سی و سه سالگی خبر نداشتم همجنس گرا هستم	I didn't realize I was a lesbian till I was thirty three 
الان به شما می گم که شما خودتون چطور میتونین به زخم من بهتر از هر جراح مرهم بگذار ین.	I will tell you how you can care for me better than any surgeon.
هرگاه موسیقیش خوب باشد خود معرف خویش خواهد بود.	if his music was good it would speak for itself.
به این فکر افتادم که دوباره دماغش رو بشکونم.	I thought about breaking his nose again.
من که پولی برای این سهام نمی دم .	I'd not be buying the halfinterest.
گویی همواره در این اندیشه بود که چرا اساساً به این دنیای فانی قدم گذاشته است.	with which it seemed to be always wondering why it had ever been born.
گستاخی نمودم و از راهنمای خود خواهش کردم به من بفهماند	I made bold to desire my conductor, that he would be pleased to explain to me
اینک من با نهایت صراحت در مقابل اشخاص حاضر میگویم که اتفاقا قصد من همین هم هست.	I now declare openly, in the presence of these witnesses, that I will do so.
اما دست هری جز هوا به چیز دیگری نخورد.	but he felt only air
دستانش را پشت سر در هم گذاشت و دراز شد	lay on his back with his hands behind his head
به طرف باد چرخید و قایقی به آب انداخت و ناخدای کشتی را که به جای دنباله قایق با بی صبری در دماغه آن ایستاده بود به طرف ما کشاند.	dropping a boat, her captain was impelled towards us, impatiently standing in the bows instead of the stern.
اما با نهایت شرمساری دید که دستش را گرفتند و در میان خندهٔ مردم با خواری و رسوائی بیرونش کردند و به خانهٔ خود فرستادند تا کتک بخورد.	she had the mortification of being pounced on, ignominiously expelled amid jeers and laughter, and taken home, where she was whipped.
ناگزیر این نکته را نیز باید قبول کنیم که	it is plain too that
طره ای از موی کودکش و برگ پژمرده ای از روی مزار پدرش.	a lock of her baby's hair and a withered leaf from her father's grave.
فقط نسخه بنویسد و خود دارو در اختیار بیماران نگذارد و از داروسازان پورسانت نگیرد.	simply prescribe, without dispensing drugs or taking percentage from druggists.
دومین بار در ارتفاع پانزده متری از روی جارو افتاده بود.	the second, fallen fifty feet from his broomstick.
بقایای جسمی که وقتی ورانسکی دیوانه وار به انبار راه آهن دوید	that is, what was left of her when he had run like one distraught into the cloak room of the railway station
مغزش دوار گرفته بود اما نتوانسته بود حتی یک فکر بنیادی را از متن کتاب درک کند.	his brain was in a turmoil, but not one essential thought in the text had he grasped.
چون راه نزدیک است به خاطر اینکه زحمت تغییر لباس و تعویض مجدد آن را در ده به خود ندهیم	as it is so near, and to save the trouble of undressing and dressing again
جلیقه سفید و بالاپوش سیاه کوتاه و شلواری سیاه در بر داشت.	a white kerseymere waistcoat, and nankeen pantaloons, three inches too short, but which were prevented by straps from slipping up to the knee
در شب بیستم نوامبر جمعیت هشتاد هزار نفری قشون متحد روس و اطریش از توقفگاه خود برخاست	in the night from the nineteenth to the twentieth, the whole eighty thousand allied troops rose from their bivouacs to the hum of voices
آنگاه جیب خود را بررسی کرد و بیست کو پیک در آن یافت و بیرون آورد	feeling in his pocket and finding twenty copecks
دو سگ دیگر دمشان را روی کو لشان گذاشتند و زدند به چاک.	the other two fled with their tails between their legs.
باز به تلاش نومیدانهٔ اراده توانستند برای چنین مقصودی نیروی لازم را در خود بیابند.	they screwed up their courage for it by a desperate effort of will.
هرچند که به خاطر ندارم مزارعی در آن حوالی بوده باشد.	though I don't recollect any fields anywhere in those parts.
اگر میل داشتید حاضرم شام منزل شما باشم و یا شب هم دور هم باشیم.	I'll stay to dinner if you like, or stop the night.
اما معلوم بود که خیلی کم آن را پوشیده چون خوب مانده.	were little worn and fine.
این اشتیاقی بود که او هرگز قادر به تشخیص آن نبود.	an eagerness which she was too confused to see.
من زودتر می تونم پی داش کنم چون می دونم دفترش کجاست.	I'll be quicker, I know where his office is
از وسط چند بچه که ایستاده بودند رد شد	broke through a group of boys
زیرا احساس تنهایی موجب تغییراتی در ذهن و روح او شده بود	because solitude had made a selection in her memory
بلکه چه بخواهند و چه نخواهند زن یک افسر است.	but was at any rate an officer's wife.
مش گل بزرگ من ای نه که چطور خودم نباشم !	she laughed, a little ruefully.
پا را روی هم انداخته نشسته بود و لبخندی تحقیرآمیز بر لب داشت.	sat crossing and uncrossing his legs and smiling contemptuously to himself.
اول اطاق نشیمن را از نظر گذراندم و بعد به برانداز کردن شخصی که در آن بود پرداختم.	I examined first, the parlour, and then its occupant.
بعد از شام من از وسط حیاط شما رد میشم.	I'm going through the dooryard after dinner.
انگشتان خود را در آن موی آرا مبخش فرو برد.	sank her fingers into that satisfying hair.
ما به قدر کافی از کشش جریان امواج دور شده بودیم	we had got so far out of the run of the current
ساختمان گنبدی شکلی بود به اندازه یک تئاتر بزرگ.	a dome like building, the size of a big theater.
بدانید که دیدار من و بانو دول سینه نیز مانند جوابی که از طرف او برای شما آوردم امری بود غیر واقعی	I must tell you that my seeing her and the answer I brought you back were by hearsay too
نزدیک بود او را به واسطه وضع ظاهرش سرزنش کنم.	I was on the point of chaffing him on his state.
در حالی که خودشان صد هزار مرتبه از او بدترند	all those who're a thousand times worse than she
چنان تهیه و تدارک آن جشن را دیده بودند	had arranged every detail
خیلی بده که زن و شوهر همدیگر و دوس داشته با شن.	it's very bad form for husband and wife to love each other.
چون مرا نیافته و پاسخی نشنیده بود به عذابی الیم دچار گشته بود.	was in cruel agonies when I did not appear, nor answer when she called.
لکن چون فکر کرد که از هیچ گونه احترامی نسبت به ژنرال کوتاهی نکرده است بار دیگر احساس آرامش کرد.	but eventually concluded that he needn't do so, since in spite of it he was truly sorry for the old man.
کاملاً اطمینان نداشتیم که در را قفل کرده باشند	I was not quite sure whether they had locked the door
حالا دیگر برایم مسلم شده بود که چنان کاری احمقانه است.	now, it was disclosed to me all at once that that would be a foolish plan.
من نیز چند گیلاسی خواهم نوشید. اما از لیکور متنفرم.	I want some myself, and I can't bear liqueurs.
پیش از آنکه خانم وین سی صدایش کند از صدای گشوده شدن ناگهانی پنجره سر برگرداند.	turned round at the sudden sound of the sash, before she called to him.
اما هدف جوانیم هرگز رسیدن به سال خوردگی نبوده است.	but my young way was never the way to age.
سپس اسبی با راهنمائی به مبلغ پنج شیلینگ اجیر کردم	I hired a horse and guide for five shillings
مگر اینکه از عهده خرج نگاه داری یک دو خادم نیرومند که پیوسته همراه او باشند برآید.	unless he can afford one or two strong servants to attend him.
جاسوس آنچنان مشتاق درک علت این ملاقات عجیب بود	so eager was the spy to penetrate the motives of an interview so different from what he had been led to expect
پلکان قسمت شرقی را در پیش گرفته و به خوابگاه خود رفتم.	turned the corner and pushed through the door that led to my own rooms in the east wing.
به نظر من شما باید در پی جایی باشید که بیشتر با وضعیت خاص شما هماهنگی داشته باشد.	I would suggest that you try to find employment more suitable to your circumstances.
من تصمیم گرفتم با این فرض جستجو کنم که او بعلاوه سعی کرده بود به خانه برود.	I decided to operate under the assumption that he had tried going home as well
در چنین موردی آنچه از طبیب برمی آید انجام دادم و او رفته رفته آرام گرفت و چون مردگان در رخوت فرو رفت.	I did what little could be done to assist that opportunity, and by and bye she sank into a lethargy, and lay like the dead.
حال ناچار است برای آماده کردن آن به اتاق خود برگردد.	he was compelled to return to his room and make it out there
با هر دو دست چنان گلوی کماندار را گرفت	with both hands seized the officer by the throat with all his might
دست کم یک قوری آب نقره صیقلی مقابلم هست	I have, at least, a well polished, silver plated coffee pot in front of me
با تعجب زیاد که یکی از مفاخرات و امتیازاتی را	much surprised that one flower of her crown of pride
امیدوارم که او را راضی با ین امر نشه.	I hope that he will not consent to it.
به جمع حاظر نظر انداخت تا اطمنیان یابد که دارنی در جای مقر قرار گرفته است و آنگاه به خواندن دیگر اسامی پرداخت.	glanced over them to assure himself that he had taken his place, and went through the list,
ملاحان گفتند که ناخدا فرمان داده است تا مرا همراه خود برند.	with the captain's command to fetch me on board.
تا هر مدتی که بخواهید با شما حرف خواهم زد	I'll talk to you as long as you like
سر او را به یک ضربت از تن جدا کردند.	his head cut off at one blow
تا مدت زیادی فقط باید به پول در آوردن فکر کنم.	I can think of nothing for a long while but getting an income.
من تکلیف خود را در این مجلس به عمل آوردم.	I have done my duty
تنها به گریختن از برابر او نباید اکتفا بکنم	I must not simply retreat before him
اوا صلا خیال نداشت درشکه رانی را متوقف کند.	she had no intention of stopping her trips.
او یکی از سازمان دهندگان ایالتی حزب و یکی از بهترین ناطقین ماست!	he's a state organizer of our party, and one of our best known speakers!
زیرا چنانکه اکنون خواهید دید درخور این نام زشت نیست.	for it does not deserve it, as ye shall soon see.
مرا به اینجا آوردند و زنده به گور کردند.	I was brought here, I was brought to my living grave.
اگر من بی حرکت و ساکت بمانم به هیچ وجه مرا نخواهد دید.	if I sit still he will never see me.
ولی هنوز به طور کامل خوب نشده بود و حاضرهم نبود راجع به اتفاقی که افتاده بود صحبت کند.	but he hadn't come back all the way and he wouldn't talk about what had happened.
مرا هم با او در تاریخ 1816 یا 1817 بود که اتفاق ملاقاتی شد	I myself had occasion to see this man in 1816 or 1817
آبی برای پرس و جو و کسب اطلاعات در مورد افراد مظنون است.	blue is an inquiry for information about a suspect
تا مرا دید کشید تو اتاقش و یواشکی در را بست و پرسید او را دوست دارم یا نه.	she took me in her room and shut the door very soft, and asked me if I liked her
هر چند با توجه به مشاهدات خودم هم به همین نتایج رسیده بودم.	though I had already come to the same conclusions from my own observations.
تا آن قدر نزدیک شد که تمام خشمش را رین ببیند.	until she was close enough to give him the full benefit of her anger.
به حکم وظیفه و به خاطر روشن شدن موضوع است نه به خاطر مشغولیات خودم و سرگرمی دیگران.	I don't conduct this inquiry for my own amusement.
اما پیپ برای جان درستی من زیاده از حد هوش دیوانگی دارد.	but he's too crazy witty for my sanity.
از این که سرانجام با او تنها مانده بود دلشاد بود.	glad of the chance to be alone with him.
ولی سرانجام این کار فیصله یافت و خوب هم فیصله یافت.	but now it is ended and over for good.
او در سکوت کامل از درون مغزش خطاب به لیوان فریاد کشید که به حرکت در بیاید.	without making any sound at all she kept on shouting inside her head for the glass to go over.
آیا به خدمتکاری چابک و کارآمد احتیاج دارد یا نه	if he wanted a handy fellow
تا به خیال آسوده قبل از سوزاندن بار دیگر نامه را بخواند.	to read it at her ease before she burned it
دلیل جدی اگر نیاز به دلیل داشت بر محبوبیت او به عنوان یک رهبر به دست وی داد.	gave him a new proof, if he had needed one, of his popularity as a leader.
از تاریخ فوق دیگر هیچ خبری از او نشد	has not since been heard of.
اما شما نباید گناه این ناکامی را به گردن این پهلوان سرگردان بینوا بیندازید	for which you must not blame this unhappy knight errant
که همه را خنده انداخت و فتوا دادند که متلکی که گفت خیلی آبدار و بجا بود.	which made them all laugh, and they said it was a prime good hit.
لیکوریش و بعد ذرت بوداده که یک پاکت بزرگش نیم پنی قیمت داشت	so were liquorice pistols, popcorn was a halfpenny for a large bag
یعنی یکی از آن سه شغلی که پدر ما به ما توصیه کرده بود	which was one of the three careers our father proposed to us
ایوان اوراعصبانی کرده بود و اوهم دخترک رابا اجاره نامه آپارتمان تنها گذاشته بود	she had pissed him off and so he had just slipped into his boogie shoes leaving her holding the lease
امروز قادر نبودم این دست شایستهء احترام را در دست بگیرم.	I could not now touch this honoured hand.
لکن حرف زدن خود یک مشغولیتی است ولو اینکه مخاطب لال باشد	but still to speak to a man even though mute was something
اما بلافاصله مردی که دوربین به دست داشت از جا جست و صدایش را صاف کرد.	but the man with the black camera jumped up and cleared his throat.
مقداری از گل از پشت به سرش می خوره.	a large amount of mud hit him in the back of the head.
در خط منحنی که بایستی مرا به دیوار قلعه برساند از نداشتن اسباب درست سهو کردم	only unfortunately I did not curve aright
واقعاً نگاه داشتن حساب دقیق بزها آنقدر در اصل حکایت تو دخیل است که اگر در حساب یک رأس آن اشتباه شود	is it so essential to the story to know to a nicety the goats that have crossed over, that if there be a mistake of one in the reckoning
درست بر طبق عمو و پسر عمویش رفتار کند	he was going to be all that his uncle and cousin obviously expected of him
پس استفاده از آن وقتی ممکن بود که به دیوار تکیه داده شود.	so that it was of service only when propped against the wall.
یادم رفت اخبار ییلاق را برایتان بگویم البته اخبار غم انگیزی است.	I forgot to tell you the farm news, but it's very distressing.
وگرنه به جای آنکه او را عامل بهبود بطئی اما محسوسی در وضعیت اجتماعی خانواده بدانند	she, instead of being the emissary of a slowly and modestly improving social condition for all
زنجیر ساعت برایش درست کنند یا وقتی مشغول کار بود صدایش بزنند	plait him watch chains, or interrupt him at his work, hailing him
قلب من از لحظه اول دیدار به شدت به او علاقمند گشته.	that something taught my heart to love so dearly from the first!
من از هیچ شیطانی هراس ندارم این جمله را درسکوت مرگب اری که درآن قسمت زندان حکمفرما بود به زبان آورد و ازطنین آن لذت برد.	I will fear no evil, he said into the dead silence of the cellblock wing, and he liked the way it sounded.
وگرنه اشتباه عظیم و غیرقابل جبرانی مرتکب خواهی شد.	or else you will make a cruel and irrevocable mistake.
در آنجا با جسم و جانی بی رمق به یکی ازدرختهای باغچه تکیه داد.	she paused to lean against a tree that was there her nervous and physical strength all but failing her.
از خواننده تمنا دارم این نکته را همواره به یاد داشته باشد	I beg the reader to note this from the beginning.
دنبال آن به اعماق دریا فرو رفت و در هوای فارغ از جسمانیت در نظر آورد!	dived for in the deep, and featured in the unbodied air!
به جای آن که او از در وارد شود تاریکی از پنجره وارد شد.	darkness only came in through the window.
برای آخرین بار صورت او را به خاطر سپردم	I memorized her face one last time
روزی تمام مردان آن روستا را در داخل اطاق کوچک خود جمع کرده	he gathered the men of the village in his little room
یعنی مرد مسلم اضافی آن عده ایام که در پیش بود.	a supplementary clean gain of so many months or weeks as the case might be.
زیرا هر یک از ما موظف است به دیگران خدمت کند.	for all men should wait on one another.
بین راه از عمل خود پشیمان شدم و پاورچین بازگشتم.	but, repenting half way, I returned softly, and lo!
دی گه وقتش رسیده که نامه رو به خونی.	I reckon it's abou' time yeh read yer letter.
اما او میل دارد شوهر کند و بن ابر این شروع به اندیشیدن درباره ازدواج نموده است و آنقدر در این خصوص فکر کرده است که سرانجام بجای یک شوهر برای او فرزندی بو جود آمده است.	but she wants to be married, and so she's been thinking of getting married, and thinking and thinking of it till now she's got it, that is, not a husband but a baby.
در آن هنگام به طور مایل رو به اقیانوس گشوده داشت.	was now obliquely pointing towards the open ocean.
ولی عجالتاً عاقلانه ندید که چیزی به روی خودش بیاورد.	but did not think it wise to betray the fact.
تا شمایل نقره کاری را بیاورد و چراغ کوچکی را که جلوی تمثال مقدس روشن بود شکست	to move the holy picture in its silver and gold setting, and had broken the little lamp,
که باید تمام این قضیه را از کنت مخفی نگه داشت	enjoining on her that it must all be kept from her father
چون نتوانستم آن همه رنج و دردی را که بدان دچار شده بودم تحمل کنم	being unable to support the agonies I was under
طبق معمول هنگام باز شدن در گیر کرد و وقتی آن را فشار دادند تمام ساختمان به لرزه درآمد.	which invariably stuck to the jamb, and then, when you wrenched it open, shook the whole cottage.
چنانکه اگر درمانی برای درد شما باشد به درمان خواهم کوشید	either in relieving your misfortune if it admits of relief,
من کیلومتر استفاده شده از اتومبیل را بررسی کردم.	I checked the elapsed mileage.
از آن جا که با پالتوی پوست موش کوری که به تن داشت تمام فضای راهرو را پر کرده بود	as he filled most of the corridor in his moleskin overcoat.
در حالی که زندگی در همین دنیا واقعاً بسیار لذتبخش است.	when life might be so very amusing in this world.
جواب میدهد که در این حوالی عده ی زیادی زن زندگی میکنند.	answered that there were a great many of them about there.
او را عقب زد و خود به جای او ایستاد.	driving him back and standing in his place.
به لحاظ اهمیت تجاری فقط بندرگاهی ساحلی بود که خرید و فروش نیل و پوست گاو محلی در آن رونق زیادی داشت.	had never been commercially anything more important than a coasting port with a fairly large local trade in ox hides and indigo.
در این صورت من حکم بتی را خواهم یافت که او در مقابلش به سجده در خواهد آمد	I will be a god to whom he can pray
من دندونام رو نشون دادم و سعی کردم که وضعیت رو کمی آرومتر کنم.	I gritted my teeth and tried to get my head straight.
بنابراین به نحوی قالب محدب طرف مقابل آن است.	is, therefore, in some sort, the outer convex mould of it.
در غیر این صورت موجب خواهم شد امیدهایی را که هرگز تحقق نخواهند یافت بیهوده برانگیزانم	for I might otherwise excite hopes destined never to be realised
راستی به شما گفتم که قبر او را با دست خودم کندم	did I tell you that I dug his grave with my own hands
شهادت دو جادوگر سیزده ساله هیچ کس رو متقاعد نمی کنه.	the word of two thirteen year old wizards will not convince anybody.
اجازه نمید هم که به من درس بدهد ..	I won't let him train me as he pleases.
میز و صندلی را به باغ آورد و در زیر درخت شاه بلوط چید.	gave orders for a table and chairs to be taken into the garden under the chestnut tree, and lunch to be laid there.
باید از یه جائی پول گیر بیارم حداقل پنجاه دلار.	I must get money somewhere at least fifty dollars.
دستش استخوانی بود که بر آن پوست چین خورده کشیده بودند	the hand holding onto the canvas was a skeleton covered with wrinkled skin.
چنان بر این موجود کوچک دلش سوخت و چنان از آسیب دیدن او هراسان شد که دست پیش برد تا مانع کار قابله شود.	such pity for the little creature came upon him, and such terror that she would hurt it, that he held her hand back.
خود را به وانت واژگون شده رساند و در سایه درازکشید.	he pulled himself over the overturned pickup truck
با رفتارش نشان دهد که خطای خود را پذیرفته است.	behave so as to show that she admitted any error in herself.
نور بنفشی پدیدار شد و صدایی شبیه به صدای ترقه به گوش رسید.	there was a flash of violet light, a sound like a firecracker
هیچ کس حتی جزئی از کاردانی او را هم نخواهد فهمید.	cause nobody will never know half of what he was.
می خوام نگهش دارم و بهش به گم چقدر دوستش دارم.	I want to hold him and tell him how much I love him.
سه نفری همدیگر را به عنوان هزارها نفر کشتند و سر بریدند.	killed and scalped each other by thousands.
با آن پسر مو قرمز که من ازش فرار کردم دی دمت.	I saw you with the red headed man I ran away from.
که چنین تساهلی در تالار این دادگاه به کلی منتفی بود.	that such levity was out of the question in this courtroom.
گامی برداشت و بر سر راه او قرار گرفت.	he moved and stood in her way.
این که ما در آینده بالاخره تو این دنیای منزجر کننده هلاک میشیم.	that we can and will perish in this hell hole eventually.
لکن خون به طور ناگهانی صورتش را سرخ کرده بود.	but now the red blood had rushed back to his cheeks in a torrent.
از اینجا یک مبلغی گرد آورد و با این مبلغ سرمایه ساخته داخل عمل بانک شد و بخت مساعدت نمود مایه را چندین برابر زیادتر کرد	then with that money he speculated in the funds and trebled or quadrupled his capital
اما خسته و ناامید از این تصمیم چشم پوشید.	but he felt his resolution checked by despairing resentment.
اما آن کشیش که این ارباب کوچولو را در کنف حمایت خود گرفته بود مانع رفتن او شد.	but the clerk who had taken the young gentleman under his protection stopped him.
به نزد او آمده و داروی مخصوص سقط جنین خواسته بود.	for some medicine which would bringabout a miscarriage.
من حتی از تذکر آن در مقابل جمع خوشوقتم.	I am glad indeed to find other persons present.
اگر به حرف طبیب گوش ندهی و به موقع دوای خود را نخوری!	if you won't obey the doctor and take your medicine at the right time!
سپس نور یک چراغ جیبی در توی خانه به چشمشان خورد.	then from inside the house they saw the glow of a flashlight.
در این هنگام وجنات و رفتار این دو برادر چندان به یکدیگر شبیه بود	the look and bearing of the brothers were then so exactly alike
زیرا بعد از آن که با آ به بزونی حرف زد	for ever since he had conversed with the priest
با بلاهایی که به سرش اومده رفتارش زیاد عجیب نیست.	after the things he's seen, it's not surprising.
هنگامی که باد خشک و گرمی شروع به وزیدن کرد	when an and wind began to blow
اگر بانو دول سینه تنها در نظر شما تغییر یافته و حسن و جمالش تنها از چشم شما پوشیده مانده باشد	if it be that it is only from your worship she is hidden
با صدای آرامی توضیح داد من بدون توضیحی بیشتر فهمیدم.	I understood without more explanation than that.
آنگاه نگاهی طولانی به بلانش افکنده بود چنانکه گویی خواسته بود اثر و تصویر او را درذهن خود زنده نگاهدارد.	then he gave her a long look as though to impress on his mind the picture of her.
در آن لحظه این فکر احمقانه به سرم زد که هیت کلیف با یاد آوردن خاطراتی که از مادر کاترین در دل دارد فکر آزردن و بدبخت کردن دخترک را از سر به در خواهد کرد و راضی نخواهد شد موجب اذیت و ناراحتی وی شود.	I was foolish enough to imagine the memory of her mother might disarm him from desiring her injury.
به طرف در عقب خانه رفت و از آنجا خارج شد.	went to the back porch and out through the gate.
چنانکه برای به حال آوردن او بیش از ششصد تخم مرغ مصرف کردیم	so that to bring him round again, ever so little, cost me more than six hundred eggs
با آن که طبقه و ثروت میان من و او فاصله زیادی انداخته	though rank and wealth sever us widely
تو با این استعدادهایی که داری باید پایت به محافل درجه یک باز بشود.	with your superior talents, you have a right to move in the first circle.
قطع سه خط آهن و بازگشت به صحرا برای تقویت نیرو هم یک هفته کار داشت.	the cutting of the three railways and withdrawal to reform in the desert, another week.
در نتیجه هنگامی که باز نگاهشان با هم تلاقی کرد	the consequence was that when their eyes met again
مگر مهر اندوه که در مهر زنان بوده است.	but the stamp of sorrow in the signers.
که یگانه تسلی من این است که شاهزاده خانم به من اجازه دهد تا در غم او شریک باشم.	that the princess allowed her to share her sorrow
ترسی در من در مورد رسم و رسوم این مهمانی شروع شد.	I began to get in a panic about my costume.
تصمیم گرفتم بجز با شما با هیچ کس دیگری در این باره حرف نزنم.	determined that to none but you would I impart this vision.
یعنی پس از اینکه او تو روتان گفت قاتل	after he had called you murderer to your face,
بلکه حالتی غریزی که با دیدن حال آن چشمان خاکستری سرریز شده بود.	just something he instinctively offered when he saw what lay in the grey eyes.
من سخت هوادار این فکرم که وال سر زا بوده است.	I am strongly inclined to think a sperm whale.
مقداری رنگ خرمایی برای بدن و چند تکه فلز.	tan body paint and my few scraps of metal.
اون معجون برای تبدیل شدن به شکل حیوانات مناسب نیست!	the potion isn't supposed to be used for animal transformations!
اگه یه استاد همراهتون با شه من خیالم راحت تره.	I'd be happier if a teacher were present.
از رفتار بدوی مردم آنجا نیز به تنگ آمد.	but of the primitive manner of the people.
زور و بازوی من گواه بر آرزوی من به خدمت گزاری شما باشد.	then the might of my arm will show my desire to serve you.
یک دایره که از پانزده تا سگ ساخته شده بود دورم درست شد.	circle of fifteen of them packed together around me
که در آن ورود خود را به وی اطلاع داده و از او خواهش کرده بود که به ملاقات وی برود.	informing him of his arrival and asking him to come to see him.
چشمانم را پاک کردم و زیر لبی گفتم که امروز صبح حالم زیاد خوب نیست کار خود را از سر گرفتم و موفق شدم آن را به پایان برسانم.	wiped my eyes, and muttered something about not being very well that morning, I resumed my task, and succeeded in completing it.
اما مصمم ماندیم که تا لحظه آخر در ساحل بمانیم.	however, to sleep ashore till the last.
یک بار دیگر با حوصله تمام موادی را برای انجام آزمایش جلو کشیدند	involved once more in the patient manipulation of the material
ولی نو مسلمان بار دیگر تکرار کرد که اگر او یک کلمه حرف بزند کارش ساخته است.	but the renegade once more told him not to utter a word, or they would take his life.
اما بیگمان آشکاری کوری آور آن سبب این حال شده بود.	but its very blinding palpableness must have been the cause.
از وحشت فریادی برآورد و دستش را عقب کشید.	held it up again with an exclamation of horror.
شراع عقب را با شراع مقدم بالتمام گشودیم و کشتی را دادیم به دست باد تا از چنگ توفان خلاص شویم	we put the helm up to run before the tempest ten minutes after we struck our tops'ls and scudded under bare poles
در میدان مرکزی شهر بازوهایش را به طرف آسمان گرفت	he opened up his arms in the middle of the square
من تا حالا یه شاگرد کلاس سومی ندیده بودم که اگر یه گرگینه به بینه تشخیص نده که اون چیه.	I never thought I'd meet a third year class who wouldn't even recognize a werewolf when they saw one.
من آن قدر احمق نیستم که قدرت سخنوری را در آن منکر شوم.	I'm not so foolish as to deny the force of the language.
دست دیگرش را برای یافتن گلوله در جیب ژاکت کرد.	his other hand in his jacket pocket for a shell.
یکی دو پیراهن در خورجین خود چپاندم و خورجین را زیر بغل زدم	I stuffed a shirt or two into my old carpet bag, tucked it under my arm
من نصف آن را از آب بطری روی دست شویی پر کردم.	I half filled it from the water bottle on the washstand.
انواع سبزیجات در بین خنجر و دشنه به فروش میرسید و قالی ها را در کنار توتون و تنباکو در معرض تماشا قرار داده بودند.	vegetables for sale amongst daggers, and carpets displayed alongside tobacco.
که از ملاقات با یه جن خونگی توی اتاقم خوشحال به شم.	to have a house elf in my bedroom.
ولی تو با دست خود و به میل خود موجب چنین جدایی گشتی.	_you_, of your own will, did it.
حتی بعد از ازدواج و پس انداختی چند تا بجه هم به نواختن آکاردیون ادامه داد	he still was after he had married and had children
با شتاب رو به ساحلی که طرف ده بود دویدند.	hurried to the shore toward the town.
ولی خب از طرف دی گه خیلی راحت می شه با من کنار او مد	but on the other hand I am very easy to get on with.
شروع به خواندن اخبار مربوط به آن شهر کرد	was reading the news of that city
منتها من نه در اوایل و نه بعدا قصد نداشتم اغفالش کنم.	but I didn't try to seduceher at first or at any time, really.
بلکه حقوق و مزایا و امتیازات ناموری را نیز به او داده بودند	but he was admitted into all the rights, privileges
زیرا چند بار امتحان کردم و دیدم ممکن نیست با این چنین حالی به خواب رفت.	for I tried it myself after hearing the suggestion thrown out, and found it couldn't be done.
پیش از آن که بتواند خودداری کند سؤالش از دهانش بیرون پرید.	the thing he really wanted to know spilled out of his mouth before he could stop it.
هیچ دلیلی وجود نداشت که امسال غیر از این باشد.	he had no reason to suppose they would remember this one.
از آنجا که جماعت سخت نیازمند فراهم آوردن تفریحی دیگر برای خویش بود	the crowd being under the necessity of providing some other entertainment for itself
که دیگر هیچ شکی برای دختر جوان نمانده بود	that no doubt now remained in the young girl's mind
مساله ملاقات وی با پسرش را موضوعی بس ناچیز تلقی خواهد کرد.	the question of her seeing her son would seem a matter of very little consequence.
روزاموند با خشنودی منتظر روزی بود که خود بتواند این چنین تحقیرآمیز آنان را ارزیابی کند.	she felt much contentment in the prospect of being able to estimate them contemptuously on her own account.
زود همان جا را نزدیک میز پا برای او خالی کردند.	for no time was lost in procuring her former place beside the croupier.
همچنین به خاطر دارم بوی سپرد که سخت از من مراقبت کند.	nor the strict charge she gave the page to be careful of me.
ضمناً سفارش کرد که ما آرام بگیریم و هیچ سر و صدا نکنیم.	bidding us keep quiet making any noise.
آنچه از دستم برآید انجام خواهم داد تا وسایل عروسی ایشان فراهم شود.	I will do all I can to arrange the match between them.
اشتیاق به همان قدرت بار اولی بود که به وی او را حس کرده بودم.	the craving every bit as strong as that first moment I'd caught her scent last week.
که مچ پای چپش پیچ خورد و با پشت به زمین افتاد.	that he twisted his left ankle, fell backward
در این موقع گوشه دنج خود را ترک گفتم و از در فرعی که خوشبختانه نزدیک بود بیرون آمدم.	I then quitted my sheltered corner and made my exit by the side door, which was fortunately near.
متوجه به وی خوبی شدم که در هوا پخش شده بود.	I recognized the sweetness in the air
اما همه کاراکترهایش درجه یک پاشند و سه زن اصلی هم داشته باشد.	but every character first rate, and three principal women.
با ترس و احتیاط از آنجا عبور کردم و داخل راهرو شدم. عاقبت به مقصد رسیده بودم.	I went through then to the little morning room I had not seen before.
من هفت دهه بدون خون انسان سر کرده بودم.	I'd gone seven decades without human blood.
خوب دی گه من باید چیز میز ای شما رو برات ون حاضر کنم خان وم .	but git your things ready right away, mum,
به خاطر نبود آب لوله کشی هوای خشک شهر برگیاهان فائق شده بود	without daily watering from the city mains the arid climate had triumphed
من به دلم برات شده که او چنین کرده است!	I almost feel as if she had.
بلکه با سماجت مرد عاقلی که از بتون ساخته شده	but with the stubbornness of an old man made of stone
به سرعت خود را به در تالار رساندند و یکی پس از دیگری از راهروها گذشتند.	they swung around the doorpost and galloped down one corridor then another
عاجزانه از و خواهش کردم که در به کار بردن الفاظ مورد حاجت مرا یاری کند	humbly desiring his assistance when I wanted proper words
پس از حدود یک ساعت مقدار بخار برای به حرکت درآوردن ترن بحدکافی رسید و دوباره به راه افتاد. در این هنگام چند قراول به محلی که من نشسته بودم آمدند و آنجا را به دقت مورد بررسی قرار دادند.	for nearly an hour to get up a head of steam, while an officers' patrol came back and searched, very carefully, the ground where I had been seen sitting.
چون از بیرون سنگ غار پوششی روی چارچوب کشیده بودند	for the native rock formed a sill outside it
که دو هزار میل مسافت را برای جنگیدن به خاطر مقبره مقدس بجنگند	content to traverse two thousand miles of land to fight for their holy sepulchre
اما او خوابی دیده بود و با پادشاهی ملاقات کرده بود	but he had a dream, and he had met with a king.
من از منبع مؤثقی خبر دارم که دیشب واقعا شب زیبایی هم بود!	I have it from good authority that last night and a pretty night it was!
اما پیش از این که بروی فقط به چند سؤال من جواب خواهی داد.	but before you go you will be pleased just to answer me a question or two.
از دیدن این سینی حالم به هم می خوره.	I'm through with trays.
که زمینش سابقا متعلق به این جمعیت بوده است دفن شوند.	which was made of land which had formerly belongedto their community.
این تهدید که ورانسکی پشیمان خواهد شد که در آخرین نزاع بر زبان آورده بود.	that he would be sorry for it that she had said when they were quarreling.
هر بار با کلاه خود در هم شکافته شما را از اسب سرنگون کنم.	unhorse you with a split helmet every time.
که در سایه یک درخت ارژن از چشم افراد کنجکاو پوشیده بود.	screened from the eyes of the curious by a plantation of yoke elms
آرزو داشتم که می تونستم برات طوری توضیح بدم که تو هم بتونی درک کنی.	I wish I could explain it to you right so that you would understand.
اما وقتی به مخفیگاهش رسیدم دیدم هیچ کس اون جا نیست	but when I arrived at his hiding place, he'd gone.
به تدریج چهرة او رنگ طبیعی به خود گرفت و بسیار زیبا شد.	her face got animated, and she was charming.
یک جفت قلب دوقلوی ناهمسان غرق شدند و روی پلة بالای پله ششم جا گرفتند.	a pair of two egg twin hearts sank and settled on the step above the sixth.
او این را وقتی که از کوره در رفته بودم توضیح داد	he'd explained when I'd flipped out.
اینست که در حیات خویش خود را مشهور خاص و عام بیند	is to find himself in his lifetime in print and in type
من باید راجع به دلایلش فکرکنم و بهت اجازه نمیدم که راجع بهشون بامن بحث کنی.	I have to think of my reasons why not. I'm not going to let you draw me into a discussion of my reasons why not
همان روز که نه چیزی برای خوردن و نه جایی برای رفتن داشت.	when he had nothing to eat and nowhere to go
ضمناً از وضع گرفته غم زده او نیز اندکی متعجب بود.	much surprised at the mixture of sadness and boisterous spirits, which his whole behaviour displayed.
ای ولی نعمت بزرگوار! احسان شما به قدری در من اثر کرد که همین الان اشکم میریزه!	my august benefactor, I melt into tears!
که در آنجا جمعیت کثیری با شور و اشتیاق از او استقبال و بدرقه کردند بسیار شادمان بود.	where crowds of people had rapturously greeted and followed him.
ولی پیدا بود که نگاه و حرکاتش همه کام لا طبیعی بودند.	with looks and gestures that clearly were unstudied.
راستش من از مردهای چشم قهوه ای لایق نفرت دارم!	I hate estimable young men with brown eyes!
من نمی دون ستم که اون می تو نه کار خاصی بک نه.	I wasn't aware that she did anything special.
بار دیگر نظری به پائین افکند و دیگر هیچ تمایلی در خود نیافت که خود را پائین پرت کند.	he looked down once more, and his desire to throw himself down was gone.
از این جهت زنده مانده بود که مثل پدربزرگ سخت دل و لجوج بود.	had survived only because she was as mean as her husband.
بلافاصله شیء طلایی رنگی از دهانش بیرون آمد و در دستش افتاد.	something gold fell into his hand.
اما هیچ راه سالمی جلوی پایم نبود که یک طوری خودم را داخل کرده جریان را عوض کنم.	but I didn't see no safe way for me to chip in and change the general tune.
مطلبی بود بسیار منطقی که خوب هم نوشته شده بود.	it was so reasoned, incisive, and well written
ارباب هم کتک مفصلی به او زد و وی را به دنبال مرغ به دهکده فرستاد.	left his master dinnerless, had been whipped and sent to the village in quest of chickens
اما به اینهم واقفم که سلیقه من فاقد اصالت است.	but I am conscious that it has no originality.
من حالا به شما ثابت خواهم کرد که از اسرار فراوان دیگری نیز اطلاع دارم .	I shall show you that I know more than that.
به خطر گسترش وسیع جبهه خود پی برده بود	knew the danger of his extended position
که ترسیدم مبادا نسبت به او توهینی مرتکب شوم.	that I was afraid I must have given him some offence.
بعد به همراه مردی که تا چانه خود را در میان شنلی پیچانده بود بازگشت.	presently returned accompanied by a man muffled to the chin, who carried a bundle under one arm
زیرا در اینجا هیچ کس جرئت ندارد آنچه را در دل دارد به میان نهد.	for nobody here will tell the truth.
که فورا و نیازموده جوابی مستقیمانه بر این اظهار او بدهد.	yield immediately to the young man's request, but made a few conscientious objections
وسرآنرا لخت کردوگیره سوسماری را به انتهای سیستم دزدگیر وصل کرد.	stripped it, and connected the alligator clamp to the end of the alarm.
اگر پزشکان با تهدیدها و اخطارهای غیرمستقیم اصرار نکرده بودند که به تعطیلاتی دراز مدت برود	if the doctors had not insisted, with veiled menaces, on his taking a long holiday.
بعد نگاهی به خانه کرد و آن را بخاطرسپرد.	then looked back and noted the house.
همه حودشان وقتی او بود مؤذب و منظم بودند.	everybody was always good mannered where he was.
با عجله رفتم سراغ عکس برگ درون چاله آب.	I hurriedly shuffled back to the one of the leaf floating on the puddle.
اما شیئی عظیم و لای شعر بر سرش فرد آمد و ا را به پشت غلتاند.	but something huge and merciless struck her on the head and rolled her on her back.
او دقیقاً قیافه سی سال آینده چارلز را داشت	he was the projection of what his son would be like in thirty years.
با این از دیدنتان خوشحال خواهیم شد نشنون می ده	very happy to see you, which seemed to indicate that perhaps
افسار را تکان دادم و متوجه شدم که بازویم هنوز تحت کنترل است.	I clutched at the pommel, and found my damaged arm there and efficient.
بر آن نوشته بودند هرکس در این منطقه گدائی کند زندانی خواهد شد.	warning all persons who begged within the district, that they would be sent to jail.
اما این بار احتیاطات لازم را به عمل می او رد چون دیگر اصلا قصد نداشت حامله شود.	but this time she took proper precautions, for she had no intention of ever getting pregnant again.
زنش مانند گذشته به دروغ پاسخ دهد که این بدگمانیها مسخره و بیاساس است.	she would answer mockingly as before that his suspicions were absurd and utterly groundless.
که چند مورد تاریخی بوده است که در آن وال به خصوصی در اقیانوس در اوقات مختلف و نقاط دور از هم شناخته شده است	that there have been several memorable historical instances where a particular whale in the ocean has been at distant times and places popularly cognisable.
حتی به من اطمینان دادید مثل اینست که این پول در جیب من است.	you said it was as good as in my hands
وقتی او آنسلم را با رنگ پریده و ترسان و لرزان دبد	but seeing him come pale, worn, and haggard
اما من به قدری گرسنه بودم که برایم اهمیتی نداشت.	but I was hungry enough that I didn't care.
این نوع شهادت دستکم برای مدت محدودی ادامه یابد.	this type of testimony to be continued for a whileat least.
مثل اینکه یک گلوله توپ جلوی پاش در رفته و حالا موقع راه رفتن یک کمی تاب ورمی داره.	by a bursting shell and it did something to his legs makes them makes them, well, I hate to use the word but it makes him spraddle.
بدون این که عصبانیتش کمتر شده باشد با فکرش از موضوع منحرف شده باشد.	without any relaxation of anger, or any material digression of thought.
نه روشو دارم نه جرئتشو که تنها برم پیش دکتر.	I'd feel too much ashamed and frightened to ever go alone.
هم ون وقت کرام منو کنار کشید که داورها نتونن حرفشو بشنون.	then he sort of pulled me away from the judges so they wouldn't hear
پای راستش را در دست گرفت و پنج انگشتش را لمس کرد	she held the right foot in her hand and felt the five small toes
تا دست کم در آن اطاق که به قول خودم مانند انبار بدنه کشتی بود محصور و محبوس نمانم.	where I might at least preserve myself some hours longer, than by being shut up as I may call it in the hold.
به یک زن غرغروی بداخلاق تبدیل خواهم شد و ما با کینه و نفرت از هم جدا خواهیم شد.	I'd turn into a screaming shrew and we'd end up hating each other.
