یا اینکه هنوز یک تابستان دیگر را در خودش دارد.	or if he might still have another summer in him.
پس نخست در یک کشتی سپس در کشتی دیگر به پزشکی پرداختم.	I was surgeon successively in two ships, and made several voyages.
می تونستم صدای دیگران رو که توی خو نه بودن بشنوم.	I could hear the others in the house.
دیدم چوب دستی پسری که جلوی من نشسته بو از جیبش بیرون زده.	I saw, in front of me, a wand sticking out of a boys pocket.
همچنین کارها که جریان دیگری یافته بود او را سر وجد آورده بودند	wherefore, he was the more enraptured at the turn that things had taken
سعی کرد درماندگی و بدبختی را به پس ذهنش براند و سنگری بیابد و حصاری که برای فرار از درد در آن بیارامد .	aloud, trying to push her misery to the back of her mind, trying to find some bulwark against the rising tide of pain.
چون اگر دایی من از بیماری پهلوانی شفا یابد	for it would be no wonder if, after being cured of his chivalry disorder, my uncle
سعی خواهم کرد. ولی این کار خیلی غیر مردانه بود.	I'll try, but it was a very ungentlemanly thing to do
از روی صندلی بلند شد و صورتش را به شیشه چسباند.	he rose in his seat and pressed his nose against the window
واقعاً یکی از هزاران وظایف شاق و طاقت فرسا که بر عهده پادشاهان محول گردیده این است که مجبورند گوش به حرف همه مردم بدهند و به همه ایشان جواب بگویند و	for one of the greatest among the many troubles kings have is being obliged to listen to all and answer all
هر یک از این بناهای مشهور در برابر چشم ظاهر شد.	each of these famous buildings rose to view.
برای هری هیچ چیز خوشایندتر از صدای زنگ نبود	the bell could not have been more welcome.
موی مادرمو توی مقداری از معجون انداختن و من او نو خوردم.	containing one of my mother's hairs.
کاترین و دوشیزه تیلنی که هم در نحوهی گذراندن اوقات تفاهم داشتند	the two girls agreeing in occupation
چه طوری باید جن خاکی رو در به یاریم.	how to de gnome a garden
در آن لحظه ما آنقدر به هم نزدیک بودیم که من خوب دیدم او یک سر و گردن از من بلندتر است.	we came so close together that I could see she stood more than a good palm over me.
ری تا از جابرخاست و بی آنکه حرفی بزند	she got up and apropos of nothing
باز نزدیک شاهزاده رفت و در مقابل او سر طاس خود را مطیعانه پایین انداخت	came up to the prince, bowing his bald head resignedly before him
که تنها او توانسته است شیرینی و جذابیت عشق را دریابد	that he alone had experienced and known all the charm of love
هدفی که در سر تا سر عمرم دانسته یا ندانسته در قلبم بوده	this aim which, whether knowingly or not, I have always had in my heart
خود سراسر شب در اتاق او به پاسداری نشست.	sat there alone through the small hours.
یا به تازی تیزپائی که تا دریدن شغال خیزشی بیش فاصله نداشته باشد.	to be off at the heels of its prey of a foxhound within the last leap of its kill.
چون برای عاشق مهجور گمان بدی نیست که دنبالش نکند و بیمی نیست که بر او مستولی نشود	as everything distresses and every fear haunts the banished lover
سربازان سوار گرد او جمع شدند و با فریاد بسیار رسا هورا کشیدند.	he exclaimed in his dashing, old, hussar's baritone.
دخترهایش یک لیارد هم به من نخواهند داد و تمام اسباب و اثاثه او ده فرانک هم ارزش ندارد.	those daughters of his would not pay me a farthing, and his things won't fetch ten francs.
اما ناگهان ایستاد و از یکی از سه پنجره قدی اتاق که مشرف به خیابان بود به بیرون خیره شد.	stood looking out of one of the three long windows giving on the street.
از دست خورشید که در حال طلوع بود عصبانی بودم.	I was angry with the sun when it began to rise.
یعنی آسایش و رفاه زندگی و ثروت و حتی حیات و زندگی	the comforts of life, wealth, even life itself
من که به تو گفتم تهیه پول برای ما مقدور نیست	I told you it would not be enough.
در حالی که یکی به خاطر چیزهای گذشته از شادی انباشته بود و دیگری نسبت به چیزهای آینده از بد دلی مالامال	one all jubilations for things passed, the other all forebodings as to things to come
اگه فرصت بهشون بدی دوباره هم ون وضع رو برای خودش ون درست می کنن.	given time, they are right back where they were before the world turned over.
بعد دستش را دراز کرد و انگشتان مرا در دستش گرفت.	then stretched out his hand to me.
بلکه وضع آفرینش انسان این طور شده که قدرت و توانایی وی محدود گردیده و اما میل و خواهش او را حدی و نهایتی مقرر و معین نگشته	but in providence who while limiting the power of man has filled him with boundless desires
من قصد داشتم پیاده به طرف پل رفته مطمئن شوم که آیا در قرارگاه پل کسی هست یا خیر.	for I meant to walk round till I could be sure the bridge post was empty.
شمع را روی میز گذاشت و شروع کرد به چیدن نان و نمک و بشقاب و قاشقی که آورده بود.	she set the candle on the table and began to lay out what she had brought bread, salt, a plate, a spoon.
زره و کلاه خودها را جادو کرده بودند تا هرگاه کسی از کنارشان رد شد سرود بخوانند.	the suits of armor had all been bewitched to sing carols whenever anyone passed them.
مسافت زیادی را در میان خلنگ زار پیاده طی کرد	walked a great distance over the moor
فکر کردم تو هم با این کار موافق باشی.	I thought you'd want me to dothat.
با اراده و تصمیم قاطع به طرف آدم جزیره برگشتم	I set my face resolutely for this man of the island
از هیجانات آن روز چنان خسته بود که حتی نیروی آن نداشت به چیزهای خوبی که پدربزرگ به او داده بود دست بزند.	but he was so tired with all the day's emotions that he had not the strength to think about what his grandfather had done.
سکانبان آن را در صورت عملی بودن در پیش بگیرد و به وی سپرده شد.	if practicable, was once more given to the helmsman.
از شما نخواستم موضوع ملاقات خودتان را برای من شرح دهید.	I do not ask you what your business may be
افسوس خورده بود چرا زودتر وارد این گونه کارها نشده است.	that it was a pity he had not gone earlier into this kind of thing.
به پیش دوید و خود را در آغوش پیرزن افکند.	yielding to his first impulse, he sprang into her arms.
چه در موقع تشویق و چه به هنگام تنبیه.	whether in praising or in reproving
سر بینوایش در عظمت امواج جز یک نقطه نیست.	his miserable head is but a speck amid the immensity of the waves.
اما کنجکاوانه در جهان خود جدا و متفرق از هم بودند.	but curiously isolated in their world.
لباس و اسلحه لازم را برای یک سرباز آینده در برداشت.	contained the necessary clothing and weaponry for one future soldier.
نمی دونم از این نظر به کی رفته .	I don't know where she got that from.
اما شک نیست که سر او از لحاظ جمجمه شناسی سر بسیار خوبی بود.	but certain it was his head was phrenologically an excellent one.
هیچ گاه صدای خوبش این قدر مطبوع و کامل نبود	never did his fine voice sound at once so sweet and full
عرقی که بر پشت لب تراویده بود با نوک زبان لیسید	, wiping the sweat from his lips with his tongue.
در صورتی که پشتیبان قانون زور سر نیزه باشد.	when the law is supported by strength.
حق این است که سهمی از آن به شوهر تعلق گیرد	the husband must needs bear his part of it
این بچه رو میذارم که عمر طولانی داشته با شه	I got to keep her around a goodish time.
نه از مرگ که از زندی وحشت زده شد.	not so much of death, as of life
نگاهی عمیقانه و پر از قدرشناسی برمن انداخت و باز هم سخن نگفت.	but the swift lash of his reply was unexpected.
برای نخستین بار از آغاز این گفت و گو سربلند کرد	looked up for the first time since the beginning of the conference.
خاموش چشم به چشم آبی و پر دامنه دریا دوخته بود.	silently eyeing the vast blue eye of the sea.
سرش بط رزی غیر طبیعی به جلو خم شده بود گوشت تنش را پرندگان تقریبا کاملا خورده بودند.	his head grotesquely cocked, his flesh nearly picked clean by the birds.
اگر از این معرکه جان سالم به در ببرد	if he gets off free
مدت مدیدی بود آرزو داشتم با شما آشنا شوم.	I wanted to know you for a long time.
خوشبختانه حالا دیگر تقریباً به خارج شهر رسیده بودند	for they were out of the city now.
ژنرال از بخش کوچکی از پارک به طرف ان به راه افتاد.	he led the way to it across a small portion of the park.
دو مهتر در طرفین در گشوده کالسکه ایستاده آماده بودند تا کنتس را به کالسکه سوار کنند.	menservants stood one on each side of the open door and the carriage steps waiting to help the countess in
سعی کرد تا آنجا که ممکن است تعادل خود را حفظ کند.	holding himself as close to himself as he could.
امیدوارم از این که راضی شدم به او قول به هم مرا آدم فضولی ندانید.	I hope you will not think that I consented to take a liberty in promising to do so.
من خیلی از موانع و از سر راهت دور کردم.	able to curse many obstacles out of your way.
اما شوهرش را دید که وارد شد و اندکی دور از دیگران نشست.	but she saw her husband enter and seat himself a little in the background.
که گویی نه فقط به هر طریق در صدد پرهیز از بروز برونی آن مبارزه طلبی است	that it almost seemed not only every way seeking to avoid the slightest outward manifestation of itself
مصمم بودند اجازه ندهند هیچ چیزی این مهمانی افتخاری را خراب کند	they were determined not to let anything spoil this party for her.
اگر مرد شجایی باشی به این اعتراض پاسخی نخواهی داد.	you'll be a bold man to say no to that.
مثل این است که نور خورشید هیچ وقت مستقیم به این بیغوله وحشتناک نتابیده باشد.	I don't think the sun has ever shone directly on this horrible hole of an alley.
از برای دختر ضررش بیشتر است تا برای پسر.	e contract always injures the lady more than the gentleman
به زودی آثار نیکوی این عمل را مشاهده کردم.	whereof I soon found the good effects.
زیرا که سه نفر اصل زاده مفلوک را صدر اعظم و تقریبا پادشاه حقیقی مملکت فرانسه مشایعت نماید	three poor gentlemen escorted by a prince of the church!
او هم با یک نفس آن را سر کشید	he drank without pausing to breathe.
من اطمینان داشتم تو از سر قول خود بر نخواهی گشت.	I was sure you wouldn't break your word
در تمام مدت عمر خود هرگز از شعر خوشم نیامده است.	I have hated poetry all my life.
ما همه باید در پایان حیات علیرغم میل خود گردن به زیر یوغ آن نهیم.	under whose yoke we have all to pass, whether we like it or not, when life's finished.
که به هیچ وجه سزاوار تحسین و ستایش نبود.	that there was no merit in his kindness.
آنقدر رنجیده بودم که چشمانم پر از اشگ شد.	so much hurt that tears started to my eyes.
هرکسی باشی سیاست گاه برای پذیرایی زهر دهندگان حاضر است	the scaffold awaits the poisoner, whoever she may be
دستم را به سوی کمربند دراز کردم و با خونسردی ان را بستم.	I reach for my seatbelt and buckle it up nonchalantly
در آن صورت تمام هوش و حواسشان متوجه کار خواهد بود.	they won't neglect it, if they do
نیاز داشتم که به تنهایی تو ذهن خودم فکر کنم.	I needed to be able to think in privacy.
به این ترتیب که از یک سو مواجه با دشمنی این گروه سه نفری بود	so, between these three on one side
روی سرش تاجی از برگ قرار داشته و در دستش نیز یک زنبیل میوه و گل گرفته بود	crowned with holly, bearing a basket of fruit and flowers in one hand
هرچند که خود آن زن برای انجام هر کاری حاضر بود.	who, of course, was ready for anything
شاهزاده خانم به این کلمات که رسید نتوانست خود را نگه دارد و به گریه افتاد.	princess could not refrain from weeping at these words.
چون متهم به انجام کاری شده بود که روحش هم از آن خبر نداشت.	to be accused of a crime that she definitely had not committed.
بررتا فورا بر آن شد که به کلاید بگوید چون دیر شده داست	at once she was about to say that, since it was a little late
از قرار معلوم گریفیث این دختر جوان را فریب داده بوده و قصد داشته است او را به خاطر دختر ثروتمندی ترک کند.	whom he had wronged and then planned to desert in favorof a richer girl.
آنچه من فهمیدم زندگی سخت و وحشیانه و خشن و چند رنگ و زنده وپرحرارتی بود.	I received the impression of a life intense and brutal, savage, multicoloured, and vivacious.
یادم آمد از سرما در سالن قوز کرده بودم وقتی که در کتابخانه باز بود.	I remembered crouching in the gallery when the library door was open.
انگار که من یک قولنج بد هستم که باعث کشته شدن او بشوم.	as if I were a bad case of colic.
اما از چندین سال پیش زندگی خود را وقف عالم کلیسا کرده بود.	but for many years past had dedicated his life to the ministry.
مگه هیچ وقت کارش رو تعطیل می کنه .	I know you aren't going to leave that there.
من با آسودگی خاطر پشت سر او وارد خانه شدم.	I followed her into the house quite comforted.
مثل این که دو تا موش توی یکی از جیباشه.	I think I still got a couple o' doormice in one o' the pockets.
جرأت نداری با او حرف بزنی یا نزد او بمانی.	you dare not speak to him or seek his presence.
اکنون اگر به واقع این نکته را بیفزاییم که فوران هوا از آن سوراخ با آب امیخته است	if it could truthfully be added that his spouts are mixed with water
روحیه شادش با تشخیصات دقیقش در شناسایی امراض مغایرت بسیار داشت.	whose festive spirit seemed in no way related to his accurate diagnoses.
آن را آرام فشار داد به طوری که بمیرد	gently pressed the life out of it
ماجرا همان گونه که در اینجا روایت شده روی داده است.	it occurred even as is here set forth.
مثل برق به دنبال صدا افتادم و گوشم را برای شنیدن آن تیز کردم.	I went tearing after it, listening sharp to hear it again.
به صورت بهترین نمایشی که از او ساخته بود	in the finest dramatic manner he was master of
شاید امروز را با سرافکندگی و حتی شرم به یاد بیاوری.	you might be tempted to remember today with embarrassment, even shame.
خیلی هم بیمار است و شاید او نیز دیوانه شده باشد.	she is very ill, too.
در کمال حیرت و هشدار قلم با نهایت نرمی و روانی کج شد و به چرخش درآمد.	to her astonishment and alarm, the pen began to curve and caracole with the smoothest possible fluency.
در آن دم که چشم من بر آن دو افتاد	just as my eyes fell upon him
میز کوچکی را با شیشه لیموناد و شمع مومی مارپیچی شکل نزدیک تختخواب او بکشد.	the table on which stood a glass of lemonade and a spiral wax candle moved close to the bed
بنابراین او را بغل کردم و بردم روی تختخوابش خواباندم.	so I took her up in my arms and carried her off to bed.
او را بیش از آنچه در تصور آید همه جا دید	he found only too much of her
هر یک گاری دستی یا طبقی با خود داشتند که لبریز از اجناس غیرعادی بود.	carrying trays and pushing carts full of extraordinary merchandise.
من بست و چهار ساعت بهت مهلت می دم که از این شهر بروی	I'm giving you twenty four hours to get out of town.
هم به خاطر این که وجدان خودش آسوده شود	in part to quiet his conscience
حال اگر این امتیازات به نظر شما کافی است تا به خوشبختی من رضا دهید	if this be a sufficient inducement for you to venture to make me completely happy
چند روز پیش از هنگ سوار به جای دیگر منتقل شده بود به فرمانده هنگ نزدیک شد.	but recently left their regiment, rode up to the colonel.
که هیچ چیز نامعقول و نامربوطی نیست که بعضی از فلاسفه آن را به جای حقیقت نگرفته باشند.	that there is nothing so extravagant and irrational, which some philosophers have not maintained for truth.
در نوشتن این کتاب هیچ نظر به سودجوئی یا ستایش این و آن ندارم.	I write without any view to profit or praise.
برای چرب کردن زورق و مصارف دیگر پیه سیصد گاو را فراهم کردم	I had the tallow of three hundred cows, for greasing my boat, and other uses.
زیرا مایل بود او را نه چندان باهوش بداند	for he liked to think that she was not clever
هر چه از جیب من در آوردند هنگامی که بخواهم آن سرزمین را بدرود گویم به من باز خواهند داد	whatever they took from me, should be returned when I left the country
اگر پنجاه سال از عمرش هم باقی مانده باشد حاضر نیستم به جای او باشم	I wouldn't trade places with him if he had fifty years of life before him.
او به من در مقابل این سنجاق هشت کپک داد گو این که سنجاق من بدون شبهه چهل کپک ارزش داشت.	he gave me eight francs for it it was worth at least forty.
بسیاری از اکتشافات خود را بر اکتشافات من شوند	adding many new discoveries of their own, justle me out of vogue, and stand in my place
در مقایسه با هیجان و جوش و خروش خویشاوندان نسبی مرد سالخورده بسیار اندک بود.	was a feeble emotion compared with all that was agitating the breasts of the old man's blood relations
امیدم این بود که لااقل آهنگ صدا به گوش او خوش آید.	hoping at least that the cadence might be more agreeable to his ears.
ما را به اطاق کوچکی وارد کرد و سر میزی نشاند که بازمانده غذایی که تازه صرف شده بود روی آن پراکنده بود	ushered us into a little room, and seating us at a table spread with the relics of a recently concluded repast
با یک حرکت تند و ناگهانی طعمه بدون قلاب را از دست شیطان بقاپد	by one powerful snatch at the devil's bait,
من نتوانستم بیش از یک قاشق از آن بخورم.	I was not able to get down a second spoonful.
به علت این زیرکی این محافظه کاری و آگاهی کامل و روشن او از درماندگی آ دل این فقدان آشکار احساس محبت نسبت به او بود که اندوه نهفته همیشه آزارنده من بار دیگر سر برداشت.	it was from this sagacity this guardedness of his this perfect, clear consciousness of his fair one's defects this obvious absence of passion in his sentiments towards her, that my ever torturing pain arose.
تا روی زمین خم شد و به سوی امپراطور رفته پاکتی را به وی تقدیم کرد.	approached him, presenting an envelope.
از این رو مطالب اصلی این کتاب در نظر عموم تازگی نداشت.	so that the leading ideas of the work could not be completely novel to the public.
ولی با این حال شما فرصت خواهید داشت که در ظرف این مدت قلب خود را بیازمایید.	it will give you time to be sure of your self.
به امور اقتصادی ما سر و صورتی ندهی بزودی تمام املاک و اموالمان به حراج خواهد رفت و همگی به گدایی مجبور خواهیم شد.	their whole property would be sold by auction and they would all have to go begging.
پس از نزدیک به چشم خودم دیدم که چه کششی دارند.	so I know firsthand the appeal they had.
از اینجا تا محلی که خود گفته است به خاکش بسپارند کمتر از نیم فرسخ راه است.	it is not half a league from this place to where he directed he should be buried.
به این فکر افتادم که وقت آن شده بود با خودم معلوم کنم که به چه قیمتی و به چه شرایطی حضار به قبول سفر هستم.	I began to think it was high time to settle with myself at what terms I would be willing to engage for the voyage.
من خود شنیدم که شاه فرمان داد یکی از غلامان را تازیانه بزنند.	I myself heard him give directions, that one of his pages should be whipped
من که به حال شما ترحم و دلسوزی نخواهم داشت.	I shall not pity you, not I.
ضم نا باید به گم که خیلی هم قشنگ میرقصین.	I guess. I'll say you dance swell.
یا حتی سلاح سنگین رزم از تن بدر آورد خود را که در پیش دارد به نظر آرد یا حتی سلاح سنگین رزم از تن بدر آورد	without even relieving himself of the weight of his massive armour
مثل دودهای کلیسا و در زمان و مکان بسیار دور بود.	like a hymn, very remote in time and far away.
ممکنه معنی شو نو ندونم ولی میدونم یه چیزی توکله ته.	I may not know what it means, but I know it when I see it.
یاد آن زندگی افتادم که تا زمستان ۱۹۷۵ از سر گذرانده بودم	I thought of the life I had lived until the winter of 1975 came
که سرّ شما را فهمیدم و شما سرّ مرا نخواهید فهمید.	if knowing your secret I were to tell you mine?
در حالی که با آن پاهای باریکش که به پاهای سربازان سواره نظام شبیه بود از درگاهی تا درگاه دیگر در آمد و شد بود	flitting on his thin cavalryman's legs across the doorways, either just
فکر اینکه امسال فستیوال خرمن و مجالس رقص روستایی انجام نخواهند شد غم انگیز بود.	sad to think there would be no husking bees and barn dances.
فقط نمی خوام کریسمس بدون دادن چیزی بهش بگذره .	I just didn't want to let it pass without giving her something.
در این موقع طول دیوار پایینی باغ را طی کرده بودم.	I had coasted along the lower wall of the orchard
آن محیط با سکوت عمیق و غیرطبیعی بیشتر ناراحتم کرد.	that the silence was unusual
بعد بدون اینکه بداند باید پیش برود یا بازگردد	not knowing whether to advance or retire
اما آن وقت من آن را به سخن هفتگی دادم .	but I sent it to the _Weekly Review_.
برای آنکه به جمله بعدی خود وزن بیشتری بدهم یک لحظه سکوت کردم.	I was silent for a moment in order to give greater force to my next remark.
من که حتی الا مکان چیزی به شوهر اینده امنمی گم.	I'm planning to tell my future husband as little as possible
ممکن است این احساس در شخص دیگری اثر گذران و ناپایدار داشته باشد	in any one else this moment would be only due to yesterday's impression and would be only a moment.
باید یه جفت کفش نو به رام به گیره.	she's going to have to buy me some new shoes.
پنج برابر این عده لازم است که زنم را بیارایند.	five times the number to adorn my wife.
فرمانده آن به حال عاری از حتیاط روی پایگاه قایق ایستاده به نوعی تیر شبیه بود که در قایق نشانده باشند	its commander recklessly standing upon the top of the loggerhead, a stout sort of post rooted in the keel
نه برای آوردن چرخی که چای روی آن قرار داشت.	but not to admit the tea trolley.
که نخواهد به او دروغ بگوید و قلبش را بشکند.	not to want to lie to her or to treat her badly.
تو اگر مانند مارمولک در لای جرز دیوار پنهان شوی به چنگ من خواهی افتاد.	I shall find you though you should lie closer than a lizard.
حالا به کلی عقلش را از دست داده بود.	he was just as mad as a hatter.
که روی میز خاموش شده بود و هنوز دود از آن برمی خاست مشاهده نکرد.	which had but just been extinguished, and which was still smoking on the table.
پس از سه هفته تازه فهمیدم که علت بیدار شدن ناگهانی من چه بوده است.	it was three weeks before I knew the cause of my waking so suddenly.
که قطعه دشواری را نواخته و از شنوندگان انتظار دارد که از هنر و مهارتش قدردانی نمایند.	who has just performed a difficult operation and admits the public to appreciate his skill.
زنانی که چهره ی خود را با روبند پوشانده بودند.	women with their faces covered,
فقط یک تشک نازک و پاره روی کف سیمانی سلول افتاده بود	only a thin, worn mattress thrown on the cold cement floor.
ولی گارسون یک شیرینی برفکی بسیار لذیذ برای او آورد که تا آن هنگام نظیر آن را نخورده بود.	but the captain brought a delicate flaky pastry that was the most delicious thing she had ever tasted.
این تأییدیه پس از امضای مسؤولان مؤسسه بلافاصله به من داده شد.	signed by the inspectors of that institution, should forthwith be furnished me.
ولی چون این جوانک در صحبت خود را قدری متلون و دمدمی مزاج نشان داد	but, as he had a rather flightly and dissolute mode of conversing
صد نوع بازی سرگرم کننده از خود در آورد.	perform a hundred diverting tricks.
بر فرض که آثاری از ترس در من باقی بود بار کنجکاویم بر بیم و وحشت غلبه داشت.	if I had any apprehensions left, my curiosity prevailed over them.
بر قالیی سرخ در آبگیر ارغوانی مثل خون غلتید.	huddled on the crimson carpet in a scarlet pool like new blood.
که از همان اوان عمر ولگرد و عاطل و باطل بوده	one who hadbeen from the first a drifter and a waster
از ترس اینکه مبادا در باغ باز شود و مردان بدرون آیند.	for fear of opening the garden gate and allowing the men to enter.
پیرزن بلند شد و باعجله به طرف کمد رفت.	old woman got up and shuffled over to the bureau.
تا شاید بتوان هر دو عروسی را در یک موقع برپا کرد.	in order that the two weddings might come off together.
اگر بهر تقدیر بتوان عنوان نیکی به مردم فقیر داد	if indeed that title can be given to him who is poor
تل و تل و خوردم و به سمت وان افتادم.	I stumbled and fell toward the tub.
امّا به چه دردش می خوره اینجا هم به راش محیط خوبی نیست مگر اینکه ما فورا کاری کنیم	it's obvious that she won't be received here unless we do something quickly
اگر به کمک و مشورت نیاز داشتید و به شخصی محتاج بودید که عقده دل خود را برای او بگشایید	if you want help, advice, or simply to open your heart to someone
من میرم ماشین رو میارم و تو با من میای خو نه	I'm getting the car and you're coming home with me.
بشر افتم سوگند من از این موضوع هیچ اطلاعی ندارم.	I give you my word of honour that I had nothing to do with the matter and know nothing about it.
اگر شایسته و لایق باشی من ترا فراموش نخواهم کرد.	I shan't forget you if you deserve well.
دیگر مسافتی از سکو دور شده بودیم که سر برگرداندم و به عقب نگاه کردم	I looked back at the platform when we had left it far behind
تنها چیزی که به یاد دشات نور خیره کننده سبز رنگ و سوزش زهم روی پیشانیش بود.	a blinding flash of green light and a burning pain on his forehead.
رفیقش برگشت و دخل را شکست و محتویاتش را در جیب خود خالی کرد	who went back and broke open the cash drawer and filled his pockets with the contents.
دیدشان را تا حد زیادی مختل کرد. اما وقتی هوا دوباره صاف شد دیدند که جاده پشت سرشان مسدود شده است.	when the air cleared again they saw that the path was blocked behind them.
درباره آسیب و گزندی که با عهد شکنی خود ممکن بود بر این خانواده وارد آورد به هیچ رو نیندیشیده بود	he had not occupied himself with the inconvenience and possible injury that his breach might occasion them
برای هر کدامشان پنجاه لیره و دویست لیره هم برای خودم کار کردم.	I made fifty pounds for each of them and a couple of hundred for myself.
هیچ قمست و هیچ عضوی در بدنش از درد و رنج فارغ نبود.	not a limb, not a part of his body that did not ache and cause him agony.
من هم با بیلی که اونجا بود کله شو داغ ون کردم.	I killed him with a shovel that was layin' there.
من حتی به زحمت توانستم به دنبال دربانان بفرستم	I had scarcely sent for the porters
تلفن همراهم را بیرون او ردم و شماره خانه را گرفتم.	I pull out my mobile and dial home
مثلاً جمع و تفریق و این جور چیزها را یاد گرفتم.	I can, you know, do math and stuff.
تصحیح صورت بالا بلندی از ارقام که نیاز به دقت زیادی نداشت.	the rectification of a long list of figures, not needing close attention.
ما تا مدتی صدایی از این شش دریانورد بزدل نشنیدیم.	we heard no more, for the time, of these six very faint hearted seamen.
اگر راحتم گذاشته بودی حسابی حالش را جا می او ردم.	I could have licked him if you had left me alone.
ای کاش به این زودی و آ سونی زیر بار نرفته بودم.	yielded so easily and so soon upon his demand.
نفهمیدم که هنوز سه پله باقی است پای را بد هم نهاده و افتادم.	I forgot there were three more steps before the landing.
اعضای تیم گریفندور به محض ورود به زمین بازی با هلهله و تشویق پرشوری مواجه شدند.	walked onto the field to loud cheers.
آنجا را تبدیل به اتاقی برای نگهداری از کودک نوزاد کردم.	I converting it into a nursery
که تا آن موقع برای او فقط چیزی بود خیالی. اطمینانی که فقط در فکر وجود داشت.	that until that moment had been only an imagined certainty.
وقتی حتی حقوق درست و حسابی هم بهت نمی دن	if they don't even pay you well for it?
دیگر از آن تنبیهات خسته و بیزار شده بودم.	which had been tried upon the pair so often and so uselessly that I was sick of it.
من بودم که او را پیوسته شکنجه دادم و به این اقدام برانگیختم.	I tortured him and drove him to it.
با چشمان درخشان و با دماغی که آماده نبرد شده بود.	her eyes shining, her nose ready for battle
لیکن وقتی خواستم او را به تحصیل علوم دیگر وادارم دیدم چندان مایل و مشتاق به فرا گرفتن علوم شعر و ادبیات است	when I wished him to turn to the study of other sciences I found him so wrapped up in that of poetry
من او را در حال دیدن این صحنه تصور کردم. با نا امیدی آرزو کردم که او آنقدر مشغول نباشد که توجهی نکند.	I visualized her seeing this moment, hoping desperately that she wasn't too busy to pay attention.
حرکات دیگر او را در روزهای دیگر و جملاتی را که گفته بود و لحن صدا و تمامی وجود او را به یاد آورد.	she recalled his other attitudes on other days, the words he had spoken, the sound of his voice, his whole person
حاضر و آماده در کمین نشسته بود تا به جان خرگوشی بیفتد که آن طور زندگی را بر او حرام کرده بود.	so that she could track down the miserable whore who had ruined her life.
تفنگ را بار دوم و سوم پر کرد و دو تیر دیگر در کرد.	reloaded, fired a second shot, reloaded, let off the third.
برخاست در اطاق را باز کرد و فورا دوباره به رختخواب رفت.	unlocked the door, and promptly returned again.
فکر کردم شاید چیزی درباره من به تو گفته و یا نوشته باشد.	I thought she might have written or something.
خدا این دروغ تو را در فردوس برین جزای نیک دهد.	may this lie be counted to your credit in paradise!
بعد در گوشه دور اتاق چشمش به ننوی آویخته افتاد و زیر لب گفت	she murmured, with a glance at a hammock stretched in a distant part of the room.
مردانی که پیش از هر چیز زنی را دوست دارند.	men who could surely love a woman before all else.
فراموش کردم که قضیه دیگری که اتفاق افتاد بیان کنم	I forgot another circumstance
که تام فرصت را غنیمت شمرد و یک شیرینی کش رفت.	he hooked a doughnut.
آقای وی زلی با مهربآنی رو به جن خآنگی کرد اما وین کی چنان خود را جمع کرد که انگار او نیز سرش فریاد زده بود.	he said kindly, turning to the elf, but she flinched as though he too was shouting at her.
جز آنکه هزینه کلانی برای این استان در بر داشته باشد فایده دیگری ندارد.	is to entail great expense to the county.
خوشوقتم وقت آن فرا رسیده است که بتوانم حرفم را به ثبوت برسانم.	I am thankful that the time has come, when I can prove them.
چون در آن سرگردانی بی بند و بار من در آن هنگام راه امن دیگری برای حفظ این آمار نبود.	as in my wild wanderings at that period, there was no other secure way of preserving such valuable statistics.
قول داده بود که دیگر از عشق سخن نگوید و خود را به او تحمیل نکند .	that she would never again throw herself at his head.
علت این وضع با خستگی مفرطی است که در این نبرد بر شما عارض شده است	it must be either owing to the fatigue of this combat
به خواهری که سزاوار است که خواهر تو باشد و	who is worthy also to be yours
پس از آنکه اطرافش را کاوید به روی سؤال کننده بازگشت.	they turned back on the questioner when they had sought the ground.
با این همه اندک کوششی برای باز یافتن او کرد اما موفق نشد.	he made some efforts to find him, however, but without success.
که اگر دریا منقلب باشد و تأخیری در مراجعت به رودخانه شود ما را بی آذوقه مگذاری.	should the night happen to be stormy they will not be sorry to find something to console themselves with.
سعی داشتم تمرکز کافی داشته باشم تا محکم نرم توی یه درخت.	I was just trying to concentrate enough that I wouldn't plow headfirst into a tree.
من از مهتاب متنفرم برای اینکه زیباست و آقای جر وی این جا نیست تا با هم به آن نگاه کنیم.	I hate the moonlight because it's beautiful and he isn't here to see it with me.
دخترک اینک در همان مسیر مادر قرار گرفته بود	at present was directed toward herself
بر تخت روانی که با خود آورده بودند قرار داده آمادهء بردن آن شدند.	placed it on a litter they had brought to the door, and bent to carry it away.
با خود اندیشید که گراتسیا به او اعتماد ندارد.	he thought she had not trusted him.
پس از اینکه اولیور را به درون راند در را پشت سر بست.	drawing him into the passage, closed it behind them.
از کش تیرانی اطلاعاتی داشت که برای ما بسیار سودمند بود.	his knowledge made him very useful
من هم حاضرم سرم را وثیقه این کار قرار بدهم که او آدم رذلی است.	I for his falsehood with my head!
ناگهان چنان میل شدیدی در خویشتن احساس کرد که تصمیم گرفت	but decided for or against hastily, and without much reflection.
از این دعوت بسیار خوشحال شدم و به خود بالیدم.	an invitation I was only too proud and happy to accept.
برای هر چیزی که می دم انتظار دارم یک چیزی بگیرم.	I always expect payment for anything I give.
به عنوان یک مرد سپاهی حتی به شاه نیز مدیون نیست.	that being a soldier he was as good as the king himself.
پارو زده بودند تا به یک خانه رسیده بودند	rowed to a house
اما چون نان برشته مقدارش خیلی کم است باید آن را الان بخورید.	said she, but as there is so little toast, you must have it now
چون تا لحظاتی پیش مقادیری از راه را به آن دنیا پیموده بودید.	it's not so long since you were pretty far advanced on your way to another.
عاقبت پرید پایین و تعظیمش را کرد و رفت.	finally skipped off, and made his bow and danced off to the dressing room
اونجا متوجه به شه که من اصلا دلم نمیخواد باهاش ازدواج کنم	once she was up there and sawhow much I didn't want to marry her
قبلا متوجه نشده بودم که این مسئله چه تفاوتی می تونست ایجاد کنه.	I hadn't realized how much difference it would make to me.
در این موقع صدای سرفه خیلی نزدیکی در پشت سرم شنیدم.	the sound of a cough close behind me
یا عشق به طبقه اشراف یا احساس محاصره شدن در میان دشمنان.	or from the strain of the position he was placed in, feeling himself surrounded by enemies
احساس کرد که محبوب و صمیمی بودن نزد مردی که این همه دوست و مشاور دارد حسن و امتیازی نیست که آدم به آن ببالد.	felt, that to be the favourite and intimate of a man who had so many intimates and confidantes, was not the very first distinction in the scale of vanity.
پس شیطون تو جلدت رفته بود این وقت شب رفته بودی تو زیرزمین!	then, what possessed you to go down there this time of night?
روی تخت خم شد و به مجسمه نگاه کرد	bending over the statue on the bed.
آلوده به خشمی بود که از نزدیک شدن ربرتا به او نشئت گرفته بود.	had been some anger againsther for wanting to come near him at all.
به هنگام ورود به شهر صددروازه با وقار تمام بر پشت خرشکیلی لمیده بود.	when he entered the city of the hundred gates, went very contentedly mounted on a handsome ass.
الآن متوجه شدم که شما دو تا را چقدر دوست دارم.	I was only now discovering how much I loved you both.
با تمام قدرت سعی کردم این فکر را از بین ببرم	with all my might I endeavoured to stifle it
در عالم خواب با نیروی وحشتناکی که معتقد است بی شک آن جنایتکار را از پای خواهد انداخت.	raises his arm to strike that ruffian a terrible blow which he knows should annihilate him
به طور خاص جالب توجه نویسنده این سطور بوده است ببینید.	peculiarly interesting to the writer hereof.
بدون دچار شدن به زوال روحی یا جسمی چنین نفرینی را تحمل کنند.	it without mental or physical deterioration in some form.
آنقدر از مشاهده آن دو در آن حالت به حیرت دچار شده بود که حتی نتوانست اظهار نظری بکند.	it affected him too deeply to allow an observation on the subject that night.
که آن بیچاره از فرط خشم و استیصال تا سه ربع فرسخ از آن میدان به دور افتاد.	that in vexation, anger, and rage, he took the sword by the hilt and flung it away with such force
شاه فرمان داد که به قصد آزمایش مرا در آن زورق بنشانند و در مخزنی پر از آب بگذارند.	who ordered it to be put into a cistern full of water, with me in it.
به گره آن نگریسته لختی به فکر فرو رفت و اندوهناک و با ابهت سر را تکان داد	seeing the knot in it, pondered, shaking his head sadly and significantly.
گریان و ملتمس گفت که هر چه زودتر و در صورت امکان همین امشب او را از مسکو بیرون ببرد.	implored him with tears to take her away quickly, that very night if possible.
خوب به یاد دارم آن وقتی را که قد و بالایش این قدر بود.	I remember when he was no higher than that.
با ین زودی بیست ترجمه گوناگون در میدان عمومی جای گرفته است.	there are already twenty translations on the public place.
انتظار داشتم اسمم را از دهان یک نفر بشنوم	expecting to hear my name pronounced
منظورم ای نه که این ادم مدت یه سال منزوی بوده.	I mean, the guy's been shut away for three years.
حالا دیگر زندگی هم برایم خسته کننده شده است.	I find that I am heavy company enough for myself as I am.
یا کبوتر در حین پرواز یا داشت را گم کرده بود یا صاحب کبوترها خودش را به آن راه زده بود	either the pigeon had lost the note en route, or the pigeonkeeper had decided to play innocent
به جای آن کلاه تیره رنگ و با شکوهی بر سر گذاشت.	substituted a hat, of grave and sober shape, which he took out of the chaise.
مامان و بابات باید یه ماه گرسنگی بک شن.	your parents will go hungry for a month
من از آن آلا مدهایش نیستم و خیال هم ندارم که باشم.	I'm not a fashionable party and don't mean to be
از موضعی بالاتر تسلای خاطر بر وی فرود آمد.	draw comfort down.
یتیمان را دست گیرند و بیچارگان را فریاد رسند.	to succour the orphans and the needy.
که نوشته بود هم باید دیرتر بروند و هم باید زودتر برگردند.	which at once delayed its commencement and curtailed its extent.
اگر به دنبالش نگردیم تنها همین حدس قوی که ممکن است او صاحب پول باشد	if we do not see him, the strong suspicion we have as to his being the owner
من صد و بیست پوند پول آن وسایل و لوازم را دادم.	I paid you a hundred and twenty pounds for that equipment.
اما کام لا معلوم بود که سعی کرده موهایش را شآنه بزند	but he had certainly attempted to comb his hair
اگه راستشو بخوای من خبری ازش ندارم و نمی دونم کجاست.	as a matter of fact, I've no idea where he is
از کردة خود پشیمانم و امید به بخشایش دارم.	I am very sorry for what I did, and I hope you will forgive me.
بدون آن که از آن زن سؤالی کرده باشد.	without his having to be asked.
اما رسم معمول این بود که همه اسم خود را روی میز کنده کاری کنند.	but it was the etiquette that you had to carve your name.
زیرا چنان بی سواد و احمق بود که گفتگو با وی امکان نداشت.	especially as she was so childish that there was nothing to be got out of her.
گردن کشیدم تا از بالای سر بقیه بتونم ببینم	I crane my neck so I can see over everyone's heads
دی گه لازم نیست تکالیفتو به من تحویل بدی.	you need not hand it in.
اما او چیزی نگفت و کیتی با حیرت به او نگاه کرد.	but he did not, and she glanced wonderingly at him.
کشتی هیسپانیولا را پیدا کند در تاریکی شب آن را تصاحب بکند	find and board the HISPANIOLA under cover of night
احتمالاً گفته بوده که احمق است که اولین بارش نود.	thought him a fool presumably, not for the first time.
بعد دوباره آن را بالا برد و روی سرش گذاشت.	she again lifted it to her head.
امیدوارم تو هم به اندازه من احساس عشق و علاقه کنی.	I hope it was as wonderful for you
انگار اگه پیرهن تنم رو هم نکنم و به مردم ندم نمی تونم زنده به مو نم.	if I don't quit giving my shirt away I'll starve to death.
آن وقت باید به نحو دیگری دست به کار شوید.	then you must go differently to work.
از اینکه بالاخره به مقام پهلوانی رسیده بود چندان شاد و خرسند و ذوق زده بود	so happy, so gay, so exhilarated at finding himself now dubbed a knight
زیرا که او جرئت و جسارت نکرد که ما را نگه دارد.	he did not dare to keep us
دل و جرئتش را نخواهم داشت که درونش گام بگذارم.	I wouldn't have the guts to step through.
اما قاعد تا زندگی برایش بسیار سخت بوده است	but life must have been very hard
پدربزرگ بچه به جستجویش آمده بود و کام لا حق داشت که او را با خود ببرد.	but her grandfather had come for her in the mostnatural way in the world.
دو گوش نوک تیز از لای موهایش بیرون زده بود.	there were long, pointed ears poking through her hair.
از شوربختی ثابت کرد که شایسته این صفت است.	to my misfortune, he well deserved it
به جای آنکه به اتاق خودش برود در اتاق طبقه پایین ماند و در را به روی خود بست.	instead of going to bed, shut himself into the room beneath.
درست در همین فاصله بود که آن رویداد مهم اتفاق افتاده بود	it was exactly at this moment that the significant thing happened
خواهم دید تا چه حد در مظان اتهام قرار دارید.	you will find how seriously you are compromised.
ولی توتسکی درصدد است که خود را از چنگ او برهاند	who wishes to get rid of her
سعی کردم سیب زمینی سرخ کرده در ست کنم و چیزی نمو نده بود خونه رو آتیش بزنم.	I tried to cook some french fries and almost burned the house down.
سپس مقداری آب برداشتم و با جو در آمیختم	then took water
چون ایشان از قول و قرار بین من و نو مسلمان آگاه نبودند	for they did not know the renegade's plan
حالا هم تصور اینکه کاترین مرا فراموش کند تنها وقتی برایم امکان پذیر است که مطلب را از زبان خود وی بشنوم و در آن صورت دیگر دنیا و آنچه در آن است برایم کوچکترین لطف و ارزشی نخواهد داشت.	but only her own assurance could make me admit the horrible idea again.
نمی دون ستم می تونم انجامش بدم یا نه	I didn't know if I could make it.
اما مدتی طول کشید تا به مقررات این بازی آشنا شود	but it was a long time before she could understand the game
بلکه در هلاکت او مساعدت و معاونت هم از من صادر گردید	was I not accessory to his death by my supine insensibility, by my contempt for him
بلکه اولین کار و وظیفه خود را به جای آورد.	but only of the task nearest to hand.
در حالی که نجبا بی سر و صدا و مشتاقانه	nd the noblemen noisily and eagerly
مانند یک آدم بزرگ سال اطرافیان را ورانداز کرده بود	looking at people with the judgment of an adult
اما آن چاقو داخل صندوقش در قلعه بود و نیم کیلومتر با او فاصله داشت و در دسترسش نبود.	locked in his trunk in the castle a quarter of a mile away, no use to him whatsoever.
لری خود را به خاطر چنین فکری ملامت کرد	he thought before he could help himself and then hated himself for thinking it
ولی من در مورد شما چنین تغییری منظورم نبود.	but that is not the change I had in view for you.
وی پس از توضیحات بامداد تا آن لحظه خوابیده بود	he had been asleep ever since his interview with the prince in the morning.
بار و بند یل را از روی اسب چه باز کرد و روی زمین انداخت.	unlading all the pony's packs and throwing them on the ground.
از اتاق بیرون رفت که نماز بخواند و دوباره برگشت.	he went out to go and say mass, came back
بنابراین آن دو هم در رستوران کوچکی در میدان مرکزی ناهارشان را صرف کردند	so the pair ate their own lunch in the small restaurant on the main square
از دیدن این حال آن اسب و رفیقش که اسبی کهر بود ظاهراً بسیار متعجب شدند	whereat, both he and his companion who was a brown bay appeared to be much surprised
جبران خواهد شد و همهٔ گناهان عفو خواهد شد.	that it will make it not only possible to forgive
دلواپس شد و به فکر فرو رفت. پس خطر هنوز رفع نشده بود.	he wondered uneasily if she was out of the woods yet.
لیکن چون پنیر بر اثر فشار فشرده شد آب آن بر چهره و ریش او فرو چکید.	but as the curds were pressed and squeezed the whey began to run all over his face and beard
ولی او هم مانند دیگرتاجران اسلحه چنان حریص بود که هیچ پیشنهاد سودآوری را نمیتوانتس رد کند.	but, like most arms dealers, he was a man so greedy that no offer of money could be turned down.
چند پیراهن جدید و امروزی و یک جفت کفش شیک به او داد.	gave him some youthful shirts and two toned shoes
من قدری جلوتر آمدم تا ببینم جا هست یا نه.	but I came on first to know if there was any room.
دلسردیش بیش از آن بود که موهایش را کوتاه کند و یا به فکر صورت ظاهرش باشد.	he was too discouraged to cut it, or to think about his appearance.
که هنوز اسیر سرپنجه قوی تر از خودش است	restrained by a more muscular hand than his own
صدای شلیک توپی در سراسر شهر پیچید و معلوم شد که ساختمان شهرداری به تلی از آوار تبدیل شده است.	a rebel cannon shot that echoed in the whole town blew the front of the municipal treasury to dust.
این یکی خبرش کرد که سرخک تام آخرین اخطار خدا بوده	who called his attention to the precious blessing of his late measles as a warning.
گلنگدن تفنگ را کشیدم و سرپنجه عقب عقب از همان جایی که آمده بودم برگشتم.	I uncocked my gun and went sneaking back on my tiptoes as fast as ever I could.
از هزار ساحل بگذرد به اجاق تراشیده یا در زیر آفتاب به چیزی پذیرنده برخورد نخواهد کرد	passed a thousand shores, you would not come to any chiseled hearth stone, or aught hospitable beneath that part of the sun
زبیده وقتی پدر خود را چنین گریان دید متأثر شد و از روی زانوی من برخاست تا برود و او را در آغوش کشد	when she saw him weeping she was so moved that she rose from my feet and ran to throw her arms round him
معلوم نبود که مرگ را بر آن ترجیح ندهد.	it seemed to him that death would be preferable.
چند متر دورتر از من روی موزاییک نشست و بازوهای لاغرش رو دور پاهای استخوانیش قرار داد	she curled up on the tile a few feet from me, wrapping her skinny arms around her skinny knees headache.
یقین داشته باش که با کمال لیاقت و مهارت از پیش خواهد برد	if so he will have achieved a noble work
که مشخصهء بی بند و باران این طبقه است	which may be observed in all free livers of his class
اما او تا سه سال بعد کل پول قایق را به دون کارلوس برگرداند.	but he paid all the price back within the next three years.
آن را باز کرد و کنار پارچ آب میوه گذاشت.	propped it open against the juice jug.
در مزرعه و خانه به کمک او خواهد شتافت.	they will of their own accord help him in his fields and in his house
تا این که سرانجام از میان جمعیت بیرون آمدند	until they were clear of the turmoil
تا هنگامی که توانست مهار صدایش را باز بیابد.	until she could control her voice enough to say.
پول از یک کیف محکم فولادی درآورد و آن را بست.	she took her money out of a hard steel purse, and shut up like a bite.
نزدیک آشپزخانه و کنار آتش دستور دادند ناهار بیاورند.	ordered some dinner by the kitchen fire
این کار را کردم و بعد هم هیچ پشیمان نشدم.	I done it, and I warn't ever sorry for it afterwards, neither.
فقط آن قدر بود که خرج و دخل کنیم.	just enough to pay expenses.
زیرا پیش از آن صدها تن را در این موقعیت دیده بود.	he had seen hundreds pass away so.
چون بلافاصله به خاطر آورد که موضوع چیست به انبار بالا رفت	suspecting what it was, ran to the loft
او را ناگزیر کرده بودند که به خاطر دفاع از خود مرا از منقار رها کند	forced to let me drop, while he defended himself against the rest
نه به عنوان خاطرات گذشته بلکه چون واقعیتی در نظرش مجسم گشت.	not merely as something past but as something present.
قسمت راست ماشین تا رکاب درشن مدفون شده بود.	its right side drifted in sand up to the door panels.
چهار توپ سبک را پیش بکشند و دروازه قلعه را گلوله باران کنند.	four light guns to be moved forward to fire at the gates.
که این نیز قرابتی با موجودی به نام مادر ندارد.	which does not go far towards the realisation of the name of mother
چه عقیده به همکاری دیرینه هوشمندی و افکار شیطانی هنوز در اذهان مردم نیرومند بود	the world old association of cleverness with the evil principle being still potent in the minds
او در میان تصاویر بزرگی از خودش نشسته بود.	seated at a table surrounded by large pictures of his own face
ایشون دومین قهرمانی بود که همراه با گروگانش به سطح آب رسید.	was second to return with his hostage.
ضمناً این خود حقیقتی است که در اشعار پله وانان قدیم جزا لت بیش از لطافت وجود دارد.	true it is that the verses of the knights of old have more spirit than neatness in them.
بعد دوباره آن را آهسته پائین آورد و در حالیکه دستش همچنان مستقیم بود آن را در کنارش آویخت.	then slowly lowered it again, straight armed, down to his side.
راه را با دقت مورد اکتشاف قرار داده اما موفق به دیدن این گودال که چین کوچکی هم بر فراز تپه از آن نمودار نبود نشده بود.	had scrutinized the ground, but had not been able to seethat hollow road, which did not even form a wrinkle on the surface ofthe plateau.
که نفع و ضررش بسته به امور اتفاقیه و در دست اخبار است	all operations under the influence of greater or less mischances
مأموری نگران و شتا بزده پزشک را از قسمت درجه یک خبر کرد.	the doctor, summoned from first class by a very worried steward
به شانه همدیگر دست زدن و شوخی کردن و هرگز جرأت آزمودن آرامش را پیدا نکردن.	back slapping and jocular, never daring to essaythe test of quietness.
گذشت زمان و تغییر موقعیت لازم و ملزوم یکدیگرند.	I consider one as including the other.
پنداری شوهرش او را از خوابی عمیق و بدون رؤیا بیدار کرده بود.	as though he had awakened her from a very deep and dreamless slumber.
این همه از مشاهده آن همه هوش و عقل سلیم در چنان جانوری خرد شگفتی نمود	was, however, surprised at so much wit and good sense in so diminutive an animal.
تازه مردم هم دی گه به راه با اهمیت نمی دن.	people don't go much on hermits, nowadays
اولین اقدامش معاف کردن و دور کردن او از اطاق خیاطی خود بود	she banished her from the sewing room.
که تپهٔ کوچکی است با ارتفاع حدود/1800پا و به شکل تقریبا مخروطی.	a small hill about eighteen hundred feet high and roughly conical in shape.
آنگاه خواهیم دید که گشودن در بروی شما صلاح است یا نه.	then we shall see whether it will be proper or not to open to you.
با همان وضع شروع به دویدن در سراسری فاحشه خانه کرد.	ran through the house balancing a bottle of beer on his inconceivable maleness.
نشست و در پشت حصیر سبز مشغول کار شد.	sat down, with the green fan between her and the light, to work.
خیلی دوست دارم. اما باید فردا صبح زوداماده بیرون رفتن شوم	 I'd love to, but I have to be ready early in the morning.
حتی این قدر حاضر نشد که به من نام ناخدای جدید را بگوید.	neither would he so much as tell me who their new captain was.
ضمن پیشرفت در کار خود نباید از تذکر آن به ذهن یا زیر بغل داشتن اطلاعات مربوط بدئان غافل شوید	you must not fail to carry it in your mind, or under your arm, as we proceed
یک حس آشفتگی شدید او را به آغاز این تصمیم ناگهانی برانگیخت.	he obeyed a and peculiar impulse of indignation.
بلکه راجع به هر چیزی که مربوط به جنگ نبود.	but to anything that was not war.
میل دارید که این مکتوب را برای شما بخوانم	shall it be read
اما من چندان عالم نبودم که بتوانم از سخنان او سر در آورم.	which I was not skilful enough to comprehend.
در آشنایی با سگان بیش از آن دانا بودند که فریبشان را بخورند.	calm and impartial in administering justice, and too wise in the way of dogs to be fooled by dogs.
دستمالی داشتم که او را نیز صرف خاتمت او نمودم	I have torn up two of my shirts to complete the precious pages
در ضمن با خرسندی انتظار واقعه وحشتناکی را داشت.	alarm, yet at the same time joyfully expecting something terrible.
خانم را از حسن و جمال او مطمئن سازد.	, and was about to contradict the baroness upon this latter point
من باید یاد بگیرم که هم خوش بگذرانم و هم آلت مسخرگی مردم نشوم.	I got to learn to play aroundand yet not make a fool of myself.
خیال دارد که مجلس بالی رو به راه نماید.	intends giving a ball
بعد با دسته کلید بزرگی که در دست داشت ضرباتی به روی یکی از درها فرود آورد.	the turnkey knocked at one of these with his bunch of keys.
با وجودی که قالی کف اتاق خیلی رنگ و رو رفته و مبلمان آن خیلی ساده و کهنه بودند	though the carpet was faded and the furniture very plain
تا با دستی که برای مانده است شما را دربرگیرم	to embrace you with my one arm
ولی گاهی مشکل است و باید کلی صحبت کند تا شبی برود بیرون یا دوست و آشنایی را بیاورد خانه.	it was not without difficulty, without considerable address at times, that he could get away, or introduce an acquaintance for a night.
زیرا که فطرت نیکو داشت و باطنا برای ادراک ترقیات معنوی آماده بود.	since his nature was good, and, at bottom, wholly formed of latent progress.
نشست و از خشم و ناتوانی چون کودکی شروع به گریه کرد.	where he sat and wept like a child in his impotent rage.
منتها هیچ کدام از ما جز باد به دست نداریم.	yet there is not one of us that owns more than his bare skin.
اینان دو استادی هستند که هر ناخدایی باید به خدمتشان برسد و پیش هر کدامشان که کار کند کمرش را به اطراف تالار دوخت.	the two masters a captain must serve, either of which could and would break him and whose interests were diametrically opposed.
برای اینکه به کماندوهای دریائی قدرت مانور و سرعت لازم را جهت حمله بدهد.	to give marine commandos a fast and maneuverable type of assault craft.
به حقیقت و مبارزه او در راه علم است	their truth, their struggle and their science
دوستت داشتم ولی نمی تونستم بهت به گم .	I loved you but I couldn't let you know it.
چند بار سراسر اتاق را پیمود و باز ناگهان نزدیک بالاشف آمد	paced several times up and down the room in silence, and then, suddenly
بعد یواشکی زدیم به چاک جعده و تا خوب از آنجا دور نشدیم چراغ مراغی روشن نکردیم.	then we slid by, pretty wide away from the town, and didn't hoist our lantern till we was clear out of sight of it.
یک دسته شبگرد بود که ژاور در راه دیده و همراه آورده بود.	there could be nomistake as to this surmise and whose aid he had demanded.
انگار که قرار بود صد سال دیگر زنده بماند	as though he'd live to be a hundred
مادرانتان چه فکر کرده بودند که گذاشتند به دریا بیاید!	where your mothers was that let you come to sea.
اینست که در حسن شهرت و نام نیک همسر آینده خود بیش از ثروت و مکنت او تأمل کند	would be to look to good name rather than to wealth
موهای سرش را با دقت شانه کرده بود و در وسط راهروی میانی ایستاده بود	his hair was neatly combed and he was standing halfway up the middle aisle
در رویارویی با این وضع غیر منطقی و غیر عقلایی نمیدانست چه باید کرد.	he felt that he was standing face to face with something illogical and irrational, and did not know what was to be done.
در همین هنگام تریسی متوجه که فشار هوای داخل گوشش تغییر کرد.	at that moment, she felt a sudden change of pressure in her ears.
به خود آمد و دید بهتر است همان آدمی باشد که تعدادی اسب و مهتر دارد و لذایذ نقد در انتظار اوست.	he found it was as well to be a man of fortune at once with horses and grooms at his command.
گونه پیرزن را که برای بوسه عرضه شده بود بوسید.	pecked obediently at the withered cheek presented to her.
هر چه روشنایی در چنته دارم به روی این موضوع بتابانم.	all the light I can command must be concentrated on this particular web
اما درهرحال به وضع آرایش عمومی قشون پی بردم.	but I understand the general position.
در آن زمان بود که یادش آمد که عمویش گفته بود چیزهایی را برای زنده نگه داشتن یاد مادر و پدرش بردارد.	he remembered then that his uncle had said he might take something to remember his father and mother by.
فقط کافی بود نیم ساعت زودتر از معمول پا شود و برای لباس عوض کردن برود.	it would be only her retiring to dress half an hour earlier than usual.
پس از شش روز رخت مرا که بسیار بد دوخته بود آورد	in six days brought my clothes very ill made
من همیشه دلم می خواد دوستان قدیمی وضعش ون خوب با شه.	I like to know that all is well with old friends.
بدون آن که حرفی بزند از کنارش گذشت و از پلکان مرمری بالا رفت.	swept past him up the marble staircase without speaking.
اندکی فکر کنید که فردا پس از اعترافاتمان با چه چشمهائی ما به یک دیگر نگاه خواهیم کرد!	only think with what eyes we shall observe one another tomorrow, after our tales have been told!
اگه منظورت روند نه.من رون دن کامیون رو بلدم.	I can drive her, if that's what you want
که این آلوهای سبز را ببرند و بخورند و گرفتار نشوند.	to carry away and eat those green plums without being caught
به نظر من هم ابداً وضع جسمی خوبی ندارد.	I should think he is far from having a good constitution
عاقبت چون به نظرش رسید که نه جای اطمینان است و نه مناسب که وقت و فرصت برای گفتگوی بار دوم به او بدهد	considering it neither safe nor right to give him the chance or opportunity of speaking to her again
آن یک کم پولی که داشتم از دست دادم.	I lost the little money I had.
دست خود را که با آن به آسمان اشاره کرده بود بلند کرد تا درود بفرستد.	he raised the hand which had pointed at the sky to the salute.
اما عفریت هنوز هم دست از سر او بر نیم داشت	even then it would not leave him
به همین دلیل منافعش را به پول تبدیل کرد	he realized his gains
ولی از کجا معلوم که برود با آدم مناسبی ازدواج کند که تو بتوانی به او توجه نشان بدهی.	it does not follow that he might marry any body at all fit for you to notice.
حالا نمی دونم عنوان دوست برای این یارو مناسب باشه	I don't know if friend is the right word for him.
نشنیده بودم که آن دو دوباره با هم بودند.	I hadn't heard that they were together again.
اما واقعیت چنان بود که به تو نیاز داشت.	but the fact remained that he needed you.
ناگهان صدای تق و توق به صدای بلند و مهیبی تبدیل شد.	it swelled to a roar
سپس آهسته از خانه خارج شده و قدم به خیابان گذاشت.	he went out into the sleeping street.
چند صورت پشت باد زن و دستمال پنهان شد	several faces went behind fans and handkerchiefs
نه هیچ نوع جنایتی وجود دارد و نه چیزی که به فضائل انسان لطمه وارد کند.	nothing that could cause the most austere moralist to frown.
اما در مورد میلش به بیرون کردن من از بیمارستان قدیمی	as to his wanting to oust me from the old one
باید تا به صندوق پست برسد ذهنش را برچیز دیگری متمرکز کند.	but she would concentrate her mind upon something else until she had reached the pillar box.
اما در همان حال سعی کردم که آن را مخفی کنم	but I made an endeavour to suppress it, and to be as agreeable
مرا به بالین او وقتی که محتضر بود دعوت کردند که رفته مشغول تلاوت آیات شریفه باشم و وصیت او را بشنوم	I was called to see him on his dying bed that I might administer to him the consolations of religion
دیر نیز که در قرن دهم مفید و در قرن پانزدهم قابل بحث بود	monasteries, which were good in the tenth century,questionable in the fifteenth
که به تیر چراغی بسته و گردن زده شده بود.	who had been tied to a lamp post and beheaded.
من تا الان چنین چیز لیز و لزجی ندیده بود!	I've never seen that slimy thing before!
من به پنهون کاری تو خو نه خودم عادت نداشتم.	I wasn't used to covering things up in my own home.
من میدانم که چه طور خودم را تبدیل به باد کنم.	I already know how to turn myself into the wind.
امیدوار بودم که پدرم به محض اینکه مطلب را با او درمیان بگذارم رضا خواهد داد.	my father would assent to it as soon as I should tell him
چون کشتی ناگزیر شده بود که سه قایق دیگر را که به دست باد رفته بودند	forced to pick up her three far to windward boats
با زحمت بسیار توانست خود را مجاب سازد که خواب نبوده است.	she found it difficult to convince herself that it had really happened.
اما بی نهایت امید دارم که این خواب حداقل تاثیری داشته با شه.	but desperately hoping it will make the blindest bit of difference.
اگر شر این جوان را از سر من کم کنید بسیار خرسند خواهم شد.	I shall be only too glad if you relieve me of that young man. .
روی میز اتاقش یادداشتی پیدا کرد که روی کاغذ ضخیم و بسیار قشنگی نوشته	he found lying on the table in his room a note written on very heavy
در دل ظلمت شب با روشنی تمام و بدون اینکه بر چیز دیگری بنگرند به کار افتادند.	appeared in the midst of the darkness light in themselves, but giving light to nothing.
بین جمعیت همهمه شد و رقص با عجله آغاز شد.	there was a joyous stampede of passengers, and in a mad rush, the dancing began.
که به قول او تنها دوست صادق و وفادارش بود شکایت کرد.	who, he said, was the only person really attached to him.
از سر نومیدی شروع به گذشتن از میان آن کرد	in desperation started to cross it.
از اینکه ریش نداشتم غم بر دلم نشست. در رختخواب از فرط خجالت از فرط خجالت سرخ شدم.	I felt severely the having no occasion for it, and blushed in my bed.
من جرأت نکردم جوابی به اشاره و کنایه بدخواهانه او بدهم.	I durst make no return to this malicious insinuation
مثلا کلاهش که لبه آن بسیار اندک رو به بالا برگشته بود تا گمان نبرید به پایین برگشته است	enough to specify the hat brim which took the slightest upward angle just to escape the suspicion of bending downwards
اما میل دارم اگر وقت داشته باشی کمی دیگر بمانی.	but I should like you to stay a bit if you have time.
گویی با یک ماهی تابه به سرش کوبیده بودند.	he felt as though he'd been hit over the head with a saucepan.
تا از نفوذ شیون زن جوان به بیرون جلوگیری کند.	to deaden the sound of the shrieks.
بر حسب اتفاق و همچنانکه من و آن اسب پس از آن حدس زدیم	came running with all speed
راهش را از وسط هر که جلو آمد باز کرد	tore his way through all opposers
هرگاه کودک از اسرار تولد و گذشته خود اطلاعی به دست آورد باز او را دچار شکنجه و عذاب بیشتری خواهد ساخت.	if he took advantage of his birth and history, he might harm him yet.
مأمور حکومت که قایق کوچک و ضعیف خود را با دیرک نازکی به کشتی عظیم ملت تکیه داده است	administrator in his frail bark, holding on with a boat hook to the ship of the people
کارت مخصوصش و برای برگشتن به قبرستون ورمیدارم و	I lay him under the table, I take his card, so that I can get intothe cemetery again
لکن کالسکه حامل خواربار و بقیه مشروب هنوز نرسیده است.	but the cart with the provisions had not yet arrived.
از همان لحظه اول می دانستم که اینجا باید دنبالشان بگردم.	I've known all along that this is where they must be.
این هم از روی عادتی بود که به صحبت کردن با خود داشت	from the habit of talking to himself
آیا هوای تازه بام اشتهای مرا تیز کرده بود یا نه.	whether the fresh air on the roof had sharpened my stomach.
قسمت اعظم وقت خویش را به دخترش اختصاص داد.	he spent the greater part of his idle time with her.
صدای برخورد دو جسم فلزی به گوش رسید و صدای شیون گوش خراش تخم طلایی قطع شد.	there was a clink of metal on metal and the wailing stopped
البته در لباس شخصیتی دیگر که برای او تماشای همهء آن میسر نبود.	in another character, and not in a character that gives facilities for seeing much of it.
که او خواسته بود آن را برای امرار معاش خود نگاه دارد	which he preferred to retain in land instead of selling it.
بر اثر فتور و ضعف زیاد نتوانست تأثری را که بر او عارض گشت تحمل کند	for, not being strong enough to bear the start it gave him
اما حالا چیز دیگری به شما تکلیف می کینم	but we are contented with another course.
پیکرش برابر با پیکر مردی بود که زورق ما را در دریا دنبال کرده بود.	of the same size with him whom I saw in the sea pursuing our boat.
با تمام نیرو کوشش کردم که از ریزش اشک خود جلوگیری کنم.	I fought to keep back my tears.
به علت اینکه چون درباره تاج و تخت موروثی پدران خود را صاحب شدیم	inasmuch as re established so recently on the throne of our ancestors
که تا وقتی که مرگ سر وقتشان نیامده و از بدبختی خلاصشان نکرده	till death relieved them of their troubles.
تا اینکه پس از ده بیست سی سال رأی خود را صادر کنند.	in ten, twenty, or thirty years, come to an issue.
چون بعداً وقتی که مقاومت مورد انتظار ما از او دیده شد	because ere long, on finding in her that constancy which we expect
رفتن و داد و فریاد کردن در میدان عمومی!	to go and vociferate on the public place!
منتها با این نیت که به او اطمینان دهد که مخارج زندگی او را در طی آن دوره سخت بر عهده خواهد گرفت.	yet not without offering to pay herexpenses as nearly as he could during her very trying period.
کاملاً آشکار بود که حتی از شنیدن صدای بازرس هم بیمناک است.	dreading even to hear the beadle's voice.
از مواضع آتشبار دیده شد که چگونه صفوف پیادگان به جلو حرکت کرد.	from the battery one saw how those ranks of infantry moved forward.
دستش را دراز کرد تا از زیر بالش مرکب و یک لوله کاغذ بردارد.	reached underneath his pillow for his inkbottle and a roll of parchment.
بعد تا مدتی به خطی که نشانی را نوشته بود خیره شد. به خط ریز کج آشنا و عزیز مادرش که روزگاری به او خواندن و نوشتن را آموخته بود.	then he gazed intently at the address, the small, sloping handwriting, so dear and familiar, of the mother who had once taught him to read and write.
دیشب در حالیکه بر تختخوابم دراز کشیده بودم مدتی درباره وضع خودم مطالعه نمودم	I've been lying here all night, passing judgment on myself.
اما در همان لحظه گویی به انتقام گفتن این کلمات بود	but at that instant, as if to punish him for those words
احتمالش زیاد بود که این کلمات را در شماره دیروز پیدا کنیم.	the strong probability was that we should find the words in yesterday's issue
با هر فکر تیره و تاری هم که داشت باز توانست لبخند بزند.	whatever might have been the gloom of his meditations, he could still smile with them.
چون گروهی شاد و خوشبخت به میان دریا رفتیم	off to sea like jolly companions
هم امید تمجید و هم بیم در کشیدن ابروهای کنت را داشت.	he hoped for some compliments, while, at the same time, he feared to have frowns
قرار نبود مثل یه آدم عادی عاشق به شم.	I wasn't going to be able to fall in love like a normal person.
سالیان دراز زندگی خواهم کرد و مادام که عمر باقی است هر دردی را درمانی خواهد بود.	let life only last, and with that all will come right.
فقط اشکال کار در اینجاست که شما قبلاً جسد آن زن ناشناس را به نام مادام دووینتر تشخیص دادید.	that the awkward part of this whole distressing business is the fact that you identified that original body.
من فقط به او گفتم به اسبم دست نزند زیرا ممکن است لگد بی اندازد.	I only told him to leave my horse alone, or else it would kick him.
بی شک در آن دنیا به جایی خواهد رفت و مقامی خواهد داشت که من جرأت ندارم چنین مقامی را برای خود آرزو نمایم.	but probably she will there receive a place I dare not hope for myself.
اما تعجبش از این نبود که این فکر از سرش گذشت.	slipped back into his mind.
من به زحمت توانسته بودم روی تیرک افقی بادبان پیشین قرار بگیرم	I HAD scarce gained a position on the bowsprit
با پنجه پای برهنه و باریک و نرم و چابک خود آهسته روی کف سرد و چرکین اتاق به راه افتاد.	stepped cautiously on the cold and dirty floor with her slim, supple, bare feet.
فقط بلدین آ دمایی مثل منو پی مأموریتای خطرناک بفرست ین.	you are all alike, you fine men of intelligence.
اکنون به یک ضربه منهدم شده و به یک دمی از هم پاشید.	is to be crushed by a single touch, a word, a breath!
کمی بعد از آن که زنگ ساعت شش نواخته شد	shortly after that hour had struck
قول داده بود که اگر بل انش او را ببخشد هر کار که بخواهدبرایش بکند.	he promised, if she would forgive him, to do everything she wanted.
تنها بر گودی دره و اطراف مهمانخانه پردة نازکی از مه سیاه افتاده بود	it was only in the exact bottom of the dell and round the tavern door that a thin veil still hung unbroken
مطمئن نبودم که تا قبل از آمدن دیگران برای کمک وقت کافی برای کشتن او دارم یا نه.	I wasn't sure if I would have time to finish her before the others came to help.
بالای سطح میز غلاف سنگین شمشیرش معلوم شده بود.	a heavy sword hilt appeared at his side above the edge of the table.
اما از بسیاری جهات به قول خودش با عقاید نو نسل جوان موافق است و دشمن هر نوع موهومات است.	but still he shares, as he expressed it, many of the convictions 'of our most rising generation' and he is an opponent of all prejudices.
چنانکه مجروحین محتضر با رفتن خون از زخمشان چنین احساسی دارند.	as wounded men, dying, feel their life ebb from their bleeding wounds.
زیرا کسی که تهیدست است در جهان هیچ چیز خوب ندارد.	for he who is poor has no share of the good things of life.
در نتیجه به سهولت در حافظه حقیرترین مردمان نقش بندد و از محفلی به محفل دیگر منتقل گردد.	so that insignificant society people might carry them from drawing room to drawing room.
لیکن هر قدر آن بیچاره شجاع و پر دل بود به همان اندازه بدبخت بود.	but he had as large a share of misfortune as he had of gallantry and courage.
خود را در میان کلبه کوچکی که از اشیاء انباشته بود یافت.	found herself in the middle of a small room containing baggage.
ناگهان تمام جمعیت متوجه او شد و عده کثیری در پیرامونش ازدحام کردند.	suddenly a crowd turned toward him and pressed round him.
که در آن غذای مختصری با ذوق و سلیقه کامل و به وفور روی میز چیده بودند.	where a collation was prepared with abundance and elegance.
خیال نکنی از دست تو عصبانی یا دلخور هستم.	I'm not angry or mad about anything.
بیشتر گوش فرا دادم. اما فقط صدای بازی فوتبال میامد.	I listened for more, but there was nothing but the game.
تمام این تابستان من راجع به شما خیلی فکر کردم.	I have been thinking about you a great deal this summer
حکم قطعی است و فورا باید اطاعت و اجرا شود.	the order is strict and must be put into execution this instant.
یعنی بر فرض که هیچ چیزش را جز نتایج مالیش در نظر نگیریم معادل یک بلیه بزرگ از قبیل غرق یا شکست در یک نبرد است که یک نیروی دریایی مرکب از شصت کشتی را از میان برده باشد.	that is to say, if only the financial result be taken into consideration, it is equivalent to a disaster, a shipwreck or a lost battle, which should annihilate a fleet of sixty ships of the line.
از طرفی هم سپرده آن به یک کمیته در حکم اقرار آشکار به جعل سازی بود.	on the other hand, to turn it over to a committee would be to admit openly that an act of fabrication was taking place.
لابد خیال میکنن که من خیلی چیزها سرم می شه.	but I guess they think I ought to know all about these things.
ولی در صورتی که از پذیرفتن آن امتناع ورزد	, if he refuse it
من از این زوزه کشیدن بدخواهانه به همه چیز و همه کس بیزارم!	I hate that ill natured yelping at everything and everybody!
چند تن از درباریان امپراطور از میان جمعیت راه گشودند.	several of the emperor's court,making their way through the crowd.
چرا نباید با همان شرایط و مزد به تو کاری ندهد!	that he sees no reason why it shouldn't, on the same terms, give employment to you.
آخر دو سالش بیشتر نبود که طفلک مادرش از دنیا رفت!	he was but two years old when he lost his poor mother!
بند انگشتشان چنان متورم بود که انگشتانشان مثل بادبزن باز شده بود.	their knuckles were swollen so that their fingers spread out like a fan.
که در کنار در کلبه ای تیره و تار با ایوانی چوبی و پر از تنگهای بزرگ و قهوه ای ظروف سفالی بزرگ پر از آب را بلند میکردند.	raising an earthenware vessel of cool water at the door of a dark hut with a wooden porch cumbered with great brown jars.
وای نستا دی گه زود برو که حتماً میخواد خبرو بشنوه	don't you fool around any, because he'll want to know the news.
منظورم کسانیه که پدر و مادرش ون جادوگر نیستن.	you know, non magic parents.
با او بالا و پایین رفت و کوشید تا با ابهت و تکبر سخن بگوید.	began to pace up and down with him, trying to speak significantly.
ه با سر از دور سلامی محترمانه کرده بود.	who nodded to him in greeting.
به آهنگی خشن و درشت که معلوم بود تا چه پایه غلیظ و غضب بر او مستولی شده	whose low voice and clinched hands announced his growing desperation
جایی که یک غاز بادکنکی ترکید محصور شده و به آشپزخانه هوادار هتل تبدیل شده بود.	where an inflatable goose was burst had been enclosed and converted into the airy hotel kitchen.
فقط از اینکه مجبور شده بود در مراسم تشییع جنازه و عزاداری پدر شوهرش شرکت کند ناراضی به نظر میرسید.	except the preparing for the burial, and the presence of the mourners.
اما چنان اوقاتش تلخ بود که نخواست بدان اقرار کند	but he was in such a bad temper that he would not admit it to himself
احتمالش زیاد است که از طرف کسی باشد که اعتقاد دارد این قضیه ماورای طبیعی است.	it might very well come from someone who was convinced that the business is supernatural.
موهایم را با دستانی به سبکی پر حالت دادند.	shaping my hair with a feather light touch.
اگر من به مقام پهلوانی رسیده باشم و بار دیگر به من حمله شود	for, if he were again attacked, and felt himself to be dubbed knight
یک جادوگر قد بلند با مو و ریش بلند خرمایی رنگ	a tall wizard with long, sweeping auburn hair and a beard
بلکه آداب و رسوم مجللّی را رها کرد که در میان دیوارهای آن جا خوش کرده بود	but also the entire civilization that was behind the building of it
عمارت بسیار مقبولی با احتشامی منفرد و دور از سایر عمارات در میان حیاط و باغی.	a fine house standing alone, between a court yard and a garden,
از طریق مجلس به تلاش خود برای تحت کنترل در آوردن خشم موجود ادامه داد.	went on with the business of harnessing anger for parliamentary purposes.
آنان فقط اعدام را به قصابی تبدیل کرده بودند.	the whole ghastly business was to do again.
یا بدون صحبت و اذن مسی و وی لفور	or without speaking to the procureur.
که گرچه به هیبت و صلابت پهلوانان سرگردان قدیم نباشد	if not so valiant as the knights errant of yore
که هرکس یک مرتبه هم دیده باشد همیشه در خاطر دارد.	well remembered by those who have ever been there.
اما ناگهان به محض اینکه برای نخستین بار پس از یک ساعت نگاهی به حضار افکند	but no sooner had his eye swept over his audience, for the first time during the whole of the last hour
قبلا نیز من با این نظر چندان موافق نبودم	I did not fully believe in this view even before
با تمام جزئیات به یاد آورد و باز در نظرش مجسم شد	she had remained at home against his will.
پس او برای این منظور پیش من آمده است!	that was what she came for.
نیمدانست که آیا حمله به او از قصد بوده یا نه.	he doubted if the boy himself had initiated the situation.
به نظر من کار خوبی نیست که آدم این جور چیزها را مسخره کند.	I don't think it's nice to be funny about a matter like that.
سطح چرخان گردان را همچون شیر تازه که خامه بسته باشد گرد تنه مرمرین وال به جا گذاردند.	leaving the circling surface creamed like new milk round the marble trunk of the whale.
تایمز 17ر 3ر 84 سخنرانی ن ک آفریقا گزارش بد تصحیح	times 17. 3. 84 bb speech malreported africa rectify
در مورد این مسئله تحت تأثیر دشمنان من قرار نگیرید.	you will not, so far as you are concerned, be influenced by my opponents in this matter.
نه تنها این نحوه قضاوت نادرست و غیرمنطقی است	that argument seems not merely untrue and irrational
زیرا که از من تواناتر بودند و مرا به مکانی فراخ رهنمود شد.	from them which hated me, for they were too many for me.
آن روزها ساعت به اندازه حالا معمول نبود .	watches were not so common then as now
که اسراری در او هست و دریافت که او میل دارد در ناشناسی بماند	some secret in the case, that the latter had some interest in remaining in theshadow
من خواهش کرد که به محض آزاد شدن از محبس به جستجوی باغ پدر او برآیم	begging me, if I were ransomed, to find out her father's garden at once
در همان لحظه درخت آرام و بی حرکت ماند.	then the tree froze.
به من چه مربوط که پسر شما را به خانه برسانم.	to mind your son is not my business.
اگر باز نزدیکم بیایی به اتاق خودم خواهم رفت.	I'll go upstairs again, if you come near me.
در کوهساری که در آن نزدیکی بود فرو روند.	go into hiding in the sierra that was close by.
بنابراین پسرک مختصری با نوک پایش توپ را غلتانده و در یک سانتیمتری مرز مجاز قرارش داد.	he gave it a sly nudge with his toe, which put it just an inch on the right side.
دلیلی نداشت که با این تشریفات بخواهد او را پروار کند.	they never would have begun to fatten him up in that way.
کاری است که فقط از مردان آزموده و رازدار ساخته است	being the office of persons of discretion
که ظرف دو سه نسل به موفقیت و مکنتی هم رسیده بودند.	which for the last two or three generations had been rising into gentility and property.
بیل در توده برف تازه انباشته شده در دو طرف راه فرو رفته بود.	the marks of the broom were still visible in the snow .
باور بفرمایید که از بابت شخص شما و از بابت آن دکتر ما نت متاسفم.	I assure you, that I am sorry for it on your account, and sorry for it on the poor father's account.
بالاخره توم اشاره کرد و ما زدیم به در.	at last he nudged us, and we slid out
اعضای کمیته مشغول تهیه و تدوین جوابی مناسب بودند آن هم در سالن اصلی	the club was busy considering a proper reply in the principal room
مردی نیرومند و شجاع و نمونه پسران و مردان شایسته و لایق بار آمده باشد.	brave man, this model son and officer that, judging by this letter, he now was.
بدن بی جان کاترین بر روی بستر مرگ از نور ملایم و مطبوعی پوشیده شده بود.	the blinds of the silent room
از ای نرو یکسره جانب حزم و احتیاط را رها کرده و از پرورش نژاد خر غافل بودند	had, very imprudently, neglected to cultivate the breed of asses
من تنها کسی هستم که اگر این کار را بکند مقصر است	I'm the only one who seems to be doing anything about it
فورا اسلحه کمری خود را به سوی او گرفتم.	I covered him with a pistol and then spoke.
ولی یکی از دخترها باعث شد که او تغییر عقیده بدهد.	but one of the three girls surprised him with the contradictory truth.
من از اول شب از سر ساعت 9 منتظرت خواهم بود.	I shall expect you at dusk, at nine o'clock precisely
حسابی غافلگیر شده بودم. زدم زیر خنده و فوری ارام شدم.	I'm so shocked, I give a half giggle, then turn it into a cough.
همین که یکی از یاهوهای نر به او نزدیک شد	when any of the males advanced
چون وقتی بیست ساله بود حتما به همان قیافه بوده	for she cannot have looked different when she was twenty
گله اسبان وحشت زده و سراسیمه گشته از طوفان	agitated and frightened by the thunder
او مجبور شد چرخی بزند تا از آن ضربه در امان بماند.	was forced to roll right over in midair to avoid it.
قول داده بود که دیگر هرگز او را بر سر دوراهی عشق و شرف معلق نگه ندارد.	never again would she try to make him throw away that foolish honor he valued more than love.
بدون شک بعد از ازدواج عشق به آن حد خواهد بود که دقیقاً پیوند مورد نظر تو را تأمین کند.	undoubtedly enough of love would follow upon marriage to render the union right even in your eyes.
سرانجام همه حاضر بشر کت در این سرگرمی شدند.	the thing was original, at least, and might turn out to be amusing.
همه شاگردان او در اطراف آن صف کشیده بودند.	whereof all his pupils stood in ranks.
که شاید کمترین همدلی یا تفاهمی با او نداشته باشند.	which might inno wise understand or care.
تا ایشان را از پرداخت مجموع بدهی هر دو بار معاف کند	to let one or other of them off without paying
ترتیبی داده بود که خود را در نقش مامورمخفی معشوق تصور نماید.	she had already half managed to translate herself into the role of a girl agent on her lover's behalf.
چه کسی قصد اذیت کردن مردی مثل مرا دارد.	who'd bother about a chap like me?
سپس از در بیرون رفت و به سوی شب مهتابی شتافت.	then slipped through the door into the moonlit night.
انگار هیچ جا کسی نیست کار او را بکند.	I suppose there is not a man in such practice anywhere.
ولی من که اکنون مسافت مورد نظرم را در سر وقتی که در نظر داشتم پیموده بودم به هیچ چیز جز یک پتو که بتوانم روی آن دراز بکشم توجه نداشتم.	but I had no care of that, having reached my night's goal, and having so powdery a blanket to fall on.
در اینجا ارزش انسان کمتر از یک دلار است.	there was no place in it where a man counted for anything against a dollar.
در کمتر از یک دقیقه در پس ستیغ تپه ناپدید گشت.	disappeared over the edge of the hill in half a minute.
که با نهایت میل حاضر بودم برای تسکین غم او در مقدراتش سهیم شوم.	that I believe I would have shared his fate if it could have comforted him.
اما در مجموع دختران سالم و در مقابل شداید زندگی مقاوم بودند.	most of them showed an unbreakable resistance as they faced the most troublesome difficulties
آنگاه با زحمت زیاد و پس از طی سه ساعت راه توانستیم بدان جا برسیم.	with great fatigue to our beasts, we managed the distance in some three hours.
هر چند از پیش میدانست که در هیچ اوضاع و احوالی نبرد نخواهد کرد.	though he was fully aware beforehand that he would never under any circumstances fight one.
مستحفظین او در پی او به محوطه داخل شدند	the escort rode in close upon his horse's flanks
او را بیشتر متغیر ساخت که برخاسته و به شدت تمام حمله کرد.	, and he rushed on his adversary
درخت نارونی که پای باغ بود مثل ترب از ریشه درآمده است.	an elm tree at the foot of the orchard had been plucked up like a radish.
به نظر من این منتهای موهوم پرستی و ستمگری است.	I think that so very absurd and tyrannical.
پیش روی او ظلمتی مه آلوده گسترده شده بود.	in front of him was misty darkness.
از این طریق خودم را به دست خودم نابود کنم.	letting myself die.
وقتی از یکی از درهای کناری وارد قلعه شدند	as they entered the building through a side door.
به طوری که ای و قادر نبود دهانش را بدون احساس درد باز و بسته کند.	so that she was unable to open or close her mouth without pain.
زندانی آن را به نیت پنهان داشتن آن از دیدگان زندانبان پنهان کرده است.	hidden it away to keep it from the gaoler.
اشیاء فلزی هم اکسی ده نشده و کماکان براق باقی مانده بود	nor had oxidation diminished the shine of the metals
که هنر شما این نیست که بتوانید راجع به خودتان خوب صحبت کنید	that it is not your forte to tell of yourself
او کتاب را از دست مات یلدا قاپ زد و گفت	he said, snatching the book from her hands.
تصویر آن عربده جوی پیر ظاهراً مجذوبش کرده بود	the picture of the old roysterer seemed to have a fascination for him
به کیتی بیشتر اعتماد داشت قول مواظبت از آنان داده بودند.	she reckoned more upon her had promised to look after them.
برای مدتی طولانی به دقت به صورتش نگاه کردم	 I studied his face for a long moment
بهت بگویم پس ره چه کار عاقلانه ای کرد که با دختر عمه اش عروسی نکرد.	I tell you that boy did well not to marry his cousin.
نخ ضخیم روی بسته را کشیدم و کاغذ ضخیم قهوه ای رنگ روی بسته را پاره کردم.	I snipped the string excitedly, and tore off the dark brown paper.
گویی فرمانی را به او صادر کرد که فوراً پتویش را به روی دوش انداخت	which was like a command from his organism to throw his blanket over his shoulders
به آسانی حدس زدند که صاحب آن نباید از آن جا دور باشد.	easily conjectured that the owner could not be far off.
از شما ممنونم که حقیقت را به من گفتید.	I thank you for telling me the truth.
اگر تو با پایمال کردن حق من فضیلت خود را از دست بدهی	if thou art wanting in that, refusing me what in justice thou owest me
او را به خود آورد و خود را به کنار خیابان انداخت	drove him back upon the pavement.
با چنان لوندی ای که حتی در زمان محصل بودنش هم آن طور ندیده بودش.	with a coquettishness that he had not known when she was a schoolgirl.
البته این ادعا غلط بود زیرا پیرزن از دو سال پیش کسالت شدید داشت	which was a lie, because she had been ill for at least two years
من می دونم که اون از تشک بادی متنفره	I know she hates that air mattress.
صلحی که من در آن موقع منعقد خواهم ساخت شایسته ملت من و شایسته من و شما خواهد بود ناپلئون!	the peace I shall conclude will be worthy of my people, of you, and of myself.
واسه همین فکر کنم نتونست مثل تو بهبود پیدا کنه	I guess she couldn't heal like you did.
به این ترتیب تنبیه تصوری با رضایت تام تمام شد.	so the imaginary flogging was finished to his satisfaction.
از بامداد چند مرتبه کوشید تا به کاری اشتغال ورزد	several times that morning had tried to set to work
سنگ را بیرون آورد و دفتر را از جایش بیرون کشید	pulled up the stone and ripped the LEDGER from its place
در گفتار خود چندان عطوفت و تأثر نشان داد که کسانی که به او گوش فرا داده بودند به رقت آمدند و در غم و اندوه او شریک شدند.	that all who heard him shared in it, showing their sympathy with his sorrow.
اما آیا توی ما کسی هست که بتواند راهی را که باید کشتی برود پیدا بکند!	but who's to set one?
گوریو پس از مکث مختصری سرش را تکان داد	he said, raising his head after a pause.
که در دوره سکوت خانواده گریفیث و در طول مدتی	who, during all this silence and the prosecution of a task in
آن آسایش ماندگار این است که همه چیز از پیش مقدر شده است.	that unfailing comfort is, it's all predestinated.
جروبحثهایی با مفاهیمی که برای هیچ کس آشنا نبود	full of a lot of stuff that nobody else understood
برای پاک کردن این راه ناچار باید آن را با آب زیاد شست	frequently cleanses the yard with copious supplies of water, under pain of pestilence.
زیرا برای دیدار مردی که در شرف مرگ است دعوت شده ام.	but I have been sent for to visit a dying man.
در دل به خود گفتم که رفتار او زشت و زننده است.	I reminded myself that his behaviour was abominable.
من توانستم جامه خود را با آب آن جوی هر چه بهتر بشویم	I washed myself as clean as I could
مات و متحیر مانده بود که چطور روزاموند بی توجه به خواست او بر اسب ناآشنایی سوار شده وزندگی خود رابه خطر انداخته بود.	he was utterly confounded that she had risked herself on a strange horse without referring the matter to his wish.
ثابت کرد که تا به چه حد از فکر برآوردن تمنیات عاشقان خویش به دور است.	also how far she is from yielding to the wishes of any of her lovers
تا آنجا که به سبب این فضولی کم مانده بود که یک دو بار سرم را بشکنند.	so that I had like to have gotten one or two broken heads for my impertinence.
آهی عمیق کشید و او را بوسید و به گریه افتاد.	sighed, kissed her, and immediately began to cry.
در آن مدت راجع به مدعای خود دایر بر اینکه تنها نیاز مبرم عالم به وجود پهلوانان سرگردان است	during this time he held lively discussions with his two gossips, the curate and the barber, on the point he maintained
شک دارم که حرفم روشن و نزدیک به آنچه باشد که در نظر دارم.	I dont know if thats very clear, or even if it gets close to saying what I mean.
زیرا به هیچ طریقی نتوانسته بود اتاقش را پس بگیرد.	he still didn't have his room back.
یک باشگاه محلی که احتمالاً او در امور پزشکی به اعضایش مساعدت کرده	the local hunt to whose members he has possibly given some surgical assistance
لکن بی درنگ بار دیگر علم طغیان برافراشته و مرا متهم بدان کرده است که قصد دارم خود را بالاتر از او قرار دهم	but she would soon fall, once more, into her old tormenting delusions, and would go so far as to reproach me for placing myself on a pedestal above her
با این همه دیگر هنگام دست بردن به چنین کارهای خطرناک اعتماد به قدرت و استحکام آن نداشتم.	however, I would not trust to the strength of it any more, in such dangerous enterprises.
اما تو را مغرور و متهور و خون آشام دیدم.	but I found you proud and blood thirsty
آنگاه پس از طی خیابان کوچک بس وی کافه محقری که روشنایی آن نظر او را جلب کرده بود روانه شد.	plodding along the little street, crept into a small public house, whose scanty light had guided them to the spot.
که من هوس شما را امضا و قبول نموده و بروم	I shall yield to all your caprices
بنابراین غذای نیم پخته را روی توده خاموش شده آتش رها کرده و خیزخیزک خودش را تا لنگرگاه رسانده بود	so she had left the food she had been preparing half cooked on the extinct embers and had crawled out as far as the harbour
ما را فروخت به تاجری که شغل بنده خری داشت	so we were sold to some slave merchants
بهتر است من تأسف خود را از این بابت ابراز دارم.	I must beware how I cause her to regret her choice.
از این رو در جستجوی پاسخ دیگری برآمد که زننده و به مورد باشد.	so he thought of another rejoinder, disagreeable enough to be always apropos.
از ای نرو با کمال فروتنی و شکسته نفسی از وی سپاسگزاری کردم	therefore, after presenting him with my humble thanks
او حکایت کرد که دید ناقلا از جیب ناشناس دستمالی بیرون آورد	indeed take a handkerchief therefrom
خانم ارغوانی پوش را به یاد آوردم که کنار در اتاق غذاخوری با یک بشقاب پر از جوجه ایستاده بود.	I remembered the salmon lady standing by the drawing room door with her plate of chicken
اگر چه برای پیتی چندان خوشایند نبود که دست پیش برادرش دراز کند ولی ناچار بود.	though it was very humiliating to take money from him, she had to do it.
چون دریافت که هرچه بگوید در نظر ستایشگر شورت رنگ دیگری خواهد داشت.	since he realized that with such an attitude dominating the other, whatever he might say would be colored in part at least by his admirer's awe and respect.
اونقدر صدا تون کردم تا از اون دنیا برگشتین	I called you so much thatyou came back.
لیکن دریغا که امروز پیروزی با گناهکاری و تنبلی و بیک ارگی و شکم پرستی و تن پروری است.	but now, for the sins of the people, sloth and indolence, gluttony and luxury are triumphant.
فقط خیلی خسته است و او گفت که خیال دارد تمام روز را در اتاق خودش بگذراند	only very tired, and she says she is going to stay quietly in her room all day
ولی این برافروختن شمع برای روشن کردن اطاق بود و چندان جنبهٔ تقدس نداشت.	not so much for devotional purposes as to light the room.
گویی کاغذ دفترچه آن را به درون خود فرو برده بود.	as though it was being sucked into the page
در مدت روز هم که در کارخانه مشغول بودم.	I was out at the warehouse all day
هیچ کس دوست نداشت در آن موقع سؤالی در آن باره بکند.	but no one liked to ask just then
بدون داشتن هیچ هدف خاصی بجز قصد مبهم آشنایی با فرهنگ.	without any special object, save the vague purpose of what he calls culture
رو به دیوار کردو سرش را میان بازوی خود پنهان داشت.	he turned to the wall and hid his face in his arms.
خوابم مثل هر چیز دی گه گاهی آدم و خیلی خسته می کنه	a dream does tire a body like everything sometimes.
کلماتی که شب همه شب بار خاطر کارتن بود را با اشعهء خویش خانه نشین سینهء او ساخت	seemed to strike those words, that burden of the night, straight and warm to his heart in its long bright rays.
به چشم و موی و گوش و منخرین و بیشتر از همه به ریه مردان	settling in eyes, ears, hair, and nostrils, and worst of all in the lungs of the men
الان حالم عادی نیست و به تو نیاز دارم.	I'm in an extraordinary condition about you.
من از او خواهش کردم که به من نیز اجازت دهد تا همراه آنان شوم	I desired his leave to go with them
مثل بعضی از زنهای به ظاهر ضعیف و بی بنیه که آدم هر از گاه در کمال تعجب در گوشه و کنار میبیند در مقابل خستگی و از پا افتادگی بسیار مقاوم بود	she had that power of resistance to fatigue which one discovers here and there in some quite frail looking women with surprise
8 در بزنامه زندگی اقتصادی خود اندیشه و تدبیری نیکو دارد	8. he is anxious to purify and dear the source of his earnings
در حالی که از جیب خود جزوه کشی بیرون آورد	taking out some papers from his pocket book
این زن زرنگ و باهوش بود و طبیعتی بهتر از آن دیگری داشت.	she was cleverer, and she had a much nicer nature.
همة حیوانات طبقة پایین برای از بر کردن کلمات قصار جدید دست به کار شدند.	all the humbler animals set to work to learn the new maxim by heart.
چطور ممکن است از این واقعیت بی خبر باشم	how can I fail to know this fact
اما همچنانکه فقرش شریف بود اتاق محقرش نظیف بود.	but as his poverty was noble, his garret was neat.
پیشانیش را به پیشانی من فشرد و چراغ را فوت کرد	pressed his forehead against mine, and blowing out the light
پس از این که نگاه برآشفته اش را به مرد پیاده دوخت فقط سری به نشان نفی تکان داد و در دل آن غوغا و هیاهو به راهش ادامه داد.	after looking down critically at the ragged mozo, shook his head without a word in the uproar going on around.
ولی شاید تو بتونی تا موقعی که تغییر می کنه حواست بهش با شه .	but maybe you could keep an eye on him until he changes?
به خصوص طفلی که بسته او را در دست گرفته بود اظهار محبت بیشتری کرد.	especially the one in which he held his little bundle.
به شرط اینکه همین باشد و بیش از آنچه گفتی نباشد.	since they are no more than thou hast said.
من چند بار به همراه پا پا تا نزدیکی آنجا رفته ام.	I've gone very near with papa.
خواسته حیات در بهترین حالت کاری بود پردردسر و غیرطبیعی که او ترجیح	arranged life processes, well, that was a ticklish and unnatural business at best which
اما وقتی برگشتیم دیدیم شیش ماه از زمان دنیا گذشته.	only to return to find six months have passed here.
لیکن دعاهایش عاری از هر مفهوم و احساس بود.	but there was neither heart nor meaning in her prayers.
با آن بی دست و پایی و آن فقرش.	what with being so clumsy and so poor.
اقای وی زلی لنگه چکمه را به دست مردی داد که دامن اسکاتلندی پوشیده بود	picking up the boot and handing it to the kilted wizard
بچه هم به راستی خیلی قشنگ و ملوس است.	it's such a beauty!
اما او با خونسردی تمام آخرین تصمیم وحشتناکش را گرفت	but she decided with frightful coldness
جواب داد که ممکن نیست این پول را قبول کند.	replied that she couldn't think of it.
اطمینان داد که دخترش بسیار مهربان و خوش اخلاق است.	assuring them of her daughter's being a very well disposed, good humoured girl,
ابی گیل او را تحسین کرد و به پدر و مادرش گفت که به ازدواج با اوراضی است.	she had blessed him for it and told her mother and father she intended to go ahead.
که فاش شدن سفرش به بیگ بی ترن همراه با آن دختر از یک سو معلوم خواهد ساخت که او مقررات کارخانه را زیر پا گذاشته است	which his presence here on the lake with this girl would show to have been broken
در طول مدت روز مثل گذشته همچنان از سر راه شما کنار خواهم بود.	I shall keep out of your way all day
بتوانم در اندک مدت به زور بازوی توانای خود سلطان کشوری شوم	to see myself king of some kingdom where
اگه شنیدی که کسی از دزدیدن غلام سیاه حرفی زد تو هیچی نمی دونی و منم هیچی نمی دونم.	if you hear anything said about a runaway nigger, don't forget to remember that YOU don't know nothing about him, and I don't know nothing about him.
مشروط بر اینکه من تنها از طریق کسب و کار خود به او خدمت کنم.	on condition that I would serve him in the way of my calling.
البته هیچ وقت نگفتم هیچ کدامشان را قبول دارم.	I never said I believed either one or the other.
ضمناً در طول آن سفر طولانی در اثر زاد و ولد بر تعدادشان نیز افزوده شده	but their number had grown during the crossing
منتظر بودم خودتان به من بگوئید که شما هستید.	I was waiting for you to tell me that it was you.
سیلی او با تمام قوت به صورتش فرود آمد.	she slapped him across the face with all the strength she had.
به درون شیر خوری سیمین بسیار زیبائی ریخت و آن را در برابر کلاید روی میز گذاشت.	then carried it to the table and put it down before him.
به تدریج از آن حدود نیز تجاوز کرده و آوازه در چند ایالت مجاور دیگر نیز انداخته بود.	it had eventually passed the confines of a small district and had been spread abroad through two or three neighboring departments.
به مغزم خطور کرد که همین دقیقه به سالن پایین بروم و با او خداحافظی کنم.	I should say goodbye to him in the lounge, perhaps, before we left.
که اگر خود او دست در کار آن خطا باشد	that if he be already involved in the matter
به صدای بلند پرسید که آن که از عقل و جسم شفای کامل یافته و آهنگ رفتن دارد کیست.	he asked in a loud voice who it was that was going away cured and in his senses.
کینه و تنفر من از این زن پست و منفور است.	it is hatred of that vile woman!
سکوت عمیق آن شب را برای شما شرح بدهم.	I cannot describe to you the intense silence of the night.
حاضرم جان خود را در راه سعادت هر دو فدا کنم.	I would give my life for the happiness of them both.
که بی آنکه با خود به حساب پردازد یا خطری را که در پیش دارد به نظر آید	without stopping to consider, without pausing to reflect upon the danger to which he is exposing himself
اسکار لت احساس کرد که دوباره در سخن گفتن بی پروایی کرده است .	she knew she had said the wrong thing.
بعد کودک را در حوله پیچید و خشک کرد	wrapped in towels, dried
ولی از ترس اینکه مبادا چیزی بگوید که خدعه و نیرنگش را فاش سازد بیش از این دنباله گفتگو را نگرفت.	but he did not like to reply lest he should say something that might disclose his trickery.
به دستور ارباب بسیار مهربان شما خدمت کوچکی را در حق شما انجام دادم.	I executed, at the request of your good mistress, a small commission in your favour
هرگز قادر نخواهد بود به طور عادی در جهان بیرون زندگی کند.	he would never again be able to participate in the outside world.
ولی وقتی امروز اومدیم بیرون هنوز دوتاکاسه مواد باقی مو نده بود.	I saw two bowls when we went out this morning, man.
من یک کو پک پول از شما قبول نخواهم کرد.	I will never accept one single copeck from you
که یا جان بر سر این کار خواهد گذاشت یا آزادی ما را به ما باز خواهد داد.	for he would lose his life or restore us to liberty.
ورانسکی خم شده بود و دست او را میبوسید	he bent down over her hand and began kissing it,
با این نظریه که منشهای کارگر کشاورزی را باید چون هوا و خاک عاملی مؤثر تلقی کرد	the plan of which turned on taking into account the character of the laborer on the land as one of the unalterable data of the question, like the climate and the soil,
با پیچ و تاب عجیبی اعتراف کرد که چند ساعت پیش گذاشته است	he began, with wonderful contortions, to make us a confession.
نه وقتی که یه لشکر از شیاطین بین ما و او نا قرار گرفته.	not when an army of demons separates us from them.
از کنار او گذشت و رفته رفته چون رد پای آرام آن از چهرهء آب محو گردید.	floated by him, and died away.
من تمام زمستان را مجبور بودم صبح خیلی زود از خانه بیرون بروم و تمام روزم را صرف کار برای دیگران بکنم.	I've been routed up early all winter and had to spend my days working for other people
برای این که وقتی آدم نامزد شد باید این جور بک نه.	because that's the way you do when you're engaged.
مشارالیه را مجبور نمود که او نیز داخل آنجا شود.	ordered him to do the same.
که مخصوصی به طور عجیبی نیکوکار و شریف هستند	who is horribly beneficent and extraordinarily honourable.
البته حالا دیگر شاید اجل برایش فرصتی باقی نگذاشته باشد	that's not often, for she is dying very hard
صدها حدس و گمان وحشی به مغزش هجوم آورده و مصیبت قریب الوقوعی او را در خود غرق کرده بود.	but a hundred wild surmises came to him, a sense of impending calamity overwhelmed him.
شما هم باید هر چه زودتر از هر جا اوم دین برگردین!	yah muh goa back whear yah coom frough.
سپس علف آبشش زا را از جیبش بیرون آورد و در دهانش چپاند.	pulled the handful of gillyweed out of his pocket, stuffed it into his mouth
در ازای هر صد سرباز بیگانه یک سرباز خودی.	there was only one soldier for every hundred yards of it.
اما نگاهی به چهره آقایش به او فهماند که بهتر است خاموش بماند.	but glancing at his master, he saw from his face that the only thing to do was to be silent
بعد دید آن شخصی که در کوچه منتظر بود	, saw the man who appeared to be waiting
ابتدا فکر کرد همین او را بیدار کرده است.	he thought that was what had woken him.
قبل از آنکه این سخنان را با شما در میان نهم خیلی انتظار شما را کشیدم.	I have long waited to tell you all this
پس از طی آن مسافت طولانی کرخت شده بودند.	we were numb from our long drive.
هنگامی که خواست پیاده شود پاهایش را پیش گذاشت	he alighted with his hind feet forward
که چگونه و از کدام جهت گرگ ظاهر خواهد شد و چگونه او را دنبال خواهد کرد	as to where and from what side the beast would come and how he would set upon it.
این مرد دست کم استحقاق آن را داشت که بر اساس قوانین مملکتش بمیرد.	this man had at least deserved death by the laws of his country.
بعد با تأکید از فرزندان خود خواست فکر و ذکرشان آسایش و مشغولیت دوشیزه مو رلند باشد.	anxiously recommending the study of her comfort and amusement to his children as their chief object in his absence.
مرد سالخورده که پشتش را به چند بالش تکیه داده و دراز کشیده بود	propped up comfortably on a bed rest
آنان که بر عرشه بودند به طرف دنباله کشتی دویدند	those on deck rushed towards the bows
منظورم آشنایی بیشتر دوشیزه فیرفاکس با اخلاق و رفتار آن خانواده است.	I mean, as to the character and manners of the family.
من با اولین پرواز در آن جا خواهم بود.	I'll be on the first plane.
وقتی پایت را از آستانه در به داخل اطاق گذاشتی این را از صدای پایت فهمیدم.	I heard it in your step as you crossed the threshold.
سیگار برگی از قوطی درآوری و یا حتی سیگاری معمولی	to be taking from its case a cigarette or cigar even
اما من این صفت و خاصیت را ناشی از ضعف و سستی بسیار عادی طبع بشری میدانم	but I rather take this quality to spring from a very common infirmity of human nature
تا برای دیدار با آن دختر از هر نظر آماده باشد.	he had to prepare himself for his meeting with the girl,
امیدوارم که خواننده بزرگوار از تفصیل این مطلب و نظائر آن مرا معذور دارد.	I hope the gentle reader will excuse me for dwelling on these and the like particulars
آن هم نه بارشی ملایم بلکه سیلابی مدام و غران که سر ایستادن نداشت.	not a gentle downpour but a steady, roaring deluge which went on and on.
شش روز نشستن در قطارهای پرازدحام و هیاهوی جمعیت و خفه شدن از دود سیگار و دوده.	five days sitting up in crowded trains, choked by cigarette smoke and soot.
من دوست دارم خانوادم ارزش حفاظت رو داشته با شن.	I'd like very much for our family to be worth protecting.
آن جا تنها هستم و مزاحم هیچ کس نخواهم بود.	there's a wilderness, and there I shall be no trouble to any one
زیرا خودش اصرار ورزیده بود برای خداحافظی به بالینش بشتابم.	he insisted upon saying good by to me.
این بار از سمت غرب خانه شروع به حفاری کرد.	continued on the side to the west.
این زن صبر خواهد کرد تا بتواند این اتهام را نیز به اتهامات دیگر خود اضافه کند و نتیجهء کار را مقن تر کند.	this woman would wait to add that strength to her case, and make herself doubly sure.
چهار دست و پا روی زمین افتاد و نفسش بند آمد	bringing him gasping to all fours
در حالی که خود در برابر پکوئود تازیانه و مهمیزی بیش نبودند.	mere riding whips and rowels to her, that they were.
قوطی مرکب به طور کامل روی آن ریخته بود	the ink bottle had smashed all over it.
البته منظورم چیزی شبیه به یک دلقک نمایش نیست.	I don't mean that I'm like something in a sideshow at a fair.
لیکن من چه بسا که درصدد تحقیق برآمده و با گروه کثیری از مردم	I have often, with divers people and on divers occasions
او هفت تا از هشت پرونده را مطالعه کرده بود.	he had been through seven of the eight files.
من اجازه دارم که هر وقت بخواهم خارج شوم.	I can go out when I like
قبل از ساعت سه نیز خانه مرا ترک کردید.	you rose and went out at about three.
درست مانند کسی که بترسد مردم در دلیری او تردید کنند.	like a person who was jealous lest his courage should be called in question.
من به چشم خود یکی از ایشان را دیدم که به اتهام دو فقره قتل عمد توقیف شده بود	I myself have known an actor taken up for two murders
متعلق به کسی بود که آن را مفت به دست آورده بود و حتی به آن نیاز نداشت.	someone who took it lightly and didn't need it.
کشیش چند قدم جلوتر از آن دو برداشت و پشت میز خطابه ایستاد.	the priest walked a few paces in front of them and stopped at the lectern.
به نظرمی رسید که آماده است همان جا مقام کند.	it looked as though he intended to stay there.
من تو این کار یه شیطون به تمام معنا هستم!	I'm a perfect devil at that
یکی ظاهر و سخت دیگری در باطن و مخفی.	the one violently, the other heavily.
با آن جنسیت لطیف خود و با آن ویل ون سل گناهکارش.	with her tender sex and her sinner' s cello
دایه ناگزیر شد که آخرین تیر ترکش را درآورد یعنی پستان خود را برای مکیدن در دهانش بگذارد.	so that she was forced to apply the last remedy by giving it suck.
یک دیوار گرد از ستایندگان روغن زده به دور دخترها تشکیل داده بودند	a circling wall of oiled and simpering admirers
او است که هر وقت لازم شود خواهد گفت که شلیک کنیم.	he's the one who will give the word when we are to fire.
من باید این نامه را به پست صبح برسانم	I must get this off by the early mail
از روی فرش گذشت و با ظرافت به زانوی کشیش پرید	crossed the carpet and leaped delicately onto the priests knees
با همان تنگ مادیان دوباره آنقدر به من تازیانه زد	gave me a fresh flogging
آقای جان نای تلی آن مدارایذ توأم با احترام را در قبال پدر اِما نداشت.	the want of respectful forbearance towards her father.
به راش جواب دادن به او دجار تردید شده است.	wondering whether to answer or not
لذا به سرعت برق خود را به پای او انداخت و زانوانش را در بغل فشرد	the instant the idea struck her, with wonderful quickness she clasped him round the knees
در واقع تو فقط برای دو روز هشیار نبودی.	actuallyyou were only unaware for just over two days.
اما کوچه که مملو از گلوله بود خطرناک بود.	but the street, which it filled, was terrible.
مرکبی که به عقیده تو مادیان راهوار بود و به نظر من جز ماده خر نیامد	as thou sayest it was, though to me it appeared a she ass
به زحمت توانسته بودند اضطرابی در نگاهش ایجاد کنند و این چهره شاهانه را که سرشار از اطمینان بود هیچ تیره نکرده بودند.	had hardly troubled his gaze andhad not overshadowed that face of imperial certainty.
افتخاری نصیب من شد که جادوگرهای دی گه آرزو شو دارن.	I will be honored by him beyond the dreams of wizards.
خودم را برای هر چیزی آماده کرده بودم. برای بویی غیر قابل اجتناب مانند بوی انسان درون جنگل.	I'd been braced for anythingfor a scent as impossibly insistent as the human smell in the woods.
مثل این که خیلی وقته صدای او نای دی گه نم یاد.	but it seems ever so long since I heard any of the others.
وسایل پذیرایی از آنا را فراهم کرده و با نگرانی منتظر ورود او بود.	she had made everything ready for her arrival, and was expecting her sister in law with emotion.
نخست یکی از خدمتکاران را به سراغ وکیل وی فرستادم	I despatched a man to fetch the attorney
یک بار دیگر به زور در دلیجان برایم جا باز کردند.	once more I was stowed away in the coach
وی همین که پالان را دید آن را باز شناخت	the moment he saw it he knew it
نتوانست و فریادی کشیده بر زمین افتاد به حالت بسیار بد	but at each effort he fell back moaning and turning pale
بدین ترتیب هیچ کسی مایل نیست که افرادی را به آنجا اعزام نماید که کاری را بچرخانند.	so no one wants to send staff men down there to run anything.
اگر به عمر خویش کسی را تحقیر کرده باشم	if ever I despised a man
ولی منصرف شدم و گفتم که او بهتر است نزد من باشد تا از من محافظت و نگهداری کند.	but, on second thoughts, I shall keep him to take care of me.
منتظر بود و عرق زی ادب به رخسار داشت	was standing at the foot of the steps, his face bathed in perspiration.
ولی با این وصف چند قدمی دیگر جلو رفتیم.	yet for many paces more we crept in under their horns.
اما ناگهان تلاطمی در سطح دریاچه به وجود آمد.	except that the surface was suddenly not smooth at all.
آنگاه با یک نوع محبت چنانچه گفتی میل دارد ناراحتی ایوان را مرتفع کند چنین افزود	he added patronizingly, as though encouraging a nervous visitor.
بعد برای اینکه شما درست همان کسی هستید که در مخیلهٔ خود مجسم ساخته بودم.	I seemed to imagine you exactly as you are
بلکه به عنوان منبع مجازی نکاتی را که من از آن بی خبرم باطل اعم برساند.	I simply went to him for information concerning the facts, of which I was ignorant to a great extent, and which he was competent to give.
که او را با ما همسنگ نگرفتید ما خود پیش از همه اقرار و اعتراف داریم که ما با ایشان برابری نداریم.	he is worth us all, and we avow it to you!
بیشتر دلواپس این بود که مبادا اِما مریض بشود.	more anxious that she should escape the infection
من که درست در همان لحظه بالا رفتن از چپر دچار چنین احساسی شدم.	I felt all mine suddenly going away, as I was climbing over it.
همچنین وقتی که جانی از دریچه بام خانه گذشت و خود را به آنجا رسانید	thus, when the murderer emerged at last on the house top by the door in the roof
سر نیز بایستی در آن واقعه مجبور به احساس درد اعضا باشد.	it should be obliged to feel their sufferings.
نگاهی به اطراف کردم و بعد شتابان به طرف کتابخانه رفتم.	I went towards the library
دوباره همهمه دانش آموزان فضای سرسرا را پر کرد.	gradually, a babble of talk broke out again.
تنها چشمانش را با حالتی پرسشگرانه به او دوخت.	only raising her eyes to him inquiringly.
گرچه هرکس که مدت درازی با او صحبت کرده بود	although noone who talked with him sufficiently or
تاریک بگذریم و وارد آن نشویم و کسانی را که همراه ما هستند	without introducing the minds which accompany us
آن شب به هیچ وجه به او خوش نگذشته بود.	the evening hadn't been much fun.
تا آزادانه و خودخواسته به راهنمایی شخصی تن در دهد که	give her the freedom of voluntary submission to a guide who
برخی محرکات احتیاط آمیز و بخر دانه بود که هدفشان احیاء روحیه جاشو ان در امری به شگفتی قطب نماهای واژگون شده بود.	were certain prudential motives, whose object might have been to revive the spirits of his crew by a stroke of his subtile skill, in a matter so wondrous as that of the inverted compasses.
به طور باورنکردنی چنین فکری هرگز به ذهنم خطور نکرد.	if you'll believe me, the idea never occurred to me.
نیک آگاه بود پدر و برادرانش در خانه نیستند .	her father and brothers being from home, as he well knew.
ولی این کار درست در جهت مخالف آرزوهای منست و خیلی سخت است.	but it's working against the grain, you see, and comes hard.
به شرط اینکه درد جانگزایی که از سقوط بر من عارض شده است بگذارد و باور کنید که این درد مرا به حال نزاری انداخته است.	if, indeed, the shock of my fall will allow me, for it has left me in a sorry plight enough.
آنگاه استخوان بندی ترا برای حیرت آیندگان بر جای نهند.	leaving the skeleton as a monument of admiration to posterity.
حال دوست عزیزم یک حرکتی هم بکن تا یک گلوله در مغز سرت جای دهم	believe soft spoken gentlemen again
فکر کردم خوب است راه بیفتم به اینجا بیایم و پیش از این که کاملاً از دسترس من دور بشوی یک بار دیگر تو را ببینم.	I thought I'd just set off, and get a look at you before you were quite out of my reach.
به اصرار من مرا در بلندترین اطاقی که در عقب خانه بود جای داد.	at my earnest request he led me up to the highest room backwards.
چنانکه گویی شمردن بیش از پنجاه را بلد نیست	as though he could not count more than fifty
نگاه و بیهودگی و بیاثری گفته ی خود را احساس میکرد.	he felt all the uselessness and idleness of his words.
سخن باید تا تیر اصوات را در روح کسان فرو کند.	the bow of words is necessary to send the arrow of sound into the hearts of all men.
با اشتیاق در آغوش کشیدن او به استقبال شتافتند.	they ran to embrace him.
با این همه اجازه داشتم در باغی بزرگ تفرج کنم	however, I had the liberty of a large garden
این خود یکی از عللی بود که مرا به خریدن این ویلا برانگیخت.	that is really why I bought this house.
عمل غصب وال گروئنلندی از هر حیث کامل بوده است.	this usurpation has been every way complete.
انگار کاملاً با آن موافق بودند و هیچ تردیدی نداشتند.	as though they agreed with it entirely and had no doubts at all.
هویت مرا جویا شد و من خود را به او معرفی کردم.	who I was, and I told her.
روز بعد را برای آن مهمانی عقب افتاده تعیین کند.	to appoint the next day for the long delayed picnic,she consented.
شما مرا برای این موضوع به شش ماه و یا یک سال زندان محکوم خواهید	I suppose you'll put me away for him for six months, or a year perhaps, in a house of correction.
زیر نوری کم رنگ و بی رمق و لژیونری با کلاهخود قهوه ای و در هم کوبیده شده درست در مقابل پیش زمینه ای سیاه و قیرگون.	in an oval of pallid light, and a helmeted brown legionary smitten down, right across the bituminous foreground.
از سوی دیگر به اتاق اعدام که صندلی برقی در آن بود.	at the other into the execution room in which stood the electric chair.
با سه پسر و چهار دختر مجاز نبودی هزینه هنگفتی صرف تحصیلاتی بکنی که	with a family of three sons and four daughters, you were not warranted in devoting money to an expensive education which
چیزی که چون اخگری فروزان دائم در خون موجود است	something present in the blood like an ever burning ember,
ببین چه جای خوبی است برای به شن نشاندن کشتی!	there's a pet bit for to beach a ship in.
در میان بحث از جیب بغل خود دفتری بیرون کشید	in the course of the dispute drew from his side pocket a well filled notebook
سرانجام سرش به جلو خم شد و مجددا بخواب رفت.	in the end his head sank forward and he went off again.
بدین ترتیب همه آنان از جا برخاستند و سوگند خوردند.	so, all rising and being sworn in.
قبول خواهید کرد حرفی که چند دقیقه پیش راجع به احساس نداشتن خودم زدم	you will see how truly I spoke of myself just now, in saying I had no feelings
از شدت ناراحتی و وحشت سر جایم منجمد شده بودم	I stare at her, frozen in horror.
اگر این بار هم چنین شده باشد جای تعجب نخواهد بود	it would be no wonder if it were the same now.
با پشت دستش قطره عرقی را که روی صورت حساب افتاده بود پاک کرد	he wiped the sweat from the pink bill with his sleeve.
کوچک موجود وحشت زده ولرزان را بادستهایش گرفت وگردن حیوان را شکست.	had caught the trembling little thing in his bare hands and broken its neck.
مبادا با انجام دادن کاری که خلاف طبع و پیشه آنانست خللی بر استعداد فطری وارد آورند.	rather than injure the faculty, by doing any thing unbecoming their nature or their office.
وقتی که معمولاً بدون اجازه بیرون از خانه هستند.	when they're away without permission.
زیرا امید این که در آن دنیا به سعادت و آسایش برسد بسیار ضعیف است.	for his chances of comfort in another world are very small.
نسبت به این نظریه در باب آینده عالم هیچ اعتراضی نداشت.	had no objection to this theory of the world's future.
در آخر سال دوم بود که دانتس دوباره ترک نگهداری شماره اوقات نمود	at the end of the second he had ceased to mark the lapse of time
دستورهای خود را درباره مسیر کشتی با فریاد ابلاغ کرد تا طبق آن اصلا شود.	shouted out his orders for the ship's course to be changed accordingly.
من منتظر ری بین خواهم شد و او را با خودم خواهم برد!	I'll wait for him, change his clothes and lead him off.
اگر یک کلمهٔ دیگر سخن رانی از تالار اخراج خواهی شد.	another word and I will order you to be removed.
نگاهش را به طور ثابتی بر دیوار مقابل دوخته بود.	his eyes were vacantly staring on the opposite wall.
ممکن بود مدتی بگذرد بی آنکه به یکی از کارگران مزدبگیر برخورد کند.	she would often go long periods of time without running into any of the hired people.
سه ماه بود که خود را در آیینه ندیده بود.	it was three months since she had looked at herself
اما توپچیان هنوز شادمان بودند و روحیه عالی داشتند.	but the artillerymen were still as merry and lively as ever.
اتفاقاً من این طوری پند و اندرز دادن را دوست دارم.	I like that kind of sermon.
امکان نداشت آدم بتواند سلاح خود را در مقابل او به زمین بگذارد.	you never could tell when the dull weapon you put into his hands in an unguarded moment
اما نتوانست در برابر روحیه پر نشاط او مقاومت کند.	but unconsciously he fell under the influence of his gaiety
تا بلکه ترس و وحشت همسرش را تخفیف بدهد.	in an attempt to alleviate her terror.
وقتی که تو رو به بینه باید من صورتش رو ببینم.	I got to see her face when she sees you.
به بیرون پرتاب شد و بعد به طرف زمین رفت.	bounced off, and then fell all the way to the ground
نقشه ناپلئون این بود که نیروی فرانسه ولینگتن را به آن نقطه جلب کند و به سمت چپ متوجهش سازد.	the plan was to drawWellington thither, and to make him swerve to the left.
با خود گفتم که فراموش کردن و شکستن آن پیمان گناه نیست.	I thought it no sin to forget and break that vow now.
باور کنید که اگر یکی از این نوکران بدبخت روزی ثروتمند شود معجره کرده است.	it would be a miracle indeed if a page volunteer ever got anything like a reasonable bounty.
تا بدانند که با میلیونها دست و میلیونها جریب زمین خود چه میکنند که حتی الامکان برای خیر عموم خلاق و سودآور شود.	were to do with their millions of hands and millions of acres, to make them as productive as possible for the common weal.
آنگاه چیزها بگویم که اسباب حیرت و تعجب شما گردد.	then I'll tell you things that will astonish you.
که به محض شروع پیکار از راه جنگل عقب نشستم	that as soon as the action began he had withdrawn from the wood
به شنیدن وصف جبین چروکیده و فک کج شده از جا جستند	at the mention of the wrinkled brow and crooked jaw they had started
من هیچ وقت شما سه تا رو جدا از هم ندیده بودم	I've never seen you three apart.
که من قصد کرده بودم شب را در آن به روز بیاورم.	where I had thought to spend the night.
اما در هیچ یک از چیزهایی که خرید شکلات به کار نرفته بود.	though nothing with chocolate in it.
توجهی را که از این همنوع دریغ داشتیم خداوند بر او ارزانی دارد.	it is even held sublime for our neighbor to expect the utmost there, however little he may have got from us.
من فوراً وضع خود را دید زدم و کنار مادرم نشستم	I at once fixed on my plan, sat down by the mother
مقداری که به رای خودشم ی خواهد درون بشقابشم ی رزی دو بعد آن را به جلو هلم ی دهد.	he takes what he wants from the plate and passes it across.
که هنگام آزاد شدن از زندان به وی پرداخته شد.	which had been counted out to him on his departure.
اگر کسی بتواند ازدواجی بکند که به نفعش باشد دیگر نباید این دست و آن دست بکند.	but everybody should marry as soon as they can do it to advantage.
آنگاه بود که کورسوی چراغی از این پنجره و آن پنجره به چشم آمد	then poor lights began to shine in high windows
این را ببر به منزل نوتر مخصوص من و به او بسپار.	take that to my solicitor.
دی گه هیچ چیزی نیست که بتونه منو بهتر کنه!	there's nothing don't make ME better.
نزدیک چراغ ساحل پیاده شدم و پاروها را بستم و گذاشتم قایق خودش روی آب برود.	I closed in above the shore light, and laid on my oars and floated.
هنوز ساعات فراغتش را با اندیشه درباره لذت ابراز محبت آزادانه پر نکرده بود.	it had not even filled her leisure with the ruminant joy of unchecked tenderness.
ولی متوجه نبود که یک قطعه طلا به ته پیمانه چسبیده بود.	but without taking notice that a piece of gold had stuck to the bottom.
من هم باهاش رفتم البته تا دم در بیشتر نرفتم.	I went with her that is, to the door.
این دو نفر را هم با آن به قیمت مناسبی به لندن خواهیم برد.	takes them cheap
برداشت و هر قدر سعی کرد که او را به دهان او داخل نماید نشد	he endeavored to introduce it into the mouth of the patient
کل خانه پنداری در معرض امواج کر کننده صداها قرار گرفته بود.	the whole house seemed to sway in the deafening wave of sound.
که چرا باید برای مشتی باروت اندکی سرب این امکان باشد که فرصت را از من بگیرد.	that powder and lead may rob me of the opportunity
سوار یک کشتی کوچک قاچاقچیان دریایی شده و از آنجا هم فرار کند.	he set out in a smuggler's schooner
من آن کسی که قسمت بود بلا به او بله بگوید نبودم.	I was not the one she was destined to say yes to.
چون در یک آن واحد همه چیز باید در همه جا انجام بگیرد.	for at one and the same time everything has to be done everywhere.
بی آنکه تعهدی برای خود ایجاد کنند او را بهتر بشنساند.	what they really did think without committing themselves in any way.
قبل از اینکه از مرز تمدن عبور کنم متوقف شدم.	I stopped before I touched the borders of human civilization.
چون هر چیزی در مورد تو منو یاد اون میندازه.	because everything about you reminds me of him.
بی شک این ماجرایی که من در پیش دارم بسیار وحشتناک است.	I am convinced beyond a doubt that the adventure which is about to befall me is a terrible one.
قبل از درست کردن چای یک بطری از جیبش درآورد و چند جرعه از مایع زرد رنگ درون بطری نوشید.	he took a swig from before starting to make tea.
ساعت آن فرارسیده است که همه چیز در مقابل دیدگان ما کام لا فاش و روشن شود.	the fatal day has come and all has been brought to the surface.
مثل ماهی توی قوطی ساردین به هم پکی ده بودند	they were packed in like sardines
بسیاری به وجد آمدند و بسیاری ناراضی و ناخشنود شدند.	many were in ecstasies, many were disgusted and unhappy.
بلکه به نحوی باور نکردنی سبع و پیوسته تشنه خون انسان است.	but also to be so incredibly ferocious as continually to be athirst for human blood.
زیرا نه فقط بیهوده سخنی نخواهد گفت بلکه به عکس با سکوت خود دشمن را عصبانی خواهد کرد	because instead of saying too much he would be irritating his enemy by his silence
روز بعد آفتاب کم نوری محوطه را روشن کرده بود.	find a weak silver sun shining down upon the grounds.
کتری را که به پریز برق وصل کرد تماشایش کرد.	watched while she plugged in an electric jug.
متوجه شد که شفقت بار دیگر بر غم آن نامه غلبه کرده است.	he once again felt compassion prevailing over the bitterness caused by the letter
ولی هنوز چند قدم نرفته به گوز گوز میفته و تم وم می کنه	then 'fore you can git her goin', she peters out again.
تا وقتی که کشتی مست چنان لرزید و به حرکت در آمد که گفتی با کوه یخ تصادم کرده است.	till the drunk ship reeled and shook as if smitten by an iceberg.
من حاضر نبودم خودم پول پست ارسال این تصویر را بدهم.	I would not have given the cost of postage for the picture.
مردی که چنین رفتاری را در پیش گیرد خودخواه خشنی بیش نیست	he would be a selfish brute
من دیگر به روح المناک خود فایق آمده و خود را جمع کرده و برای حضور بر سر میز شام آماده بودم.	I had mustered up my spirits again, and was ready for my knife and fork.
به شرفم سوگند که به دار آویخته خواهید شد!	I promise, upon my honour, you shall hang at the next assizes.
مثل چشمان لعل گون حشراتی که در نور با هزاران رنگ بدرخشد!	like jewel eyes of insects turned brilliant in a spotlight!
برای من کار دیگری جز آن باقی نمانده است که به تابوت بروم.	I might as well be in my grave at once.
که گویی همه جثه آن از سرب انباشته بود	as if laden with pig lead in bulk.
این نکته به تحقیق پیوسته است که جادوگر پهلوان را به بند کشید	who, it is positively asserted, holding him captive
من برای دیدنشان رفتم ولی ایشان را ملاقات نکردم.	I went to see them, but missed them.
در جواب شنیدم که مسافرخانه پر شده و هیچ تخت خالی موجود نیست.	received for answer that his house was full not a bed unoccupied.
اما راستی این چه عشق و محبتی است که طاقت یک ساعت ماندن در زیر برف را نداری!	that's a poor love of yours that cannot bear a shower of snow!
بهتر است خودت را از این کارها کنار بکشی.	you are better out of the way of such doings,
اما صورت غذایی در جلوی تک تک افراد بود.	but small menus were lying in front of each of them.
به او هم دستور اکید داده شده بود که با هاکلبری دیده نشود و با او بازی نکند.	was under strict orders not to play with him.
ممکن نبود مدت زیادی وانمود کند که وضع و موقعیت را درک نکرده است	he could no longer so much as have pretended not to understand the situation.
ولی وقتی سم وحشیانه از کنترل خارج شد سرنگ از دستان ایزابل خارج شد.	but it jerked out of his arm as he seized violently.
رو به آدم موهومی در گوشه اطاق کرد .	he seemed to be addressing some imaginary auditor in the corner
لیکن جز یک دست لباس تازه که به دقت ماهوت پاک کن خورده و تا شده بود هیچ چیز جالبی در آن نبود.	but nothing was to be seen on the top except a suit of very good clothes, carefully brushed and folded.
البته منظورم این است که به طور داوطلبانه آن را شروع کردم.	reading voluntarily, I mean.
در این دو دفعه هم همیشه خود را در میان شنلی پیچانیده بود	both times he was covered up in a large cloak.
سپس شرم و آزرم نگذاشت بیش از ین چیزی بگویم	after she had done, my bashfulness would not suffer me to express myself farther
من از زاییمان آخریم مریضم و شوهرم از پنج ماه به این ترف ترکم کرد و هیچ ممر عایداتی در این دنیا ندارم و گرفتار حولناکترین فلاکط هستم.	I sick since my last confinement, abandoned by my husband five months ago, haveing no resources in the world the most frightful indigance.
خود را به لب قبر کشید تا با او مدفون شود.	he dragged himself towards the grave
من به انتظار جزرومد دریا ناچار ساعتی درنگ کردم	I was forced to wait above an hour for the tide
به حمام رفت و در را به روی خود قفل کرد	she locked herself in the bath room
من دانشجوی بیچاره و بیماری هستم که از بیچارگی در عذابم و همین طور گفت در عذابم	I am a poor student, sick and shattered shattered was the word he used by poverty.
این بود که پنج روز متوالی ملاقات با وکیل مزبور به طول انجامید تا تمام جزئیات مرتب گردد.	so well was that it took five days of meetings with the lawyer before the details were in order.
احساس حق شناسی بیش از کینه از خود نشان دادیم.	showing ourselves grateful rather than indignant.
پسرک که بیش از پیش گیج شده بود گفت	the boy said, more puzzled than ever.
در حالی که از نقطه ناپدید شدن او لک سیاه کوچکی به زحمت دیده شد که از آن ارتفاع شامخ به دریا افتاد.	while from the point of that disappearance, a minute black spot was dimly discerned, falling from that vast height into the sea.
این مکان چنانکه پیداست هم علف فراوان برای اسبان ما دارد	for, so far as I can see, this place will furnish grass for them
پیوند دو خانواده با نام و نشان که شاهزاده خانمی به شاخه جدیدی از فامیل افزوده و مناسبات رسوایی آمیز آن را گسترش داده بود.	the exact crossing of genealogies which had brought a coronet into a new branch and widened the relations of scandal
من باید بروم و گزارش کارم را به او یا به اسکوایر بدهم.	I might as well ride round there myself report to him or squire.
بر خاتمیت و انجام این کار نامطبوع و ناخوش.	this is a very unhoped for conclusion of a very disagreeable affair.
این سه سر کرده قایق در حکم فرماندهان گروهانهای او بودند.	these three headsmen were as captains of companies.
اما دستور داد تا قفل در را باز نگه دارند	but she succeeded in getting them to leave the padlock off
در این لحظه چهره و مخصوصاً پیشانی پریده رنگ پر صلابت و حجیم او چه شباهت عجیبی به یک قطعه سنگ مرمر داشت که تازه از معدن استخراج شده باشد!	how like quarried marble was his pale, firm, massive front at this moment!
مسیر زندگی دو تن از کسانی را که برایش گرامی بودند تعیین کرد.	determined the course of this history with regard to two persons who were dear to him.
در خفا دست مایه شوخی و بذله گویی بود.	indeed, but rather as a subject for discreet jocularity.
برای کشتن من یکی از استادان این فن را منتخب نموده بودند	they have sent some fencing master
به زودی خودم این نکته را به گوش همه خواهم رسانید.	proclaim it with my own lips upon the spot, if I can reach it.
اکنون که به واسطه خونی که قبلا در وال بسته بود اینک جاری شده بود از نو و با شدت ترغیب شده بودند	the sharks now freshly more keenly allured by the before pent blood which began to flow from the carcass
که پیه همه مشکلات را به تن بمالد و به کلاید میدان دهد.	accept his attentions regardless of the problem in connection with them.
زیرا برایش خیلی جالب بود که نام ناشناس را بداند	for he was curious to know the stranger's name
که نه تنها هستی مرا به من باز خواهی گرداند	not only in giving me life
چنانکه یک لحظه طول نکشید که آن بساط علم شد.	which was done at once.
تقریبا روی آن رسید و از این جهت جلوگیری از اصابت بدان غیر ممکن بود.	was almost upon him, so that it was impossible to prevent its striking against him.
چگونه سرانجام به تقاضای پلید او تن داده بود	then finally succumbing to his wiles
چون سه ماه نیز گذشت امید خلاصی دلیلی دیگر به نظرش آورد که حد انتظار را به شش ماه گذاشت	three months passed away then six more
به ناچار جناح چپ خود را عقب کشیدیم و هر جا توانستیم با شتاب آنرا مستحکم و تقویت نمودیم.	were forced to bend it back and hastily entrench it where it chanced to be.
اما این قدر یادم هست که در یک مملکت خارجی بود.	but I think it was in some foreign country.
زیرا که احترام من نسبت به شما دو عصا به چشمم بسته.	, for my friendship for your family and my respect for you are as a twofold bandage over my eyes
در همین زمان ژنرال منتظر بود که او را به میزی خالی ببرند.	the general waited to be seated.
باید امیدوار باشم که قلب بلندحمت شما در این موضوع انسانیت خواهد کرد و این میل بزرگ که نسبت به من مصاعد بوده و لطف خود را به صورت یک احسان کوچک بر سر من ریزد بر شما غالب خواهد شد.	I think I may hope that your generous heart will melt at this statement and the desire will subjugate you to be propitious to me by daigning to lavish on me a slight favor.
تا اینکه بالاخره تحت پیگردهای اسکار لت ناچار شد به اجبار اقامی بکند.	until she prodded him into it, then he had done it apologetically and half heartedly.
عبارتست از یک سطح صاف و هموار از الماس	is one even regular plate of adamant
یک لحظه چشمان همه گشاد شد و برق زد	their eyes glistened very big for a second
یک نفر دیگر به جای او پا به جهان گذاشته است.	someone else had taken his place in the world.
یعنی آقای بروک مثل هر جنتلمن دیگری خیلی خیلی با احترام رفتار می کرد گردید.	who treated the tutor with as much respect as any other gentleman.
اما من خودم سال گذشته مبتلا به چنان رماتیسم سختی شدم که اکنون هم آن را به یاد دارم.	but I had such an attack of rheumatism last year that I remember it to this day.
بی این که بتواند آنان را از جا بدر ببرد.	without managing to dislodge them.
به خود اجازه داد که با آزادی بیشتری درباره او حرف بزند.	he permitted himself to talk more freely abouther.
فقط باید خوب فکر کنم تا همه چیز روشن بشود.	I have but to think, and all will come clear!
هنگام وسعت جریان جنون نیز یک ذره از ذکاوت طبیعی عظیم او کاهش نیافته بود.	so in that broad madness, not one jot of his great natural intellect had perished.
امّا پس از مدتی که به نظرش خیلی طولانی آمد	but after what seemed an enormous lapse of time
آخر این احتیاج به آلوده ساختن چیست که در بسا ری از مردم است	what is this impulse towards dirtiness, which is in the majority of human beings
اندکی پس از نیمه شب شرشر باران شروع شد.	a little after midnight it began to pelt with rain.
چون این کار مغایرتی با رسم نژاد خود او نداشت	for it was not unlike the custom of his own race
که حتی یک بار هم موقعیت ییش نیامدکه افراد خانواده خودشان دور هم بنشینند با هم غذا بخورند	that they did not once sit down to a family dinner.
برم عجیب است که چه چیز شما چهار هابیت را واداشته که دست به چنین سفری طولانی بزنید.	I wonder greatly what brings four hobbits on so long a journey.
که سردوشیهاش را با مداد کپیه نقش کرده بود.	wearing epaulettes drawn with pencil.
مانند همه ما به جای یافتن علت خشم و رنجش خود درصدد توجیه آن بود.	irritated feeling with him, as with all of us, seeking rather for justification than for self knowledge.
من چنان کرنش کردم که سرم به تخته میز خورد.	I bowed down to the board of the table.
گویی که هیچ گاه از او دور نبوده است	it was as if he had never been away from her.
تآبستون دو سال پیش که رفته بودیم فرآنسه از ایناخوردم.	I had it on holiday summer before last.
حس میکرد بیش از حد برای یک خواب تکراری ارزش قائل شده.	that he was giving too much importance to his recurrent dream.
که در خاطرة من با روزهای گذشته همبستگی کامل دارد	so linked in my mind with the young idea of what is gone
هرچی با شه الان دی گه درد ندا ره	it doesn't hurt anymore
سرم را از ماشین بیرون آوردم و دست تکان دادم.	I waved out the window
