تمام هوش و حواسش به آماده باش درآمده بود.	wary, every sense alert.
تا هم به موقع و هم با نظم و ترتیب صحیح تنقلات را دور بگردانند.	to carry round the refreshments at exactly the proper hour, and in the proper order.
خوابی دیدم که با دل لرزان از آن بیدار شدم.	I had a dream from which I awoke with a throbbing heart.
همچنانکه پهلوان او را از نام و حرفه و وضع زندگی خود آگاه ساخته بود.	since he himself had rendered account of his station and life.
فکر کردم بهتر است موضوع را با تو در میان بگذارم.	I thought it better to tell you, my dear.
تصمیم گرفتند که پیرمرد آن شب ساعت هشت در مهمانخانه بیاید	it was arranged that he should call at the hotel at eight o'clock that evening
ولی رفتی و خودت رو به مردی فروختی که دوستش نداری	but you would sell yourself to a man you didn't love
اکنون مرا چگونه گرفتار کرد و به چه نوع از برای من اهمیتی پیدا نمود.	I am in my turn bitten by the serpent whose tortuous course
چشم بگشایید و آن مردی و مردانگی و زنده دلی را که شایسته پهلوانان سرگردان است از خود نشان بدهید.	cheer up, rouse yourself and show that gallant spirit that knights errant ought to have.
اولین احساس گناه تمام وجودش را در خود گرفته بود.	the first feeling of guilt at her intended conduct creeping over her.
من قضیه را به نفع خود خاتمه یافته خواهم دانست.	I will acknowledge the issue decided.
اما بلافاصله متوجه شد که آنها نیز او را دیدهاند و بعد ارام و بی سر و صدا به سمت آنها آمد و آرنج دستش را روی در کالسکه چهارچرخ گولد گداشت.	but directly he saw himself noticed, he approached quietly and put his elbow over the door of the landau.
محال است که برای خرج جیب کمتر از دو هزار فرانک درنظربگیریم.	it is impossible to allow less than two thousand francs for pocket money.
طرف مشرق بود و یک میل دور بود.تا اینجا آوردش.	got it a mile an' a half east of here an' drug it.
که سرش تقریباً به طور کامل از بدنش جدا شده است.	his neck was almost completely severed.
از قول من هم به او پیغام بده که کاترین نیز به موقع در تشییع جنازه پدرش حاضر خواهد شد.	carry a message from me, that her young lady will follow in time to attend the squire's funeral.
به ایمانم قسم اگر بنا بود که مردم را به گناه عاشقی به پاروزنی محکوم کنند	why, if for being lovers they send people to the galleys
نگذارید این آقا صحبت مرا قطع کند اگر نه ما بجائی نخواهیم رسید.	keep your companion quiet, or I shall never have done.
از آن سو لوتر نیز برای آنکه نقش خود را ایفا کند	the better to support the part he had to play
مرحله دوم بلافاصله بعد از صدای سوت من شروع می شه.	which will start on my whistle.
چون سرتاپای او را معاینه کردند نشانی از زخم نیافتند.	after searching for his wounds could find none
دوشیزه تیلنی هم تعجب کرد و هم خوشحال شد.	which at once surprised and amused her companion.
هرگز هم برای ایجاد توهم درباره خود فعالانه شرکت نکرده بود.	he had not actively assisted in creating any illusions about himself.
در راه افتاد خود را در زیرزمینی دید که دست و پایش را بسته بودند.	on falling found himself bound hand and foot in a deep pit underground
تا من نیز بتوانم چنانکه سزاواری قدر تو را بدانم.	I may learn to value you as you deserve.
مگر آن که او را از نقش شاعرانه ای که در نظر دیگران داشت خلع کند.	but would only perhaps detract from his romantic character in the eyes of others.
بدون آنکه وقتی در مطالب آن کنم شروع به ورق زدن آن کردم.	turned the pages without reading it.
اگرچه در سه چهار سال اخیر از این موضوع بویی برده بود.	though for the last three or four years she had had a sneaking suspicion it was coming.
اما صدای سگ صاحبش اونقدر ضعیف بود که من چیزی نشنیدم.	but his beastly voice was so weak that I didn't hear.
آن صورت در روی همان میز تحریز مقابا شما است.	you will find the menu of the day on the blotter, beside you.
با دستان انسانی ضعیف و رقت انگیزم به دنبال گلویش گشتم ولی نتوانستم آن را به دست بیاورم.	I grabbed for its throat with a pitifully weak human hand and missed.
برای این اشتباه متحمل کیفری شد که در همه مدت تلاوت دعا به طول انجامید.	for this piece of absent mindedness she underwent acoulpe which lasted during the whole service
من یک نظر جنگ با نیروهای قوی تر از خودمان را دیدم.	I caught glimpses of a battle with forces greater than our own.
لرزشش را هنگامی که صورتش را در موی من دفن کرد.	shuddering against me as he buried his face in my hair.
کاترین او را رها کرد و متفکر کناری ایستاد.	while she stood by looking very contrite.
اما او از فروش یکی دو عدل پنبه در سال و گدایی از این و آن راضی بود.	but he was well satisfied to remain and to subsist miserably on the proceeds of a bale of cotton a year and the charity of his neighbors.
اگرچه شما را خواب گرفته و همچنان نشسته بخوابید.	even though you slept while hearing me
حس کردم که صندوق را به ارتفاعی بسیار به هوا بلند کردند	I felt my box raised very high in the air
امیدوارم کارها به خیر و خوشی پیش رفته باشد.	I hope it all went off tolerably well.
آن را شب از رستوران به خانه من آورده بودند و بامداد هنوز حاضر بودم که او را ببخشم با اینکه یقین داشتم به من خیانت ورزیده است.	it was brought me from the tavern and only that morning, only that morning I wanted to forgive him everything, everything even his treachery!
تاکنون در زندگی به مردم احمق فراوان برخورده بود!	he had met so many idiots in the course of his life!
که سرانجام جای خود را در این جامعه باز کرده است.	at last he was nearly as well placed here, socially, as any one.
من نود و سه درصد مطمئنم که اگه اون بره سر کلاس اتفاق بدی نمی افته بی تغییر نگه داشته است.	I'm ninety three percent sure that nothing bad will happen if he goes to class.
بلکه به خاطر این که زمان موعود فرار نرسیده است.	but also because their attempts were premature.
بضاعت نهانی و بلاغت یک هوش متواضع و واقعی را داشت که ناگهان آباد شده باشد.	he possessed the secret riches and the eloquence of a true and humble mind which has spontaneously cultivated itself.
اما آن قدر آدم حقیری هست که به خودم گفتم کاش از مخالفین ما بود.	but he's such a low fellow, that I wished he had been on the wrong side.
آنهادر حال فرار به جنگل ولی هنوز هم خطرناک خواهند بود.	running for the bush but still dangerous.
لیکن به نظر من اشکال فوقالعادهای در بر دارد.	but I look upon it as difficult.
که بر ترس و هراس ما بیفزاید و نه صدایی شنیدیم.	to increase our terrors, till, to our relief
من مطمئن بودم که درباره این مطلب از من سؤال خواهید کرد.	I KNEW you would ask about him!
حالا دیگر او خنده شوم و شدیدی را سر داد	now, he gave vent to several very grim laughs
مجرد باقی ماندنش معمولاً به عزم زن بستگی خواهد داشت نه او.	his remaining a bachelor will usually depend on her resolution rather than on his.
به او فرصتی بدهم تا در دوئل مرا بکشد و بر من بخندد!	so as to give him a chance to kill and laugh at me!
اصلاً از اول هم من اعتماد زیادی به آنان نداشتم.	I never much believed in neither of THEM.
در واقع این چوبدستیه که صاحبشو انتخاب می کنه.	it's really the wand that chooses the wizard, of course.
خلاق و نابغه و منبع تمام خردها در دنیای بازاریابی و تجارت	creative genius and source of all wisdom on business and marketing
لیکن بانو وی را از این زحمت معاف داشت	the lady, getting up from the ground, saved him the trouble
به نحوی که قسمت کوتاه پایینی هنوز به قلاب بسته است	so that while the short lower part is still fast
تا در پایگاهی خارج از کشور در کنار شوهرش باشد	accompanying her husband on a foreign station
زیرا آنان در زبان خود لفظی ندارند که دلالت بر دروغ گوئی کند .	for they have no word in their language to express lying or falsehood.
بعد با یک خر خر خودش را روی یک آرنج بلند کرد	then brought himself up on his elbow with a snort
یک سوسک بزرگ چاق و چله در آن بود.	one large, fat beetle.
میتونه به میل خودش هر که رو که دلش بخواد از بینش ون انتخاب کنه.	admirers from which she could take her pick.
به همین جهت موظفم این انتظار را برآورده سازم.	I am therefore bound to fulfil the expectation so raised,
با این همه اسم جایزه اول بسیار بزرگ است و اهمیت خاصی دارد.	but, for all that, the title of first is a great distinction.
می دونم یه کم طول می کشه تا بهش عادت کنی .	I knowit takes some getting used to.
ولی در نهایت تعجب دید که او به تنهایی بلند شد و بالا آمد و از سلول بیرون رفت.	she rose easily to her feet and walked out of the cell unaided.
ولی حتماً اون می خواد ادوارد واسه خودش با شه.	but she probably wants him to herself.
تا مبادا خاطرة حوادث گذشته را به یادش آورند.	lest they should recall or bring back to his recollection what had taken place.
سه ماه پیش نیست که من دویست فرانک از برای شما خرجی گذاشتم و رفتم	yet I gave you two hundred francs when I left three months ago
فریب خورده و فاسد و آواره در دشت و صحرا منم نه ارباب تو.	it is I who am deluded, and led astray, and taken tramping about the country, and not thy master!
لباس مردانه بپوش و پشت ارابه من سوار شو!	put on a livery, get up behind the carriage
با این همه فکر او متوجه آن مرد بود	but still he had been in his mind
من فقط او نو سر جای خودش می ذارم.	I would only set that right.
بنده را حق غیظ در مقابل مالک خود نیست.	a slave does not dictate to a master
با پاهایی که از ترس این اخطار به لرزه در آمده بودند عقب رفت.	backed off, his stumps jerking in alarm.
بالشم هم یک برآمدگی کوتاه پوشیده از خزه بود.	a low, mossy swell was my pillow.
پاشنه پاهایش را که به خارج خم شده بود به شکم اسب چسباند	turning out his toes pressed his heels against its sides
لیکن از نزدیک دوست داشتن افراد امری محال است.	but at close quarters it's almost impossible.
من تا آن دم راز جامه پوشیدنم را پنهان کرده بودم	I had hitherto concealed the secret of my dress
از آنجایی که او هیچ گونه توانایی ای در آشپزی نداشت خوشحال بودم کسی هست که او را از بی غذایی نجات دهد.	I was glad someone was trying to keep him from starving due to his lack of cooking ability.
به محلی در جنوب شرقی روسیه که پیش از این هرگز به آنجا نرفته بودند شتافتند.	so these men with their wives and children streamed to the southeast, to parts where none of them had ever been.
سفر چهارده مایلش را به سوی خانه آغاز کرد.	he set out alone on his fourteen miles' journey
ولی وقتی که من را دیدند سر جایشان خشک شدند.	they all froze when they saw me.
ده هزار پوند خرج کرد و انتخاب نشد چون به اندازه کافی رشوه نداده بود.	spent ten thousand pounds and failed because he did not bribe enough.
ولی راستش ای نه که این پیشنهاد به قدری ناگهانی بود که منالان نمی دونم چی باید به گم.	but this is all so sudden that I do not know what to say.
همه چ ی ز را از درون چشمان جانورمی بی نم.	I see everything through the eyes of the beast.
در بالای آن چیزی مثل محجر و در داخل آن پرچین بلند و خارداری حس کردم.	above it, something like palisades, and within, a high and prickly hedge.
که باید مطالب بسیاری را در خلوت و پنهانی به یکدیگر بگویند	that they had much to say to one another in private
چندین هزار پوند در بانک به نام تو است.	many thousands of pounds already in the bank in your own name
شخصی هم هست که بر من رئیس و بزرگ است.	but there is another over me.
این موضوع را از عادات او به ولخرجی و اسراف دریافته بود.	he gathered that from her spendthrift habits.
هرچند روز پیش در کنار دریاچه به این نتیجه رسیده بود	although on the lake the day before he had been deciding
پیش از این که بارانداز را ترک کند من آخرین کسی بودم که او مخاطب قرار داد.	I am the last person he spoke to before he left the wharf, you know.
این کتاب دیروز بر حسب تصادف بدست من افتاد.	I read of it yesterday by chance.
با چند تسمه بلند آهنین به هم متصل شده بودند.	bound together bylong transverse strips of iron.
امیدوارم تمام وقتم درایت بعد از ظهر لعنتی به این کار نگذرد.	I hope it doesn't take me the whole blasted afternoon.
تصور کردم که اتاقک راننده چه بویی خواهد داشت و بعد سریع از آن فکر بیرون آمدم.	I imagined what the cab of that truck would smell like, and then quickly drove out the thought.
کشیشی که مرا پذیرفته بود مشوش شد و شروع کرد به دعا خواندن.	after which I saw the sacristan make a low bow to the visitor, and then another bow as the visitor took his leave.
دلم می خواس شما بودین ببین ین چن بار لقمه رو دور سرش گردوند تا این که به لب مطلب رسید.	you should have heard the elaborate way he worked up to it.
تا حالا توجه نکرده بودم تارهای قرمز رنگ توی موهای تو پیدا می شه.	I never noticed before your hair has red in it.
به طرفی که دکتر در پشت پرچین در انتظارمان بود	to where the doctor awaited us on the other side of the stockade
اینک برادر ارجمند و عروس محبوب شما که هر دو در حضور هستند!	for you have before you your worthy brother and your good sister in law.
لیکن چون دیدیم که چوپان از این داد و فریادها غوغایی در ولایت بپا خواهد کرد و سواران مرزبان ساحلی بی درنگ برای شناختن هویت ما خواهند آمد	but reflecting that the shouts of the shepherd would raise the country and that the mounted coast guard would come at once to see what was the matter
حالا که یادآوری عدم کفایت روابط انسانی دردناک بود	at the very moment when it was painful to be reminded of the inadequacy of human relationships
وی را ترک گفته ولی هنوز در روانش خفته بود دوباره زنده کرد.	he had not thought lately, but which still found place in his soul.
که چون تیر رها شده از کمان یورتمه از تپه سرازیر شدند و به جانب دراگونها شتافتند.	his deployed squadron rode at full trot downhill toward the dragoons.
جایش را یک نوع شیفتگی و جنون فرا گرفت.	was replaced by a kind of fascination.
در برابر وسوسه خرید بشقابی با نقش و نگارهای قدیمی مقاومت کرد.	restrained his inclination for some plate of an old pattern which was shown to him
بی گفتگو بر طبق تعریفی که من از وال کردم وال هستند یعنی ماهی آبجهان با دنب افقی.	by the terms of my definition of what a whale is i. e. a spouting fish, with a horizontal tail.
مطلوب است که چنان شاهدی بدست آید که شبیه به دو دو تا چهار تا باشد!	I should like to make a chain of evidence such as twice two are four
آن وقت به دور و برش نگاه کرد در حالی که گیج شده بود.	gazed at it, and then around him, confusedly.
اما من کم کم به این نتیجه رسیدم که او وقتی درباره خود گفت آدم سرسخت و خونسردی است حقیقت را گفته بود.	but I began to feel he had spoken truth of himself when he said he was hard and cold.
به قدری در مداهنه و تعارف کردن بیداد کرد که سرانجام نزدیک بود به ناچار زنگ را به صدا درآورم.	that I began to think I should be obliged to ring the bell.
آن وقت من رفتم تو و در پشت سرم بسته شد.	I went in and the door closed behind me.
گوئی خوش گذراندن یا بد گذراندن ما به خواننده مربوط است.	as if the readers were personally concerned whether we fare well or ill.
تا گماشتگان او نبینند و آن را از چنگمان به در نیاورند.	that his people should not see it and take it from us
من امروز صبح حیوان را دیدم که پالان و افسار نداشت	I saw him this morning without pack saddle or harness of any sort
البته ما اقدامات احتیاطی لازم و آن جام دادیم	whatever precautions we take
با شور و شوق شروع به هم زدن آن کرد	began to stir feverishly.
شماره تلفنی که روی کارت ویزیت او نوشته شده بود.	the number was printed on his identification card.
این تقصیر من بود که جریان را قبلاً به تو نگفتم.	I was a fool not to expect something like this.
در فضایی مشخص و در زمانی معین و کاملا در دسترس آن مرد دیگر انسانی آرمانگرا و اهل رؤیا به نظر میرسید که اهمیت چندانی نداشت.	definite in space and absolutely attainable within a limited time, the other man appeared for an instant as a dreamy idealist of no importance.
به دوستی هیچ یک از ایشان به اندازه دوستی با این آجودان کوچک اندام که مورد نفرت اوست تمایل ندارد.	he knew there was none he would so much like to have for a friend as that very adjutant whom he so hated.
من در انتظار شما بودم! من در انتظار شما بودم!	I was expecting you! I was expecting you!
پولی نا این جمله را با لحن تحقیرآمیزی گفت که فقط خودش گاهی قادر به ادای آن بود.	I believe you, she said, but in such a manner in the manner of which, at times, she was a mistress
در ضمن کوششی هم برای ربودن چیزی از تازه واردان نکرد.	also, he did not attempt to steal from the newcomers.
امیدوارم گم شدن یک لنگه پوتین بخشی از روال معمول زندگی در اینجا نباشد.	I hope that to lose one of your boots is not part of the ordinary routine of life over here.
زیرا او هنوز عقیده داشت که فردا یا پس فردا حالش بهتر خواهد شد و به سر کارش باز خواهد گشت.	for he was still clinging to the faith that tomorrow or next day he would be better, and could go back to his job.
چون او شکم خود را نه از آب کاسنی بلکه از طعام انباشته بود و به مین جهت تا صبح یکسر خوابید.	for having his stomach full of something stronger than chicory water he made but one sleep of it, and
ولی بذار یه چیزی راجع به ساعت هزار دلاری بهت به گم.	but I know something about this thousand dollar watch.
اما هیچ کس قادر نبود صحت این گزارش را تایید کند.	but no one was able to substantiate the reports.
به کسی نیرنگ بزنی که در عمر خود همواره به صفا و صداقت با تو رفتار کرده است.	or have recourse to falsehoods with one who has dealt so truly by thee
سرم را تکان دادم و در جعبه را باز کردم.	I nodded and opened the container.
بهترینشان گردنبند ظریفی با نگین یاقوت و یک صلیب مروارید با پنج قطعه برلیان بود.	the finest that was obvious at first being a necklace of purple amethysts set in exquisite gold work, and a pearl cross with five brilliants in it.
اگر بجز هوس دلیلی بر نگاه داشتن من ندارید	if no other reason will induce you
ناچار مختصر خطاب خود را به این پسر عمو باید بگوید.	he will feel obliged to make some little speech to the cousin,
چهارده ساله که برای این مجله من یک آشغال بودم	for 14 years I've been a whore for the advertising industry
که شهرت داشت به تنهایی به پیر گرگی حمله کرده است.	famous for having tackled a big wolf unaided.
دو سال و نیم بعد در اوایل سال 1923	about two and a half years later, at the beginning of '23
از شانه خاکی دو طرف را مسدود کرده بود.	blocking it from shoulder to shoulder.
رالف را که بوسیده بود از چیرگی ناتوانی گذرا نبود.	she hadnt kissed him in a passing weakness when she had kissed him
زیرا تصویرش در آینه خیلی به او نزدیک بود.	their reflections were so close together
دیدیم که در تمام عمرش یک لحظه هم دست از رذالت و شیادی برنداشته است.	he has been a thorough paced little villain, all his life.' 'I never will believe it, sir
اندیشه نیمه تاریک قبلی ناگهان با وضوح تمام در ذهنم ظاهر شد.	my half effaced thought instantly revived.
ولی آنقدر سریع پائین نرفت که شادی شگفت زده را در چشمان هارولد نبیند.	but not so quickly that she didn't see the stunned happiness come up in his eyes.
منتها این کار مرا با نتایج نامطلوبی روبه رو خواهد کرد.	but that would expose me to unpleasant consequences.
که شخصی به سبب نامعلومی موظف به تدارک وسایل آن بود.	which someone for some reason had to provide for him.
او را در اتاقی در طبقات فوقانی عمارت محبوس کردند	the maiden was placed in an upper chamber
اندیشیدن به روح خود هنگام گلدوزی در اتاق شخصی خویش	the care of her soul over her embroidery in her own boudoir
به او گفت که تاکنون جوانی این چنین نازنین ندیده است	told him that she was beginning to think he was the nicest ever
بالاخره به بیت تصمیمش را گرفت و با خود گفت که به یس بال یک سرگرمی بسیار عالی است.	IIBaseball, he determined, would be an excellent hobby.
بلکه تا از گفت و گو با آنان لذت ببرد.	but certainly to take pleasure in talking to them.
تا در وقت جمعشدن از هر گره و پیچ خوردگی مصون بماند.	so as in the act of coiling to free it from all possible wrinkles and twists.
اما وقتی به آن رسید دریافت که جاده است.	but when he reached it he found it was a road.
یک شیشه نیمه پر هم کره بادام زمینی پیدا کرد.	she found a half used jar of smooth peanut butter.
راستش ما هیچکدوم از حرفائی که اون زن بدجس در مورد شما شایع کرده بود باور نکردیم	we all thought it such a SHAME when that horrible woman was going round telling those stories about you.
من که می گم بکشی مش و راحتش کنیم.	I'm for putting him out of his troubles.
خارج شد و در را با صدای بلند پشت سرش بست.	he said and went out, closing the door noiselessly behind him.
در اندیشه شد و کوشید به معنای نهفته این اظهارنظر رسوخ کند	pondered, trying to penetrate the full significance of the words.
جناح چپ خود را از موضعی که قصد اشغال آن را داشتند عقب کشیدند	withdrew their left wing from the position they had intended to occupy
در نتیجه یاد گرفتند که چگونه به زورآزمایی در بستر عادت کنند.	so they had to be content with sharing power in bed.
آنقدر تیره بود که به نظر میامد از جنس قیرباشد.	so dark it seemed almost resinous and pitchy.
نیز دو میز و یک قفسه برایم ساخت تا لوازم خود را در آن بگذارم.	two tables, with a cabinet to put my things in.
شاید در تمام مدت هم به انتقاد آمیخته با دیر پسندی و سختگیری نسبت به شراع یکدیگر مشغولند.	all the time indulging, perhaps, in finical criticism upon each other's rig.
قبلاً تصمیم خود را گرفته بودم که از او بخواهم روزی آن را به من امانت بدهد.	I had already formed the intention of asking her to lend it to me some day.
فورا آرام شد و موجی از رضایت و شعفی آمیخته به تحیر آنا وجودش را فرا گرفت.	he at once relaxed, a wave of puzzled satisfaction as well as delight instantly filled him.
به فکرم رسید سری بکشم و بهشون خبر بدم که اومدم و اینکه میتونن به شکار برن.	I figured I'd poke my head in, see what was going on, give 'em the green light to go hunting
در آنجا ناهار خوبی خوردیم و با خوشی روز را به سر آوردیم.	where we had a very comfortable dinner, and passed the day with great satisfaction.
وقتی تازه به اینجا آمده بودی اطمینان نداشتم همان لایدگیت باشی.	I was not quite sure when you first came that you were the same man.
هرگونه نشانه طفولیت را از او دور کرده بود.	had erased all girlish traces from her.
پس لازم بوده است که او را در وسط راه بر زمین بگذارم.	I was compelled to lay it down in the middle of my career.
مجبور شدم به دنبال طنابی بگردم و او را به زور برگردانم.	I had to get some string.
سرزمینی که شوهرش فقط برای او بنا کرده بود.	which had been built by him and for him alone.
هر چند که دیگر به روال کنونی زندگی خود عادت کرده بود.	even though he had gotten used to the way things were.
هر سه با دست و پای سفید زیر آب رفتند	they all went under in a tangle of white legs and arms
او این کار را به چیزی نتوانسته بود حمل کند مگر به اختلال حواس من.	which he knew not well how to take, but imputed it to some disorder in my brain.
این خبر چون نفس سردی قلبش را مچاله کرد.	the news playing upon him as an icyand congealing breath.
من از یازده سالگی خودم مسئول خودم بودم هم ون وقت که مادرم مرد.	I've taken care of myself since I was eleven that's when my mother died.
دستی لرزان پیش آورده بود تا نامه را بگیرد	holding out his trembling hand for the letter.
اگه جرئت داری از رو این خط رد شو	I dare you to step over that
با قیافه آرامی که نتیجه یک تصمیم عجولانه بود روی صندلی نشست	sitting down with a kind of desperate calmness
گویی تمامی جوش و خروش غروب تابستان چون تارهای عنکبوت به دور او تنیده بود.	as if all the fertility and amorous activity of a summer's evening were woven web like about his body.
شرح مصیبتی را که بر سرش آمده بود از او پرسیدند.	questioned her as to her misfortune
من امیدوار بودم که با این زمرد بتوانم این مبلغ را تهیه کنم.	I was hope to get it for this emerald.
از لبه آن آویزان است بدون آنکه به چیزی گیر باشد.	hanging over its edge completely disengaged from everything.
ولی در درون خویش از این امر راضی نبودم	if that were all right which I had a secret misgiving was nearly all wrong for
من از شباهت عجیب او تصویری که داستانش را گفتم سخت متعجب شدم	his strong resemblance to this picture I have spoken of, struck me with astonishment.
دندان در آن فرو کرد و با آن به تقلا درآمد.	sinking his teeth into it, surging and wrestling with it.
اما از یک یا دو هفته پیش اضطراباتی از نوع دیگر دچار شده بود.	but for the last week or two, anxieties of another nature had come up.
راست است که موهای من کمی صاف است اما دیگر مثل موهای آلیس نیست.	I know my hair is straight, but it isn't as straight as that.
طبق روال عادی همیشگی خود از در فرعی بیرون آمدم و به اطاقم رفتم.	in my natural and wonted respectful manner, I slipped out by the side door and got away.
زیرا که غالب دریانوردان نسبت به سگ ماهی احساسات بسیار خرافی دارند	because most mariners cherish a very superstitious feeling about seals
بعلاوه اگر جنبه ذوق و تفنن علم ادبیات و شعر و شاعری از جنبه مادی و سودجویی آن بیشتر است	though that of poetry is less useful than pleasurable
اما رفتار خوش و مناسب او بزودی این حالت را برطرف ساخت.	but his easy patronage soon put that to rights, and made me quite at home.
یا شاید بهتر باشد بگویم او با من زندگی کرده است.	or the darling has lived with me
خیلی از مردم عقیده داشتن که اقدامات کراوچ مناسب و درس ته.	plenty of people thought he was going about things the right way
در این خصوص هیچ کار نکردن ب همه منزله کار کردن است!	to do nothing, in short, was to do everything!
مگر این که به دونی مغزش چه طوری کار می کنه.	if you can't see where it keeps its brain.
البته اکنون دیگر همه چیز از بی رفته است!	for all is lost now!
که منظور و هدف آن آزردن و رنجاندن یکدیگر بود.	with the sole object of offending one another.
اکنون آزاد بود تا راه خود را پیش گیرد	she were free now to take her way
لکن چون تصمیم گرفته بودم قبلا من سکوت را نشکنم از جای خود تکان نخوردم.	but as I had sworn that he should speak first, I continued to lie still and the more willingly
من نخستین کسی بودم در آن موقع که به شما حمله کردم.	I was the first to pitch on you.
هر چند که فاصله برای کمان کوچک او بیش از اندازه زیاد بود.	though it was a long shot for his small bow.
جز این که بگوید کار از کار گذشته است چیزی از دست برنیامد.	he could only say that the end had come.
پس در اتاق پذیرایی به انتظار ربایندگان دختران نشست.	she seated herself in the drawing room to await the abductors.
به همین خاطر آمادگی پذیرایی از مهمان را ندارد.	his health would not allow the reception of any visitors.
اما معلوم نبود که زنش هم او را دوست دارد یا نه.	I could not tell if she loved him.
مواظبت بودم و گذاشتم هر از چند گاهی منو ببینی به این امید که جادوی تو به جادوی من واکنش نشون بده.	I staked you out and let you see me from time to time I hoped your magic would respond to mine.
بلکه گویی فرصتی برای این گونه کارهای بیهوده ندارد.	but as though he hadn't time to waste on such trifles.
بدون هیچ گونه لغزشی نشانه گرفت و آتش نمود.	took steady aim, and fired.
با چنان تغییر وضعی که اگر تصویرش را بر لوح جانم نقش نکرده بودم امکان نداشت او را بجا بیاورم.	so well disguised, that if I did not carry his image graven on my heart it would have been impossible for me to recognise him.
اما علتی نداشت که آدم وقتش را سر او تلف کند.	but there was no reason to waste one's time over him.
اما باید مواظب باشیم که به هیچ وجه احتیاط را از دست ندهیم.	but making sure we take things very carefully all the time.
اما یک هفته پیش از آن که این کرم با قدرتی تازه دوباره سر بردارد.	but a week before that worm had been roused up again with fresh force.
از ای نرو بکار نبستن دومی نشانه ضعف است.	so it was weakness not to enforce the second.
یک نقاشی طبیعت بی جان که مقداری پرتقال در یک بشقاببود بیادم هست	I remember a still life of oranges on a plate
زیرا نور خاموش نخواهد شد حتی هنگامی که تو در این جهان نباشی.	for your light will not die even when you are dead.
چند نفر داوطلب خواستم تا برای پیدا کردن او با من بیایند.	I asked for volunteers to come back and find him.
در انتهایشان بیست پا و در نوکشان شش پا از سطح آب ارتفاع داشتند.	were about twenty feet high at the base and six feet above the water at the tip.
اونوقت در امتداد ساحل غربی دریاچه پارو زدیم و دنبال زنبق گشتیم.	then we rowed alongthe west shore looking for water lilies.
با موجود دم انفجاری نیز همین طور مبارزه کرده بود.	as he had done with the skrewt
نرده را دید که در ارتفاع چند متری زمین آویزان بود.	to see the bars dangling a few feet above the ground.
با این دشمنی مخفی خانه شما باید این بار سخت کوشید.	with the enemies you have to do with there is no time to be lost.
بعد وارد سالنی شد که از خیابان نگاه خود را به درون آن فرستاده بود.	entered the apartment into which he had looked from the street.
من این نام را بلند بر زبان رانده بودم.	I had said it aloud.
شاید بد نبود که زمان دقیق را در پرانتزی یادآور شویم	here the exact amount could be indicated in brackets
به گمان من پستان راست را خیلی خوب کشیده است.	I think the right breast is very well painted.
صدها تن از درباریان دیدند که بوزینه برفراز عمارت نشسته.	the monkey was seen by hundreds in the court, sitting upon the ridge of a building.
حتی نجواهایش بسیار بلند و به همهمه ناگهانی ارگی خارج از کوک شباهت داشتند.	even her whispers were loud and liable to sudden bursts like those of a deranged barrel organ.
تا آن زمان کسی در آنجا فوت نکرده بود	for no one had died up till then
او را به پیش خان چسباند تا به نان تست برسد	pinning her against the counter as I reached for the toast
این کار را کردم و سر او را به زانوی خود تکیه دادم.	I did so, raising the boy's head against my knee.
مقابلم ایستاد و با دقت به من نگاه کرد.	stood before me, and looked at me attentively.
مدتها بود که به وضعی نکبتبار دچار و به مسیری غیر شرافتمندانه کشانده شده بود.	would have been forced to some dishonorable course, if he had found himself in such a difficult position.
من خیلی مستم و میخ وام قبل از اینکه شب تم وم به شه بیشتر مست به شم .	I am very drunk and I intend to get still drunker before the evening's over.
یک بار دیگر خودم را در آیینه برانداز کردم.	I take one last look at myself in the mirror
متهم در پشت جایگاه خود بر چارپایه ای نشست.	the prisoner withdrew to the back of the dock, and sat down.
در آنجا گروه زیادی از متهمین دیگر به انتظار نوبت خود بودند	where some prisoners were waiting till their turns came
چون گلوله درست روی کارت شناسایی توی جیب بغلش خورده بود.	because she shot him through his identification card.
اما بزودی آن را فراموش ساخت و در اندیشه کار خود فرو رفت.	but in thinking about his own business he soon forgot it.
او با چوب خود آمد و مار را کشت.	who jumped in with his riding cane and settled it.
چون نگاه داشتن دن کیشوت در خانه ظاهراً غیرممکن است	as it seemed impossible to restrain him
اینک فرانک حسی پر هیجان و نو در خود یافته بود.	an exciting and novel sensation for him.
طناب را گرفتم و خود را به زحمت بالا کشیدم	I pulled in hand over hand on the cord
که از کوچکی و سبکی مجبور بود بکفشایش سرب بزند تا باد نبردش.	who was so small and so thin that he was obliged to load his shoes with lead in order not to be blown away by the wind.
او را از شناخت واقعی شکل اشیا بازداشته بود.	barely permitted her to make out the shape of things
بیاید و شاه را دیده و به شما بگوید که این شاه است یا نه.	let him approach and say whether it is really his majesty lying there.
به عوض یک جنازه دو جنازه حمل خواهند کرد.	thinking to attend one funeral would follow two
موهای خود را پودر مفصلی زده و عینکی طلائی نیز بر چشم گذاشته بود.	with a powdered head and gold spectacles.
در حالیکه دری را که در متن دیوار مخفی بود باز کرد	opening a door concealed by the drapery
چون ممکن بود شر و مصیبتی در کمین باشد.	for evil in that quarter was at hand.
ممکن بود بتواند بگوید که چیزی تغییر نکرده است.	she might almost think that nothing had changed.
آهی کشیدم و در جهت مخالف با او به راه افتادم.	I sighed as I continued in the opposite direction.
اما صبح که آمده بود یک شنل با خود آورده بود که بعد از کار فورا لباس عوض کند و راه بیفتند.	but she meant to bring a frock up with her in the morning and hurry into her clothes at the shop.
سپس مراتب لطف و ارفاق اعلی حضرت و شورای سلطنتی را به تو ابلاغ کند	then to signify the great lenity and favour of his majesty and council
اما ناچار باید مراجعت خود را تا سه ماه دیگر عقب بیندازم.	but as it is I have to postpone my return for three months.
خیالی و خوابی را حقیقت پنداشته و در قوه متخیله تجسم یافته	it was a fright of the imagination, a dream of your fancy
با روباهی که پشت زینش بسته بود خارج شد و به جانب ارباب جوان خود رفت	rode toward his young master, with the fox tied to his crupper.
آن وقت مثل این که دوازده جور درد به جانش افتاده باشد	as if a dozen agues had taken charge of him at
به سوی اتاقی که ندیمه را در آن حبس کرده بود شتافت.	hastened to the room where he had locked her in.
درست بدان گونه که پرستار کوچک من به من آموخته بود.	just as my little nurse had instructed me.
با این امتیاز که این پول همیشه فورا در اختیار او است	with this peculiar feature, that they were always at his immediate disposal
همیشه هم ممنون دوستان با محبتی هستم که مرا هم دعوت کرده بودند.	feel extremely obliged to the kind friends who included me in it.
او را تازه از ده آورده بودنش و در میان خدمه بود	she had just come from another village
این است علت پیدایش این حرکت و قوانین آن.	that is why this movement took place and those are its laws.
به خاطر داشته باش که ما در سعادت خود تا چه مایه نیرومندیم	remember how strong we are in our happiness
بآنها لباس محکومین بم رگ یعنی یک پیراهن بلند سفیدی پوشان یدند	dressed in long white tunics
یعنی ده هزار مرد دیگر در سر تا سر دنیا دارند.	which ten thousand other men in the world have.
هر دو بر این بودند که از ایشان یکی بهتر است در آنجا بماند.	in favour of one of them remaining.
از این که مجبور بود کار خود را توجیه کند شادمان نبود	not pleased at having to justify himself
احساس کردم که آن زن سیلی به من زد و از خواب بیدارم کرد.	I feel like she's slapped me awake from a dream.
بطورکلی باید چهل سلاح با این استحکامات نبرد کند.	which will have forty guns in all directed against it.
هرگز تا آخر عمر این محبتتان را فراموش نخواهم کرد.	I'll never forget this.
خوب به خاطر دارم که من آن زمان جرأت باور نکردن این مطلب را نداشتم	I remember that I dared not disbelieve it then
من این را از روی نقشه سلطنتی که به فرمان شاه ترسیم کرده بودند حساب کردم.	as I measured it myself in the royal map made by the king's order
مبلغ معتنابهی را که خود به یکی از بانک داران عمده ما سپرده بود بازستاند	to withdraw a considerablesum deposited by him with one of our leading bankers.
هرچند پیش از ان سر همین درس تنبیه شده بود.	though he had already been punished over this lesson.
او در حالی که محکم به جارویش چسبیده بود و در هوا معلق زد. از درد نفسش بند آمده بود.	he rolled over in the air, clutching his broom, completely winded.
عده بیشتری هم بودند که چون بر حسب تصادف از دور و به طور مبهم	a still greater number who, chancing only to hear of him distantly and vaguely
مادرش از دوران جوانی در همان خیابان یک مغازه خرازی داشت	where she had kept a notions shop ever since she was a young woman
در همان حالی که از ضربات او وحشت داشتم	while dreading the blow
به واسطه نیشی که از صدای استهزاء آلوده چند لحظه پیش ناخدا به جان او فرو رفته بود	stung by the mocking voice that had last hailed him
این جور که مردم دارن خو نه می سازن	the way people are rebuilding
در پایان با یه عده غریبه همراه میشی و باید ازهمه چیزهایی که دوستشون داری دل بکنی	in the end, your reward will be to go away with strangers from all the things you love best
زیرا اگر تو جزئیات آن را چنانکه بوده است برای من حکایت کنی	for if thou wilt report them to me as they were
در آن دم دیگر بیهوده دلهره بیمه بودن یا نبودن صاحب مسافرخانه را نداشتم.	I no more felt unduly concerned for the landlord's policy of insurance.
حرف سر همان است که این روانشناسی لعنتی همیشه دو سر دارد!	well, you see, it all lies in this that this damnable psychology can be taken two ways!
به اهمیت حفظ وقار و تشخص خود با محکم کاشتن پاهایش توجه زیادی دارد.	this standing captain is all alive to the importance of sustaining his dignity by maintaining his legs.
اما موفق نشده بود زن خود را در مجالس آنان وارد کند.	but he had never succeeded in making his friends accept his wife.
دلیل اینکه به چنین درد غیر قابل تحملی دچار شده بودم را به یاد آوردم.	I could remember the reason why I'd committed to enduring this unendurable agony.
ماهی سیم دریایی تازه تندروی و کرپ سوزت در فهرست غذایشان بودند.	fresh tandoori pomfret and crepe suzette on their menu.
بدی را نصیب کسی کند که در پی آنست.	the evil for him who goes to look for it
از حیرت و تعجب دود کردن پیپ خود را فراموش کرده بودند.	orgot to smoke in their surprise and interest.
به خصوص اصرار او به اینکه در ته قایق پوشش اضافی چسبانی بگسترند	particularly his solicitude in having an extra coat of sheathing in the bottom of the boat
اما راستی که چقدر همة این کارها پست است!	but how degrading it all is.
آنگاه زنگ کوچک خود را بار دیگر به صدا درآورد	he rang his little bell again
خوشحال از این که کسی از رفت و آ مدش خبردار نشده	congratulating himself that nobody knew of his escapade.
اما این دگر از خصوصیات من است و من در ذات حیوانم!	such is my fate and I am a beast by nature!
گویی تردید داشتند که کارش آن به نتیجه برسد.	as though sure this couldn't work.
در باک و رفقایش هیچ قوت و روحی نبود.	no snap or go in him and his fellows.
یک پیمانه آبجو تلخ و یک تکه شیرینی سردشده که از آبجو هم سردتر است	a pint of bitter and a slab of cold pie, so cold that it's colder than the beer.
بلکه فقط اندکی سبب دلداری و تسکین خاطر خود را فراهم آوردم.	I gave some ease to myself.
نیز با همان سرعتی که خوابش برده بود بیدار شد	waking up, as suddenly as he had fallen asleep.
از من شما نصیحت که نه حالا و نه هیچ وقت به فکر کورتاژ نیفت ین.	so the very best advice I can give you now is that you do nothing at all now or at any time.
ولی در همان لحظه به این اندیشه افتاد که اگر اکنون سرنوشت او تعیین نشود دیگر هرگز تعیین نخواهد شد.	but at that moment the thought occurred to her that her fate would be decided now or never.
بعد از ظهر در آشپزخانه مشغول شستن لباس بودم.	in the afternoon, I was busy getting up linen in the kitchen.
کاتاواسف گازی به خیار خود زد و جواب داد	biting with a juicy sound into a cucumber.
دریافت که هنگ او به حادثه وحشتناکی دچار شده است	the general realized that something dreadful had happened to his regiment
چندان که از فرط کم خوابیدن و زیاد خواندن مغزش خشک شد و کارش به جایی رسید که علقش را از دست داد.	what with little sleep and much reading his brains got so dry that he lost his wits.
اما قصد داشت که در صورت امکان حتما به خانه واندا بیاید.	but still she was intending to come if she could.
در حالی که از این بشارت نخورده مست شده بود.	who was quite confounded at the metallic sound of these golden words.
فقط مثل همیشه تأکید کرد که خودش نباید پایین میز بنشیند	only made the usual stipulation of not sitting at the bottom of the table himself,
هنوز روز به پایان نرسیده بود که پا یک بیش از تمام عمر خود به کشیدن سورتمه مشغول بود.	ere the first day was done he was pulling more than ever before in his life.
موژیکها به صورت جمعیت انبوهی به طرف انبار آمدند	the peasants had come in a large crowd to the barn
دیک تا به حال چیزی به درخشانی پوست او ندیده بود	he had never seen anything so dazzling as the quality of her skin
فکر کنید که او شاید هرگز از محبت مادری یا گرمی کانون خانوادگی برخوردار نشده است	think that he may never have known a mother's love, or the comfort of a home
سپس برای ربرتا شرح داد که چرا آنجا را دوست دارد	there was more talk as to why he liked to come out
سرم را پایین انداختم و به صدفی که در دستم بود نگاه کردم.	I glanced down at the shell again, rather taken aback.
باید پیشنهاد او را برای آمدن به اینجا رد کنم.	I must decline the proposal it contains to pay a visit here.
تنه خاکی رنگ بیدهای کهن سال و پر شاخ و برگ در آب منعکس شده بود.	branchless old willows mirrored their grey backs in the water
دو یا سه مشتری که بر میزها فرو افتاده و به خواب رفته بودند	the two or three customers fallen forward asleep
همه تو سرسرا نشستیم و چن گیلاس عرق خرما خوردیم.	we all set on the gallery and had several toddies.
ولی یکباره کلامش را قطع کرد و چیزی از مادرش پرسید.	but she interrupted him to ask something of her mother.
ولی تریسی ناگهان متوجه شد که اتاق خالی نیست.	suddenly she realized that the room was not empty.
من روی ادوارد حساب کرده بودم که طرف منو به گیره.	I'd counted on him to be on my side.
اینک صنعت پوست و دباغی کشور در دست اوست.	it already owned the leather and the grain business of the country.
به خاطر این کار دستگیر و زندانی خواهی شد.	I could have you arrested for that.
کنتس ناگهان چنان سرخ شد که این سرخی با چهره لاغر و با ابهت و فرتوت او تناسب نداشت.	the countess began, with a blush that looked very strange on her thin, dignified, elderly face
من تو را به جای یک مست گرفتم و تو هم واقعاً مست بودی	I simply took you to be drunk, and you were drunk, too.
آنا هنوز همان لباس مخصوص تماشاخانه را بر تن داشت.	she was in the same dress as she had worn at the theater.
بلکه تا حد زیادی با واقعیات سرو کار داشت.	but immensely matter of fact.
یا سختگیری قانون را در مورد پسر او نارو بدانند.	or resent any legal injustice that might have been doneher son.
شاید این سه ماه تا شش ماه تمدید شود.	perhaps the three months may extend to six.
وقتی این کثافت و روی پیشونیت دیدم گفتم کارم ون ساخته شد و تو رفتنی شدی.	when I see that truck I thought we'd lost you
از روزی که آن مشت را خورده بود از تخت پایین نیامده بود.	he had lain in his berth
علاوه بر آن ظرفیت فراوانی برای کار جسمانی داشت.	a stupendous capacity for work.
ولی هیچ کس به این سر و صداها جوابی نداد.	but, attracting no attention
اما ناگهان درخشش گنج پیش چشمانش نمودار شده بود.	but the shining spectre of the treasure rose before him
در غیر آن هم مردن در کنار موجودات بشری برایش به مراتب بهتر از ماندن در آن مزارع خالی و دوردست است.	if they did not, it would be better, he thought, to die near human beings, than in the lonely open fields.
زیرا افراد بشر هرگز موفق نخواهند شد نان را به طور عادلانه بین خود تقسیم کنند.	for never, never will they be able to share between them!
به عنوان کسی که تنها این حق را دارد	as the only one who has the right of doing so
بعد دیگر به شکلی غیرمنطقی در همین نامه همین مطالب به صورت مکرری نوشته شده بود.	as she had done before and then ran on, wildly, in the same words, over and over again
حرص بی حد و حصر جمع آوری مال و ثروت اکنون چون طاعونی د رخانه دل وی ریشه دوانیده است.	avarice is growing with him a besetting sin.
به همراه مردی بازگشت که صورت خود را در دستمالی پنهان کرده	returned followed by a man with the lower part of his face buried in a handkerchief
که شروع اصل داستان را به تأخیر خواهد انداخت و باعث خواهد شد که اشخاص عجول ما را نبخشند.	which would delay the progress of the story to an extent that impatient people would not pardon.
ارباب به عنوان نماینده ناحیه ما به آنجا رفت.	whither my master went as the representative of our district.
عزیزم! راستی که او برای همه ما فقدان عظیمی بود.	my dear this is a great loss for us all
یگانه شانسی که برای هیرتن باقی مانده است آن است که کاری کند تا شاید اندکی رحم و انصاف طلبکارها را به سوی خود جلب کند و بدین ترتیب بتواند باز در آن خانه باقی بماند و لقمه نانی بخورد.	the sole chance for the natural heir is to allow him an opportunity of creating some interest in the creditor's heart, that he may be inclined to deal leniently towards him.
این مدت نیز در تماشاخانه مشغول خمیازه کشیدن و چرت زدن بودم.	those I have been dozing and grumbling away at the play.
برای شام به آشپز دستوراتی داد و به اتاق خواب رفت.	gave instructions in the kitchen for supper, and went to the bedroom.
به طور مبهم به یاد میآورد که چنین عبارتی را از کسی شنیده است.	vaguely recollecting she had heard some similar saying from someone.
یک ابر که آسمان را در خلاف جهت پیمود برای زیر و زبر کردن عالمی کفایت کرد.	a cloud traversing the sky out of seasonsufficed to make a world crumble.
خب به این فکر کردم که او نیازی به چک کردن پشت سرش ندا ره.	I supposed he didn't need to check.
ولی من نتونستم ببینم چی رو نشون می ده.	but I couldn't see what it was.
همه با دقت مشغول درست کردن نوشدارو به شین.	I want you to brew them carefully
دریاسالار یکی از اولین کسانی بود که غرق شد	the flagship had been among the first to sink
با این همه هنوز هوا گرم و آفتابی بود.	although still warm and sunny.
وقتی بی معطلی و بدون اعتراض اطاعت کرد حیرت زده شدم.	I was surprised when she complied immediately and without objection.
که من آنچه بتوانم تدارک قلم از برای خود نمایم	as affording me the means of increasing my stock of pens
بر گرد بنای در حال سوختن بیشهء دیگری از دود به وجود آورد.	begirt the blazing edifice with a new forest of smoke.
بیش از نیمی از سرمایه و اوقات فراغت خود را صرف درمان و رسیدگی و آلام او کرد	spent half the value of his store on medicines and pastimes
خود را پابند آن تعهدی بدانم که مذهب نادرست و باطل به من تحمیل کرده است.	be bound by what a false religion laid upon me.
می تونستم بهش سنگ ببندم بینداز مش تو دریاچه.	thrown it in the lake here, maybe, with a stone in it?
تا آنکه حس کرد که اگر همان دم از آنجا نرود از پا در خواهد آمد.	, until she felt she must leave or fall
وقتی نقاشی مرادید ابروهایش را بالا برد و به راه خود رفت!	when he saw my drawing he just raised his eyebrows and walked on.
اگر این فرصت را از دست بدهد دیگر بازگشت آن میسر نخواهد بود.	if he let it slip it would not return.
البته در روستاهای سر راه مجبوربودند خیلی آرام از پیاده روها حرکت کنند.	even going through the villages it was only necessary to putt along the sidewalks at walking speed.
من که از این درخواست ملاقات نابهنگام به هراس افتاده بودم گفتم اول خودم با او صحبت خواهم کرد تا ببینم که چه مقصودی دارد.	I shall ask him what he wants first,' I said, in considerable trepidation.
سه بار گوش او را محکم بگیرد و بکشد	lug him thrice by both ears
به خاطر حفظ اصول و قواعد فن که از آن صحبت کردم	in trying to observe the principles I have spoken of
خودش روی مبل دیگری نشست و مرا هم در کنار خود نشاند.	herself taking another, she called me to her side.
زیرا ما تا دو ساعت دیگر در این جاده به چندان مرد مسلح بربخوریم	for we shall not have been above two hours among these cross roads before we see
که همه از چیزهای سبک وزن و کم قیمت بود.	but all flimsy and gaudy, of little substance and less worth.
ولی او آن قدر نگران شیوع وبا در محلات قدیمی بود	but he was so concerned with the outbreak of cholera in the colonial district
اگر بنا باشد دریچه قلبم را به روی عشق این دخترک بگشایم و او مثل فرزند خلف مادرش باشد از آب درآید واقعاً که در آن صورت دچار وضع عجیب و غیرقابل تحملی خواهم شد!	I should be in a curious taking if I surrendered my heart to that young person, and the daughter turned out a second edition of the mother.
باید بگویم که حبس شدن برای شما مسئله چندان مهمی نیست.	I dare say it is no great matter for you to be locked up.
من یک لقمه نان و پنیر داشتم که شما را مهمان کنم.	I would have offered you something.
ابتدا نام خود و سپس نام دو نفر دیگر را بر روی کاغذ نوشت	wrote on the first his own name and on the others those of his two companions
اون وقت نمی دونم چی شد که به خودم اومدم و پا به فرار گذاشتم.	then I dunno I just sort of came to my senses and ran for it.
سپس دوباره اتومبیل تند کرد و از نظر دور شد	then it gathered greater speed and disappeared.
همان موقع خدمتکارش یک سنی پر از تنقلات آورد و تعارف کرد.	at the same time that a tray full of refreshments was introduced by his servant
بیایید این جا تا من برات ون چای بریزم.	come to me, and I will fill it.
وقت خواب که شد با بام بلند شد و دستش را دراز کرد	when it was bedtime the old man rose up and held out his hand
ولی در عوض به دیگران اعتقادی وافر داشت و به آنان امیدوار بود.	partly in modest propitiation of everybody else.
از اینکه فرصتی رو از دست بدم متنفر بودم.	I hated knowing that I could be losing my chance.
زیرا از طرفی تو ناخوش و بستری شده بودی	partly because you were poorly
بعد صندلی را تا سر حد امکان به کنار دیوار نزدیک کرد	dragged it back close to the wall
جاستین کلاه بزرگ حصیریش را جابجا کرد تا صورت و گردنش از آفتاب در امان باشد.	carefully adjusting her big straw hat so her face and neck were well shaded.
من نمی خوام که تو مجبور به شی برای من فداکاری کنی.	I don't want you to have to make sacrifices for me.
امسال درس اقتصاد را برداشتم اشتباه کردی موضوع بسیار راه گشایی است.	I've elected economics this year very illuminating subject.
اما وقتی مدیر مدرسه برای سخنرانی از جایش برخاست حرفش را قطع کرد.	but at that moment the headmaster stood up to speak, and he broke off.
من این فاجعه را به عنوان یک واقعیت قبول میکنم و نهایت تلاشم را برای کمک به شما و او به کار خواهم برد.	I accept the calamity as an accomplished fact, and am doing my best to help both her and you,
در صورتی که بنا به فرمایش جنابعالی اگر اعضای بدن من مجبور باشند سردرد را احساس کنند	if the members are obliged to feel the suffering of the head
دو بار گردن درازش را چرخاند و آهی کشید.	turned his long neck twice this way and that, sighed
من بعدا یعنی مدت مدیدی بعد متوجه این موضوع شدم.	I only noticed it later.
هر چه باشد در آنجا ما از سرما و باران بیش از وضع فعلی خود در زحمت نخواهیم بود.	we cannot be damper, or colder, in the rain than we are here.
تا اینکه ناگهان به خود آمد و کار دوخت	till with a sudden recollection she returned to her sewing
هرگاه امروز برای تو پیش آمدی روی داد قبل از هر کار به فکر من باش.	if anything happens to you to day, turn to me before any one!
من بر اثر خوانده این نامه بود که همه چیز را خوب دریافتم.	I understand all by means of this letter, and understand it correctly.
لیکن وی را نه در با یافت و نه در اطاق خوابش	but she could not find her either in the garden or in her own room.
من وقتی که به گرگ تبدیل شدی دی دمت.	I've seen you as a wolf.
با مردم تازه که متعلق به محیط وی نبودند	people quite new to him, belonging to a different world
مرا وادار نکن به اجبار تو را با خودم ببرم.	don't oblige me to compel you.
من به فکر افتادم و فهمیدم که آدم مقدس نیست مگر وقتی که جزئی از یک کل با شه.	I got thinking how we was holy when we was one thing
مدتی طولانی از آن جا که بودم هیچ صدایی نشنیدم.	I hadn't heard any sound from there for a long time.
شب گذشته نکته با ارزشی در این خصوص گفته بود.	had made an interesting comment the day before on that subject.
هیچ چیزی نیست که خوشحالم کند یا برایش غصه بخورم.	I've nothing to grieve over and be comforted about.
یکی دو کلمه کافی است تا لهوین از حالش باخبر شود.	if it were but two words only, to let him know that all was well with her.
اینجا حتی یک نفر هم به من وفادار نباشه	none here are loyal to me
که هفتاد مایل آن در امتداد ساحل است و یکصدمایل بدرون خاک و به سرزمین داخلی پیشرفته است.	being seventy miles along the coast and a hundred miles deep into the hinterland.
درست مثل ماهی ای که با قلاب از آب بیرون کشیده شود.	as if she had just fished them out of a pond.
زیرا خانه یا تکه زمینی ندارند که خاطرات خود را در آن حفظ کنند	they have no home, no corner of the earth wherein to house their memories
دست بار دیگر دنبال کار را گرفت و پیکر بار دیگر بر کفش خم شد.	then the hand dropped to his work, and he once more bent over the shoe.
چیزهای زیادی هست که باید به تو یاد داد.	there'd be so much to teach you.
چون می تونم با قطار ساعت هفت راه بیفتم.	it would be all right, wouldn't it I could go on the seven.
هیچ وقت کسی رو نداشتم که به هم دلداری بده	I've never had anything to sustain me
حتی با روشن کردن شمع آن را جشن گرفتند.	they even lighted candles and celebrated novenas.
اگر چیزی دارید به من بدهید بخورم یا در جیبم بگذارم.	if you have here anything to eat that I can take with me, give it me
با این حال عبور از آن جاده چندان دشوار نبود و مناظر میان راه هم بسیار دلکش بودند.	but easy to get over, and the scenery fine.
لری به صورت درخشان و تمیز او نگاه کرد.	he looked at her, her clean and shining face.
با دوربین به انبوه قشون خود نظر افکند و مشاهده کرد	looked through a spyglass at the streams of his
او نیز بعد از آنکه مانند سایرین دوری رقصید	when she had gone through her figures like the others
ما به زحمت قادریم خودمان را زنده نگاه داریم.	we have scarcely been able to keep alive.
بعد هم مدتی وقت خود را صرف کارآموزی کنند	in time makes a 'prentice of him.
زیرا هرگز حالش مانند امشب خوب نبوده درصورتیکه سه روز پیش مشرف بم رگ شده بود.	for he never had felt better than this evening.
اندام لرزان و چهره عبوس پیرمرد در جبه سفید ظاهر شد	the stern figure of the old man in the white dressing gown looked out.
بی حرکت روی صندلی ای در زیر نور آفتاب نشسته بود	remained motionless on a skylight seat
تا هر کس که از آن به درون آید با گشاده رویی پذیرفته شود.	for anyone to walk in and be welcomed.
که قادر بود غلامان و کنیزان را هر چه قدر هم قلدر باشند به کار وادارد.	who could galvanize the most shiftless negro into energy.
ولی جین به آن ضربه زد و لگن با صدایی زنگ دار به زمین افتاد. البته نیک آن را نشنید.	but she thrashed and knocked it onto the floor with a hollow bonging sound which he also couldn't hear.
اما چون مدت زیادی از آن گذشته اثر آن از بین رفته است.	but that time had passed and the effect was grown faint.
با وجود اینکه بیرون روشن و هوا صاف بود	, and although the day was brilliant out of doors
که قسمتی به دربار و قسمتی به ملاکان مختلف متعلق بود.	whose serfs paid quitrent and could work where they pleased.
با فاصله یک سال هر دو به یک طریق از جهان بروند.	to die in the same way within a year of each other.
باعث شده است تا این خیالات پلید به سر تو بزند	has engendered these lawless thoughts in thee
بهترین کاری که اکنون نسبت به آن کله از ما ساخته است این است که دعا کنیم ابزارها طاقت بیاورند و سر همچنان آویزان بماند.	the best we can do now for the head, is to pray heaven the tackles may hold.
محض رضای خدا نگذار وارد بحث و جدل بشویم!	for heaven's sake, don't let us indulge in recriminations!
لیون لیموناد هروری پر از خرده یخ را برایش برده	she sent for her husband' s daily glass of lemonade with chipped ice
زنک جواب داد بیا تو و من رفتم تو	COME in, says the woman, and I did.
کالسکه ران پیر با شانه های پهنی که ژاکت کوتاهش با قیطان دوزی های نقره ای به سختی آن را در خود جا داده بود	the old coachman, with his broad back filling a short, silver braided jacket,
آنقدر راه برود تا از خستگی بیفتد سپس خشنود از چنین روزی که با کار گذرائیده است بخوابد.	walk till she dropped from exhaustion, and then fall asleep, content with the day's work.
جرأتی یافت و از گوشه پنجره بیرون آمد و به سویش دوید .	he encouraged, he leaped from the sill and ran to him.
بر استی در پاسخ اعتراض شاه چیزی نداشتم بگویم	truly I had little to say in return
من به کمکت احتیاج دارم تا اینو متوقف کنم.	I need your help to stop this.
همه خبر داشته باشند که این دارائی از خانواده بیرون رفته است	everybody was to know that the property was gone out of the family
چند تن از ملاحان من در کشتی به واسطه سرسام خاص مناطق بحری استوائی در گذشتند.	I had several men who died in my ship of calentures
جولیا مدتی از هنری کرافرد توجه دیده بود حتی جلبش کرده بود.	but she had very long allowed and even sought his attentions,
من قصد ندارم خودمو به خاطر اون کاهن لعنتی به کشتن بدم!	I'm not running myself dead for that damn druid!
اما بیشتر به پنج یا شش فرانک فروخته شدند.	but mostly they went for five or six.
همه چیز باید درست به حال خود باقی بماند.	everything must be left exactly as it is.
دیگر آدم مجبور نبود آن قدر آرام دراز بکشد تا یک طرف تنش از عرق خیس شود.	not have to lie still until one spot was sweat saturated.
البته منظورم این نیست که تو خدا نکرده کاری بکنی که	course I don't mean you'd ever do anything that would put
من چنین کاری نخواهم کرد زیرا وقتی شیر خشمگین شود اول کسی را که بدرد منم.	for if I anger him, the first he'll tear in pieces will be myself.
مشغول تایپ کردن مشتی چرت و پرت در کامپیوترم شدم	I start typing drivel into my computer
از جا برخاست چنان که گویی تصمیم دارد آن را در بخاری بیندازد.	rising with the letter as if he would put it in the fire.
می دونم چه قدر وقتتو توی کتابخونه تلف کردی.	all those hours in the library.
به عقیده ناچیز من بیش از ده هزار کشتی که همین حالا در دریا هستند در خطر نبودیم.	man, and all of us, were in no more danger then, in my poor opinion, than all the crews in ten thousand ships now sailing the seas.
در ضمن یک اشکاف پر از کلاه سیلندر هم در ته آن قرار داشت.	including one window full of beaver hats and bonnets.
تمام افرادی که در این ماجرا شرکت مؤثری داشتند پیشاپیش راه افتادند	as many of the crowd as could achieve the feat, got a little ahead
اونوقت مردم میان می گن که من با اون بودم.	I would be identified as having been with her.
ولی من یقین دارم که تنها در چنین موقعی شما خودتان هستید.	I think it is only then that you are yourself.
چون در چهره او جز عزمی جزم چیز دیگری نخواند	reading in his countenance nothing but severity and determination
شاید به این دلیل که با بررسی کارهایی که انجام شده بود	perhaps, because the inspection of what had been done
اما هفته ی آینده به نزد تو بازمی گردم.	but I'll be back next week.
می تونم کار معمولی بکنم و روزی یک و نیم دلار بگیرم.	I could earn a dollar and a half a day, common labor
به قدرت عشق و محبت خود به ایشان پی برد.	feeling all the strength of her love for them.
پدران نیز از فرزندان یاد خواهند گرفت و به تدریج خواهند آمد.	the fathers will hear of it and they too will begin to come.
این گوشمالی باید همین امروز صورت گیرد. قبل از تماشای آن من میل ندارم از اینجا بروم. اما	I am very anxious that she should get it, without delay, and I shall stay till she does.
به جای مخصوص خود در کنار پنجره رفت و شروع به خواندن کتاب کرد.	withdrawing to his accustomed window recess, he began to read it.
اما همین که روسیه به مخاطره افتاد به یکی از فرزندان خود نیازمند شد.	but as soon as she is in danger she needs one of her own kin.
لیکن خود بسیار پیش تاخته و در صدر نشسته بود.	but he advanced his own position a good deal.
به او پیشنهاد شده است برای همراهی و مشارکت اتاقی که ما اشغال کردیم	she has only been offered our company for this evening and a share of the quarters we occupy
چون برای کار مهمی با شوهرش در گفتگو بود.	but she and her husband were so busy that I couldn't get to speak to her.
از سر تا پایش را با کج چلقی صابون زد.	soaping himself furiously from head to foot.
صدا به سرعت بیشتر و ثابت ماند و موتورها به نحوی موزون در حال چرخیدن بودند.	reached a high, steady hum, and leveled off.
چوب دستی تو باید از همه بهتر با شه.	yeh gotta have the best wand.
آنقدر غرق در افکار خود بود که برای چندین روز چیزی ندیده بود	so sunk had she been in thought that she had seen nothing for several days
اشاره او به ازدواج بار دیگر افکار تلخ و تشویش آمیز گذشته را در من بیدار کرد.	bitter and agitating recollections were awakened by the allusion to marriage.
خیلی اهمیت دارد که این کار را انجام بدهید.	it is essential that you should do it.
تفنگ را برداشت و دو تیر به سوی پدربزرگ انداخت.	she fired both barrels of a shotgun at her husband
اسمی از زنش نبرده بود. فقط گفته بود خواهری دارد.	he had never mentioned a wife, and he had acknowledged a sister.
اما می خواهم یک دقیقه به حرف من گوش بدهی.	but I want you to listen to me for a minute.
ارباب من به قدری نجیب و جوانمرد است که بارها و به کرات وعده آن جزیره را به من داده است.	he is so noble and generous that he has promised it to me ever so many times.
بسته خود را از روی این شانه بر آن یکی نهاد و با زحمت و دشواری به راه خود ادامه داد.	he changed his little bundle over to the other shoulder, and trudged on.
مشروط بر اینکه حیوان مابین ساعت یازده و دوازده شب یا روز بزاید	provided she conceived between eleven and twelve either of the day or night
کشتی ای که از بخت خوش مقارن با همان ساعات وارد لنگرگاه شده بود.	just then, as luck would have it, entering the harbour.
به علاوه تو هم با من باید همراه باشی.	besides, you will accompany me
تمام شب در این باره فکر کرده بودم و دی گه میدونستم اون دختر چه حالی داره.	I had beenthinking about it all night, and I realized how badly she would feel
زخمش رو با براندی شستیم و خوب پانسمان کردیم وگرنه نمی تونست روی پا بایسته.	, he was pretty well laced with brandy or he'd never have had the strength to go through with it all so well.
دنبال فکری را که در سر داشت گرفت تا نتایج احتمالی آن را برآورد کند.	traced the thought in his mind to its possible consequences.
استخر بزرگ و سبز رنگ باغ نیز پر از قورباغه بود.	a big green pond full of frogs.
غرض از ذکر این نکته این نیست که بخواهم چیزی از محاسن آن بانوان بزرگوار که در چشم من بسی ارجمندند بکاهم	I do not mention, or intend, to the disadvantage of those excellent ladies, for whom I have all manner of respect
بایستی یا همچنان ایستاده بماند یا دستش را از بیخ بکند.	he had nothing for it but to stand upright or pull his hand off.
شش تن دیگر نیز قرار داشتند که یکی از ایشان روی دست نویس خود خم شده بود	there were some half dozen persons, and one of these was bending close over a manuscript
مگر آنکه قبلا اوراق و اسناد خود را تهیه کرده باشد.	unless they previously produced their papers.
که دور از چشم مردم مقصود پلیدش را در مورد دخترک جامه عمل بپوشاند.	for that vile purpose which already he entertained inregard to her.
امروز صبح با آمدن اگنس و شهرش دیرتر از وقت معمول چیده شده بود	which because of the visitors this morning was unusually late
یا دو دست خود را از دست خواهم داد.	or my hand will have lost its cunning.
نه اینکه من بخواهم او یا هرکس دیگری را برای خواستن ادوارد سرزنش کنم.	not that I blamed her or anyone else for wanting him.
من هر کاری که از دستم بر به یاد انجام می دم.	I will do my best.
آنگاه با ین فکر افتادم او آنقدر برای من اهمیت قائل نیست که مدت زیادی برای خاطر من از عصبانیتش جلوگیری کند.	but then I thought that perhaps she despised me too much to feel any resentment against me.
من امشب این همه راه نیومدم که فقط با شما خداحافظی کنم.	I didn't walk all this way here tonight just to tell you all good by.
از با گوشت گوسفندی که جیرة آن روز بود از نانوا خانه رسید.	came in from the bakehouse with the loin of mutton which was our joint stock repast.
ولی شب به خیر را با صدایی مطمئن ادا کرد	but said good night again, in a steady voice
یقین داشته باشید که تاب حال قلب هیچ مردی به این شدت برای زنی به تپش درنیامده است.	my heart is set, as firmly as ever heart of man was set on woman.
امّا این نیش را در خاموشی نوش کردند و حرفی نزدند.	but swallowed the home thrust in silence.
یا باید من محبوب شما باشم و یا باید بمیرم.	to be loved by you or to die.
که ناگاه تمام اعضای بدنش به لرزه در آمد	when a strange trembling seized her
این مرد پس از اینکه نگاه خود را در تمام اطاق به حرکت درآورد	after casting a hurried glance round the room
هر کاری که از دستم برمی آمد انجام دادم.	I have done all that I could.
چند تکه ماهی استخوان دار که خوشمزه بود و در آرد خوابانده شده و در روغن مایع با چیپس سرخ شده بود.	a piece of boned fish which tasted delicious, dipped as it was in floury batter and fried in the smoking well of liquid fat along with the chips.
من همان کسی هستم که شما او را خواسته بودید.	I am the person you inquired for.
کرست از پارچه حریر بود که در آن روزگاران مد روز بود.	it was of a white damask which was fashionable in those days.
این منم که باید خجالت بکشم نه تو .	I'm the one to feel shame and I do.
ولی هیچ ماشین آتش نشانی برای فرونشاندن آتش به محل نرفت.	but no fire engines had come to put it out.
برگرد سر جایت و آن را همان جا بخور!	back to your post to eat it,
رو در رو از خودتان بپرسم از من چه شکایتی دارید.	ask you to your face what you had against me.
بدون از دست دادن ضربان قلبم به او گفتم	I told him without missing a beat.
اما کار مشکلی بود که زنبور زنده را روی قلاب بگذاریم.	but it's a ticklish job to put a live wasp on the hook.
به نحوی که اگر در کشش بعدی وال یکی از آن دو بیرون آید دیگری به وال بند باشد.	so that if, in the coming drag, one should draw out, the other may still retain a hold.
از آن برخورد به هیجان آمده بودم و در ضمن که سعی داشتم حواس خود را جمع بازی شطرنج کنم خیال من سرگرم کار خود بود.	I was excited by the encounter, and my fancy worked busily while I sought to concentrate myself on the game I was playing.
سرگذشت من با این پنج انگشت دستم نوشته شده است.	whose life is written by these fingers.
غذای گرم و نرمی برای ناهار من فراهم کنید	get me ready something hot for breakfast
تو دیگر وقت را به این طور آمدن و رفتن تلف مکن و الا تا یک سال هم این همه بز را رد نخواهی کرد.	don't keep going and coming in this way, or thou wilt not make an end of bringing them over this twelvemonth.
خود را بالا زده نگاهی جدی و خشن به اطراف افکند و به راه خود ادامه داد.	with her usual threatening gesture and glancing sternly round, moved across the room.
منالان یک پزشک خواستم و اگر بمیرد به عقیده من شما علت آن هستید.	I have sent for one, and, if she dies, I shall hold you responsible.
آنجا در ساحل پیاده شد و به گروه اکتشافی پو یست	went ashore there, joined a discovery party
یعنی آن دیوانه تصور نکرده بود که دانشجو دانشجوی واقعی نیست	his conviction that the bachelor was not the bachelor
با این همه به نظر با هم متحد بودند	yet the party gave the impression of a unit
باری لازم نیست در این خصوص به تفصیل صحبت کنم.	which I need not explain
که معلوم نبود چگونه وقت پیر شدن را به دست آورده بودند.	that no one could explain how they had time to grow old.
من قادر نیستم دو کلمه پشت سرهم حرف حسابی بزنم.	I am not used to stringing words together properly
یک کم نقشه خوب کشیدن و ساختمان محکم درست کردن	getting a bit of good contriving and solid building done
همسری که بتواند با خرد و منطق خود به او یاری رساند	who could help her husband out with reasons
که میان آنچه به شکل بزرگ و نامحدود و نامعین در نهادش بود	between something infinitely great and illimitable within him
در دقایق عزیمت به سفر و تغییر برنامه زندگانی نیز کام لا در حال تفکر هستند.	men capable of reflection are generally in a serious frame of mind.
او جرأت نخواهد کرد از این پس حرفی به او بزند.	that he had no heart to say anything more to her.
وقتی در این خاک غنود دیگر چیزی باقی نخواهد ماند که نشانگر این اختلاف باشد.	when he too lay here there would be nothing left living to mark the fact.
من با تو در این مورد مخالف نیستم .	I don't disagree with you there.
مرد او را به اتاق نشیمن که یک زن چاق و چله مو پلاتینی در آن نشسته بود و محو تماشای تلویزیون بود راهنمایی کرد و گفت	the man said as he led her into the sittingroom where a large platinum blonde woman was gazing rapturously at the TV screen.
اگرچه برای برخورداری از حمایتش به قدر کافی نزدیک بود.	but close enough for his protection.
از نظر یک بیننده شاید حضوری به زحمت قابل درک.	to an observer therefore, perhaps barely there.
من بجز این جوابی ندارم و شما نیز بجز این نباید چیزی بپرسید.	that was all that was to be said and all he had any business to know.
اینجا بود که هراسانی از خواب بیدار میش و د.	that was when he would struggle up from sleep
همه شوم می گن حالا که این دوا اثر نکرده دی گه هیچ داوئی اثر نمی کنه.	the drug stores and they tell me if this one won't work that none will.
حتی به اندازه جای یک سکه هم در سراسر بدنش از پشت گرفته تا جلو و از گردن تا نوک پاها خالی از خال کوبی نیست.	there was not a square inch of his body that was not tattooed, front and back, and from his neck to his toes.
کمی کمی ماشینم را هل دادم و بعد سوارش شدم	I cranked up the car and got in.
به هر حال یک جلسه درس در هفته خانه خراب کن نخواهد بود.	a lesson from time to time, that wouldn't after all be very ruinous.
صاف بود و تیرهای تیره آن کام لا کنده کاری شده بودند.	was flat, and it had dark beams richly carved.
به دو تکه نان و مقداری پنیر بر روی میز اشاره کرد	pointing to two slices of bread and a lump of cheese on the kitchen table.
او به شما خواهد گفت که دلی مهربان و صمیمی دارم.	I am sure she'll tell you I'm affectionate.
زیرا هر چند پیشه خاص من جراحی یا طبابت در کشتی بوده است	for although my proper employment had been to be surgeon or doctor to the ship
این صورت شتاب کرده و به سرعت به سمت او آمد	the apparition advanced more quickly towards her
اکنون همین مانده است که از نظر گاه باستان شناسی و سنگواره شناسی و پیش از توفان نوح او را بزرگ کنم.	it now remains to magnify him in an archaeological, fossiliferous, and antediluvian point of view.
با این همه به سبب اینکه حق مهر و محبت او را ادا کرده باشم	but, however, in return for his favours
بعد در کنار پرستار دیگری که حالا برگشته بود نشست	having done so, she resumed her seat by the side of the other nurse, who had by this time returned.
با احترام و در رفاه و راحتی زندگی خواهد کرد.	he would be well respected, comfortably provided for.
باز سعی کرد خودش را کمی دیگر به طرف راست بکشد.	he made an effort to stretch yet a little farther to the right
کیک عروسی هم که آرام و قرار را از او گرفته بود بالاخره تا آخر خورده شد.	the wedding cake, which had been a great distress to him, was all eat up.
صدایی مردانه گفت برگشتم و آرزو کردم که این کار را نکرده بودم.	I turned, and then wished I hadn't.
تا ما همه به اتفاق آراء حاضر شدیم او را از حقیقت قضیه آگاه کنیم.	that with one consent we all agreed to tell him the whole truth of the matter
اگر گاهی این هوسها از حدود این کوهها پا فراتر میگذارند به خاطر این است که زیبایی آسمان یعنی نخستین و آخرین آرامگاه روح را بهتر تماشا کنند.	if they ever wander hence it is to contemplate the beauty of the heavens, steps by which the soul travels to its primeval abode.
مثل این که آدم با شه و دلش به راش نسوزه!	thout any more feeling than if he was a human!
البته دلیل بر جلب لطف و مرحمت محکمه خواهد بود.	will certainly bespeak the favour of the bench.
زیرا سایه کژ خلقی را بر چهره دژم او	for she had noticed the shade of mortification that had passed over his face
شما عشق مرا از دستم گرفتید و آزادی مرا از من سلب نمودید	you deprived me of liberty, of love, and happiness.
کمی روغن هنوز در ته آن به جا مانده بود	a little oil still lay in the wells.
دوست ندارن راجع به این جور چیزها تلفنی صحبت کنم.	I don't like to discuss this sort of thing on the phone
امیدوارم درحین پائین آمدن از اون کوه یخ زده تصادف نکرده باشه	I hope he didn't have an accident coming down that frigging mountain
با تمامی وجوه افتراقشان در این مورد خاص مطلقا یکسان بودند.	they were quite alike in this.
اعلام کرد که حتماً فردا صبح خرم و شاداب از خواب برخواهد خواست.	assuring them that she felt certain she should rise in the morning, quite well.
که رد طی یک سال زندگی مشترک نصیبشان شده بود.	during the year in which they had been married.
حتی لباس تهیدست ترینشان بی تردید بهتر از پنج سال پیش بود	even the poorest dressed better than five years ago surely
از شما ممنون شدم که مرا مطلع ساختید .	I thank you for the warning
به خود آی و به طرف من نظر کن که اینک منم در پیش تو.	awake, and look at me!
کمی بعد فقط آرزو کرد که کاش حرفی رد و بدل نشود و کمی به حال خودش تنها بماند.	to be silent and alone becoming soon her only wish
تا احساس کنی که همه چیز دوباره سر جای خود شه	so that you can feel like everything's in its place again.
اجازه داد تا او ادامه دهد و او ادامه داد	allowed him to proceed, and he continued
معهذا اکنون بچه ها رنجهای او را با بخشیدن لذتهای کوچک جبران میکردند.	the children themselves were even now repaying her in small joys for her sufferings.
متوجه اینکه چرا این را مطرح کرده بود شدم حمله بهترین دفاع بود.	I understood this for what is was offence as the best defense.
وقتی آن پیرمرد شریر از زمین بلند شد از بالا بر سر ما بانگ زد که چون خصومتی نهانی با صاحب این کتابخانه و این کتابها دارد	the old villain said in a loud voice that, for a private grudge he owed the owner of the books and the room
آسمان به رنگ خاکستری و ارغوانی در آمده بود	the sky had turned to a clear, purple tinged gray
فکرشو بکن ببین درست کردن اره و قلم و نوشتن روی سنگ و بقیه چقدر سخته!	you can't think what work it was to make the saws, and pens, and inscriptions, and one thing or another
بدانید و آگاه باشید که عشق و جنگ هر دو یکی است	war are the same thing
دختر بیچاره مادر مرده همیشه بدون مونس و همدم بود با پدری بی قید که تنها فکر و ذکرش این بود که دخترش تحصیل کرده و باسواد باشد.	the poor, motherless girl, never accompanied, with a careless father, who had thought only of making her learned.
باز هم چند قدم دیگر جلو رفتم و به سمت چپ پیچیدم.	I hesitated, then turned left
امروز حامی مخصوص و منحصر به فرد شده بود	becoming the sole protector, support, and adviser
بعدش هم باید یک نسخه از قباله ازدواج و به خاطر بچه پیش خودم نگه دارم.	get a copy ofher marriage certificate, too, and keep it for her own as well asthe baby's sake.
وقتی دوباره به سالن عمومی برج برگشتند پشت گردنشان آفتاب سوخته شده بود.	then back to the common room once more, with sunburnt necks
بلکه از آن روست که به طرزی نکبت بار و غریب بدبخت شده است.	but from his being shamefully and repulsively unhappy.
در ضمن که دیگر عضلات سخت در کشش و کوشش هستند	while all the other muscles are strained and half started
اما اگر خدا مرا به خاطر این حرف جابجا بکشد	but if I was to be struck helpless
عادت داشت غذایش را روی عرشه کشتی و با نوای همین شیپورها صرف کند.	used to dine alone in his cabin on board ship to the sound of trumpets.
بدون آن که زحمت دعا خواندن را به خود هموار کند	without the added vexation of prayers
ولی بدنه آن پر اززنگزدگی و درب وداغان بود .	but it was rust eaten and battered.
ولی به هر حال یه درصد هم امکان داره بتونم در برم.	but still it was a chance, wasn't it?
دیگر طاقت نداشتم در آن اتاق بمانم و آن ماجرا را از نو بشنوم.	I could not stand it any longer.
باد آن را پر از چین و چروک ساخته بود.	roughened by the wind.
صورت خندان او به جانب مخالف قرار گرفت و سرش را تحت فرمان خانم قرار داد.	his laughing face towards me, and submitted his head to her inspection
خودم حاضرم بروم ولی میدانم این خدمت را شما بهتر انجام خواهید داد.	I would go myself, but you'll know how to do it ever so much better.
دیدم آب به قدر سه قدم در کشتی بالا آمده	there was already three feet of water
که در فصل پیشین از آن سخن رفت و طول اسکلت آن از هفتاد قدم کمتر است.	that was less than seventy feet in length in the skeleton.
چیزی در داخل یکی از تیرهای چوبی کنده کاری شده بود.	something carved into one of the support beams
که این مراقبت اغلب اوقات به امید یافتن علایم بهبودی و تخفیف رنج و درد بیمار نبود	often watched him not with hope of finding signs of improvement
مثل یک دیوانه در آمدن به اینجا رفتار کردم	I acted like a madman in coming in here
صد و هشتاد.درجه متفاوت از آخرین باری که با او صحبت کرده بودم.	one hundred and eighty degrees from the last time I'd spoken with her.
یک کار دیگری در آنجا دارم که باید به آن رسیدگی نمایم.	I have another business deal to attend to.
قطعا نه از روی همدلی یا دلسوزی دستکم یک امروز را به اینجا آمده بود	no pity or sympathy for him, surely had come up for this dayanyhow
من نمی دونم تو چرا خودت رو تو دردسر میندازی.	I really don't know why you bother.
به پشت خوابیده بود و به مه سفید خیره شده بود	he lay on his back, staring up into the white fog
در یک خط راست غیر طبیعی در حرکت بودند.	moving in an unnaturally straight line
مثل این بود که از برطرف شدن یک خطر خیلی خوشحال شده.	as if well pleased at seeing a danger averted.
از علم و دانش برای تغذیه بیماری شناسی معنوی خود استفاده کند.	take all knowledge as mere nourishment to his moral pathology and therapeutics.
حدس من تا اینجا صایب بود که بجز بچه کسی با او نیست.	I was so far right, that she had no other companion.
جاستین نیز در گوشه و کنار و محو نبود و در صحنه آغاز به درخشیدن کرد.	she began to stand out against the scenery instead of blending into it.
نخستین کلماتی که به زبان آورد این بود که	the first words he pronounced were
حتی در این خصوص اطمینان من از شما بیشتر است	I am more convinced of it than you are
من خیلی متأسفم که تابوت ساز مزبور با دست خودش تابوت او را نساخت	I wish he had made his coffin
بلکه به راه خود در میان تاریکی و گل و شل و سرما ادامه دادند	but still kept walking on, in mud and darkness, through gloomy lanes and over cold open wastes
سال ششم مدرسه را هم به پایان رسانده است	he was likely to be in the sixth year
گفتند که به طیب خاطر و با سعی و دقت ممکن به پرستاری و مواظبت دن کیشوت ادامه خواهند داد	meant to do so with all possible care and assiduity
یک رسید استاندارد برای پول مزبور به وی داد.	he gave him a standard receipt for the money.
نیرو و استقامت نفوذناپذیر مردان مناطق کوهستانی را داشتند.	impenetrable perseverance of men from the uplands.
یایشید شما دوست ندارید که شما را به طور اختصار قربان و آقای محترم بخوانند.	or perhaps you don't like to be called 'my dear fellow' and 'old man! ' _tout court_?
اگر او به پدرش بگوید که بدون اجازه من از محوطه باغ بیرون رفته است	that if she revealed my negligence of his orders
عیب کار اینجاست که ممکن است حرفمان را نفهمد.	except he might not understand.
بلکه با غروری درونی نسبت به درستی قضاوت خودش.	but also with some secret conceit at his own accuracy of judgement.
هری در تاریکی به درِ درمانگاه خیره شده بود.	his eyes on the dark doorway to the hospital wing
مطمئنم نیستم این کار درستیه یا نه اما به جهنم.	I don't know for sure that I should, but to hell with it.
یک من در لایتناهی بالا هست همچنانکه یک من در لایتناهی پایین وجود دارد.	there is an _I_ in the upper infinity asthere is an _I_ in the lower infinity.
ما نمی خوایم به او نا فرصت بدیم تا ما رو دور بزنن	we don't want them to have a chance to sneak past us.
در آن اظهار داشتند که اگر مأمور کشیک قدری دقت و انسانیت	by adding some words to the effect, that if the relieving officer had
زیرا باید صبح خیلی زود بلند شویم و خیلی به این خواب احتیاج داریم.	for we must be up early and shall need all the sleep we can get.
اما نه آن قدر خوب که آدم را معذب کند.	but not too uncomfortably good.
تنها تغییری که در نظر من در این محیط از یاد رفته ایجاد شده بود. همان تجاوز طبیعت به گوشه و کنار این فضای بیکران بود.	I saw that the garden had obeyed the jungle law, even as the woods had done.
چهره مردی از درون یک خانه قدیمی که در سمت مقابل حوضچه واقع بود ظاهر شد و به پل نزدیک گردید.	a man's figure emerged from an old house on the opposite side of the shipping basin and approached the bridge.
که چگونه در آن وقت صد گام با آن مرد عامی را پیمودید.	when you walked a hundred paces beside that workman,
در اثر کشیدن چمدانش به نفس نفس افتاذه بود.	panting from the effort of dragging his trunk.
ممکن است خاطره و طعم تلخ گذشته را در قلب او بیدار کند.	could revive the unpleasant taste of the past in her heart
دلم می خواد یک نصیحت کوچولو به تو بکنم.	I feel so sure of it that I want to give you a little advice.
که پیر مخصوصا حال یکی از برادران او را پرسید و متحیر ماند	that he asked so confidently and precisely
سپس به دور او گشت و سرتاپایش را ورانداز کرد	then going around him he looked at him from head to foot.
بسیار خسته و از نظر بنیه بسیار ضعیف است.	was much fatigued and in a very weak state of health.
زیر بار وزن سلاحها و ابزار آهنین با سر و رویی پوشیده از گل و لای و کثافت با سر و رویی پر از جانوران و حشرات موذی	loaded with irons, covered with dirt, with vermin,
ولی اگر آنجا نبود عین نامه را برایم پس بیاورید.	if he is not there, bring the note back to me.
که آمادگی خود را برای هر نوع فداکاری نشان دهد	that he wasready to go all lengths and was prepared to sacrifice everything.
پوست و نعشش را یه دلار و ده سنت فروختم.	I sole de hide en taller for a dollar en ten cents.
بی آنکه به یاد آورد که قاعدتاً باید هزار و یک بار نظیر آن را دیده باشد	without reflecting how often he had seen it before
با دست دستکش دار خود از دربان خواست تا در را برایش بگشاید.	she tapped with a gloved hand for the porter to unfasten it for her.
تو را بیشتر از هر کس دیگری در زندگی دوست دارم.	I love you more than anyone I've ever loved in my life.
خیلی خسته بودم و همین که تو این فکرها بودم خوابم برد.	I was pretty tired, and the first thing I knowed I was asleep.
پس از فراغت از این کار به چالاکی گوزن پا به فرار گذاشت و دوباره در دل کوه فرو رفت.	having done this made off back again into the sierra with extraordinary swiftness.
از مسیر ساحلی چند اسب عوض کرده و خود را به شهر رسانده بود.	riding with a few peons across the coast range.
وضعی به خود گرفت که در وی سابقه نداشت.	began to take on anexpression such as they had never worn before.
مرد با دستی که یک انگشت کم داشت او را زد.	hit him with a hand that had a finger missing.
ما را در محاصره گیرد بی شک نابود خواهد شد.	the enemy would inevitably be destroyed.
بیش از همه متخصصین کشور با زمین ساختمان و معدن آشنایی داشت.	he knew more of land, building, and mining than most of the special men in the county.
پیشخدمت مخصوص را به اتاق خواب خود احضار کرد.	summoned his valet to his own bedroom.
چون دیدند که تمام مقیمان کاروانسرا سرگرمند به اینکه بدانند آن چهار سوار در جستجوی چه هستند	seeing everybody busy about finding out what it was the four men wanted
در حالی که تعداد کسانی که تا آن هنگام عملا و با علم با او در افتاده بودند بسیار معدود بود.	while the number who as yet had actually and knowingly given battle to him, was small indeed.
او نو از خوابگاه بیرون بکشین و توی دردسر بندازین.	trying to get him out of bed and into trouble.
با سکوی وعظی در یک انتها و ارگ عظیمی در انتهای دیگر بود	with the pulpit at one end and a huge organ at the other.
درست در همین دم نخستین علایم حمله پیدا شد.	just at that moment came the first news of the attack.
که مثل گوشت سفید و نیمه ژلاتین نارگیل در ماه سوم آن شفاف است	like the transparent, half jellied, white meat of a cocoanut in the third month of its growth
آن طرف تر به پشت در آب دراز کشید و موج به آرامی گردنش را نوازش کرد	he reclined and let the gently moving water flow around his neck.
یعنی تا زمانی که سیر این وقایع عجیب به سوی سرانجام هولناکشان سرعت گرفت.	a time when these strange events began to move swiftly towards their terrible conclusion
ولیکن آن مردک پیر چندان نادان بود که خشمگین شد و ترشروئی نمود.	at which the old fellow was fool enough to be angry and out of countenance.
در یک روز ده میلیون به آنجا حواله دهم	if I draw out ten millions on the same day
بیش از آن آشفته بود که فکر از نو خواندن را به خود راه دهد.	she was too much upset to think of singing again.
لیکن چون هنوز پدر من در قید حیات است حقاً این خواستگاری باید از طرف او صورت بگیرد	but that as my father was alive it was his by right to make this demand
درهای دو طرف راهرو یکی پس از دیگری باز شدند	door after door flew open along the corridor
مجبورشان کرد همه از قایق پیاده شوند و جزیره را کشف کنند	she made them all disembark and explore the island
از عالی جناب به سبب حسن ظنی که در حق من حاصل کرده بود با کمال فروتنی و شکسته نفسی سپاسگزاری کردم	I made his honour my most humble acknowledgments for the good opinion he was pleased to conceive of me
به دور زنی گرد آمده بودند که غش کرده بود	who encircled the lady who had before fainted
ولی بعد پاره کرده و به داخل سبد کاغذ پاره ریختم.	I threw the sketches into the waste paper basket in disgust, thinking no more about them.
امشب را هم در آنجا کار کن و بکلی راه نقب را مسدود ساز فردا بعد از رفتن زندانبان بیا	keep at it all night if necessary and do not return here to morrow till after the jailer his visited me
بلکه مردی که سعادت خود او را هم تباه ساخته است در نظر دارد.	but also to the man who had ruined his own happiness.
گفتم منظورم در مقایسه با قبل از جنگ است.	I mean compared with before the war,' I said.
به دیدن من و تنها به قصد تحقیق این داستان آمد.	came on a visit on purpose to inquire into the truth of this story.
اما من فکر کردم شاید به حالتان مفید باشم.	but couldn't I be of use to you?
چون به پایتخت رسیدم به حضور سلطان بار یافتم	where I was admitted to an audience
وقتی آفتاب طلوع کرد از کوه بالا رفتیم و به بقیه افراد پیوستم.	I climbed up to the main body while the early patrol searched the railway.
به هر جان کندنی بود خودم رو کنترل کردم	I manage at last with a fixed smile.
برای کشف این موضوع دوباره تو را زیر نظر گرفتم.	I resumed my notice of you.
به اینکه چقدر در این زمان شاد از خوشی بیزار بودم لبخند زدم.	I smiled at how perfectly blase I sounded.
کسی که افزایش خیرخواهیش با مربع مسافت نسبت مستقیم داد.	a man whose charity increases directly as the square of the distance.
هشت روز نیز مهلت خواست که به او دادند	he begged for another week which was granted to hiM
دریافته بود که فقط یک دقیقه فرصت باقی است	knew there was only that moment and that
ولی به طور کلی و روی هم رفته چکیده بیانات او این بود	but the sum and substance of it was
مدت مدیدی بود که قصد ملاقات تو را داشتم.	I've long been yearning to see you
او که در آن موقع کاملاً حالش خوب شده بود	who had perfectly recovered from his accident
آن قدر نشاط آور بود که صبحگاه روز بعد او را باز به این کوچه کشاند.	was exhilarating enough to lead him over the same ground again the first thing in the morning.
اگر از یادم برود خدا کند کشیش من مرا فراموش کند و شیطان به یاد من باشد.	may my parson forget me, and the devil remember me, if I ever lose sight of it.
ماحصل صحبتشان این بود که کدورت کاملاً رفع شده است	the upshot of their conversation was that the breach is quite healed
هر طور شده باید ظاهرا را حفظ کرد چون پدر لقب بارون دارد.	papa is a baron, and we must keep up appearances.
چنین کسی هنگامی که در خانه باشد حیران و سرگردان نیست	in his house, he cannot be at a loss.
دستش را از روی پیشانی برداشته و به چشمانش نگاه کردم.	I took his hands away from his face and looked into his eyes.
پس نام تو را به تو رد کرده و ثروتی کافی به تو خواهم داد	I restore to you the riches and name of your father.
وگرنه همواره با یاس دست به گریبان خواهد بود.	or you will always be disappointed.
اما وقتی من رسیدم بیرون جستنش شروع شده بود.	but it had started to spill out by the time I arrived.
بعدش خودم رو انداختم رو تخت تا غروب یک نفس زار زدم.	then I lay down and cried to beat the band all afternoon.
اما برخلاف واهمه پیشین دخترک رفتار دکتر چندان دلسرد کننده نبود.	though by no means so unfavorably impressed as she had feared she might be.
او از اینکه دخترش به خدمت دربار درآید و بردیگران برتری یابد شادمان بود.	was glad enough to have his daughter preferred at court.
در هر حال من که قصدم این بود که پیاده برویم.	I was going to walk in any case.
بلکه باید با مراقبت تمام آن موانع را دور کرد	but that they should be removed
وقتی از کنار جنی که جلوی در تعظیم کرد گذشتند و وارد ساختمان بانک شدند	sharply as they were bowed into the bank by a goblin at the door.
بنابراین عقبش شتافتم تا تقاضا کنم او را نکشد	I ran out to beg him not to kill her.
یکی دو ساعت است که من فقط منتظر همین هستم.	I've been waiting a couple of hours for just that.
چه چیز او را به صورت یک زن دیوانه درآورده است.	what drove her like a mad woman.
با دختری که چهار ماه بعد از بازگشت از سفر به دنیا آمده بود	the daughter who was born four months after their return
زیرا به ارباب گفتم که یاری او مرا بس است	because I told my master, that his help would be sufficient
ولی او به ایشان گفته بود که گورشان را گم کنندو پی کار خودشان بروند.	but he had told them to get lost.
بیست و چهار سالم است وموقعش رسیده که سرو سامانی پیدا کنم.	I'm twenty four and it's time I settled down.
که از وقتی به مقام شامخ افسری ترقی کرده از آن لحظه دیگر ندانسته بود غیر از گرسنه بودن چه حالی دارد.	that ever since he had arisen to the dignity of an officer, from that moment he had never known what it was to be otherwise than hungry, more or less.
چشمانم را بستم و سعی کردم به خاطر بیاورم که کجا چنین بویی به مشامم برخورده.	I shut my eyes and tried to remember.
ای کاش می تونستی جمله تو تم وم کنی.	I wish you'd been able to finish.
حالی که برای آنچه در انتظارش بود ضرورت داشت.	she needed this so for what lay before her
من خبری در آن دیدم و شروع به خواندن کردم.	I saw a piece of news and began to read it.
چند ثانیه قبل از پیدا شدن جسد اون بچه	seconds before that kid was found
امروز خیلی دلم هوایت را کرده بود و تصمیم گرفتم به تو تلفنی بکنم.	she said, her telephone voice typical of herself, brisk, rather masculine, standing no nonsense, and then not waiting for my answer.
اما عجیب آن بود که این مجموعه زشت نبود.	but it was so odd that it was not quite ugly.
سیمای برافروخته و بیگانه این مرد که شمشیری را به طرف زمین نگه داشته	the excited, alien face of that man, his bayonet hanging down, holding his breath
سعی داشت تأثیر آن را دروجود دوست جوان خود در تصوّر آورد.	he tried to imagine its effect on the head of his young friend.
از اینکه شام اما ده نبود عذر خواست و به خانم تکلیف کرد که تا شام حاضر شود به شناسایی خانه خود بپردازد.	apologised for not having dinner ready, and suggested that madame, in the meantime, should look over her house.
میان دو تن از استادان بحثی بسیار گرم درگرفت	I heard a very warm debate between two professors
ناگهان به خود آمد و پس از آن که چند قطره اشک دیگر فشاند	 she suddenly recovered herself, and began to cry
فریفتگی عجیبی که بعضی از مردان به انجام کار دارند.	the strange fascination some men have for utterly demanding labor.
شما دو تا هیچ وقت به من نگفت ین این پاتر چه کارمی کند.	you never told me what he did?
انگار که بار درست روی شانه جا نگرفته تا بتواند بهتر آن را به دوش بکشد.	as if the burden sat askew, would not distribute itself so she could bear it properly.
تو را چه کار به این کارها بگذار شوهرت اجرای تکلیف را به عمل آورد	but do not meddle with what you do not understand
برای او رنج بزرگی بود که این سرهای بینوای محکوم رهسپار میدان اعدام شوند.	it was anguish to him to abandon these miserable, condemned heads.
ولی آماده بود اولین دیکتاتوری را که بیاید و شبح سرخ را جارو کند در آغوش بگیرد.	but he would have taken _in petto_ the first dictator who came along and swept away the red spectre.
اشک دیگری را قبل از اینکه از چشمم بیفتد زدودم	I rubbed another tear out of my eye before it could fall.
که حتی ممکن است فیلسوفی هم به خاطر از دادن آن حسرت بخورد	which might be regretted even by a philosopher
با وجود آنکه ناپلئون فرمان شروع جنگ را صادر کرده بود	strange as it may seem to suppose
دخترک که برای نخستین بار دست او را ول کرده بود	releasing her hold for the first time.
در برابر نزدیکان خود آشکارا گفته است که اندیشه انتقام در سر دارد.	in the presence of her chief confidents could not forbear vowing revenge.
دوباره مرا بردست نهاد و به باغ برد و به زمین نهاد.	taking me up again in her hand, walked into the garden, where she set me down.
چه با هم باشیم و چه جدا زندگی کنیم.	whether we remain united, or whether we part.
به دین سان روح سختگیر شعری را تسکین دهد	so to propitiate the austere spirit of poetry
در حالی که نفس را در سینه حبس کرده بود به دروازه نزدیک شد.	which he did, holding his breath.
انگار از گرفتار بودن در آتش گذشته و کنترل آتش را در دست گرفته بودم.	it felt like I'd gone from being tied to the stake as I burned, to gripping that stake to hold myself in the fire.
اگه میترسین پیرهن قشنگتون خراب به شه دستمالتون را بینداز ین روی کیسهها و اون وقت روش بنشینین.	if ye're feared o' muckying yer grand silk cloes, spread yer hankerchir o' t' top on't.
بتواند پول اجارة اتاقی برای هر سه نفرشان را پرداخت کند	could earn enough to rent a room for the three of them
نمی دون ستم با این سرعت خودش رو به اینجا می رسونه.	I didn't know he'd get here this quickly.
باید در مورد کار کوچکی با دوستان قدیمی صحبت کنیم	talk a little business with old friends
از آن خوب مراقبت و مرز آن با سنگ مشخص شده بود.	well tended and bordered with stone.
بالای سرش نگه داشت که برای ضربه زدن آماده باشد.	raised it over his head, ready to strike.
در حالی که پیاله و قاشقش را در دست داشت	basin and spoon in hand
اما به نظر او عمویتان مشکل به این کار رضایت بدهد.	but he seemed to think it hardly probable that your uncle would consent.
در این لحظه روت متوجه شکافی شد که در اطمینانش پدید آمده بود	in that moment, and for the moment, she was aware of a rift that showed in her certitude
از سوی دیگر ترس برش داشت که مبادا از ازدواج شتا بزده واهمه دارد.	half fearing that she really shrank from speedy marriage.
با نقل حکایتی سر او را گرم کند به ذکر آنچه که در فصل بعد خواهد آمد پرداخت.	among the things he said to him was that which will be told in the following chapter.
اگر بدانید آنقدر از شنیدن آن متأثر شد که به گریه افتاد.	it moved my darling to tears.
تقریبا دوازده عدد مسکوک طلا و پنج شش عدد هم پول پنج فرانکی و قدری هم پول خورده دیگر داشت	the contents consisting of a dozen gold pieces five or six five franc pieces and some smaller coin
سرش را با دو دست گرفت و از پلکان به پایین دوید.	nd clutching at his head he ran downstairs.
او حق ندارد پایش را از اینجا بیرون بگذارد!	she shan't go home!
زیرا به هیچ رو عقیده نداشت که پستی و زبونی مظلومان عذری برای رذالت ظالمان باشد.	for he did not hold that the baseness of the oppressed was any excuse for that of the oppressor.
پانزده سال قبل بیش از بیست و هشت تن نبودند.	fifteen years ago there were not more than twenty eight of them.
که اگر ناخدا زن و بچه یا بستگی دیگری از آن قبیل داشته باشد	that if the captain have a family, or any absorbing concernment of that sort
خود بیاید و از ما بخواهد نه اینکه به زور از چوپانان بستاند.	at least to come and ask it of us and not take it by force from the shepherds.
مرد قصد داشت که امشب او را در اتاقش لخت کند.	the party had the intention of rifling his room that night.
بتواند به آنجا بیاید و بار این مسئولیت سنگین را از دوش من بردارد.	able to come down to take this heavy burden of responsibility from my shoulders.
آن هم در شرایطی که جمع اوباش و اراذل سرازیر شده از شهر در سرتاسر ساحل پراکنده شده بودند و در مقابل ورودی ساختمان فریاد میکشیدند و از فرط خشم کف بر لب آورده بودند.	while the mob which, pouring out of the town, had spread itself all along the shore, howled and foamed at the foot of the building in front.
فقط دانشجو از عزیمت ایشان باخبر بود و خواست که تا نیم فرسخی ده ایشان را بدرقه کند.	except the bachelor, who thought fit to accompany them half a league out of the village
چیزی شبیه به یک توپ تنیس کوچک خاکستری به یک طرف سر هری برخورد کرده بود.	as what appeared to be a small, gray, feathery tennis ball collided with the side of his head.
که نکند اشتباه کرده باشم و خودم را مسخره دیگران ساخته باشم.	to be afraid that it was all a mistake and I'd made a fool of myself for nothing.
با وجود نگرانی همگانی دیگر از بیماری جدید خبری نشد.	no other case was discovered despite constant vigilance.
از خوشبختی من او هنوز از شهر بیرون نرفته بود.	by good fortune was not yet gone out of town.
گریفیث جوان یا به تجهیزات اجتماعی بی اعتناء است	he must be very indifferent to social equipment.
سپس چشم خود را دوباره به سوراخ کلید گذاشت.	then he looked again through the keyhole.
من معتقد نیستم که بتوانم نقاش خوبی از آب دربیایم.	I don't believe I shall ever do much good as a painter.
در خصوص این مشکل نامشروع با او همدلی نکنند	likely very expensive and unfriendly to such an immoral adventure as this
همه عالم که خو نه ندارن تا یه جایی بدنیا بیان.	it's not everybody who has a house in which to come into the world
چند پله را یکی کرده و در عرض دو دقیقه خود را برابر اتاقش رساندم.	I climbed the stairs, three at a time, up to the third floor.
با پرداخت پول نسخه یا دستوری برای حل این مسئله بگیرد.	for a price, provide him with some worth while prescription or information.
از لباسش تعریف کرد و گفت موهایش چه فرِ قشنگی دارد.	admiring the set of her gown, envying the curl of her hair
که ساقش را از او برید شاید فقط شکاف بدنی جانکاه را حس کرده بود و بس.	he probably but felt the agonizing bodily laceration, but nothing more.
هر وقت بازرسی تم وم شد خودم بهت خبر می دم.	I shall tell you once we've finished checking it.
بد نصیب کسی باد که در پی آن است!	the evil for him that goes to look for it
زیر تصور کرد کلاید پیام مساعدی درباره برنامه آن روز بعدازظهر به او داده است.	because she imagined it contained some further favorable word about the afternoon.
پذیرفت بدون هیچ قید و شرطی نسبت به دارائیش با بولسترود ازدواج کند.	she consented to marry without reservation of property.
تا بقیه ساعات امروز نگذارید کسی با او حرف بزند.	let no one speak to her during the remainder of the day.
نمی تونم این جمله رو واسه اون دو تا قربانیت به گم !	I can't say the same for your two victims.
همان زنی که جام پیروزی بکارت او را برنده شده بود.	who had carried off the prize of his virginity
اما نوعی تردید یا دلواپسی او را تسخیر کرده.	but some dark doubt or care sits on him.
که من و رفیقم بیش از آنچه من به شما گفتم چیزی ندانیم	if we do not know more than we have told you, as my comrade and I
از وقتی که تو یه بچه بودی می شناسمت.	I've known you since you were a baby.
حتی اگر این خاموشی تا مدت نامحدودی دوام یابد.	if it were to last till morning.
زیرا که ظاهرا یک زن برای آنکه قابل ستایش باشد لازم است که مادر باشد.	for it seems that a woman must needs be a mother in order to be venerable.
در میان تاریکی و ظلمات طبقه فوقانی ناپدید گشت.	was lost in the gloom above.
همان موقع بود که استپلتن برای نخستین بار همسرش را از وجود رقیبی آگاه کرد.	he showed her for the first time that she had a rival in his love.
بر اثر احتیاطی که پلیس بدلیل شورش بکار برده بود درهای آهنین باغ بسته بود.	the gates had been closed by order of the police, on account of the insurrection.
هدویگ با جیغ بلند و شکایت آمیزی از قفس بیرون پرید	she rose out of it with an angry screech
توجهی به گناه وی در حادثه روی داده داشته باشد.	in how far she was to blame for what had happened.
از طرفی این برای حفاظت سر من از ضربات سنگ کافی خواهد بود.	all the more as it will be quite enough to protect me from any chance blow of a stone.
از روی اطاعت آنچه را به خوردن و آشامیدن در کف او گذاشتند خورد و آشامید	he ate and drank what they gave him to eat and drink
انگشتانم در مقابل انگشتان او چاق و بزرگ است.	my fingers large and chunky in comparison to hers.
میل به بلند پروازی و به کار کردن بیش از دیگران سیری ناپذیرست.	my desire to rise higher, to do more than others, insatiable.
ژان وال ژان خستگی او را از آنجا که در اثناء راه رفتن	JeanValjean perceived it by the way she dragged more
که یکی از افراد آن سمت منشی و نیز عضویت هیئت مدیره را دارد.	one of whose partners acted as company secretary and was also on the board.
چون به خاطر شیئی یا موضوعی دور از دسترس و نامعلوم به کار گمارده شوند	when retained for any object remote and blank in the pursuit
با این همه قرب و منزلتی را که نزد او داشتم از دست دادم	yet I lost all credit with him
چون مردی که در طبقه یازدهم ساختمان سکونت داشت. از هیچ کس به اندازهءشانون نفرت نداشت.	for there was no one the man in the flat in the 11th arrondissement hated more.
از اون اولیه کاری که یک ذره عقل و شعور توش با شه تو نکردی.	for you're the one that's entitled to it most.
ملاح خم شده با دقت آن قسمت از نیمکت را که میان پاهایش بود می کند.	stooping over and dili gently working away at the space between his legs.
غصه و نومیدی مرگ وی را تسریع خواهد کرد.	grief and disappointment are hastening his death.
پادشاهان و شاهزادگانی را که از ایشان ناراضی بود توبیخ و سرزنش نمود.	the kings and princes with whom he was dissatisfied
مهربانی و فداکاری و بخشندگی و شجاعت و عشق ورزی که او واقعاً خوب بود.	effacing and unselfish and loving and brave she was good through and through.
انگار سعی کرده بود در برابر عکاس مو دب به نظر برسد	as though he was making an effort to be civil to the photographer
مال خواهرم هستند که رنگ پوستش کاملاً با من فرق دارد.	they are for my sister, who has quite a different complexion.
یاد مه برعکس می شمردن تا با هم تو یه زمان انجامش بدن.	I remember they counted backward so they'd do it at the same time.
چنان با این بیان زیبا اوئرسپرگ را دوره کردند	so bewildered him with fine words
تا حدی خوشحال بودم که خوابگاه ما در سمت مخالف دریا قرار دارد.	I was glad our rooms were in the east wing.
که از جان و دل به او تعلق داشت.	to whom she belonged heart and soul.
نامه حتما در پست گیر کرده و به همین دلیل تأخیر دارد.	it must have been held up in the post.
ولی من دی گه نمی تونم کشیش به شم.	I can't be a preacher no more.
من این امر را در اولین گزارشم برای شرکاء شما توضیح دادم.	I explained that in my first report to your associates.
صرفاً به این یکی ذوق و شوق پیدا کردم.	, my interest has been diverted elsewhere.
آنجا را در گذشته به طور مبهمی به یاد آوردم.	dimly I could remember the passage as it used to be
به من حتی پنجاه هزار پوند هم بدهند حاضر نیستم دو مایل با آن بروم.	I would not be bound to go two miles in it for fifty thousand pounds.
شما را به زهر آموخته کرد که مزاج بر زهر دیگری مقاومت نماید.	against the fatal effects of the poison
شما اکنون به اندازهٔ کافی در خانه پول دارید.	as you've plenty of money of your own
اما در آن هنگام عقل و استدلال را از دست داده و تشنهٔ انتقام بودم.	but at that moment I was incapable of reflecting and was all eagerness for revenge.
بلافاصله ماشین را روشن کرده و به راه افتادیم.	cranked up, and drove off.
من اکنون تنها یک آرزو دارم و تمام وجود و حواسم خواهان آن است که بدان آرزو دست یابم.	I have a single wish, and my whole being and faculties are yearning to attain it.
عجب است که این یادگار دوران نابسامانی را هنوز نزد خود نگه داشته است!	I wonder that he keeps that reminder of his sufferings about him!
فقط امضا و دست خط خودتان را به او بدهید	you give her an autographed picture.
کوهستان تیره و خالی از هر نوع سبزه و گیاه بود	the hill bare and dark
پدرم و مادرم و خواهرم آمده بودند و وقتی چشم مادرم به آن افتاد گریه کرد.	my father and mother and my sister, and my mother cried when she looked at it.
با شنیدن این اخبار ضد و نقیض شدیدادلواپس شدم.	I grew seriously disturbed in the conflict of rumour
ولی صدای ویل ون فقط برای اوست و بس.	the violin played for her alone.
منشی چهره پر مهرش را به سوی دالی گردند .	turning his handsome, good natured face to her.
در نتیجه دریافت که مرغ از قفس پریده است.	so found the cage empty and the bird escaped.
سانکو پس از گفتن این سخنان به استقبال آن سه زن دهاتی شتافت	with these words he advanced to receive the three village lasses
به اندازه پهنه کشوری میان خود و مسافر پهلویی خود فاصله دارد.	with the breadth of a county between him and the next.
خیلی چیزها راجع به مدرسه و متعلقاتش به گوشم خورد.	I heard all kinds of things about the school and all belonging to it.
شما تنها آز ادب خود را از دست دادید	you had only lost your liberty
بر صفحه دریان که در برابر چشمانم گسترده بود نگاه کردم	the sea being full in my view
من به اصطلاح معروف کار بسیار ظریفی بر عهدة او نهاده و خواهش کرده بودم که آن خانم و دخترش را دعوت کند.	I gave her the most delicate instructions, so to speak, for inviting that lady and her daughter
که به خاطر اون بچه هم که شده باید باهاش ازدواج کنم.	on account of the baby and all, not to marry her
تا او به اتاق نرفت و در را قفل نکرد مراقبش بود.	waited until he heard her turn the key.
به اینکه با رفتن من چه قدر گرمت می شه فکر نکردم.	I didn't think about how hot you would be with me gone.
به خصوص اگر درست به خاطر داشته باشم به حضرتعالی عرض کرده بودم	that, after my telling your worship, if I don't mistake
آن را بخوانید تا ببینید عرایض من صحیح است یا نه.	you will see that what I have said is true.
جوابش کوتاه بود و دیگر نگرانی نداشت که رتبه او بهندد.	she said shortly, not even troubling to blush at his implication.
اما چیزی از این بیشتر عاید شما نخواهد شد.	but nothing more would come of it.
به شرطی که او نم مواظب رفتارش با شه.	I will if she does
احساس کردم که یه چیزی بالای جاده معلقه وداره مارو می پاد.	I felt like there was something right over by the turnpike embankment, and that it was watching me.
درست وقتی پدرش از پشت میز صبحانه بلند شد.	applying the glue just as her father was getting up from the breakfast table.
در توضیح گفتند که بجز آن ماهی نوع دیگری موجود نیست.	for there was no other fish to give him.
البته شرایط آنقدر بد نبود که درحال مرگ باشد	but not badly enough to be in the mortal shadow
که از پشت درختان بزرگ مشخص بود و این مایه تفریحشان شد.	which they could see through the branches of the large trees, and which diverted them greatly.
دی گه نیم خوام بیشتر از این خسته به شی.	well, I won't go on and bore you.
تو از همه کس در دنیا برای من عزیزتری	you are dearer to me than anyone in the world.
برق زد و همچنان بر پا ماند و به تدریج از آن شدت درخشندگی فرود آمد و فرود آمد	stood there gradually fading and fading away from its first sparkling intensity
مردی که پیوسته در دسترس او بود و او هرگز قدرش را ندانسته بود.	the man who had always been within reach and whom she could never acknowledge.
یک کاغذ سیگار قهوه ای را فوت کرد و کند.	blew a brown paper free of the pack
دوم را مانند تفسیر آه اول پیش خود بر لب آورد.	as an explanation of the first.
در همان موقع من با ین فکر بودم که تابلوی این اعدام بسی مفید خواهد بود.	I thought at the time what a picture it would make.
از ای نرو چندان پیش رفتم که پایم بزمین رسید و همین قدر توانستم چانه خود را از آب بیرون آورم.	I advanced so far that I could just hold up my chin and feel the ground.
تا این که سرانجام اندازه یک عروسک خیمه شب بازی شد	until finally it might have fitted a hand puppet
حاضرم سر جا روم شرط ببندم که خودش اون غوله رو آورده توی قلعه که حواس همه رو پرت کنه.	I'd bet my broomstick he let that troll in, to make a diversion!
هیچ ردی از اندک انسانیتی که سعیم بر آن بود که خود را در آن بپوشانم باقی نمانده بود.	no trace of the shreds of humanity I'd managed to cloak myself in remained.
همان نگاه خالی و خیره که اسکار لت قبلاً هم آن را دیده بود.	in a gaze totally devoid of the deference she was accustomed to.
هرگز آن شب را که با او گذراندم از یاد نخواهم برد.	I shall never forget the evening I spent with him.
هر چند که این جمله را بر زبان نراند.	but not aloud, of course.
جایی در خاطرم با این اسم و با این چهره آشنا هستم.	I have an association with the name'and with the face.
در آنجا من شاه را که بر تخت خود نشسته بود دیدم	where I saw the king seated on his throne
عادت همیشگی به رک و راست سخن گفتن از میان آن همه آشفتگی و اضطراب باز خود را به نمایش گذاشت.	her habit of speaking with perfect genuineness asserting itself through all her uncertainty and agitation.
اگر من ازاحساس واقعی او نسبت به خودم مطمئن نشده بودم راجع به دورویی او	if I hadn't read what she really thought of me her hypocrisy
بدین ترتیب تسلط خود را برکلاید به دیگران نشان خواهد داد.	her control over clyde to all those others
در پیکر سست و لرزان دستگاه حکومت نیروئی تازه دمند	to restore new vigour to a crazy administration
چرا که قدیسین هیچ گاه در آن نواحی محبوبیتی نداشتند.	seeing that saints have never flourished in those parts
زندگی ایشان نیز نباید از زندگی من مجزا و مستقل باشد.	while others live so apart from it
آن را به انتهای موج شکن استوار ساخت و سپس طنابی دیگر را کمند آسا به هوا افکند	secured one end to the bulwarks, and then flinging the other like a lasso
به نظر من ممکنه زیر کلاهش ون یه جور دهن با شه	I suppose there must be some kind of mouth under there
که پدر و برادرهایش بالاخره طاقتشان طاق شد و او را از مملکتشان بیرون کردند	for all I know, that his father and his brothers finally got fed up and shipped him out of the country.
ولی اگر وقت اعطای پاداش و انعام هرگز نرسد و من ناگزیر شوم که فقط به حقوق اکتفا کنم	but I should like to know in case the time of favours should not come, and it might be necessary to fall back upon wages
او این نکته را از روی وحشت ادا کرد.	which he mentioned with horror.
که به ملاقات ولی نعمت بسیار محترم خود بیایم.	see you at the same time, my honored benefactor
بلندی قامتش بیش از یک گز و سه گره نبود	not above forty feet high
کارت را به جای خود نهادم و کشو را بستم.	I put it back in the box again, and shut the drawer
شاید سرش بر روی دامن وی قرار داشته است.	that the forlorn head might perhaps have been lying on her lap.
نگاه تندی از زیر ابروان خرمایی به در انداخت	looking sharply out from under his thick red eyebrows
که پیدا بود به علت تاخت و تز گرم شده است.	obviously heated from galloping.
درخشندگی خاصی داشت و در این هوای صاف به خوبی ممکن بود هر یک از تزئینات آن را مشاهده کرد.	glittered in the sunlight, and in the pure air every ornament on it could be clearly distinguished.
این عمارت در کنار رودخانه ادامه یافته و طبقات فوقانی آن کاملاً بر رودخانه تسلط داشت.	stood a large building, formerly used as a manufactory of some kind.
که ما آمده و قهوه را آنجا خواهیم خورد	that I will take coffee with her
پرسید آیا لازم است در را به رویش ببندد!	should he fasten the door in his face?
من هم امضا کردم و بعد دوات را پرت کردم و فرار نمودم.	I wrote my name, threw it at him and ran away.
کلاهم را که برای رعایت آداب در زیر بغل نگاه داشته بودم روی سرم به جنبش در آوردم	I took my hat which I held under my arm out of good manners, and waving it over my head
که به جریان عمومی امور نظامی توجه و علاقه فراوانی داشت.	whose chief interest lay in the general progress of the war.
اگر او بدجنس نبود حاضرم سر خودم را بخورم!	I'll eat my head if he is not a bad one
بنابراین راه انداختن سه هزار فرانک کار محالی نبود.	it was impossible that they could not find three thousand francs.
به هر نحوی سعی کردم او را مجاب کنم	I have to try to win them round.
الان من میرم از راننده بپرسم چه خبر شده.	I'm going to go and ask the driver what's going on
به این دلیل مرتکب قتل نشدم که پس از دسترسی به وسایل و قدرت به مردم نیکوکاری کنم.	I didn't do the murder to gain wealth and power and to become a benefactor of mankind.
مطلقا لازمه که لباس و کشف برای هنگ خودم فراهم کنم.	I have got to equip my men with new clothes and boots.
پشت به دیوار تکیه داده و چشمش را به شعله شمع دوخته بود.	leaning his back against the wall, his eyes fixed on a burning candle
تمام گوشت و پوست و استخوان و همه وجودمان با هم آمیخته.	ever more absolutely bone of his bone and flesh of his flesh.
وی لفور به وحشت تمام بانگ زد و گفت	cried the magistrate, with an accent of horror and consternation
اگر گوش سپردن به مهملات مشمئزکننده بخشی از تاوانی است که باید برای دور ماندن از اذیت و آزار حکومت پرداخت کند	if the appearance of listening to deplorable balderdash must form part of the price he had to pay for being left unmolested
یک سگ ترسیده ممکن است چه حالتی داشته باشد.	an embarrassed dog looks like.
که مادر خود را فدا کرد و به عاشق خود گفت که با دختر من ازدواج کن	ending in the mother's sacrificing herself and offering her daughter in marriage to her lover
من وارث بر حق او یعنی هم ون پسر کوچیکه محروم موند.	I am the lineal descendant of that infant
کسی که باید در سرنوشت من تصمیم بگیرد خود من هستم.	I'm the person to judge that
چقدر دوست دارم شما را در مجلس رقص ببینم	I should so like to see you at a ball.
حال آن را در برابر شمع روشنی قرار بدهید شگفتا	but place now against it a lighted candle as a centre of illumination, and lo!
چون ممکن است دوباره به تو احتیاج داشته باشم.	you may be wanted again.
در حالی که من عقیده دارم که علاقه به منافع مشترک در هر کسی با هر درجه از تحصیلات و تربیت وجود دارد.	while I suppose that interest in the common weal is bound to exist in every man of a certain degree of advancement.
با یاس مفرط دست از خواندن برداشت و سرش را روی کلیدهای پیانو گذاشت.	left her quite distressed, with her head hanging down over the keys.
ولی کارد از دستم افتاد روی چنگال و چنگال پرید بالا	but my knife tumbled over my fork, my fork tripped up my knife
اتاق نشیمن او را هیچ وقت خالی از دود پیپش ندیده بودم.	I've never seen his sitting room when it wasn't dim with pipe smoke.
برای این کار از چاقوی برانی استفاده کردم که از درفش تیزتر بود.	but a burnished poniard sharper than an awl.
هر چند ممکن بود این نکته را از واقعیت صرف حادثه برداشت کنم.	though indeed I might have inferred as much from the simple fact of the accident.
که جان من به اجرای تصمیمم بسیار شتاب داشت	so eagerly did my soul urge me on to the accomplishment of this purpose
اما به یقین میدانست که به زودی اتفاقی روی خواهد داد.	but she firmly believed that something would very soon turn up now.
تا از من مواظبت کند و به من دستور دهد که چه کنم.	to take care of me, and direct what I should do.
بهتر دانستم راجع به مدرسه و شاگردان حرف بزنم.	I bethought myself to talk about the school and my scholars.
دودی آتشین که راه گریز نداشت تقریبا شبی تاریک بر این صحنه جنگ افکنده بود.	a close and burning smoke almost produced night over this combat.
خیلی دوست دارم نگاه دیگری به آن بی اندازم.	I should like another look.
چه بر خلاف آرزوی پدر به جای پرداختن به کسب و کار مقدس او به ادبیات رو آورده بود.	having to his father's disappointment taken to books instead of that sacred calling business.
خری که آراسته به زر و زیور باشد بیش از اسبی که پالان بر پشتش نهاده باشند جلوه دارد.	an ass covered with gold looks better than a horse with a pack saddle.
به طوری که هر که درون آن چادر بود بر تمامی قسمت جلو کشتی اشراف داشت.	so that the insider commanded a complete view forward.
طوری که وقتی مرغ وحشی را در برابرشان گذاشتند قلبش کمی آرامش یافته بود.	had eased his heart a little of its burden by the time the wild fowl were before them.
در کنار مادرم خزیدم و به خوی سابق خود که مدت مدیدی متروک مانده بود نشستم	I crept close to my mother's side according to my old custom, broken now a long time
که خویشان آن جوان راضی نیستند که دختر ورشکستی را او بگیرد	but whose family now will not allow him to wed the daughter of a ruined man
اما درست کبریت را با کشیدن به کف دست زبر سنباده مانند خود روشن نکرده بود	but hardly had he ignited his match across the rough sandpaper of his hand
خودش هم کسی نبود که به این چیزها نیندیشیده باشد.	she had thought much the same herself.
اما روز بعد موقعی که به دفتر امتحانات جهت دیدن نتایجی که بر دیوار زده بودند مراجعه کرد با کمال حیرت متوجه شد که نمره وی میان نمرات قبول شدگان نیست.	but next day, when he went up to the examination buildings to see the result posted on the door, he was astounded not to find his number among those who had satisfied the examiners.
حتی اگر مجبورمان کند آن قدر فریاد بزنیم که بمیریم.	even if it makes us scream aloud to die.
حالا اگر به زنده ماندنش اهمیت میدهی مانع من نشو و بگذار همین جا حسابم را با او تسویه کنم!	so, as you value his existence, let me get at him!
با این عبارت همه را وادار کرد که از آن بین کسی را بیابند و ادعای او را رد کنند.	they were seeking an example to confront him with.
خیلی هم دوست دارم در حضور شما از بین ببرم	it is my particular wish to do it in your presence
بلکه به طور تصادفی گویی به این جور قدم زدن عادت داشته است.	, but just casually, as though he was accustomed to walk that way.
من فقط گفتم که در نوع خود آدم خوبی است!	I only say he is a nice man in his own way!
روزی متعلق به مردی بود نقش زمین شده بود.	picked body of what had once been a man.
او جز اینکه زود رو برگرداند و از حضور ارباب خشمگین دور شود کاری نتوانست کرد.	his only thought was to turn round and make his escape from the angry presence of his master.
معلوم بود که حوصله شانه کردن و آراستن موی سرش را ندارد.	she couldn't comb them out.
دانتس باز جماعتی سرباز دید که آمده او را از سرازیری تندی بالا بردند	he saw soldiers drawn up on the embankment
دیگر کام لا مصمّم شد که حتی انگشت کوچکش را هم به خاطر او تکان ندهد.	was resolved not to stir a finger for him.
او مثل یک تصویر شوم با دو نامه روی میز ایستاده بو.	she was still standing there like a figure of doom, with the two letters
حتی امکان داشت خویشانش دورتا را به مرد جوان بدبین سازند.	perhaps even in her mind, which others might try to poison.
پیش بینی کرده بودم ظرف شش ماه انگشتر برلیان تو انگشتت با شه	I would have predicted a rock on your finger within six months.
اما با آن قوهی تصوری که آن دو داشتند این موضوع چیزی نبود که انتها داشته باشد.	it was not a thing likely to have an end,with imaginations like theirs to furnish material.
من دوباره در حال تکرار داستان خود از ابتدا هستم.	I'm repeating myself from the beginning.
او کاملاً هوش و قابلیت لازم برای تدریس در یک خانواده بزرگ را دارد.	she is clever enough to be a governess in a high family, papa.
من می خواه پیشاپیش از این بابت از شما تشکر کنم.	I wish to thank you in advance.
یادش افتاد که بارها به اشتباه به شیطنت متهم شده بود.	remembering how often she had been falsely accused of being arch
این طوری امکانش وجود داشته که یکباره حمله کنن.	so they could respond immediately.
اگر باز هم به همین تصمیم فعلی باقی بودید	if you still adhere to your present resolution
اما ناچار بود تصدیق کند که در پشت این کلمات حقیقتی بی رحما نه نهفته است.	but she could not help admitting that there was a grain of brutal truth in the words.
اما اسم شوهرش را یاد گرفتم و یادداشتش کردم.	but I found out her husband's name, and I made a note of it.
به این امید که پیش از رسیدن اخبار شوم و سرنوشت ساز به مقصد برسد.	in the hope of out distancing the fatal news
آن وقت پسرک در آن نقشه جستجو تغییراتی به وجود آورد.	who then modified the entire search plan
تنها فاصله میان من و آن ورطه هولناک آثار کمی از مناعت طبع بود.	a remnant of self respect was all that intervened between me and the gulf.
مدادی نامرئی روی نقشه پر نشان پیشانی او به ترسیم خطوط و مسیرهایی مشغول شده بود.	some invisible pencil was also tracing lines and courses upon the deeply marked chart of his forehead.
در آن به حد پریشیدگی رسیده بود به تماشای کوزت پرداخت.	in which theexpression of kindness and tenderness almost amounted to aberration.
همه رو نوشته بودم ولی نمی دونم کجا گذاشت مش!	now I don't know what I've done with them!
کلاه سیلندر خود را از سر برداشت و مثل تفنگداران تعظیم کرد	making a cavalier' s flourish with his top hat
وقتی اثر افسون از بین بره به مراقبت بیمارستانی نیاز دارم.	I'll need hospital treatment when the spell wears off.
تا عوام دچار حیرت شوند و به تماشای کمدی بشتابند.	ill come in well to astonish stupid people and draw them to the play.
اما هر طور بود خودش را حاضر کرد و به اتاق رفت.	but he nerved himself to it and entered.
من از همان روز تصمیم گرفتم که به تو و مسی و دووینتر درسی بدهم که هرگز فراموش نکنید.	I made up my mind then I'd teach you a lesson, and him too.
سپس با حرکتی سریع و چابکانه تمامی وزن خود را درپشت چنگک متمرکز میکرد	then with a rapid, supple movement leaned the whole weight of her body on it,
یعنی زمانی که همسر و شوهر و کدبانوی خانه	which was to come for her when she would at once be the wife of her husband and mistress of the house
یک تکه بره موم برای نرم کردن نخ در قوطی کارش موجود است.	at the little bit of wax candle she kept for her thread
تصویر صورتش شاید با عبارت زیبای متعارف قابل وصف بود	her face could have been described in terms of conventional prettiness
بعد هم برای اثبات رفاقت از کاترین خواسته شد	as the first proof of amity
فکر کردم بد نیست که من هم از نو مشغول لگد زدن به هرم بشوم.	I thought I might as well fall to kicking the pyramid again.
به قدری دلگرم شد که فورا تصمیم گرفت به رنگ و نیرنگ هم که شده برای ربرتا دکتر پیدا کند.	took heart to the extent, at least, of thinking that at once now, by some hook or crook, he must find a doctor to whom he could send her.
اما واقعیت این بود که او هرگز از این راز باخبر نشد.	but he had really never been.
دومین فکرش این بود که کسی را بوسیله ی این خبر آزار دهد.	your second is to club someone with it.
شاید ذوذنب دیگری که بنا به حساب آنان پس از سی و یک سال دیگر ظاهر خواهد شد ما را نابود کند.	that the next, which they have calculated for one and thirty years hence, will probably destroy us.
اما به یاد آورد که چیزی جز جامه ی خواب بر تن ندارد	but remembering that he had nothing but his shirt on,
مسلماً هر یک از ایشان در خانه خود شاهزاده خانمی هستند.	in her own house each of them may be a princess.
اگر جرات پیدا کنند و نصفه شب به خانه برگردند و برای خودشان شیر و شکلات داغ درست کنند	when they dare creep back in at midnight and make themselves a hot chocolate.
فقط کارمندان شهرداری نظیر بنده و جنابعالی حق دارند این مطالب را به زبان آورند!	except, as I may say, among the porochial officers, such as ourselves.
دمی بعد بار دیگر فقط زمستان بود و تاریکی.	the next all was winter and blackness again.
گرچه قبلا هرگز نامی از وی به گوشش نخورده بود.	although he had never heard of the man before.
مطمئن بود کاری نکرده است که دل بستگی او را از دست داده باشد.	had no presentiment that he had done anything to repel it.
فقط روشنایی شو به اون شخص نشون می ده.	it gives light only to the holder!
در انتظار آنکه سوراخ دیگری یابد که در آن منزل کند.	he could find one where he might dwell.
مرد خواهش کرد او را کنار پنجره حرکت دهند.	the man asked if he could be moved next to the window.
هر چه زودتر حرکت کنید و گر نه همه را از دست خواهید داد.	as early as you can for if you do not you will lose everything that you have won.
به داخل خانه رفت و شروع به نواختن پیانو کرد.	she went in and began to play the piano.
آنجا منتظر ماندیم تا آن دو تا آقا آمدند بیرون	waited there until two gentlemen came out
تا فضاحت و فلاکت این مصیبت دستکم تا حدی فراموش شود.	shame of this had in part at least been forgotten.
نیز دختر کاروانسرا دار را دختر قلعه بیگی پنداشت که سخت عاشق او شده بود	the daughter of the innkeeper was daughter of the lord of the castle, and that she, won by his high bred bearing, had fallen in love with him
مانند یک جعبه بزرگ یا صندوق کوچک با خود داشته است.	ike a large box or a small trunk.
شخصاً بدون اعتراف شما هم در این امر یقین دارم.	for myself, I am convinced without it.
بر آن شد که تنها به حضور مداوم در برابر او بسنده کند	resolved merely to keep himself always before him
برای تدریس در مدرسه بیشتر از تدریس خصوصی آمادگی دارم.	I am less unfit to teach in a school than in a family.
من تو را برای آنچه کردی سرزنش نخواهم کرد.	I shall not scold, but I don't like your conduct there.
سوزن شراع را از میان به طور افقی بالای یکی از صفحات قطب نما معلق ساخت.	horizontally suspended the sail needle by its middle, over one of the compass cards.
دم در ساختمان که رسیدم صدایی گوش خراش شنیدم	I've just reached the edge of the lawn when a shrill voice hits my ears.
تحمل رنجی را که به طبیعتا ممکن است از چنین آزمایش خطیری نصیبم شود بر من آسان خواهد ساخت.	I shall bear without complaint the pain which my so dearly bought experience will naturally cause me.
