حتی یک لقمه دیگر هم نباید بخورم و ناگهان دید که مشغول چشیدن بستنی شل و ول و آب شده روی بشقابش است.	not 'nother mouthful, and discovered that he was againtasting the sickly welter of melted ice cream on his plate.
دیگر نتوانستم به جز شما به چیز دیگری فکر کنم تمام مدت شب بیدار بودم	I haven't been able to think of anything else. I haven't slept.
برای چیزی که در شکمش داشت به تأیید بیشتری نیاز نداشتم.	I needed no more confirmation of what she carried in her womb.
لیکن نتوانست قاطرش را برگرداند یا حرکت دهد چون حیوان خسته و وامانده بود	being unable to execute any sort of manoeuvre with his mule
گویا با کنشی خود به خودی به نوشتن هم مشغول بوده است.	as though by automatic action.
عواقب کار خود را به بخت و طالع واگذار کنم.	leaving the consequence to fortune.
بجز مقعد و فرج بقیه تنشان پوشیده از نوعی کرک بود.	but none on their faces, nor any thing more than a sort of down on the rest of their bodies, except about the anus and pudenda.
باز هم لازم بود از وی مراقبت نمایند تا با چوبی آغشته به مدفوع خودش روی دیوارهای خانه عکس حیوانات کوچک را نقاشی نکند.	it was necessary to keep an eye on her so that she would not paint little animals on the walls with a stick daubed in her own excrement.
در مادر خود نظر کرد و به این التجای قطع روزی خود زبان به اعتراض گشود.	turning to his mother, strongly deprecated any praying away of his personal board.
او همین که سر برگردانید از جای خود جستن کرد.	he, raising his head, sprang nimbly to his feet
حتی دو بار موقعی که شوهرش نه در سفر بود و نه در بازار.	even on two occasions when her husband was not on a trip or at the market.
از شاعر تقاضا کرد که بر ابیات قصیده بیفزاید	telling him he must add to his satire
واقعا سه دقیقه نگذشته بود که مردان آشکار شدند.	three minutes had not elapsed when the men made theirappearance.
زیرا بیش از آن ضعیف و پریشانند که هوای باز را تاب آورند.	because they are too feeble and diseased to stand the open air.
اگه دلت بخواد می تونم بعد از شام می تونم بعد از شام ظرف چند دقیقه یادت بدم.	I could show you in a few minutes after dinner if you wanted to.
نتوانستم به خاطر بیاورم قبلا کجای شهر او را دید هام.	though I couldn't remember where in town I'd seen him before.
مؤدبانه سر فرود آورد و بی درنگ به اجرای فرمان ناخدای خود مشغول شد.	he politely bowed, and straightway went on to do his captain's bidding.
روی کندة درختی پای چوب پرچم کنار تفنگ گذاشته بودند.	set up on a stump at them foot of the flagstaff, beside the gun.
حتی از حد اعلای خود تجاوز کرده و تا فاصله دو تیررس تفنگ نیز آن سوتر افتاده است.	even goes a couple of bowshots beyond the greatest.
مدیر سکان خوشحال شد که شریکی برای زحمت او پیدا شده و با گوشه چشم نظری به ناخدا کرده و از او اجازه طلبید ناخدا اذن داد	the steersman glad to be relieved looked at the captain and the latter by a sign indicated that he might abandon it to his new comrade
دلیل فعالیت من در این راه چیز دیگری است	I have another ground of action
من دی گه نمی تونستم این پس رو لمس کنم.	I could not touch the boy.
به هر کدام یک قاشق پر از شربت مغز استخوان خوراند	gave a spoonful of marrow syrup to each one
باز برای آنکه آن را به لب خود بفشارد سر طاس او را با ملایمت از خود دور کرد.	in order to press them again to her lips, she slightly pushed away the bald head.
ولی حیف که من فقط یک کمی ازش خوشم میاد.	when she could take no more than a passing interest in him.
معنایش بیش از آن چیزی است ما بتوانیم بنویسیم	meant more things than we have space to write out
حالا به خاطر برنامه چیدن از دست خودم عصبانی بودم.	I was mad at myself now for having made the plans.
با لباس مرتب ایستاده بود و پدر کوچک اندام و مست او را در پناه خود داشت.	not a ruffle disarranged, supporting her small, thickset father.
این کار برای اطباء جرم سنگینی حساب می شه و زندان داره.	whether there are bad consequences or not.
به آسانی ثابت کند که این پیشینه چندان درخشان نبوده است.	which, alas,was not as impressive as it might have been.
شب را در اختیار هر دو تای شما خواهم بود.	I'll share myself with both.
والانتین را مجبور کرده بود تمام خانه را توصیف کند	he made her describe the whole house
دیروز من در مقابل بدبختی بزرگی که در انتظار اوست به تعظیم درآمدم.	I bowed down yesterday to the great suffering in store for him.
نیز به جای مطالب و وقایعی که نقل آن لازمه یک تاریخ واقعی و حقیقی است وقایع و حوادث دیگری آورده باشد.	amusing himself by relating transactions which have nothing to do with the sequence of a true history.
چون این احساسات به هیچ وجه با هم منافات ندارند.	since they are by no means incompatible emotions.
سبب آن است که این خوشبختی را غیر قابل دسترس میداند.	it was simply because it seemed to her unattainable happiness.
دلم نمی خواد اینجا بایستم و توهین بشنوم .	I won't stand here and be insulted.
آستین شخص مورد بازجویی را به سختی چسبیده بود.	had held the examined by the drapery of his arm in an official manner.
بار سنگین کارهای دار التبلیغ را به دوش پدر و مادرشان انداخته بودند.	leaving the burden of the mission work on theirfather and mother.
من اصلاً خیال ندارم ای نق در اینجا بمانم.	I've no intention of being here that long.
چه در زمان حیات چه پس از مرگش هیچ دانش آموزی به میان حرف او نپریده است.	no student had ever interrupted him before, alive or dead.
ای کاش کشیش دان کن لااقل در آن لحظه مسئله را به این شکل دیده بود	or at least not entirely guilty if only he had seen itthat way
زیرا بی آنکه پای از دایره تواضع بیرون نهم	without breach of modesty
نگران بودم که دفعه بعد کجا و چگونه ظاهر خواهد شد	I'd felt uneasy about where and how he might turn up next.
خواه سالیان دراز عمر کنی و خواه هم اکنون ترا در آغوش خود برگیرم و به خاک گور بسپارم.	whether thou livest many years, or they carry thee from my arms to the grave.
من از این گدای کور چنان وحشتی پیدا کردم	I was so utterly terrified of the blind beggar
او خم شد و بی پروا او را بوسید.	she bending, she kissed him carelessly.
که در باد چیزی بسیار با شکوه و بسیار با عنایت هست.	that there's something all glorious and gracious in the wind.
تعهد و پایبندی محض به مفهومی انسانی و عمیق که اندیشه انقلابی آن دوران ملهم از آن بود	the simple devotion to a vast humanitarian idea which inspired the thought and stress of that revolutionary time
بر آن شدم که دیگر از دست وی آزرده و خشمگین نشوم و کج خلقی و بداخلاقی وی را نادیده بگیرم و همیشه به دیده بخشایش بر او بنگرم.	though we should quarrel the next moment, I must forgive him again.
بیماری هرگز او را مثل دیگر هم ردیفانش درهم نشکست.	the disease never broke him down as it has broken many of his peers.
مجبور شد چشم خود را برگرداند و زمین را نگاه کند.	was fain to withdraw her eyes, and turn them towards the ground.
به نظرم آمد که لحنش در مجموع صمیمانه نبود.	it seemed to me that the tone of his greeting was not altogether a cordial one.
در خاتمه به گفته افزود که از بابت مواجب ایام خدمتش هیچ تشویق به دل راه ندهد	said he was not to be uneasy as to the payment of his services
یا تا زمانی که تو دوباره به دیدنش بروی.	or until you visit him again.
خانه ای که حال ستون نماهای خراشیده و قرنیزهای شکسته و کل شأن و منزلت افول کرده اش در تاریک روشن شفق گم و محو میشد.	whose chipped pilasters, broken cornices, the whole degradation of dignity was hidden now by the gathering dusk of the street.
اما نه مثل لوله پیچیده قرع و ان بیق بلکه به صورتی که یک توده گرد پنیر شکل	not like the worm pipe of a still though, but so as to form one round, cheese
برای من محبت گرم و ناگهانی تو باورنکردنی بود.	I could not feel anything.
در استودیوی خودم هیچ چیز ندارم مگر یک سا پایه و چند تا بوم کار نرفته.	I've got nothing in my studio now but an easel, my paints, and some clean canvases.
اعلام کند که هر پهلوانی از عهده برآید بی شک در شمار برترین پهلوانان جهان خواهد بود.	he who shall achieve it shall be deemed the best knight in the world.
اما عیان بود که سخنان او را شنیده است	but it was evident that he heard what was said
آن اولی هم مثل قهرمانی که پشتش به زمین خورده باشد به راه خود رفت.	he wandered away a dismantled hero.
یعنی اطاقی که در گذشته آن همه به آنجا احضار شده بودم تا تنبیه شوم یا مرا سرزنش کنند.	to which I had so often been summoned for chastisement or reprimand in former days.
از آن پس پوشیدن لباس نظامی برای هر یک از ما موجب شرمساری است	would feel ashamed to wear the uniform.
اما کاترین خیالش راحت بود که این راز را نه هنری برملا کرده و نه ژنرال از آن باخبر است.	equally safe did she believe her secret with each.
ساعتش را پیش رو گذاشت و منتظر ساعت دوازده شد.	putting his watch before him, he sat down to wait for twelve o'clock.
پیش از عبور از پل پیاده شد و بقیه ی راه را پیاده رفت	before crossing the bridge, and walked to the house.
همه با غلغله و فریاد او را تأیید کردند.	, and aroused a tumult of approbation
خبرتون کنم که من از هنگ چلم نا نیستم.	I warn you that I don't belong to the regiment of simpletons.
چرخ توپ نخ سین یخ ترد ساحل را شکست	one wheel of the foremost gun broke through the ice at the edge.
بی اینکه حتی مرا نگاه بکند این طور گفت	she replied without so much as looking at me.
رطیل زهرناک رخنه را یافته و به درون خزیده بود.	it was as if she had found the chink in his armor, crept inside with her spiders poison.
با افسر رنگ باخته جوانی که در این ارابه خوابیده بود به گفتگو پرداخت.	was speaking to a pale young officer who lay inside.
سپس دوباره از انتهای حیاطی پدیدار گردید تا در چوبی را باز کند.	then he came back to the end of a courtyard to open the gate.
به طرزی عجیب خمیده و پیر به نظر رسید.	he seemed to become strangely bowed and old.
در صحت این اصل همین بس که هرگز شمشیر قلم را کند نکرده و قلم نیز هیچ گاه از حدت شمشیر نکاسته است.	whereby we may see that the lance has never blunted the pen, nor the pen the lance.
که مبادا جرأت و شجاعتش که نیاز بسیار به آن داشت این مناظر جانخراش را تحمل نکند.	which he knew would not stand the sight of these unfortunates.
خیلی خو به که آدم از خبرهای دنیای جادوگری مطلع با شه.	it's so good to keep up with what's going on in the wizarding world.
این سخن را با لحنی گفت که معلوم بود پس از ادای آن تازه به مفهومش پی برده است.	in a tone which showed that he only understood the meaning of his words after he had uttered them.
این دوشیزه که تصادف وی را برای چند ساعت به او نزدیک ساخته بود تقریبا تا سرحد بیماری خجول بود.	the girl whom chance had thrown in his company for a few hours was almost morbidly shy
مثل این بود که یک اسب آبی سر در عقب یک بز کوهی نهاده باشد.	it was a hippopotamus undertaking the pursuit of a chamois.
من همیشه در حال دادن هزاران کلمه به این ترس بی نام هستم.	I'm always giving / thousands of words to this nameless dread.
به ربرتا اطمینان بده که در آنجا با او ازدواج خواهی کرد.	where, of course, they wouldsurely be married.
او تصمیم گرفته که این کار را خصوصی و بدون تشریفات انجام بدهد.	I don't think he wants anyone, and anyway you would have sailed,' I said.
تن ما داشت اجازه صادر شود تا او را در قبرستان مؤمنان دفن کنند.	that he be buried in holy ground.
دیواری که ارواح خبیث میان او و شوهرش علم کرده بودند.	erected by the silent work of evil spirits, between her and her husband.
که وقتی مرد جوان برگشت با او صحبت کند چشمان جیل کاملاً سرخ شده بود.	by the very red eyes with which he regarded the young gentleman, when he turned round and addressed him.
پس یک راهنما با دو استر اجیر کردم تا راه به من بنماید	I hired two mules, with a guide, to show me the way
آنقدر گفت و گفت تا حوصله آن مرد سر رفت.	then she commended his patience and perseverance in going through with it.
که یک یک صد هزار فرانک او را حق حدس الرؤیا به شما تقدیم کردم	, of which 100,000 have been honestly paid to you
تو به چه جراتی این ده روبل را از او گرفتی!	how dared you take ten roubles from him?
بلکه به قدری ناممکن است که حتی از فکر به آن شرمنده شد	so unattainable that he felt positively ashamed of it
اما در غیر این صورت ساعت بسیار مفیدی بود.	but otherwise very informative.
زیرا با آنکه انسان عاصی آفریده شده است غلامی تمام عیار است.	for they are slaves, of course, though rebellious by nature.
تا زمانی که اصل آن در دسترس قرار نگرفته	until the original is available
ناگهان مانند اینکه کسی را به مبارزه بطلبد با دیدگان درخشانی چنین فریاد برآورد	she cried suddenly with a sort of defiance, and her eyes flashed.
من هم قصد نداشتم در آن مورد با او بحث کنم.	I was not going to discuss it with her.
زمانی که قصد کشتن جا سپر را داشت همین موضوع جلودارش شده بود	she considered it a minor detail that she had once planned to kill him.
آنگاه به خود بالید و گفت که هرگز چنین فکر بلندی به خاطر هیچ یک از آدمیان خطور نکرده است.	he flattered himself, that a more noble, exalted thought never sprang in any other man's head.
که نزدیک قرابه ی ودکا ایستاده بودند و سرهنگ زنده دل و عیاش که توسط افسران احاطه شده بود.	standing near a barrel of vodka, and the robust, good humored figure of the colonel surrounded by officers.
ولی او دست خود را پس کشید و رو پیشانی پولی نا را بوسه داد.	the old lady withdrew it, and herself kissed the girl on the cheek.
هراس داشت که با من یک کلمه صحبت کند یا محبتی نماید	that she was afraid to speak to me or to be kind to me
در آن تصمیم گرفتیم که آنان را در جزیره بگذاریم و برویم.	it was decided that we must desert them on the island to the huge glee
چدر خوشحالم شدم که شما هم عقیده منو دار ین.	I'm glad to hear you say it.
حس ماجراجویی در او فروکش کرده و به حداقل رسیده بود.	his desire for adventure was at its lowest ebb.
با حرص و طمع به قاشق مرباخوری خیره شد.	eying the teaspoon avariciously
پیش از آن هیچ بزرگ سالی را در قطار ندیده بودند	they had never seen an adult there before
مثل درخت سپیدار سفیدند و باید تصدیق کرد که دلیر و با تربیت هم هستند.	as white as birchbark and some of them are such fine fellows, you might think they were nobles.
بخار غلیظ که لاینقطع از روی بدن حیوانات برمی خاست	a thick steam, perpetually rising from the reeking bodies of the cattle
مرا ببین که باید از او مراقبت کنم مثل اینکه خانهٔ من آسایشگاه است.	I have to look after him, too, just as though I kept an almshouse, she laughed.
معلوم شد بعد رواندازش را مرتب کرد و دوباره دراز کشید و سرش را روی همان زین گذاشت.	then, rearranging his wrappings, he sank full length and laid his head again on the saddle.
یک بار واقعاً سر میز خوابم برده بود و او مجبور بود مرا تا تخت حمل کند.	once I'd actually fallen asleep right at the table and he'd had to carry me to bed.
پوشیده شده بود با درختان بزرگ و سرسبز کاج	buried in tall green pines
دوباره به زیر آب رفت و دیگر بالا نیامد.	then sank again for good.
در کاسه بزرگی که پر از سرشیر بود افکند	let me drop into a large silver bowl of cream
میل داشتم اثری از دوست تازه آشنای خود در دست داشته باشم.	I felt I wanted some possession of his.
فرار کردم و چنین اندیشیدم که او مرده است.	I ran away thinking I'd killed him.
زیرا به قدری که در کندو زنبور عسل است در کوی و برزن اشخاص بددهن و یاوه گو ریخته است.	in the streets here they swarm as thick as bees.
او که یک کلاه بالاکلاوا بر سر گذاشته بود یک بشقاب جگر خام سفارش داد.	who ordered a plate of raw liver from behind a thick woolen balaclava.
حالا باید آستین بالا بزنی و کار مفیدی بکنی.	now you must try to be useful.
که جورابی پاره پوره و کفشی پاشنه خوابیده به پا داشت	in shoes down at heel, and blue worsted stockings very much out of repair.
ولی بهتر است در این مورد خوب تعمق کنید.	but think it over carefully.
حاصل این شد که هفتصد هزار فرانک در این ماه ضرر کردید تقریبا.	you have lost nearly 1,700,000 francs this month
اما چون دیدند که آن توله یاهو از نزد من گریخته و صحیح و سالم است	but finding the cub was safe for away it ran
با چشمانی بسته دو قدم راه رفت تا به خوبی وضع دیشب را مجسم نماید	taken two steps with his eyes shut, to accompany his description with appropriate action
چه با وجود مصائب گذشته شوق جهانگردی همچنان بر دلم چیره بود.	the thirst I had of seeing the world, notwithstanding my past misfortunes, continuing as violent as ever.
نگاهی به خانه قدی میش انداخت و به طرف در چرخید و تعظیم کرد.	he looking at his old home and bowing to the door.
ممکن بود تصور رود که پنجره یک عمارت عالی است.	might have been the lattice of a lordly mansion.
سعی داشت هر چه زودتر تمام مطالب را بیان کند و از این اتاق تنگ به فضای آزاد برود.	he hastened to say all that was necessary so as to get from under that ceiling, out into the open under the sky once more.
خانه سازی و معاملات املاک سود بیشتری دارد تا سرمایه گذاری در کشف الماس یا طلا	they would there is more money to be made here in real estate than in diamonds or gold.
اما وقتی که با پسرش مقابله داشتم آنجا جای ترس بود.	it was his son alone that there was cause to fear.
حمامی قدیمی با آبگرم کن کهنه که در پستوی انتهای ایوان پشتی قرار داشت.	an old tin bath and a chipped water heater stood in a walled off alcove at the end of the back veranda.
اما هنوز درست دستش به دور کمر باریک دختر حلقه نشده بود که موسیقی قطع شد.	but he had only just put his arm round her waist and taken the first step when the music suddenly stopped.
با چه خوشحالی و سروری حاضرم این پنجاه هزار فرانک را توی صورتش پرت کنم و یک تف هم بزمین بیندازم!	how gladly I could throw those fifty thousand roubles in his face, and spit in it, and then rub the spittle in!
چون بلافاصله موضوع را با همسرش در میان گذاشت ولی او ابتدا به بهانه خستگی و زحمت رفتن و خرج آن مخالفت کرد	for he at once communicated it to his wife, who at first refused, alleging the fatigue, the worry, the expense
چند ساعتی از شب گذشته ما را به شام فرا خواندند.	I woke and stumbled across, ate
گویی در اثر بغض و حرص و جوش خوردن فرسوده شده است.	she seemed completely exhausted by her rancor.
به مجرد ورود از این معنی اطمینان حاصل کرده بود.	a point he had made sure of as soon as he came in.
من خودم پزشک او کلمه دکتر را استعمال نکرد هستم.	I am myself a medical man' he did not say 'doctor
مو جو داتی که در یک عالم متناوب پایگاه اختصاصی خودش ون رو دارن.	who have their base in an alternate universe
که انتقام بگیرم از کسی که مرا به اینجا کشانید	but it must be after full vengeance upon him who has brought me here
بی آن که بتوان روز و زمان تغییر را مشخص کرد	none marking the exact day or hour of the change
به سوی جنوب راندم و به همان خلیجی که آن روز بامداد از آنجا حرکت کرده بودم در آمدم	got into the same creek whence I set out in the morning
وگرنه در اتاق را قفل کن و بگذار آنقدر بماند تا بمیرد!	if you do not, lock him up and leave him.
من یکی از کارمندان دون پایه و بدون مقام شرکت بودم	I'm only the crappy assistant, after all.
حتی یک جوان که اصل و نسبش ناشناخته باشد.	not one young man whose origin was unknown.
تا وقتی که آن کار را به اتمام برساند	until he had made an end of the one to which he was pledged
من نمی تونم بیشتر از ماهی یک سو برای مخارج روشناییم کنار بگذارم.	I can't spend more than a sou a month on my lighting.
هنگامی که به آنجا رسیدند در اتاق نشیمن وسیعی جا خوش کردند	they made the mselves at home in a general living room which was much more hand somely furnished
که خیلی پسرانه و آلا مد و راحت و مرتب است.	which will be boyish, becoming, and easy to keep in order.
فکر کنم تو یه داستان جن و پری این کلمه رو شنیده بودم.	I heard about it once, in a fairy tale.
بعد خود را به روی نیم تختی افکنده و دراز کشید	then he threw himself, dressed as he was, upon a sofa
اینکه کسی بگوید آن غذا درست از چه تشکیل شده است تنها به حکم قیاس است.	only by inference is it that any one can tell of what, precisely, that food consists.
امیدوار است که تا دو هفته دیگر فرمان برسد	hoped to receive an answer in a fortnight.
مثل دو سگی که در مسافتی از هم با زنجیر بسته باشند به همدیگر پارس نکنیم و تا به سر موعد ساکت باشیم.	till then we will refrain from growling and barking like two dogs chained within sight of each other
یک گز و نیمی در آب فرو رفت و شناور شد.	floated about five feet deep in water.
به این فکر افتاد هک در این لحظه در چه خیالی است	she wondered what he did feel then
برای آنکه آزاری به او برساند صورت معشوقش را تغییر داده باشد.	has changed her form for the sake of doing him an ill turn and injuring him.
اما توانسته بودند سیصد نفر از قوای مهاجم را از پای درآورند.	but before dying they had killed three hundred soldiers.
در این صورت ما حتما او را دستگیر خواهیم کرد	when we shall catch him, no doubt.
برگشت. با حالتی شاهانه بحث را خاتمه داده بود.	turning with the majestic air of having closed the interview
رالف اهرم را پایین آورد و بلافاصله صحبت کرد.	he clicked the lever and spoke again immediately.
در حالی که یک زانوی مرمرین بر سینه داشت.	with a knee of marble upon his breast.
با آنکه جراحتش سخت است جان او در خطر نیست	that he was seriously wounded but that his life was not in danger
این حالتش برایم ناراحت کننده تر از خشم اوست.	I find that more unsettling than his anger.
زن حامله که نباید مثل جنایتکارها پشت درهای بسته قایم به شه.	instead of hiding behind closed doors as if they'd committed a crime.
من ناچار بودم دم به دم دست او را بگیرم و کمکش کنم تا پایش نلغزد و به پایین تپه نغلتد.	I had to lend him a hand, or he must have missed his footing and fallen backward down the hill.
تنها آنچه را که در رزوهای پیش اندیشیده بود	what he had been thinking for many days.
رک و صریح است و قوهی تشخیص خیلی خوبی هم دارد.	open, straightforward, and very well judging.
خندیدم البته بیشتر شبیه عوعو کردن بود تا خندیدن.	I laughed oncemore a bark than a laugh.
پنجاه دلارم نقد دارم یه قرارداد هم به را چهل دلار دی گه.	I got fifty cash an' a contract for forty more.
بیهوده غرق در دریای احساسات و عواطف نشویم! ما بچه نیستیم.	is not this rather sentimental?
جواب آن صدای محبوب که صدای او را شناخت	the beloved voice answered, recognized the other voice
به طور حتم وقت زیادی برای طلف کردن داشت.	he was definitely at loose ends.
در حالی که نیزه بدست گرفته بود در وسط جاده ایستاد.	he planted himself in the middle of the road
حالا در این وسط همین یکی را کم داشتم.	just imagine, and that was all that was needed by
خیلی ممنونم که به احساسات من توجه نشان دادید.	I am grateful to you for remembering my feelings.
در نظر کسی که از دلش خبر داشت .	who knew what was passing in his heart.
که درگیر و دار پیکار از پای درآمده بودند	who had fallen in the action
گویی یک صدا یا حضور کسی خواب او را بر آشفته بود.	sound or presence had disturbed him.
برخاستم و به طرف حمام رفتم تا بدین طریق خود را بیشتر مشغول کنم.	I got up, and went into the bathroom, and began to run my bath.
سعی کرد به شیوه رت سخن بگوید و چون او استدلال کند.	she trying to equal his jesting mood
هراندازه پول که لازم داشته باشید به شما خواهم داد.	I will give all the money you require.
شانس به دست آوردن آن پنج پوند در مقایسه با اینکه احتمال دارد سرتان را ببرد خیلی ناچیز است.	the chance of five pounds is but a poor thing compared to the chance of having your throat cut.
امتناع ورزد باید با امکان بهبود وضع اقتصادی وداع کند.	she would have to abandon the hope of ever getting matters right.
باید به عنوان حق المعالجه قدری برای ما ادا در بیاوری.	for all this trouble you'll give us your performance.
دست وی را گرفت و در دست کاترین گذاشت	he putting their little hands together.
کمتر از ده دقیقه از نشستنش گذشته بود که خانمی هم سن و سال خودش	for hardly had she been seated ten minutes before a lady of about her own age
شایستگی این را دارندکه آدم دست نوازشی به سر و گوششان بکشد.	theyre more cuddly.
خدمتگار راهب که زن بود و در صومعه حضور داشت به ایشان گفت که راهب در خانه نیست.	the hermit was not at home, for so a sub hermit they found in the hermitage told them.
فقط امیدوارم قبل از تمام شدن روز لازم نباشد که نجاتت بدهند.	I only hope you will not need rescuing before the day is out.
ناگهان به سمت صدای کوبیده شدن در ماشینی در پشت سرم برگشتم.	I turned abruptly at the sound of a car door slamming behind me.
اما وضعم آن قدر بهتر شده است که خود را متعلق به این جهان حس کنم.	but I am so far mended as to feel that.
به آن واقعی نگذاری و به آنچه مطبوع و دل پذیر تست بیندیشی.	to think about what is pleasant.
یادم هست یک سال مسابقات از روشنایی روز هم گذشت.	I remember one year the tournament outlasted daylight.
که زوبین انداز تا پایان جریان کندن گوشت و پوست و چربی وال روی آن بماند.	that the harpooneer shall remain on the whale till the whole tensing or stripping operation is concluded.
البته کشتی ده ثانیه بعد موتورش را به کار انداخت.	of course that boat started her engines again ten seconds after she stopped them
من هرگز مردی را که آدم کشته باشد ندیده بودم.	I've never known a man who had killed people.
بدان سبب که بدنش زیر قایق در آب فرو رفته بود امکان نداشت	from his body being submerged beneath the boat
سگ به بوی من یک سره بالای سر من آمد	the dog, following the scent, came directly up
پلکان مرمری باشکوه آن به طبقات بالاتر راه داشت.	housed a magnificent marble staircase that led to the upper floors.
ولی در واقع یک ترس پنهانی او را در بر گرفت.	but a secret fear oppressed her
به خاطر یه جا بی حرکت نشستن بدنم لخت شده بود.	I was stiff from sitting still for so long.
ولی من به این آخرین دارو امیدوارم و باید صبر کرد و منتظر نتیجه آن شد.	he had hopes of the effect of this last medicine and one must wait and see
بلافاصله آب کدوحلوایی که در دهانش بود از دهانش بیرون پاشید.	spat out a mouthful of pumpkin juice all over it.
مردان ریشوی درشت هیکلی که سعی داشتند الماس بزرگی را از او بربایند.	bearded men trying to take an enormous diamond away from him.
قبل از اینکه افسر یانکی سوال بیشتری بکند داد و فریاد راه انداخته بود که بار تعطیل است.	before he could make known his mission she shouted that the house was closed for the night.
آرزو داشتم که یک دو جین از مردم آن سرزمین را همراه خود بیاورم	I would gladly have taken a dozen of the natives
اما در میان جغدهای قهوه ای و خاکستری رنگ جغد سفیدی ندید.	but there was no sign of white among the mass of brown and gray.
ولی پس از چند مرتبه دیگر به آن توجهی نداشتند.	but then drew their heads away and looked forward without life interest, once more.
هاگ رید برگشت و با عجله در تاریکی شب ناپدید شد.	he turned and disappeared into the dark trees
با اینکه همین که مرغ بریان شد و کره حسابی روی آن مالیدند و نمک و فلفل به اندازه روی آن پاشیدند کسی نیست که در ادای احترام اگر بندگی نگویم	judiciously buttered, and judgmatically salted and peppered, there is no one who will speak more respectfully, not to say reverentially
اما شما مگر چیزی مخصوص در این نظر یافتید.	but did you think there was anything particular in his look?
چه آقایان جوان خوش بین عادت ندارند نیروی تخیل خود را درباره نیازهای دیگران به کار اندازند.	for this exercise of the imagination on other people's needs is not common with hopeful young gentlemen.
اما نتیجه گیریهای تند و تیز مالک شایان تأمل بود.	but the conclusions of the irascible landowner required consideration.
تا سرانجام به جایی رسیدند که مانند یک لنگرگاه زیرزمینی بود.	until they reached a kind of underground harbor
که تقریبا سه ربع او خالی و در میان سینی مطبخ است.	about three parts empty still standing on the waiter, where it had been left
تابوت ساز کورمال کورمال از میان معبری تاریک راه خود را پیش گرفت	so, groping his way cautiously through the dark passage
ولی این یکی مثل این که خوش یمن است.	but this seems to be a lucky one.
مثل دودی که در معرض باد قرار گیرد به سمت شمال رانده شد.	drove north like flying smoke in the wind.
قوطی نوشابه را بالا گرفتم تا همه آن را ببینند	raise the can high into the air where we can all see it.
امکان نداشت کسی بتواند آن دو را از هم تشخیص بدهد.	it was impossible to tell it was there.
خود با آموزگار مخصوصش و همچنین چند تن از بانویانی که با او آشنا بودند به آن سوی باغ رفت.	went to another part of the garden with her governess and some ladies of her acquaintance.
در پرتو آن شما وارد دبیرستان شدید و توانستید تحصیلات خود را تحت نظر مراقبین مخصوص ادامه دهید	it was thanks to him you went to school, and also had the advantage of special teachers
دیگر مهم نبود که شال پشمی عمه پیتی گلی شود.	heedless of further damage to the cloak.
او با نفرت از آ می جدا شد و رفت.	he hastened away, hating her for it.
خودم تمام شب بیدار می شی نم که اگه برگشت با تیر بزنمش .	I shall certainly sit up all night and shoot him if he comes back.
اما بهار گذشته دهان زخمش باز شد و دکتر گفت که او باید برای معالجه به شهر برود.	but last spring his wound reopened and the doctor said he ought to go away for a cure.
حاضرم هر کاری بکنم که یه شنل مثل این داشته باشم.	I'd give anything for one of these
بر اثر خواندن این نامه با پندار بافی نامعقولی دلگرم شد.	was most romantically and hence impractically heartened.
سپس چون زورق را جای امنی یافته بود از آن بالا آمد.	then, seeing a resting place, climbed up.
یک بار به خاطر دردهای مختلف پیش پزشک رفته	he had gone to the doctor because of vague pains in various parts of his body.
در لغزان حفره پلکان را کشیدند و همه با دست به آن زور آوردند	rapidly drawing over the slide of the scuttle, planted their group of hands upon it
معادل ربع تمام عایدی است که پدرم سالیانه دارد.	I suppose this to be a quarter of my father's revenue
از ای نرو من این مرد را محاکمه و محکوم به مرگ کردم.	I have, therefore, tried that man, and condemned him to death.
خود شما خیلی خوش خط هستید و نظرتان صائب است.	you who are such a judge, and write so beautifully yourself.
وقتی چند متر بالا رفتین بدنتونو به جلو خم کن ین و آهسته فرود بیاین.	rise a few feet, and then come straight back down by leaning forward slightly.
همچون گلوله نخی در زیر لحاف او چنبره شد.	who still slept, and crouching upon it made a ball of herself.
راحت است و اشاره کرد که او را از نو روی ننو بگذارند	he murmured at last, and signed to be replaced in his hammock.
از حرکاتش پیداست که دی گه چیزی نمو نده که عاشم به شه.	actually talking and acting as though she might be ready to fall in love.
که این عمل ازدواج با فرانز تأخیری پیدا نماید	s I can delay this marriage
او را به مادرم معرفی کردم و ناستازی همچون دختری او را غرق در مهر و محبت ساخت.	I took her to see my mother, and she was as respectful and kind as though she were her own daughter.
به تو گفتم به او دارو بده تا نتواند حرف بزند!	I told you to dope him so he couldn't speak!
هرمیون از اول تا آخر درس انواع و اقسام اجسام را به سوی خودکشیده بود.	she had been making objects zoom across the room to her all lesson
طوری که گویی دست سرنوشت او را شوهر فرناندا و عاشق پتراکوتس قرار داده است.	as if fate had reversed the situation and had made him the husband of his concubine and the lover of his wife.
تا شاهد دستاوردهای بیمانند او در این ماجرای خطیر که خود به طیب خاطر بار آن را به دوش گرفته است باشیم.	for we wish to witness the valiant and unparalleled achievements he is about to perform in the course of this mighty enterprise which he has undertaken.
من نتوانستم خودم را راضی کنم و بگذارم تو جواهرات پدرت را بفروشی.	I couldn't bear to let you sell your father's jewellery.
بار اولش نیست که از ثورنفیلد به این صورت کاملاً ناگهانی و غیر منتظره رفته.	he had not unfrequently quitted it in a manner quite as abrupt and unexpected.
چندان در این جاده پیش نرفته بودند که متوجه شدندکه پیوسته به سمت راست انحنا برمی دارد.	but they had not followed it far before they became aware that it was bending steadily to the right.
قول دادند که تا پایان هفته دو بار برای او به نمایش بگذارند.	they would run it off later in the week for her
در ابتدا برای ذهن نگران او نوید بخش بود	to his apprehensive mind they seemed notes first heralding and
این قبیل وقایع فجیع معمولاً واضح و روشن است	clear as it is upon these tragic events, can possibly do.
با فکر بلندی که داری ممکن نیست آنقدر کند ذهن یا گرفتار تخیلات باشی که منظورم را نفهمی.	with your superior mind, you cannot be either so dull or so conceited as to misunderstand my meaning.
نه آنکه سرشان را بجنبانند و به تعابیر کلثوم ننه متوسل شوند.	not shake their heads, and give an old wives' darkling hint.
که چرا باید تمام ترس و بیم قبل از پیکار را بیهوده تحمل کند این روز نشاط انگیز را در بیکاری و کاهلی بگذراند.	that precedes a battle had spent that happy day in inactivity, was all the more depressed.
بی آنکه به الوی را بگوید که همه چیز را پیش دان کن اعتراف کرده است	yet without saying to her that he had ever confessed allto him
ولی نیرویی که او را در این مدت طولانی نگه داشته بود	but the energy which had supported her so long
سرپرست هیچ قسمتی حق ندا ره با دخترهای زیردست خودش دوست به شه.	that no one in charge of a department can have anything to do with any of the women underhim.
اول باید خودم تنها برم به زنم به گم.	I must tell her first, and alone.
به هر حال دیر وقت است و قدری شتاب کنیم تا زودتر به ده و به خانه من برسیم.	but let us make haste, and reach my village
او را روانه کشورش کرده بودند تا بیش از آن رسوایی بالا نیاید.	in order to cover up the scandal.
نقشه فرار خود را برای چنین شبی کشیده بودند.	it was on such a night as this that they had planned to fly.
در این زبان به درجه قابل توجهی از آمادگی و درستی رسیده بودم	I had acquired a certain degree of readiness andcorrectness in the language
با عطوفت بسیار جامی به سلامت او در کشید.	drank to him affectionately.
که در آن باید خسته و غمگین و فرسوده باشد	which required of him decrepitude and exhaustion and sorrow
تعظیمی کردم و ترس و وحشت زایدالوصفی احساس کردم.	I made him a bow and felt very much overawed.
فکر کردم اول بهتره بدونم چطوری اومده این جا.	I thought it good to hear first how he came to be here.
به هر صورت هر چه هم که تغییر نکرده بود	but whatever else remained the same
پس بسته ورق را برداشته آماده توزیع آن شد.	taking up a pack he prepared to deal.
دستان خود را به یکدیگر مالیدم تا کمی گرم شود و ضمناً اثر دست او را هم از بین برده باشم.	I rubbed mine afterwards, to warm it, AND TO RUB HIS OFF.
بگیر فرزند و در روی کاغذ نقشه آنجا را بکش.	draw me all that on the paper, my boy
اتفاقاً در آن موقع توانستم به طور دقیق از صحنة کلانتری هم آگاه شوم.	I happened, too, to hear of the scene at the office
بر آنچه از دست رفته و تکرار نشدنی بود مویه کردند.	mourned for that which could never come to them again.
صلاح نیست اگر مهمانی به خانه رسیده با همین لباس جلوی او بروم.	I did not want to face a caller dressed like this.
مردی که پای سیب با شیر را دوست داشت.	a man who would have a taste for milk and apple pie
با پشت خمیده و سر برهنه و موی سپید و چشم سفید	shouldered body, with uncovered white head
سر راه سنگ چاقوتیزکنی با بام را زمین انداختم که یعنی اتفاقی افتاده.	I dropped pap's whetstone there too, so as to look like it had been done by accident.
در روشنایی کبریت چهره شرمسار و برآشفته پدرش را دید و	by the light of the match momentarily saw his father's embarrassed and affronted face.
شما موقع عبور از روی اسکله مرا هم سوار کنید.	you shall pick me up on the quay as you pass.
یادتان هست که در همان اولین ملاقاتمان دربارة آن مفصل صحبت کردیم.	do you remember, on your first visit we talked of it?
صدای کالسکه که وارد حیاط شد به گوشش رسید.	the sound of a cabriolet entering the yard was heard
خوب تو این فکر بودم که این موضوع رو از کجا می دون ستی	I was just wondering how you know that.
کام لا هم که تنها نبودم. اما این چیز خوبی نبود.	I wouldn't be all alone, but that was a bad thing.
اینک سخن چند از پرورشگاه پسران و سپس پرورشگاه دختران میگویم.	I shall first say something of the male nurseries, and then of the female.
تا هر که ببیند از دور موفق به خواندن آن شود.	that those who see it may see it plain.
به هر جا که او رفت به دنبالش بروم.	to follow her whithersoever she may go
چهل هزار روبلی که لازم دارم از او وام بگیرم.	lend me the forty thousand rubles I need.
قول داد که در رساله خود نام مرا به احترام بیاورد.	promised to make honourable mention of me in his treatise.
دکتر و اسکوایر مرا با خود به شهر بردند	the doctor and the squire, taking me along with them, went ashore
او اینجا است و دستورهای لازم صادر خواهد شد.	an order will be issued concerning you,
بیا پولتو بده و تماشا کن و هر کدو مو خواسی انتخاب کن!	you pays your money and you takes your choice!
درست به خاطرم نیست چطور شد که اثاث خانه به نفع خانواده به فروش رسید یا چه کسی آن را فروخت.	I don't know how the household furniture came to be sold for the family benefit, or who sold it, except that I did not.
چنانچه دو دقیقه دیگر توقف کنم قطعا کشته خواهم شد.	remain here another two minutes and it is certain death, thought each one.
واگن کنار در کوچکی بر دیوار راهرو متوقف شد.	when the cart stopped at last beside a small door in the passage wall
یادم نم یاد که با همین کلمات این مطلب و بهش گفته باشم.	I don't recall that I did not just in so many words.
با این سخن اسبش را نهیب زد و چهار نعل دور شد.	he spurred his horse and galloped away.
از خواص بندگان پادشاه یکی اینست که به ولی نعمت خود بیان واقع بگویند و به خاطر خوش آیند او چیزی بر مطلب نیفزایند و به پاس احترامی عبث و بی معنی از آن نکاهند و صورت حقیقت را چنان که هست بنمایند.	for it is the duty of loyal vassals to tell the truth to their lords just as it is and in its proper shape, not allowing flattery to add to it or any idle deference to lessen it.
از دار نی خواست که از اسب خویش به زیر آید.	requested him to dismount.
با تألم تصدیق کرد که بیرون رفتن از دیر لازم است.	he recognized with anguish, the fact that it was necessary.
که عمل کیسه و بانک من ربطی به تو ندارد	you have nothing to do with my cash box
ما در کشتی بنشینیم و روی به دریا بنهیم	we were ready for the sea
من به هیچ روی برای شما ایجاد ناراحتی خواهم کرد	I won't hamper you in any way.
آنگاه نردبان کوچکی سرازیر کرد و من از آن بالا رفتم.	then let down a small ladder, upon which I mounted.
بقیه شب را روی نیمکت راحتی کتابخانه خیلی خوب خواهم خوابید.	I shall do very well on the sofa in the library for the rest of the night.
چند تن از جوانان راه را بر او بسته بودند.	some lads barred her way.
بسیار مایه ناراحتی من است اگر باعث لطمه دیدن دختران دوست داشتنی تان بشوم.	I cannot be otherwise than concerned at being the means of injuring your amiable daughters,
من دوست داشتم در پیاده نظام باشم بعد سرش را بلند کرد و به چشمان خانم السینگ نگریست .	I would have liked the infantry, he said, passing completely over her insinuation
مانند حکامی که در ایام سلطنت غاصب تخت و تاج از شغل خود استعفا کرده	magistrates who had resigned their office during the usurper's reign
تا چند ماه قبل به کلی او را گم کرده بودم.	saw her no more until a few months back.
یعنی سر مال بند اومنیبوس از ضربات آن قطع شده بود.	that is to say, the very tip of the omnibus pole.
او مجاز نیست از تلفن راه دور استفاده کند.	he would not be allowed to make any longdistance phone calls.
با آب کم عمقش که به پهنه همیشه آرام خلیج پر ابر مشرف بود	by its shallow harbour opening into the everlasting calms of a gulf full of clouds
کسان ما برای تبریک گفتن به دورش حلقه زدند.	to offer her their congratulations.
شاید بتوانم یکی دو تا خبر محرمانه هم بهت بدهم.	I might be able to tip you off to a thing or two,possibly.
او را واداشت تا برای استخوانی پر گوشت لابه کند.	made him beg for a marrow bone.
اما مهربان و بلندهمت است و بی شک آن دختری که پسرش را خوشبخت سازد دوست خواهد داشت.	but he is good and magnanimous and will love her who makes his son happy.
هر چند رفته رفته به غلتیدن از این دنده به آن دنده و تقلا کردن در تختخواب پرداخت	but, by degrees, began to roll and surge in bed
ولی خودداری نتوانست کرد و شلیک خنده را سر داد	but could not restrain herself and broke into laughter.
تقریباً وسط جریان افتادم توی قایق دراز کشیدم و گذاشتم جریان آب کرجی را ببرد	I got out amongst the driftwood, and then laid down in the bottom of the canoe and let her float.
آنگاه من هم باید وکیل دیگری بگیرم تا از حق من دفاع کند	I must then hire another to defend my right
ما را از شر سیزده تا از بیست و هفت دروازه سابق خلاص کرده.	it cut out thirteen of our twenty seven gates.
به همین دلیل هری تصمیم گرفت از خوردن دسر ظرف نظر کند	so he decided he'd better skip dessert and
با کمال منت حاضرم که من باب حق شناسی از آن عالی جناب او را از رموز و طریقه کار پزشکان آگاه کنم.	I would, in gratitude to his honour, let him know the whole mystery and method by which they proceed.
زیرا یقین دارم در غیر این صورت بلاهای دیگری به سرش خواهد آمد.	to know that the worst is over.
هفت جارو که با حروف طلایی بر رویشان نوشته بود	seven sets of fine gold lettering spelling the words
پس از میان رفتن در آن لایتناهی وزان و غران بسیار بهتر از آن است	so, better is it to perish in that howling infinite
پس از بخور نوبت به سرخ گل رسیده بود.	after the incense, roses.
زندانبان دری سیاه رنگ و کم ارتفاع را گشود	the gaoler opened a low black door
در آن مسیر طولانی که در تاریکی با درشکه طی کردیم عذابم از همیشه بیشتر بود.	never more so than during that long drive in the darkness.
تا اینکه به دشواری از بامی که به بام خانه ما پیوسته بود بالا رفت	till he clambered up to a roof that was next to ours
در آن هنگام برای آنکه یکی از آن دو را چنان ببینید	then, in order to see one of them
مخصوصاً تاریخ پهلوانان سرگردان که همواره پر از حوادث شیرین و خوش فرجام نیست.	but more than others such as deal with chivalry, for they can never be entirely made up of prosperous adventures.
این تخلیه یا باید از مسیر و مجرای طبیعی صورت گیرد یا از راه دهان	either through the natural passage or upwards at the mouth.
بشان را حیرت گرفته و ندانست که با چه شخصی سر و کار دارد.	quite disconcerted, not knowing if he was dealing with
آرزوی پایان ناپذیر من به دیدن کشورهای بیگانه نگذاشت که بیش از این نزد ایشان بمانم.	for my insatiable desire of seeing foreign countries, would suffer me to continue no longer.
ترس من از کسی بود که امکان داشت از اطاق داخلی بیرون بیاید.	I was afraid of some one coming out of the inner room.
برای همین یکی از استادها باید این کاغذ رو امضا کنه	so I need a teacher to sign for it
من بدون آنکه آرزوی صحبت کردن با شما یعنی عزیزان قلبم را برنیاورم	I shall not die without the delight of another conversation with you, beloved of my heart.
از تنه ضرب دیده پکوئود زندگی رخت بر بست.	all life fled from the smitten hull.
کاش اینجا بودی که بر وی گفتمی که من از شما هرگز امید چنین کاری و چنین انسانیتی نداشتم.	but I wish he were here that I might tell him that I did not believe him capable of so noble an act.
البته محل امضا در سطر اول هنوز خالی بود	the first line was still blank.
من هرگز ندیده بودم که برای موضوعی به این جزیی این طور ناراحت بشود.	I never knew her like this, for such a little cause.
پس از این که با رفیق جدیدشان آشنایی پیدا کرد	when he and his new companion had been made known to each other.
به ناحق شغل بهتری به پسر عموی خود دهد چنان دلخور بود	that despite his having done nothing at all to deserve it
تا صورت خود را از حضار پنهان کند و با اصرار بخوان دن اوراق خود ادامه داد.	in order to hide his face from the audience, and recommenced.
به شما باید بگویم که با او در همین نزدیکی در هتلی نشسته بودم.	I must tell you I've been sitting with him in the restaurant close by
وقتی تقدس از دست می ره که آدمی حقیر و بدبخت افسارش رو پاره کنه.	it on'y got unholy when one mis'able little fella got the bit in his teeth
اگر واقعاً به این دلیل است که پدر شما این تحول را در وجود شما پدید آورده است	that if your father has brought about this metamorphosis in your person for the reason I have mentioned
مرا اندرز داد که بروم و در اطاقی که برای من آماده کرده بودند بخوابم.	advised me to go to bed in a cabin he had provided.
حالا دست از این خشونت و بی لطفی بردار.	if you had not grown so cross to me, and so rough.
نه یکی از اعضای گله حقیق بلکه یقیناً یک گوسفند خارج از گله و بیگانه است.	not a member of the true flock, but evidently an interloper and an alien.
او از ابتدا یک تصور کلی ولی ناقص درباره من حاصل کرده بود.	by these means he had already received some general ideas, though very imperfect.
که بی فاصله پس از جلسه محاکمه مشاهدات خود را یادداشت کرده است	immediately after the trial by one of the witnesses to this scene
بیهتون گفتم که بعدش متوجه شدم که چاره دیگری ندارم.	I told you that afterwards I realized thatthere was nothing else to do.
اما به هر قیمت که برای من تمام شود وظیفه خود را انجام خواهم داد.	she was saying, but cost me what it may I shall do my duty.
خودم فهرست کتابهائی را که باید حتما مطالعه کنی تهیه خواهم کرد.	I'll make you a list myself of the books you ought to read first shall I?
با وجود این باز من مطلع شدم به دلیل اینکه هنوز به سر سفره طلعام ننشسته من آمدم	yet I have your address and in proof I am here the very instant you are going to sit at table
نگاهی بود جسمانی که به او برخورد کرد. مثل یک تلنگر.	it was a tangible look that touched him as if it were a finger.
که تا کاری را که بستگی به زندگی و آبرو و جان او دارد به پایان نرساند	until he had concluded some business in which his life, honour, and heart were at stake.
به دشواری خود را از دید اسب دورکرد و به اصطبل رفت	with an effort he tore himself from the sight of her, and went out of the stable.
البته نباید اجازه داد که کشور را غارت کنند	one can't permit the land to be pillaged
البته من شک دارم. اما شاید یه راهی با شه که به شه یه سوزن رو وارد کیسه آمین وتی کرد.	I doubt there is any way to get a needle through the amniotic sac
سر خود را داخل گاز خوراک پزی قرار داد	laid his head in a gas oven
جادوگر بلافاصله شروع به نوشتن روی کاغذ پوستی کرد.	who began scribbling upon her piece of parchment.
اما احساس شدیدی بر کارش حک مفرما بود که بینشاز حد لزوم بود	but with more feeling than was always justified
پشت یک دیوار بسیار کوتاه باغ قرار گرفته بود	wasranged behind a very low garden wall
بعد هم بگو پس از سه روز یک چراغ حسابی جلوی ما بیاورند .	let's have a quiet fill out for the first time these three days!
چرخ جلوی آن که رویش نشسته بود بسیار بلند بود	with a very high front wheel, over which she was seated
فکر کردم یعنی که من حتی از او هم بیشتر تغییر کردم و یا اینکه او انتظار دیدن مرا ندارد.	I wondered whether I'd changed even more than she had, or whether it was merely that she wasn't expecting to see me
اما از برای من هفتصد هزار فرانک ضرر عاید گردید.	but which has cost me 700,000 francs
زنگ زد تا صبحانه بیاورند و طبق معمول همیگیش پنج دقیقه دوش گرفت	rang for breakfast and had his habitual five minutes under the shower
مبنی بر اینکه اسکلت وال کلید بزرگی برای شکل دادن به بدن تام و تمام وال نیست.	that the skeleton of the whale furnishes but little clue to the shape of his fully invested body.
هنگام غذا هم بهترین چیزها به او تعلق داشت.	at table he had the best of everything.
آهی کشید و دست او را فشرد و خود عازم اداره اش شد.	sighed, pressed her hand, and set off to his office.
به ظاهر مثل دکل اضافی در آن کشتی موجود زایدی بود.	he seemed as unnecessary there as another mast.
به اتاق وارد شد و در را پشت سر خود بست.	she went in, closing the door behind her.
مجبورم همه حواسم را فقط روی این مسئله متمرکز کنم که خودمان زنده از اینجا برویم.	I have to focus on getting us out alive.
حتی شک کند که آقای تو رپ به نظر همه آدم خوشایندی است.	to distrust his powers of giving universal pleasure.
چون خودش ان بالا روی صحنه نبود که برقصد و تحسین تماشاگران را نسبت به خود برانگیزد.	because she herself was not up there dancing and winning the cheers of the audience.
به امید اینکه مقداری نان خشک مخصوص دریانوردان از ناخدایش بخرم زیرا نان ما رو به کاهش نهاده است.	in hopes of buying some biscuit, his own beginning to fall short.
پیش روی خودت ب ا ر س د را هم خواهم یافت.	I shall knit 'BARSAD' before you go.
بی درنگ بن زد رئیس زندان رفت و مطلب را با او در میان گذاشت.	who was glad enough to be of service insuch a cause.
که نباید از این قضیه لذت برده باشم ولی	I shouldn't've enjoyed that or anything, but
که در آن شب پاییزی با ورود برادرش به روستا احساس کرده بود.	that had come upon him that autumn evening when his brother had come to him.
برای همین صندلی او را مثل محتوای یک ساندویچ تا کرد	so the chair folded her into itself like sandwich stuffing
چه بسا که جدیداً انواع دیگری از سحر و جادو و طرق دیگری برای بردن پهلوانان طلسم شده ابداع کرده باشند.	they may have newly invented other kinds of enchantments and other modes of carrying off the enchanted.
حتی اگر به ازای دویست دوکا هم به گرو رفته باشد.	though it were in for two hundred ducats.
برای یافتن توضیحی قانع کننده در ذهن خود به کنکاش پرداخت.	debating with himself as to just what he would say.
شاید این کار و کرد تا وجههی خودشو حفظ منه .	if she just did it to save her own face.
از جای خود برخاسته به حیاط رفت تا کمی آب بیاورد	rsula went out into the courtyard to get some water and
لحن صدایش خجولانه و در عین حال پر غرور بود.	his voice shy and at the same time proud.
نزدیک به نیم ساعت در این وضع وخیم گذراند.	he remained in this delicate situation for nearly half an hour.
با نگاهی پرشور و حریص به سوندرا خیره شد.	he looked at her eagerly and searchingly.
بلکه تنها بر سر حفظ مشتی عتیقه چانه زده بود.	only dicker about the preservation of antiquities
من حالا فقط می خوام کاری رو که دوست دارم انجام بدم و به بقیه چیزا کاری ندارم	I'm just going to do what I want now, and let the chips fall where they may.
بگذارید از اول خیالتان را از یک بابت راحت کنم	I tell you once for all
هری خود را روی زمین انداحت و پرتوهای نورانی از بالاق سرش عبور کردند.	more jets of light flew over his head as he fell
رنج گرانباری دوباره اسکار لت را در خود گرفت.	fresh pain striking her
وقتی متوجه شد که زن عرب نیز مانند مرد همراهش از نبودن اتاق خصوصی در کاروانسرا ناراحت شده است	perceiving that both she and the man who had brought her were annoyed at not finding a room
گمان نکنم سینیوریتا اصلا بادبزنشان را در این خانه جا گذاشته باشند.	I don't think the senorita could have left it in this house at all.
امیدوارم شما بتون ین گروهمونو به مقام قهرمانی برسونین.	I hope you're going to help us win the house championship this year?
آنگاه ارباب و خدمتگارش با جد و جهد تمام چهره من و او را با هم سنجیدند	by our countenances diligently compared both by master and servant
ولی فرود آمدن آن چاقو به طرز شگفت انگیزی بی صدا بود.	but its landing was surprisingly muffled.
کنت به همان سرعت به اتاق برگشت و در را محکم به هم زد.	the count stepped as briskly back into the room and slammed the door behind him.
من خوب زندگی کردم و بیشتر از اغلب او نایی که بام بودن دنیا رو دیدم.	I've seen a whole lot of life, an' somehow I've seen a whole lot more of it than most of them that was with me.
اما نیای اعلی حضرت کنونی روزی به هنگام کودکی خواسته بوده تخم مرغ بخورد و آن را برسم قدیم شکسته بود	but his present majesty's grandfather, while he was a boy, going to eat an egg, and breaking it according to the ancient practice
من می تونستم صدای قلبش رو هم بشنوم .	I could hear her heart, too.
در میان ایشان همیشه یکی هست که سواد خواندن داشته باشد.	there is always one among them who can read
آگاهی از آن واقعیت باعث شد که طرح محو لبخندی بر لبانش بنشیند	the consciousness of that flattering fact helped him to a vague smile
کریستف دلایلی در دست داشت که این شخص در این توطئه همدست بوده است.	 he had reason to believe that the fellow was concerned in the trick which had been played him .
زوبین آماج گیر پسر همچنانکه باید جای تیر بی نخورد پدران را گرفته بود.	the unerring harpoon of the son fitly replacing the infallible arrow of the sires.
در جلویی را باز کردم و به محض اینکه پایم را از خانه بیرون گذاشتم یک ون کنار خیابان پارک کرد	I'm just stepping out of the house when a van pulls up at the side of the road.
او هر دفعه پول را گرفته و به فقراء داده بود.	on each occasion he had taken the money and had given it to the poor.
در حالی که سراپا آلوده به خاکستر شده بود	covered in soot
پس این برات بیست هزار فرانک است که به من داده	has offered me a draft for twenty thousand francs
در این خانه زیبائی و تربیت و احساسات و شعر محیطی نشئه انگیز بو جود آورده است.	beauty, education, culture the woman question poetry everything!
لیکن باز هم کسی حاضر نشد به کمک ما بیاید.	but even then not a man would go along with us.
اذیت کردن یک پیرمرد ظلم بزرگی است مخصوصا از طرف شخصی که در وضع شما باشد.	teasing an old man like that and in your position, too.
چگونه اصولاً به تأثیر مداوم آن زن بر سعادت خود خوش بین نیست.	how he should mistrust its ever conducting permanently to his happiness or hers.
رانندگی طولانی برای برگشت به خو نه در راه هم دارم	I've got a long drive home.
درناها و غازهای وحشی در بلندای آسمان پرواز کردند و بانگ بهاری سردادند.	cranes and wild geese flew high across the sky uttering their spring calls.
این جور فکرها با جوانی شما هیچ تناسبی ندارند.	it is an anachronism for you to have such thoughts
اما درباره آتش زدن پل یک کلمه هم حرف نزدید.	but you said nothing about firing it.
چون وحشت مرگ بسیار واضح روی چهره او حک شده و بر جای مانده بود.	because no one thought the faithful rendering of his final terror was decent.
برای رفتن به آنجا به کالسکة کوچکی نیاز داشت	a trap would be necessary to take her there
پرستار بدجنس جلو خونریزی زخم او را نگرفت و تمام نیرویش از دستش رفت.	he was allowed by the treacherous nun to bleed his strength away through his neglected wound.
خودش هم میدانست که در این میان مقصر است.	where indeed it belonged, as she well knew.
که اینک به سبب کمبود افسران فرمانده گردان شده بود محجویانه وارد انبار شد.	but now from lack of officers a battalion commander, shyly entered the shed
منظورم این بود که در مواردی با توجه به خطاهای تو به سوی حقیقت هدایت شدم.	I meant, to be frank, that in noting your fallacies I was occasionally guided towards the truth.
ولی مواظب باش بار دیگر با قیافه دیگری با من برخورد نکنی!	but beware of meeting me with another aspect next time!
چیزی که آرامش و قرار او را به هم خواهد زد.	a something to alter her present composed and tranquil state.
من نیز دست او را گرفتم تا بن وبت خودم آن را ببوسم لکن به سرعت دست خود را کشید	I would have kissed hers, but she drew it away.
ولی خوب این طبیعی بود که یک دختر جوان آرزوی داشتن چیزهای قشنگ و دوستان شاد را داشته باشد.	but it was very natural that the young girl should long for pretty things, gay friends, accomplishments, and a happy life.
او نیز با شتاب تمام خود را چند قدمی به عقب پرتاب کرد.	caused that gentleman to retire several paces backward, with great precipitation.
در حالیکهچشمهای خیره را به طرف کنت بالا کرده بود	fixing his haggard gaze on the count
آن دست را در دست گرفت و بر حلقه بوسه زد.	took the hand to kiss the ring.
چون یک بار با من از این خانم جوان با لحن تحقیر آمیزی سخن گفتی.	because you once mentioned the young lady to me in slighting terms.
بدین ترتیب فرصت یافت تا به برخی از رجال مهم بنمایاند	thanks to this, was able to show certain important personages
زیرا این تنها چیزی است که اکنون با مزاج من سازگار خواهد بود	for that, I feel, is what will be more to my purpose
اما من فرست این را به تو دادم که به طیب خاطر به من کمک کنی و بدین ترتیب خودت را از رنج زحمت نجات دهی.	but I gave you the chance of aiding me willingly. and so saving yourself much trouble and pain.
اما او هرگز وانمود نکرده که مرا دیده است.	but he has never deigned to notice me.
در عمق صد گز از سطح فوقانی صفحه الماس واقع شده است.	situated at the depth of a hundred yards beneath the upper surface of the adamant.
خوب بد ستش آوردی و حقه را به من زدی!	you are getting off nicely with me
من فقط از اینکه اینجا کنار تو باشم خوشحالم.	I'm happy just to be here with you.
بطورمبهم به ذهنش این موضوع خطور کرد که ۱۲ چاشنی دیگر کار گذاشته است.	it occurred to him that he had already set a dozen of the time devices.
چنان که تصور کردم هیچ گاه از درد آن خلاصی نخواهم یافت.	so that I doubt if ever again I shall be free of the pain of it.
معتقدم اگر دل به کار ببندد زود از چم و خم کار سر در بیاورد.	it's my belief that he could learn business well if he gave his mind to it.
دید که شلوارک به پا دارد و کراواتی به گردنش بسته است.	he saw himself again in short pants, wearing a tie around his neck
آنگاه همگی به خوردن کیک و بستنی مشغول شدند.	with whom they had some ice cream and cake.
بدون آنکه هیچ گونه عضوی یا برجستگی نرمی از هر گونه در آن باشد.	without a single organ or tender prominence of any sort whatsoever.
محال بود دور تا با ویل به تنهایی گفتگو کند و اندیشه پر دردسر به ذهنش راه نیابد	they had never had a tete a tete without her bringing away from it some new troublesome impression
عادت کرده بود که مرتب ب به آنجا سربزند و هرگز بیش از چند دقیقه در آنجا نماند.	where he had gone aimlessly for a moment.
این یک وسیلهءعادی برای بدنام کردن حزب و یا ایجاد بدگمانی در داخل آن است.	it is the regular method of discrediting the party and casting suspicion upon its doings.
میل داشتم او را در آغوش خود به فشارم	I wanted to take him in my arms and kiss him
چنان مرعوب و هراسان شده بود که حتی قاضی نیمه کور نیز توانست به رنج درونی او پی ببرد.	with a mingled expression of horror and fear, too palpable to be mistaken, even by a half blind magistrate.
من کمی به سمت راست رفتم و از بقیه عقب افتادم.	I drifted to the right, falling a little behind.
یک بار هری با صدایی بلندتر از صدای شیون تخم طلا از آن چیزی پرسید اما جوابی نشنید.	shouting over all the wailing, but nothing happened.
من با کارد خود و او با سنگ چخماق تیزی که با استادی و هنرمندی و به شیوه خودشان به یک دسته چوبی نصب کرده بودند	I with my knife, and he with a sharp flint, fastened very artificially after their manner, to a wooden handle
بعد با آرامش سرش را روی آرنج او گذاشت.	she laid her head against his sleeve.
بیشتر از یک ساعت در باغ وحش منظرش ماندم.	I waited for her at the zoo for more than an hour.
من هنگام آمدن به اینجا در این خصوص بسیار اندیشیدم.	I was thinking of that on the way here.
صبح روز بعد آن را چند ساعتی در آفتاب گذاشت	the next morning placed it in the sun for a few hours
حتی اگر فرار کرده و در آن طرف دنیا قایم شوند.	even if they hide at the ends of the earth.
به جز یک چیز که کنجکاوی منو تحریک می کنه.	except one thing that piques my curiosity.
پس با بانگی هر چه بلندتر به چندین زبان پاسخ دادم.	I answered as loud as I could in several languages.
مشغول بازی شطرنج با مرد کوچک اندامی بود که در کار تجارت چای بود	he played chess with a little man who was in the tea trade
شنیدم او نا تو کار همه دخالت می کنن .	I'd hearn tell they couldn't never mind their own bizness.
هرگز امیدوار نیستند که بتوانند به همگنان برتری یابند	without ever aspiring to match out of their own race
میلش از میان رفته بود و این کار دیگر برایش لطفی نداشت.	took the charm of it away
از شوخی گذشته حوادث عجیب امروز به رفتار غیرعادی جغدها ختم نشده.	I don't know about that, but it's not only the owls that have been acting oddly today.
در این موقع بود که تصمیم را در ذهنم ثبت و تنظیم کردم.	I then framed and fixed a resolution.
به خود اجازه داد و با صراحت عقیده خویش را که مخالف عقیده اجتماعی پترزبورگ بود ابراز کرد.	allowed herself plainly to express an opinion contrary to the general one.
اون به من گفت باید با یه دیو کشتی بگیریم.	he was going on about wrestling a troll.
به این زمان و مکانی که در او هستیم.	with the present time and place
من باید برم بالا و یک خورده کار کنم.	I must I must go upstairs and get out the mending.
که هیچ کس جز او آن را ندیده بود	which no one else observed.
به مین نحو از شرحی که من درباره طرز زندگانی و آداب و عادات و اعمال خود بیان کرده بودم	so from the representation I had given him of our lives, our manners, and our actions
آرامش خاطر عزیزانش در آینده به بردباری کنونی او بستگی خواهد داشت.	the future peace of mind enjoyable by the dear ones, depended on his quiet fortitude.
به من سپردند که با شتاب از آنجا دور شوم مبادا امواج دریا بر اثر جزر و مد مرا فرا گیرد	advising me to make haste for fear of being overtaken by the tide
اصلا دوست نداشتم با اون مخلوق مقایسه به شم.	I didn't like being compared to the creature.
چون او برای به دست آوردنشان هیچ کاری انجام نداده بود.	because he had done nothing to earn them.
حال آن که قبلا زیر آن بسیار کثیف بود.	where they used to be an inch long.
میبایستی در این مورد بیشتر تأمل کرد و استدلالات طرفین را سنجید.	we should have considered the subject more, have weighed the arguments on both sides,
نبردی که او و برادرانش به تنهایی علیه تمام حریفان پرقدرت جهان آغاز کرده بودند.	that he and his brothers had waged unaided, back in heroic times, against powerful adversaries from all over the world.
حالا که او مرده است برادرش در نظر من جای او را گرفته است.	requires attendance, which, for her sake, I shall supply.
من هیچ جا از این نمازهای مرده و زنده که ما همه شو داریم ندیدم.	I never saw such dead alive services as we have here.
از او دعوت کرد که او را در قایق بزرگ تا خشکی همراهی کند.	invited her to go ashore with him in the long boat.
که ارزش و اهمیت آن با توجه به وقار و خشونت عادی او از عملیات کنت کمتر نبود.	which everyone appreciated in view of her size and habitual severity.
از من نقل کرده بود که آموختن عقل و حکمت از حیوانات عار نیست	that it was no shame to learn wisdom from brutes
گذشته از درد و سوزش بسیار سبب شد که هنگام کار کردن دست و پای خود را گم کنم.	beside the excessive smart, gave me much disturbance in my work.
توتسکی صادقانه اعتراف کرد که از روش پیشین خود نسبت به ناستازی بسی پشیمان است	but candidly confessed that he could not bring himself to feel any remorse for his original guilt towards herself
کتری را برداشت و طشت را پر از آب جوش کرد.	lifting the massive cast iron kettle off the stove, filled it with hot water.
آن قدر آنجا بمانید تا کاملاً از شما دور شود.	stay there until it has gone away.
تو انسانیت را به مادری و حق را به پدری برگزیدی.	you adopted humanity for your mother and right for your father.
آن تفنگ هم با دسته کج شده کنار قفس افتاده بود.	was up on a shelf with the end all bent
دادستانی ثابت کرد که این جرم موحش انجام گرفته است.	we have fastened this awful crime
بی آنکه سرزنش و یا اعتراض او را برانگیزد.	without reproach or comment from her.
که دادگاه عالی وقت کافی برای این محاکمه در اختیار داشته باشد.	it from obtaining as much time wherein to try the caseas needed.
پی بهتره فعلاً پا تو باندپیچی کنم تا وقتی که بتونم تو رو به درمانگاه قلعه بر سونیم.	so I think it's best if we just strap your leg up until we can get you to the hospital wing.
با خونسردی عجیبی دوباره به درون قفس رفت و دراز کشید.	very coolly and tranquilly lay down again in the cage.
ناگهان لرزش تندی در طول بدنه کشتی پدید امد که به سرعت برق گذشت و این بدان سبب بود	when instantly, a swift tremor was felt running like lightning along the keel
بدرقه کنندگان را از کشتی خارج کرده و پل را هم برداشته بودند.	when visitors had been obliged to leave and the gangplank had been raised
از زیر این چراغ گذشتند و به کناره تاریک کوچه رفتند.	under that lantern, on the dark side of the street.
این استان باید مخارج سنگینی را تقبل کند که در استطاعتش نیست.	this county is going to be saddled withan enormous expense
از ای نرو هراسان از جای برخاستم و برای دفاع شمشیر کشیدم.	whereupon I rose in a fright, and drew out my hanger to defend myself.
تا او زندگی جدید خود را با فامیلی دیگر آغاز کند	to change her name by the young man
روی خود را از طرف پنجره به طرف من برگردانید.	he said, looking away from me, out of the window
من به حرف ای اون خون آشام گوش دادم.	I listened to the vampire.
حالا این سؤال برایش مطرح شده که چکار کند.	now the question is, what is he to do?
یک بار برای من پیش آمدی به راستی تاثرانگیز رویداد.	a touching incident befell me once.
سپس این فکر به خاطرم رسید که امید نگهداری وی بسیار کم است.	sore misgivings came over me that there was slight hope of that.
فکر کردم حتماً از من رنجیده و شایسته نبود که من آن صمیمیت و غمخواری او را نادیده انگارم.	I had shown the white feather.
در نتیجه اسنیپ یک کلمه از حرفش آن را درست نشنید	for in the confused din, it was impossible for him to hear exactly what they were calling him.
لذا قصد کردم به نحوی از لینتون حرف بیرون بکشم.	I was cogitating what the mystery might be
او را در مغازه رها کردم و به سمت شب زمستانی تاریک رفتم.	I left him in the store and headed out into the dark winter night.
مگر اینکه از سر و وضعش معلوم باشد که ولگرد است.	unless, of course, helooks like a bum.
اما چند دقیقه بعد گرمی خاصی سرتاسر بدنم را فرا گرفت.	five seconds later sends a lovely soothing warmth all over my body
امیدوار بود با این کار پیرمرد با متقاعد سازد که پافشاری بیهوده است.	hoping this would help to convince him that it was useless to say more.
یک لباس خواب پشمی بلند پوشیده بود و یک شب کلاه	wearing a long woolly dressing gown and a nightcap.
تحت نظارت شدید جمعیت به همین منظور در کنار او قرار داشت.	under close inspection, for the purpose
اگر به آرزوهای خود دست بیابد دیگر خدا را هم بنده نخواهد بود.	if he could have but won to what he desired.
زیرا بنا به اعتقادی که دارند پس از یازده هزار ماه دوباره همه از خاک برمی خیزند.	because they hold an opinion , that in eleven thousand moons they are all to rise again.
نیز شاید چون من پهلوان نوظهوری در این جهانم	it may be, too, that as I am a new knight in the world
کار من خدمت کردن است و مشتری راه انداختن.	I'm here to take orders and to wait on customers.
اما ناگهان آن را برداشت و داخل جیبش فرو برد.	but suddenly he removed it and stuck it in his pocket.
من در یکی از این روزهای خوب برای دیدن مادرت خواهم آمد.	I shall come and see your mother some fine day.
بعد از اینکه دو دفعه کلید را چرخانید و کلید را پشت در گذاشت	carefully double locking and barring the door behind them
هوا پس از گرمای روز چنان سرد شده بود	the air, after the heat of the day
اما من با آنکه کسالت دارم بدون تأمل سوار قطار شدم.	but I sloped off quietly, seedy as I was, took the train and came away.
ولی از هرگونه افزایش در نرخ این بیمه خودداری کرد.	but declined to be guaranteed from drowning on any higher bargain.
باز هم در آینده به دیدن شما خواهم آمد.	I hope you will come and see us.
افزود که خواهد کوشید خود را در هدف او سهیم بداند و از هیچ کمکی دریغ نورزد.	of learning how she might best share and further all his great ends.
من روحم هم خبر ندارد که گرد خارش آور چیست!	I don't even know what itching powder is!
که چقدر فرق است میانه تصور و حقیقت امر و میانه قصد تا خود عمل.	, the enormous difference between a dream and a reality, between the project and the execution
این دست بیشتر مایل بود که باز هم مدتی تار و پود این ماجرا را درهم ببافد.	would weave, for a little longer space, the thread of these adventures.
به این فکر که ریسمانی که اتفاقی به او گیر کرده بود رها خواهد شد یا دندانی که به آن گیر افتاده بو کنده خواهد شد	thinking the hap hazard line would get loose, or the tooth it was tangled to might draw
اما این رنج و شکنجه را با هیچ چیز در جهان معاوضه نخواهم کرد.	but I would not exchange even that torment for anything in the world
باید بگویم من در این یکی دو ساعت خیلی لذت بردم. به حدی که شاید در یک سال اخیر زندگی من کمتر سابقه داشت.	I've enjoyed this hour with you more than I have enjoyed anything for a very long time.
پس از اینکه از زیر آن گذشتند و چند متری که پیش رفتند پایین آمد و بسته شد.	the moment the car passed under it and got a few yards down the track, the gate lowered itself closed.
عصایی را که مهمانمان شب قبل جا گذاشته بودند به دست گرفتم	picked up the stick which our visitor had left behind him the night before.
در حالی که سگ را در بغل گرفته بود	dragging the dog with him
که به طور طبیعی برای فرارشان ایجاد شده بود	which had naturally accompanied the preparations for their escape.
به یاد آور که در آن بعدازظهر سرد چگونه از او گریخته بود.	when she turned away from him that afternoon
بی حرکت ایستاد و لحظه ای در فکر شد.	stood still and pondered a minute.
از آن هیجان خاص که مخصوص هنر است هیچ احساسی به من دست نداد.	I felt nothing of the peculiar thrill which it is the property of art to give.
بر رغم او همه اعضاء شوری به نفع من رأی دادند.	it was carried against him by the whole board.
من بسیار خوشحال و امدوار شدم که از آن پس آرامش و صلح و صفا در محیط خانه حک مفرما خواهد گردید.	I hoped heartily we should have peace now.
با آن همه آنجا که بود هرگز تصوری از این گونه نداشت.	yet he had never conceived anidea of anything similar.
اما از من نفرت دارند چون من نبوغ دارم.	but she detests me because I have genius.
دیگری از درد جگرسوز حسد در خشم و فغان است بی آنکه لئاندرا هرگز حسد او را برانگیخته باشد	even some that bewail and mourn the raging fever of jealousy, for which she never gave anyone cause
من به دنیای پرهیاهوی شهر تعلق دارم و دیر یا زود باید بدانجا بازگردم.	I'm of the busy world, and to its arms I must return.
اما این کالسکه تا ساعت چهار بعد از ظهر به در بزرگ چوبی نرسید.	however, did not appear at the gate until four o'clock.
تنخواه خودتان را برای خودتان نگه دارید وقتی که از محبس مستخلص شدید	keep them until you are liberated
تصادفا درخت غاری را دید که زیر پنجره روییده بود.	happened to be a laurel bush growing beneath the window.
مردم هم مکیف و انگشت به دهان دست زدند و هورا کشیدند	everybody just a howling with pleasure and astonishment.
من جسم او را بی جان بر زمین نهادم.	I laid him down dead.
فقط اگه اگه بقیه مردم هم نظر شما رو داشتن	even if even if a lot of other people do disapprove.
تمام زندگی و حیاتم را به قمار گذاشته بودم!	that upon that stake there depended all my life.
در آن موقع ساعت از هفت و نیم گذشته بود.	it was already half past seven.
عزم دارد این دژ را با یک کلید طلا بگشاید	wants to open this fortress with a golden key
اکنون غرض عمده من اینست که تنها به ذکر وقایع و اموری بپردازم که در آن اجتماع اتفاق افتاده و یا بر من در طول آن مدت یعنی نزدیک به نه ماه اقامت در آن امپراطوری گذشت.	my chief design at present being only to relate such events and transactions as happened to the public or to myself during a residence of about nine months in that empire.
که او را در تابوتی که در زندگی در آن می خفته است	to be buried in the coffin whichhad served her for a bed
احتمالاً از این بلایی که به سرم آمده خوشحال بودم	I could rejoice over my own misfortune
تنها به خاطر اینکه زنان ما به اندازه خود ما هستند	only because they are of our own size
بگذار پایم به ساحل برسد آنگاه خودم آرام خواهم گرفت.	I must reach it first, and then I'll rest.
ولی با این وضع کثیف راستی قیافه ناخوشایندی پیدا کردهای!	but you are so dirty!
در آن سوی خرام و جریان بزرگ آب پرستاره	beyond the vague vast sweep of star gemmed water
برایش به صورت یک رؤیای قلبی به جا مانده بود.	she had always remained for him a phantom of his heart.
در حالی که همین دهاتی میزبانمان هرچه قدر کار کند	while our host, the peasant here, however hard he works
در رحم شروع شده بود و مثل آتش سرکشی تمام بدن اورا فراگرفته بود	it had started in her womb and then just raced up through her like wildfire
یعنی هنگامی که به سنگی میرسید و یا به بوته ای ترشک برمیخورد.	when he had to mow round a hillock or a tuft of sorrel.
ولی چیزی از اون نشنیدم که تو بچه منطقی و خوبی شدی. شیرینی زنانگی خودت را به دست آوردی.	but she gave me no intimation that you had developed womanly sweetness.
من پس از ذکر نام یکی از مردان دانشگاه تا حدی به وصف قسمت علوم نظری خواهم پرداخت.	of whom I shall say something, when I have mentioned one illustrious person more
سپس خواهش کردم که آدمیرال فورا یک کشتی آذوقه به آنجا بفرستد.	I asked that the admiral send a storeship there at once.
مالک آن پول کافی برای تعمیر آن نداشت و همان طور آن را رها کرده بود .	the owner, returning after the surrender, had lacked the money to replace it.
به اسارت افتاده است که در مقابل چشم او بدن سرباز دیگری از پشت با سرنیزه سوراخ شد	was a prisoner, and that another man had been bayoneted in the back before his eyes
اگر اشتباهی که میان شما و خود کشف کردم بگذارید	if it were not for the resemblance I detected between you and me, an unornamental
یک راهی به نظرم رسیده که پول بیشتری برای بیمارستان جمع کنیم.	I've a surprise way for making some more money tonight for the hospital
به نظر من شاید جلوی کاندیدا شدنش را بگیرد.	I think the nomination may be staved off.
بی آنکه به حقیقت و مفهوم آن توجهی داشته باشند.	without troubling about their purport or significance.
هرگز نفهمید چه کتابی خوب است و چه کتابی بد.	he still could not judge what was good and what was not in all that he had read.
حتی چند دقیقه هم به درون بیاید. چون به آنجا رسیدند.	even stop in for a few moments and although once there
که او نیز بعد از مردن وصیت کند که به پسرش بدهند	who shall bequeath the packet to his son
آگاهی نامطبوع از هرج و مرج و سوءتفاهم در صفوف پراکنده شد.	an unpleasant consciousness of some dislocation and blunder spread through the ranks.
من که حالا به دلیل و شواهد کاری ندارم	I am not talking of the evidence now
متأسفانه همین باعث شده خودش ون رو دست بالا بگیرن.	I'm afraid it's given them a rather high opinion of themselves
آنان زودتر از هر چیزی از کشتی به خشکی آورده بودند	they brought ashore from the HISPANIOLA
رد صدای موسیقی را دنبال کردم و ساختمان را دور زدم. مراسم در چمن عظیم پشت ساختمان برگزار شده بود.	I follow the sounds of music and walk round the house to find the event in full swing on the vast lawn.
موتورها روی زمین و یک ساقه سنبل خطایی در میان سیلندرها.	blocks lying on the ground and a pig weed growing up through the cylinders.
از اعلی حضرت استدعا کند که روز و ساعتی را که موافق نظر کیمیا اثر او باشد معین فرماید تا جان نثار در برابر تخت او افتخار لیسیدن خاک پای همایونی را حاصل کند	to desire, that his majesty would please to appoint a day and hour, when it would by his gracious pleasure that I might have the honour to lick the dust before his footstool
بتونه این نرده رو اون جور که باید تمومش کنه.	that can do it the way it's got to be done.
موقع راندن هم آهسته بران که کسی را زیر نگیری.	drive slowly, or you will find yourself in jail for manslaughter.
تغییر ناگهانی بود. تقریبا انگار که اصلا حرکتی نبود.	change was instantaneous, almost as if there was no movement at all.
از آن عالی جناب تمنی کردم که مرا از ادامه سخنان خود معذور دارد	I begged his honour would please to excuse me from proceeding any further
خیر! من فعلا نباید بگذارم با ین سادگی عقب کار خود برود.	I am not going to let him go like this,
پیش از همه به این علت که به سوی او کششی نداشت.	,the chief of which was that he was not attracted by her
حالت تهوع و سرگیجه به او دست داد و رنج و عذاب دوران بارداری را به یاد آورد .	the nausea that tore her, the tedious waiting, the thickening of her figure, the hours of pain.
پرسیدم که آیا در آن خانه به خدمتکار احتیاج ندارند.	I asked if a servant was wanted here?
منتها به نظر همه این اتفاقی که بین خودشان پیش آمده بود خیلی خیلی بدتر بود.	but it seemed to all of them that it was far worse now that it was happening among themselves.
چون اگر اشتباه نکنم هر چیزی به مزاج من سازگار است.	for I feel it would come very seasonably.
به محض این یادآوری چشمان او پر از اشک شد.	when the tears rose to her eyes as she pursued this train of reflection.
در وجهه بورژواییش همین یک نکته محل ایراد بود.	this made a part of his bourgeois popularity.
گمان نداشتیم هیچ وقت بتوانم آن را با صدای بلند به زبان بیاورم.	which I never thought thus to have declared aloud.
روی میز همه چیز برای صرف صبحانه آماده بود	the table was covered with tea things
یک کلاف پارچه ململ از پاچه شلوارش بیرون افتاد.	he had a sort of spasm and a hank of butter muslin dropped out of his trouser leg.
دهان خود را چرخاند و ادای او را درآورد	, her mouth suddenly twisting into a grin
این حکایت با همین دوست جوونمون که اینجاست شروع شد و در حضور خودش به آخر رسید.	it begins and ends ' with my young friend here.
من قادرم به شما آموزش بدم که چه طور شهرت رو داخل بطری کن ین	I can teach you how to bottle fame
که متوجه تکه کاغذی شد که ظاهراً لای کاغذعای دیگر بر خورده و فراموش کرده بودند آن را بردارند.	when he came on a fragment of paper which had evidently been slipped in among the others and then forgotten.
لذا برای فریب و اغوای من به من گفت	so, to mislead and deceive me, he told me
دور تا از شنیدن این کلمه چندان خشمگین نشد.	she bore the word remarkably well.
رو را برگردانید و به سرعت به سوی پنجره رفت و در مقابل آن ایستاد.	turned quickly to the window and stood facing it.
سپس ایشان را به اتاق پذیرایی برد که با میز گردی از چوب سپیدار و نیمکت مزین بود	then into the drawing room with a round birchwood table and a sofa
یگانه شاهد عینی مدعی است که مرگ معلول جنایت نبوده است.	that the only eyewitness denies that death was the result of crime.
این کارها سودی نداشت زیرا از مقصود هم سر در نیاوردیم.	all in vain, for we were wholly unintelligible to each other.
از اینکه کافی آب دهان برای تف کردن دردهان داشت به اندازه تعجب کرد.	a little surprised that he had enough saliva to do it.
بلکه به دلیل حالتی لطیف و نوازشگر که به هنگام عبور از جلوی ورانسکی در چهره ی دلفریبش بود.	but because in the expression of her charming face, as she passed close by him, there was something peculiarly caressing and soft.
اما برادرشان که کاملاً خونسرد و انعطاف ناپذیر بود چشمان خیره خود را همچنان به من دوخت	but the colder and sterner brother continued to gaze,
انقباض و قلقلک را در پایی که دیگر وجود ندارد.	cramps, itches, in the leg that is no longer there.
به طوری که هیچ کس ممکن نبود متوجه این اشارات شود.	so slightly that the action would have been almost imperceptible to an observant third person.
ایمان به اینکه فرزندش به زندگی ادامه خواهد داد.	faith that the baby would live.
در طول مدتی که مراسم مهمانی در دست تهیه بود من مانند عضو زائدی تنها تماشاگر این صحنه بودم.	I was a lay figure, no use to man or beast.
از اینکه این قدر سریع متوجه جریان شده بود تعجب نکردم.	I was not surprised at her quick understanding.
به شکل جرم سنگین و درهم فشرده به طول شش کیلومتر با غرش و هیاهو به حرکت درآمد.	the army swayed and started in one enormous mass six miles long.
از پشت شیشه دیدم که نشسته و مشغول خیاطی است.	looking through the glass, I saw her sitting at her work.
از صداش معلوم بود که مرگ دی گه او نو فراموش کرده.	I could tell by her voice that death had forgotten her.
اما در این مورد مسالة دیگری هم در کار است!	but it's another question.
آشنایانی که تا همین چند وقت قبل در سوگواری شوهرش مصاحب او شده بودند.	some of them friends who until a short while ago had attended her in her grief
سایر خدمتگزاران نیز به عنوان تماشاچی توی باغ ریخته بودند.	the women servants were in the garden, looking on.
هر چند شرم دارند از اینکه آشکارا بدان اقرار کنند.	although they are ashamed to own it publicly.
با این حال هم نشینی با این گونه دختران سبب شده بود	still having associated herself with them
چون که شما حتماً هزارها و صدها هزار پا وند حاضر خواهید بود بدهید	for how many thousands and hundreds of thousands of pounds would you not give
از لای در اتاق دکتر به درون نگاه کرد.	she looked in at his door
من تا آن موقع نشنیده بودم که در رستوران قطار شام بخورند و بدون اینکه متوجه شوم همین را گفتم.	I never heard of meals being served in trains before, and I inadvertently said so.
اما مأمور می تونست همه کاری بکند و دردسر بزرگی درست شود	but that conductor could have made trouble
والاّ در در تجارتخانه آورده منتظر مراجعت او باشند.	or to wait for him at the bankers' door.
هزاران بار علامت صلیب در هوا کشید و هزاران ورد و دعا خواند.	he fell to crossing himself a thousand times, and blessing himself as many more.
گویی تمامی آن نمایش مجلّلِ رضایت هیچ نبوده جز حب نفس!	as if the whole panoply of content were nothing but self love!
شاید برای اینکه با چنین شیوه ای جلب احترام نماید	perhaps to call her attention to this most ingenious device for attracting respect
این آرزوی من بود به ویژه برای آنکه همه چیز مجاز است	I did dream of it, chiefly because 'all things are lawful.
هیچ گاه نبود که نسبت به او احساس دلبستگی نداشته باشم.	nor ever ceased to cherish for her a sentiment of attachment
چنین به نظر آمد که ایشان دختر را اسیر کردند و با خود بردند.	pretended to take her and lead her away captive
بازوانش را روی میز کوتاه درازی که جل وش بود گذاشته بود	with his arms upon the long, low desk before him
اگه من پنج روز سر کار نرم خدا می دو نه کازیه م چه قدر پر می شه.	I shudder to think what the state of my in tray would be if I was away from work for five days.
اما برای کمک در هر کار باید از وضع آن کار اطلاع یافت	know the state of affairs in order to be able to improve it
روی آن افتاد و چشمش را با دست پوشانید.	covering his face with his hand.
این خود تسلای خاطر و شادی و مرض او است.	this was her consolation, her joy, her passion
وقتی که او را به کناری کشید و از وی پرسید که به چه علت در این لباس نامناسب و پای پیاده دست به چنین سفری زده است	whom we left questioning him privately as to his reasons for coming on foot and so meanly dressed.
می دونم شیطانی بود و به خاطر کاری که کرد ازش متنفرم.	I know she was evil and I hate her for what she did
خوشحال بود از این که دوباره در عرصه جهان ظاهر شده است.	so happy was she to be in the world again.
شاید از مدمتها پیش به این نتیجه خردمندانه و معقول رسیده بود	very probably he had long since come to the sage and sensible conclusion
با این همه همه ملاحان نتوانستند آن را بیش از یک گز از جا بردارند.	which all the sailors were not able to do above two or three feet.
امیدوارم حالتان تا فردا کاملاً خوب شود و فردا هم روز خوبی باشد.	I hope not, sir.
در ساعت یک بعدازظهر صندوقی پر از نامه در اتاق پذیرایی قرار گرفت	at one in the afternoon there was a whole carton full of letters in the parlor.
مسلما برای او نمی تو انس یمن چندانی داشته باشد.	boded him no good.
من از تماشاگران پر و پا قرص اخبار شما هستم.	I'm a big fan of yours.
اگر خدای نکرده یک مو از سر کاترین کم شود اربابم قلب خود را سوراخ خواهد کرد.	he'll break his heart should anything happen! ' I replied.
بدنه منحوس آن هرگز نباید بدنی جوان و پر لطف را در بر گیرد.	that they never wrapped the young and graceful form in their ghastly folds.
برای ابراز خود هرگز در پی یافتن سخنان دو پهلو و تضنعی نبود.	nor sought to commend themselves by forced and rambling verbiage.
اما خوش نداشت صاحب مقامی باشدکه تماس نزدیکانش را با کسب و کار قطع کند	but he would not himself have liked to be of any rank in which he had not such close contact with business
روش کار این بود که وقت سوت زدن زبانش را پشت سر هم به سقف دهانش بزند	produced by touching the tongue to the roof of the mouth at short
معنایش این است که در این دریا به یک کشتی حمله شده است.	here was some unhappy vessel boarded off that coast.
من کام لا از این نوع رفتار مخصوصا در برخورد اول متنفرم	I do not like this sort of thing, and especially so at the first time of meeting a man
سپس رود لف تنها به گردش در چمنزار پرداخت و منتظر ساعت مهمانی ماند.	then he walked about alone in the meadow while he waited for the time of the banquet.
اما با تلفات بسیار دریافته بودند که آن آرامش چیزی جز از نهان گاه توفان و گرداب نیست.	but had fatally found that quietude but the vesture of tornadoes.
من حاضرم برای نجات او خیلی بیش از این هم بدهم!	I'd give the price of as many to have him back.
شاید بعدا شما را ببخشم ولی اکنون دست هم نخواهم داد!	I shall forgive you later, but now I don't want your hand.
فکر کرده بودم که دیر یا زود کسی خواهد آمد.	I thought somebody would come along sooner or later.
اما ملتی که زبون و رنج کشیده باشد در مورد همان چیز قلیلی که دارد بسیار حساس است.	but a people too weak are clamant over their little own.
من هیچ وقت در مورد این ماجرا شکایتی نکردم.	I never even remonstrated about this affair.
تنها چهار یا پنج دقیقه پس از ساعت مقرر رسید.	not more than four or five minutes after the hour.
در آنجا مقداری فراوان شیر گاو در ظروف سفال ین و چوبین با رعایت نظم و ترتیب و نظافت ذخیره کرده بودند.	where a good store of milk lay in earthen and wooden vessels, after a very orderly and cleanly manner.
این سؤال را با صدای گرفته و رنگ پریده نمود.	turning pale with anger
اما در باب اینکه ایشان را مجبور کنند که فلان علم را بخوانند و فلان علم را نخوانند این عمل در نظر من دور از حزم و تدبیر و عقل و منطق است	to force them to study this or that science I do not think wise
بدون آن که هرگز با آنان به گفتهٔ مادرم از در نزاع درآید.	though he never quarreled, at least so my mother has told me.
چون به همان گونه که روح به درون ظرف گوشت آلود خود چسبیده است	for as the soul is glued inside of its fleshy tabernacle
نمی تونم تحمل کنم که دوستانم تحقیر به شن.	I won't stand having my friends sneered at.
احساس کردم احساس تقصیرم از بین رفت و جای خود را به عصبانیت داد	I can feel my guilt ebbing away and annoyance starting to ebb in.
همین که به تندی و چالاکی تمام تخته بندهای قصر را به هم پیوستند	with great dexterity readjusted and fixed the boards of the castle
در این هنگام ناگهان صدای فریاد خواهرزاده و کدبانو را که چند لحظه قبل مجلس را ترک گفته بودند از حیاط خانه شنیدند.	but at this moment they heard the housekeeper and the niece, who had previously withdrawn from the conversation, exclaiming aloud in the courtyard
که آزادی با تأمین نان برای همهٔ افراد بشر سازگار نیست	at last, that freedom and bread enough for all are inconceivable together
به لیوان نوشیدنی کرهایش چنان چنگ زده بود گویی نارنجکی در دست داشت.	her butterbeer clutched in her hand as though it were a grenade.
پیش از آن که آن حرف دوباره گفته شود	before the repetition was uttered.
پس از بیان مطلب ضروری به انتظار اجازه مرخصی در کنار در ایستاد.	was standing by the door after delivering his message, awaiting permission to withdraw.
سعی داشت دستش را گاز بگیرد و به پایش لگد بزند.	trying to bite his hand, to kick his legs
حالا نوبت او رسیده بود که دراین وقایع شرکت کند و او ازاین موضوع نفرت داشت.	now her time was coming to be a part of it and she hated it.
رقم دو دلار و پنجاه سنت از برابر چشمانش محو شد و به جایش رقم 8 دلار درخشیدن گرفت	the $2. 50 faded away, and in its place burned $8. 00.
بعد به سرعت از کلاس بیرون رفت و در پشت سرش محکم به هم خورد.	with that she marched out of the class room, slamming the door behind her.
دوست دارم پیش از شروع زندگی مشترکمان تو را ببینم و با تو حرف بزنم.	I'd like tosee you and talk to you again if you care to, before we start.
مثل این که کم و بیش توقع داشت از روی آن برای استفاده خود یادداشت بردارم.	I think he rather expected me to copy down the list for my own use.
سعی کردم این فکر رو از ذهنم بیرون کنم و بحث رو دوباره شروع کردم.	I shoved the thought away and started in on the begging.
امکان کمک و مساعدت به شما خرسند و سعادتمندم.	am able to show my readiness to serve you
وقتی مرا با ظاهری مرتب و لباسی پاکیزه دید که وارد آشپزخانه شدم لبخندی هم به لب آورد.	when she saw me come in tidy and well dressed, she even smiled.
اولین کاری که به عنوان استاد به او آموخت	the first thing he did, with a certain magisterial delight
زیرا پاسبانی که متهم را در حال دست بردن به جیب مردی ناشناس در میان جمعیت دیده بود پیش آمد.	for a policeman stepped forward who had seen the prisoner attempt the pocket of an unknown gentleman in a crowd
بالای یک جفت چنگک سیاه براق نگه داشته بود.	below a pair of shining black pincers.
وقتی به اطاقم برگشتم به سرگیجه دچار شده بودم.	I returned to my own room with my head in a whirl.
چرا که راه امیدواری به پنهان ماندن رازش را باز گذاشته بود.	the way being thus left open for the hope of secrecy.
منم که می دونم چندان شانس و اقبالی ندارم.	I see I warn't lucky.
قبل از صرف شام وسایلشان را در اتاقشان بگذارند.	to drop off their bags before dinner.
از این گذشته در این موقعیت اسرارآمیز قرار گرفته است که یک بار خود را به مردن زده و از نو به زندگان ملحق شده است	moreover, has the mystery about him of having feigned death and come to life again!
شاهزاده به سخنان خود چنین ادامه داد. گذشته از ین به شما خواهم گفت برای چه این عقیده به ذهن من خطور کرد.	I'll tell you why I draw the conclusion, explained the prince, evidently desirous of clearing up the matter a little.
سعی کردم به راهی برای توصیف آن فکر کنم که تا بهتر متوجه شود.	I tried to think of a way to describe it so that she would understand.
وظیفه پهلوانان درباری اینست که به بانوان زیبا خدمت کنند	let the courtier devote himself to the ladies
گفتم که من نیز از این امر خوشوقتم و معلوم است که دل به دل راه دارد.	I said that I congratulated myself on having the honour to make hers, and that the happiness was mutual.
به ایشان امر داد که مانع ورود سانکو نشوند.	let him come in.
چون به زحمت می تونستیم احتیاجات ارتش رو رفع کنیم.	because we couldn't hardly pick up a thing for the army
چون آن واقعه آخرین باری بود که احساس خوشبختی کرده بود.	because, it now seemed to him, that was the last time he had been completely happy
بنابراین من به اختصار گفتم که من در این زمینه با او موافق نیستم.	so I said shortly that my opinions were opposed to his.
نمی خوام با ماشین تو به خو نه برم.	I'm not going home in your car!
ملبس به پیراهنی ابریشمین به رنگ خرمایی سیر که در سال 1806 متداول بود	dressed in a gown of puce colored silk, of the fashion of 1806
به این ترتیب جز خودم کس دیگری هدف تیرهای افترا و تهمت نخواهد بود .	the reproach shall rest alone on me.
صندلی خود را عقب زود و بی آن که سخنی بگوید به داخل عمارت رفت.	pushed back his chair and without a word went inside.
ولی حالا حتی یک دانه سیب هم برای خودتان نمانده.	but now you have not one left.
این را که دیدم معطل نشدم و مثل برق لامع از تپه پایین دویدم.	I was up in a second and shinning down the hill.
در گوشش زمزمه کند که مایل به دیدن اوست.	to whisper that he wished to see her somewhere.
که در دنیا چیزی به عنوان گربه سیاه وجود ندارد.	that there was no such thing in the world as a black cat.
سرم را برگرداندم و دیدم که اون از هال نیمه پنهان پشت پلکان به سمت ما میومد.	I whipped my head around and saw her coming from a hall half hidden behind the stairway.
به سرعت اطاق را که بزرگ و دارای سقفی کوتاه بود پیمود.	the man hastened across the apartment, which was of considerable extent, but low in the roof.
بعد هم خیلی زود کنجکاو شدند که بدانند کجا دفنش خواهند کرد.	in a reasonable time, curiosity to know where she would be buried.
آقای مسن از گوشه میخانه پیش آمد و خواستار گفت و گوی با او شد.	the elderly gentleman advanced from his corner, and begged the favour of a word.
در آن موقع که وقت آن قدر اهمیت پیدا کرده بود	when time was grown to be so precious
که از این دیر و پرورشگاه وارد زندگانی دنیوی شده و پس از چند سال زناشویی	who enteredthe world, and who after many years of married life had
او در ین اثنا به جائی که مرا نهاده بود بازگشته بود	by this time, had returned to the place where she left me
اما بالاخره تصمیم گرفت که به دنبال توپ برود	however at length he decided
به سمتش رفتم و به سرعت با او دست دادم.	I crossed to him and shook his hand quickly once.
که اگر منظورش گربه است بهتر است نگران نشود و با خیال راحت بخوابد	that if he was bothered by that he could rest easy
یا اقلا با وی با دلسوزی سخن گوید و ترغیبش کند که در آینده به راه راست رود.	or a little commiseration, with an exhortation to conduct himself better in the future.
با او عهد کرده که هر که شیطان را بدزدد برایش به سیخ بکشد و کباب کند.	signed a bond with him, that all the people the devil kidnapped, he'd roast for him?
مانند آهنگ کلمات مطنطن این اشراقی به هیجان آمده توجه نخواهند کرد.	were less audible than the sound of his opponent's voice.
دو برگ کاغذ بود که یک چهارم برگ دوم خالی مانده بود.	there were two sheets of paper, the second one with a good quarter of it blank.
از جایم بلند شدم و بازوهایم را دور پاهایم حلقه کردم.	? I sat up and wrapped my arms around my legs, curling defensively.
زنی که کاملا به اصول اخلاقی وفادار است و دل مهربانی دارد که با این اصول سازگار است.	to a woman who, firm as a rock in her own principles, has a gentleness of character so well adapted to recommend them.
گفت. میل ندارید شما را با اتومبیل به آنجا ببرم. آنقدر جدی و مصمم به من نگاه کرد که جرأت مخالفت را در من کشت.	I'll drive you there in the car,' he said, and would not listen to protests.
تا این که بالاخره یک شخص انساندوست واقعی کاری برایم پیدا کند.	that some true philanthropist will put me in the way of getting work which I can do,
سرهنگ آئورلیانو دستور داد او را به خیابان هل بدهند.	but the colonel ordered him into the street.
من با اوقات تلخی و شاید از روی خشم سر او فریاد کشیدم	I cried with some irritation almost in anger.
نامه را پشت اولین چیزی که دم دستم رسید قایم کردم و دویدم.	I hid the letter behind the first thing that come handy, and rushed.
نتوانستم شدت سرور و شادی خویشتن را مخفی کنم.	I could not help showing in my face how much it pleased me
از اسب پیاده شد و نگاهی به خدمتکاران خویش افکنده آمرانه فریاد کشید	after a glance at his retainers, shouted authoritatively that the superfluous ones should take
تا آن دو لااقل اطراف خود را ببینند و بدانند که در کجا هستند.	to all which might be added their ignorance as to where they were.
با داد و فریاد از او تقاضای کمک کرد.	shouted out, asking for help
اما این حال فقط تا وقتی پایید که در محاصره این ملاحظات بود	but that lasted only so long as he was among them.
زیرا که قادر به درک منطق و استدلال من نیستی	when you don't understand my words
این لطفی بود که پیش از آن هرگز مرا بدان مفتخر نفرموده بودند.	an honour which he had never before conferred upon me.
در این دومی است که قطعا اثری از عظمت دنیوی بایست باشد.	therein certainly must have been some touch of mundane grandeur.
انسان نیازی به فکر کردن و انتخاب کردن نداشت.	there was nothing to think out or decide
من یک روز ازش پرسیدم این کثافت چه بود که فرستاده بود.	I asked him one day what the devil he'd sent the filthy thing for.
نگاهی انداختم تا ببینم چه چیزی توجه او را جلب کرده است.	I looked to see what had his interest.
در وسط دریا بیاید ببینم که با ما چه خواهد کرد.	once out at sea, let him come.
تا به حال نشده بود کسی همچو حرفی به من بزند و من سرش را نشکنم.	I was never served so before without giving a hard blow for it
آن قدر عجیب بود مثل آفتاب گرفتگی یا زلزله یا یک آشتفشان و غیره!	for an eclipse, an earthquake, or a volcanic eruption would hardly have seemed stranger.
خودم میرم به فروشگاه ببینم اوضاع از چه قرا ره.	I'll go to town and see how things are.
یه چند روز به هم مهلت بده تا مطمئن شم.	give me a few more days to make sure.
تو باید شکر بکنی که حال وی از این بدتر نشده است.	be thankful it is nothing worse.
من نباید چیزی غیر از نگارش خط و حساب تدریس کنم.	I'm to teach nothing but handwriting and arithmetic
این دو تار مو لای درز دوربین گیر کردند و همونجا موندند.	these two hairs caughtthere and held.
هرچه در معده داشت به سر و صورت اربابش استفراغ کرد	he vomited up his inside over his very master
سپس برای آوردن شیء ای که فراموش کرده و جا گذاشته است بروم و در آتش بسوزم و معدوم شوم.	might rear it against her window, save her in my arms, go back for something she had left behind, and perish in the flames.
زیرا از سه زندانی دیگر یکی در زندان مرده و از خاطر رفته بود	for one of the prisoners so summoned had died in gaol and been forgotten
اگر بدانید مستخدمین از شنیدن این خبر چقدر خوشحالند.	I gathered from her that the servants in general were delighted.
اما چه فایده که خبر دروغ شد و ضرر عاید گردید.	but when it is not
لیکن نو مسلمان اعتراض کرد که این امر غیرممکن است	but he replied that it was not advisable
هرچند در هما ندم در دل از و رنجیده بود.	although at the same time she was heartily vexed.
یکی دو تا سؤال مهم دارم که باید از او بپرسم.	I have a question or two to ask him about myself of some consequence.
به یاد او افتاده و دیگران را واداشته بود که به این ضیافت دعوتش کنند.	had deigned to remember him in this open and direct way and to suggest that he be invited.
من دستور خواهم داد نیم ساعتی پیش از غروب آفتاب توپی در کنند.!	I'll fire a gun half an hour before sundown.
من واقعا تنها هستم و باید پشت به دیوار با دنیا مبارزه کنم.	I'm alone, really with my back to the wall fighting the world
بنای دروی دن گذاشتند اما سر شب که برگشتند دیدند اثری از شیر نیست که نیست.	when they came back in the evening it was noticed that the milk had disappeared.
خشم خود را به جوش آوردمو آن را ظاهر کردم.	I worked myself up into a state of moral indignation.
فردا صبح هم باید دوباره تو هم ون زیرزمین کار کنم.	in the morning he would be working in the basement again
زیرا وجدانش آگاه بود که رفیقش در چه اشتباهی است	for he could not forget how deceived his friend was
به صلاح تو است که دیگر حرفش را نزنی!	you'd better not!
اما زن خوش قلبی است و من از او خیلی ممنونم.	but she's a good natured woman, and I am so grateful to her.
تلگرافی دریافت کرد که خبر داد پدرش فوت کرده و تمام دارایی اش را به پسرش بخشید.	he received a telegram telling him his father had passed away, and willed all of his possessions to his son.
سراسر خبط حدود سه میل بود که زیاد بد نگذشت.	a pleasant three miles
در همه حال توجه داشتند که چشمان خود کام پیرمرد بر ایشان دوخته است.	ever conscious that the old man's despot eye was on them.
زیرا من نه دشنه کوچک داشتم و نه بزرگ	for it was not a dagger, nor little
من از آن فرصت استفاده کردم و به شتاب اندازه گری خود را به انتها رساندم.	seizing that lucky chance, I quickly concluded my own admeasurements.
که هنوز طرفین نیاموخته بودند که برای طرف مقابل چه چیزی اهمیت دارد	that they did not yet know what was of importance to each other
مطمئن بودم که این کار رای تو بدترین چیز ممکن است.	I am sure it would have been the worst possible thing for you.
باید از شما خواهش کنم که روی نوک پا راه بروید	I must request you to walk on tiptoe
اما یک ورق بسیار خوبی به دست من آمده است.	I had a splendid card all ready
وگرنه من برای اسب شکاری هر پولی حاضرم بدهم.	I would give any money for a real good hunter.
حالا دیگر آب آشامیدنی فراوان و غذای کافی داشتم.	I had now plenty of water and good things to eat
قدرت تکلم و حرکت را از او سلب کرد!	deprived him of his voice, and of power to move!
که قهرمان آن عبارت بودند از زن و شوهر و خاطرخواه.	the characters in which were husband, wife, and lover.
مقصود من در آن زمان این بود که ادعا کنم که این گنجینه از آن خود من است	I only wished to claim the treasure as my very own in those days
اما باید از همین حالا دیدگاه مثبتی نسبت به این مدرسه داشته باشی.	but you have to have a positive attitude about it.
تقریباً لباس پوشیده بودم و در جستجوی کراواتی مناسب بودم	I was nearly dressed and looking for a tie
همچنانکه دستمال را روی سر نگه داشته بود به سخنان کلیددار گوش داد.	still holding her handkerchief, and listened to what the housekeeper was saying.
بعد هم خدمتکار پیر وفاداری با چند تا چوب بیاید تو و آدم بترسد!	then to have a faithful old servant frightening one by coming in with a faggot!
همة اطفال آنجا را چون مرغان قفس آزاد سازم.	let all the boys out like so many caged sparrows.
سرانجام هم او را در آغوش خویش تکان داد و به جای لالائی برایش سرود مردگان خواند.	finally rocked him in his arms, intoning the _De Profundis_.
لذا پس از اینکه مدتی به روی موضوعات مختلفی فکر کرد	so, after a good deal of thinking to no particular purpose
نشسته در دل ابری از ململ و تور در مقابل میزی باریک و قلمی از چوب ماهون	sitting in a cloud of muslin and lace before a slender mahogany table
یک کلمه کوچک کافی بود که ناگهان غوغایی به راه افتد و باد تندی بوزد و آرامش خانه را بر هم بزند و از اسکار لت شخصیت دیگری بسازد.	it was amazing how completely and how quickly the teasing, affectionate wife who hummed to herself as she went about the house could be transformed into an entirely different person.
هری هرگز چنان اتاقی را در هیچ جای قلعه ندیده بود.	he had never seen a room like that here in the castle.
مگر اینکه درصدد اصلاح سخنان خویش برآیید و طرز صحبت کردن خود را تغییر دهید.	will speak if you don't correct and mend your own.
که راز عشقشان را حتی به تنها کسی که لیاقت شنیدنش را داشت هم فاش نکرده است.	that he had not revealed the secret of his love, not even to the one person who had earned the right to know it.
را از تاریخ و شماره گرفته تا امضاء چاپخانه خوانده بود.	at least three times, from the date of the number to theprinter's name.
در ضمن کوشیدم که تا آنجا که از من برمی آمد شیهه اسب را تقلید کنم.	imitating at the same time, as near as I could, the neighing of a horse
برای تصرف نخستین استحکامات دشمن از میان جنگل حرکت کند.	will move through the wood to seize the first fortification.
ازگردن گرگ خون جاری شد گرگ زوزه کشید وتقلا کرد تا ازدندانهای کوجک رها شود	his teeth sinking deep letting blood and the wolf howled and tried to struggle away
کیه که به اندازه پولش خرج نداشته با شه.	who has not?
اما با تفکر مجدد تصمیم گرفت ملاقاتش را تا غروب به تأخیر اندازد.	but on second thought he decided to put off his visit till the evening.
کاشکی زودتر تم وم به شه که من یه نفسی بکشم.	I'll be glad when this is over.
نمی دونم چرا جنگیدیم. اصلاً هم به رام مهم نیست.	I don't know why we fought and I don't care,
سرش را به زانوان پدر تکیه داده بود و در کنار صندلی راحتی وی نشسته بود.	she leant against her father's knee
دقیقا در همان هیئت بی حرکت ماندند که او بر جایشان گذارده بود.	remained exactly as he had left them, lest he should come back.
او که محو سکوتش شده بود خاموش مانده بود	he was silent, captivated by her silence
تبحر من در کار رزم و سلاح بیش از علم و دانش است	I have more of arms than of letters in my composition
تنش تقریباً از ضرب مشت و لگد خرد و خمیر بود	something more than pretty well pummelled
برای او نیز یک بستنی یخی لیمویی ارزان قیمت بخرند.	they bought him a cheap lemon ice pop.
از سه سرهنگ دوم دو تن در خاک و خون غلتیده بودند.	out of three lieutenant colonels, two lay on theearth
راهی هم نبود که کسی حقیقت موضوع را بفهمد.	there was no way of getting at the facts in the case.
به عقیده من جای خیلی خوب و لذت آوری است.	I believe it's a very pleasant place.
بنا به گزارش مکرر هم وطنان عزیز از گوشه و کنار کشورمان	bird watchers everywhere have reported that
سپس چندین بار به جمعیت رو کردم و احترامات چاکرا نه خود را به جا آوردم	I turned about several times to the company, paid my humble respects
من فقط یک انسان بودم. با چیزی در حد نیروی انسانی.	I was only human, with no more than human strength.
اما چشمش روی یک نقطه از آن ثآبت مانده بود.	but his tiny eyes were not moving
اما نتوانست و چنان قهقهه ای سرداد که خاص اشخاصی است که زیاد نمیخندند	but could not, and went off into peals of that infectious laughter that people laugh who do not laugh often.
مراسم کفن و دفن در یک روز برفی انجام میشد.	the burial was on a snowy day,
محض خیالات و صور وهمیه است و حقیقتی ندارد.	but the children of her imagination
که اگر بلند قامت و درشت استخوان نبود و آن اندازه نیرومندی نداشت	he would have been abnormal had he not been so tall, so broad of limb, and so strong
گاهی بدون خبث نیت و بیشتر اوقات با نوعی حس تلخ عجیب.	sometimes good naturedly, more often with a curious bitterness.
لابد به دلش برات شده بود که اتفاق بدی به راش میفته.	I suppose she had a premonition that all would not workout as she had planned.
آشوب و انقلاب را به اعلا درجه رسانیده بود.	had exercised to the full their delusions over the envious assembly.
تا من نیز بعدا نظر خود را اظهار دارم.	I'll tell you my idea after.
به کمک عمویش به زودی در خدمت دولت با درخشش به کار آغازید	with his uncle's aid, immediately started in a prominent position in the service
فکر دیگری یا به عبارت دیگر هراس مبهم بی نامی در مورد او موجود بود	there was another thought, or rather vague, nameless horror concerning him
که در آن خود کاترین را هم بشود مثلا تشخیص داد.	that she might be detected in the design.
از میان گل و لای گذشت و از کنار دیوار زندان پیچید و از نظر دور شد.	so went through the mud, and round the corner of the prison wall.
در برابر این کار پاداش یافت و با نمایش دادن من در نیمی از این مرز و بوم سودی کلان بدست آورد.	obligation was amply recompensed, by the gain he had made in showing me through half the kingdom
جز آن که نوعی حالت جدایی و نومیدی در آنجا حضور داشت	except that there was a distraction, a desperation
خیلی خیلی زیادتر از حدی که خودم بتوانم تصور کنم.	oftener than I would own at the time.
آن وقت داد وبیداد و سرزنش ارباب را من باید تحمل کنم.	I shall have the blame.
تا فراریانی را که مأمورین خارجی بوده و بآنها آزاری رسانیده بودند به قتل برسانند	to liquidate fugitives, foreign agents who had hurt the KGB
تصور چنین پیشامد خلاف عقلی برای خانم وال دشوار بود.	so preposterous a result was not strictly conceivable.
خوشبختانه پول زیادی نبود و فقط هشت پوند بدست آورده بود.	luckily not much, about eight pounds.
دوباره آن ترس و وحشت دیرین به سراغم آمد.	my old fear and horror rising up in me again.
حالا هم مسئله این نامه پیش آمده که در هتل به دستم رسیده.	now there's this affair of the letter to me at the hotel.
زندگی طبیعی اجتماعی که در آنجا باید ناچار از قوانین موضوعه پیروی کند.	his elemental hive life in which he inevitably obeys laws laid down for him.
عجب آنکه در همان لحظه شور و شعفش ناپدید گردید.	strange to say, almost all his gladness and self satisfaction passed in one instant.
به همین ترتیب به خیر و خوشی حرف زد و حرف زد	she talked in this way so long and successfully that
راستش به این امید آمدم تا شاید شما را تنها در خانه ببینم.	I really came for the chance of seeing you alone
من آن سلامت جسمی را ندارم که از آن جان به در برم.	I have not got the health to live through it.
اکنون دو نفر از دانش آموزان کلاس غایب بودند.	there were now two missing from their number
مگی عهدی را که با خود بسته بود تا در هر موردی که پیش آید سکوت کند شکست.	breaking her vow to remain silent no matter what.
اگر کسی به کمک من نیاید بدون شک تلف خواهد شد.	if nobody will help me, he'll die!
به نظر من این مرد همیشه منفور بود و آخر سر هم معلوم شد که همین طور است.	I, for instance, in her place could have felt no doubt. I always disliked him, and so it has turned out.
مردم فقط بل دن راجع به سختی اوضاع حرف بزنن.	the only thing people talk about is hard times!
همان بابایی که اسمش را گذاشته انند روی من	the guy they named after me
نه من فقط یه مرد معمولی هستم که هیچی برای از دست دادن ندارم	I'm just an ordinary guy with nothing to lose
که هرگاه بر حسب تصادف روزی با یک هیکل خیالی برخورد کنم هم آنجا خواهم مرد.	that if I were to see one I should die on the spot though I don't believe in ghosts.
در این موقع پی بردند که همسرم دیوانه است	for the doctors now discovered that my wife was mad
بعد هم سگ لرز زدن کنار بخاری زپرتی در اتاقکی سرد و نموک.	shivering thin blooded over a tiny radiator in a cold, damp room.
یادمان نرود هک اشتباه کرده و به این رابطه تن داده.	remember that she had done a wrong thing in consenting to the engagement
او به این سرودها بیانی آزاد و زنده بخشید.	he had given them a free and vivacious character.
دخترک از این که آتش بخاری را تند تر کرد	the girl, mending the fire
بلکه به طور موقت فاصله خود را با آن قایق چند برابر کرده بود.	but, for the time, to increase her distance from it.
اما وی لفور به اطمینانی که به قوت نفس خود داشت	while the procureur, who could better depend upon himself
یکدیگر را باز شناختند و یکدیگر را تنگ در آغوش کشیدند.	other asnecessary to each other, and embraced each other closely.
حتماً در تلاش برای فروش یک پناهگاه به سرمایه گذاری ثرومند.	he must be trying to sell a resort to some rich investor.
از صبح تا به حال یک آدم زنده هم ندیده بودم	I have not seen a creature the whole morning
پهلوان مهمان پس از چند روز اقامت در کاخ شاه از او کسب اجازه کند که به جنگ برود	the stranger knight, after having been some days at his court, requests leave from him to go
در اتاق خود پشت میز ایستاده و چمدان سفریاش را میبست	was standing at a table in her boudoir, packing her traveling bag,
پس از چند دقیقه که این جانوران ترسشان برطرف شد	at the expiration of a few minutes
که بدون شبهه پیر همان طور که بامداد قول داده بود یک بار دیگر بیدار خواهد شد	that the teacher would get up, and as he had himself promised in the morning
لکن آن را یک روز قبل نوشته بود ملاحظه کنید!	but he wrote it the day before that
اما حاضر نیست مفید بودن این هشت هزار روبل را انکار کند.	but there's no refusing to believe in the utility of eight thousand roubles.
این است شهامت و شجاعتی که در تمام تصادفات جنگ هیچ چیز را با آن یارای برابری نیست.	courage and daring the greatest that all the chances of war can show.
که خداحافظی به وی گوید و او نیز به هیچ کس خداحافظ نگفته بود.	nor had she thought of taking leave of any one.
انتهای هر کدام را به شکل قلاب در آوردم.	bending the extremities into a hook.
چون چشمان تو هنوز خیلی برای تحمل نورهای جورواجور یک چنین نمایشی مناسب نیست.	because your eyes are not well enough yet to bear the light of this fairy piece.
عینکش کج شده بود اما شنل را محکم دور خود پیچیده بود.	his glasses askew, clutching the cloak around him.
اگر می تونستم می ذاشتم که برای همیشه اینجا بمو نه.	I'd leave her here forever if I could.
بهتر نیست از آدم بترسند تا این که دوستش داشته باشند	is it not better to be feared than loved
من حس کام لا عادی ای داشتم به غیر از اینکه به خاطر بیدار ماندن در نیمه شب خسته بودم.	I felt perfectly normal, just a little tired from being up in the middle of the night.
اما امروز که عقل خود را به سرش جمع کرده و خود را اولین شخص عروسی رقیب خود قرار داد دیگر جای حرفی نماند	but when I saw how completely he had mastered his feelings even so far as to become one of his rival's attendants I knew there was no further cause for apprehension
با شتاب به نزدیک درب یا پنجرهٔ من بیا	you run up and knock at my door or at the window from the garden.
درخشش ستاره را در گردن و زانوبند را برپا به نمایش نهاد	let his star shine at his neck and his garter twinkle at his knee
پس از این پیکار به اعضای ستاد هم ترفیع داده شد.	following the battle fresh changes were made in the staff.
بکوبم تا سفت شود و بعد آن را با فنر پران از دنباله کشتی آویزان کنم.	batten them down tight, and hang it with the snap spring over the ship's stern.
به وجود داشتن شخص خود نیز کام لا اطمینان ندارد.	is not quite sure that it existsitself.
که لولای آن به جای آن که در پهلو قرار گرفته باشد در انتهای آن است.	with the hinge at one end, instead of one side.
فقط به یاد دارم هنگام یکه نظم برقرار گردید مأموری که ایوان را آورده بود سخت مورد مؤاخذه قرار گرفت	I only know that afterwards, when everything was quiet again and every one understood what had happened, the court usher came in for a reprimand
به من فرمان داده است که چگونگی کارهای او را بر تو روشن کنم.	has commanded me to lay this account of his affairs before you.
سمت سکان بانی را همان شخص بر عهده خواهد داشت	that subordinate is the steersman upon the occasion
با صدائی بسیار بلند خود را وارد بحث کردم.	plunged loudly and gratuitously into the general conversation.
دانکلار مشاهده کرد که این صحبت که در ابتدا اهمیتی نداشت	who, on his part, did not perceive how soon the conversation, which was at first disinterested
چند گام به استقبال او رفت و دستش را محکم فشرد.	going a few steps forward to meet him, shook hands with him very warmly.
یا زلف داشتند و زلفان خود را پشت سرشان جمع کرده به صورت گیسی بافته بودند.	whiskers curled in ringlets, and tarry pigtails
از یک لحاظ خوشحال خواهم شد زیرا به هدفم خواهم رسید.	I shan't be altogether sorry, for then my object will be attained.
وال که از آهن و زوبین تنها اندک خراشی برداشته بود گریخت.	the whale, merely grazed by the iron, escaped.
انتظار و قدم زدن کلاید در سلول و تظاهر او به روزنامه خواندن و یا استراحت پنج ساعت تمام به درازا کشید.	after that five long hours in which he waited, walking to andfro, to and fro, in his cell, or pretending to read or rest
هنوز شب تمام نشده بود و هوا روشن بود.	it was still night and still bright.
امیدوار بود که در مدتی مناسب نسل گوسفندان بی پشم را در سراسر کشور تکثیر کند.	he hoped, in a reasonable time to propagate the breed of naked sheep, all over the kingdom.
دیگر مجبور نبودند شکم پنج آدم مفت خور را پرکنند.	not having to support five extravagant human beings as well
تو هم برو به خط جبهه و اعلام کن که فردا حمله شروع خواهد شد.	ride along the line and that tomorrow we attack.
زیرا ذاتاً ترسو و خود از این نکته آگاه بود.	just because he was physically a coward, and was himself well aware of the fact.
پیش خود حساب کردم که بهتر است مطیع امر او شوم و نزدیکش بروم.	I thought it best to go back.
موقع ظهر شدت درد چنان بالا گرفت که بی حالش کرد و یکی دو ساعت بعدازظهر بکلی او را از پا درآورد.	by noontime the pain was so great that it made him faint, and after a couple of hours in the afternoon he was fairly beaten
نامرئی و در سکوت مطلق پنداری به نحوی مرموز و اسرارآمیز از قایق بزرگ مخصوص حمل و نقل پایین رفته بود.	invisible and inaudible as if he had mysteriously stepped out of the lighter.
من هم تصمیم دارم فرق قضیه را نشانشان بدهم.	I am determined to show them the difference.
اما درست در همین موقع دسته ارکستر از نواختن بازایستاد	but just then the music stopped
اما یکی از گوسفندانش شبی از گله جدا شده بود و ناچار تمام روز بعد را در جستجوی آن گوسفند گمشده گذرانده بود.	but once an animal had strayed during the night, and the boy had had to spend the entire next day searching for it.
این شد که درست رو به روی من وایستادن	so they stopped right before me
اما گزارش کار شما به ستاد کل داده خواهد شد.	but your affair will be passed on to headquarters.
از آن ملعون عنان گسیخته و جسور که انتظار دیدنش را داشتیم هیچ اثری نبود.	there was no sign within it of that desperate and defiant villain whom we expected to see.
اما من هیچ وقت به روابط خانوادگی متکی نیستم	but I never presume on the connection
برای این که ضرورت دارد او را از این حقیقت که من هم ممکن است صدمه ببینم بی خبر نگه دارم.	for it is imperative that I should keep him ignorant that harm to me is possible.
گاهی ممکنه صحبت کردن با مردم واسه دونستن بعضی چیزا کافی با شه و کارا سر و صورتی به گیره.	sometimes it is enough if some one speaks to the persons, that suffices to let them understand matters, and everything comes right.
چشم سحرآمیز و پای چو بیش هردو سر جایشان بودند.	his wooden leg and his magical eye back in place.
اون وقت سوارت میکنن و سه سال دی گه مینداز نت تو زندون.	they'll take you in and run you back to McAlester for three years.
آن را با قریحة سرشار خویش مانند نوعروس بیاراست و روی کاغذ بزرگ نگاشت	invented it, engrossed it on an immense sheet of paper
پس از این لحاظ هم باید تساوی موجود باشد.	there ought to be equality in that, too.
پس از ای که یک توپ پارچه به من نشان داد	after showing me a roll of cloth
ولی مرد اصلاً او را دوست نداشت و هرگز هم پسرش را بعد از این ازدواج نخواست ببیند.	but he did not like her, and never saw his son after he married.
این توصیه نتیجه جلسه مشاورهای بود که او و کشیش و دلاک با هم تشکیل داده و در این باره بحث کرده بودند	it was in consequence of having been previously in conclave with the curate and the barber
آن را در قلبم نقش بستم که در آنجا بماند تا در زمان آزمایش به من کمک کند.	I impressed it on my heart, that it might remain there to serve me as aid in the time of trial.
ناگهان آخرین گفتگوی خود را با او به یاد آوردم.	I remembered suddenly my last talk with him.
هزار سکه زر در بهای من طلبید که در دم به او دادند.	demanded a thousand pieces of gold, which were ordered him on the spot
اومده بودم تا اینجا رو به قیمت خوبی بهرم اومده بودم پیشنهاد خوبی بکنم.	I came out here to offer to buy this place from you to make you a right good offer.
چشمانش نظیر دیدگان من سرخ و متورم بود .	I saw her eyes were red and swollen with crying, even as mine were
دست بر رانهای خود کوبید و دو پشتک و وارو زد و سر بر زمین گذاشت و پا به هوا کرد و چنان اسافل اعضای خود را عریان نمود	a couple of somersaults, heels over head, making such a display that, not to see it a second time,
زیرا موجودی که تابع تأثیرات جهان خارجی نباشد و محدود زمان وقایع علل نباشد دیگر انسان نیست.	for a being uninfluenced by the external world, standing outside of time and independent of cause, is no longer a man.
حتی نیازی نداشت که به خود زحمت دهد تا موضوعی بیاید و آن را به زبان موسیقی در آورد.	he did not even have to cast about for subjects for translation into music.
گویی هر آن انتظار دارد که در دامی گرفتار آید.	looking nervously about him for hidden trap doors.
گرچه ما در خلال آن مدت کمال سعی و مراقبت بجا آوردیم تا مگر بدانیم چه کسی در آن خانه ساکن است	though meanwhile we endeavoured with the utmost pains to ascertain who it was that lived in the house
غار پر از بازدید کنندگانی بود که از نقاط مختلف جهان به آن جا آمده بودند.	packed with hundreds of tourists from countries all over the world.
ولی چون از وضع او نتوانست هیچ به کشف این معما نایل گردد	reading no satisfactory explanation of the riddle there
اما با آن آقایان هیچ نمیشود کار کرد .	but with these gentlemen it's impossible to do anything,
دستور به مات پنی من که برود از مستأجرهایی که آه در بساط نداشتند پول بگیرد.	advice to MatPenniman on getting money out of tenants who had no money.
او هم که رازش را به من نگفته بود.	neither did he confide in me.
در یک بعدازظهر از جریان عادی یک زندگی هشت ساله خسته شدم.	I tired of the routine of eight years in one afternoon.
حالا خیلی از آن زمان گذشته بود و بزرگ شده بود	she'd grown up since then
قطعا تمام دارائی شما در این بسته پیچیده شده است.	I suppose your whole set up is in that bundle
او با این شرط موافقت نمود که یک کلاه روی سرش بگذارد و لباس مناسب و معقولی به تن کند.	she let her go one afternoon, providing that she wore a hat and a decent dress.
پاسخ گرفت یه جفت بهتر از اینو تو خو نه دارم	I've a better pair at home, was the answer.
با شگفتی تمام متوجه شد که هیچ دستوری حقیقة از طرف او صادر نشده است	to his surprise, found that no orders were really given
که پنج دقیقه از وقت مقرر برای مشق پیانو گذشته است و با قیافه بیمناک به اتاق پذیرایی رفت.	seeing that she was five minutes late in starting her practice on the clavichord, went into the sitting room with a look of alarm.
از ناچاری و ناامیدی خود را در این پانسیون انداخت.	but even to see him no more except in private.
هرگز چنین رنگ سرخ و زیبایی در چهرة مادرم ندیده بودم.	I never saw such a beautiful colour on my mother's face before.
قبلاً حدسی زده بود که مهمانش عقل سبکی دارد	had already some suspicion of his guest's want of wits
از آن سود جستم و چاشنی ششلول خود را عوض کردم	I lost no time in changing the priming of my pistol
اینک همگی در یک نقطه زیر چترهای به هم وصل شده جمع شده بودند.	now they were all under a single assemblage of umbrellas
پس از اینکه جملاتی برای همدردی با دانکلار بیان کرد	after expressing acute sympathy with the father.
از وضعیت مالی او باخبر شد و از این رو سعی کرد	it was not long before she began to realize what his financial state was
نوک پای او را که از زیر پیراهنش بیرون بود گرفت و بوسید.	he took the tip of her foot which peeped out from beneath her robe, and kissed it.
دیگری یک تازی که از آن سگ بلندتر بود	another was a greyhound, somewhat taller than the mastiff.
فقط به آهستگی و شایستگی تمام بازوی خود را به دور گردن خانم انداخت.	but in a slow and dignified manner, put his arm round the matron's waist
این بود که خیلی مختصر درباره رقص اظهار بظر کرد.	she made some slight observation on the dance.
یکی دی گه رو گیر بیارین همراتون به یادش!	I getten summut else to do,
عدم دفن جسد مغروق برای سلامتی جامعه خطرناک است.	an unburied drowned man was a danger to public health.
از ای نرو اگر آنان را وادار به قبول این مداوا کنند	who, if they were forced to undergo the same regimen
اما این بار ناگهان سخنان خود را به زمزمه ادا کرد.	but he too spoke in a sudden whisper.
ولی برای من قسم خوردی که لحظه آخر تعمدا به صورتش نزدی.	whatever you might havebeen provoked to do at first.
برای تسریع امر به آهنگر کشتی فرمان دادند که بی درنگ دست به کار ساختن هر گونه وسیله آهنین شود که ممکن بود لازم آید.	to accelerate the affair, the blacksmith was commanded to proceed at once to the forging of whatever iron contrivances might be needed.
برای خودم که پهلوان نیستم گوشت پرندگان و چیزهای دیگری که مقوی باشد خواهم آورد.	for myself, as I am not one, I will furnish them with poultry and other things more substantial.
دستمالش را به آرامی تکان داد و رایحه عطر آ گینس را به سوی او گسیل داشت.	waved her handkerchief idly so that the faint sweet smell of the cologne could reach his nose.
که غیر از اولاد بزرگ طایفه کسی را اطلاع نیست	the secret of which they have transmitted only to their eldest sons
یک بشقاب کوچک از آن غذای لذیذ سفارش دادم.	ordering a 'small plate' of that delicacy to eat with it.
من اطمینان داشتم که از آن حوالی زیاد دور نشده است.	I felt pretty sure that he had not moved far.
مجدداً پس از یکی دو دقیقه صدای ماکزیم شنیده شد.	then, two minutes afterwards.
احساس کرد که دو نفر پلیس به او گذاشتند	she sensed rather than saw two uniformed police officers step up on either side of her.
تنها یک چیز کم داریم که آنهم فرمانده کل است	only one little thing is lacking, namely, a commander in chief.
دست دخترش را گرفت و او را همراه خود به سفر فراموشی برد.	he took his daughter away on the journey that would make her forget.
هرچند که در سایه پتوها خوابی را که شب قبل از دست داده بودیم جبران کردیم.	though we enjoyed ourselves in the shadow of our blankets, sleeping out the sleep we had missed the night before.
باید اعتراف کنم تحمل وزنش برای من بیش از اندازه دشوار شده.	I confess she grows too heavy for me.
من فقط به یک تن احتیاج دارم که با من از نهر بگذرد.	I only need one man to swim the creek with me.
آهنگ خود به خود خواهد آمد و بعلاوه اصولا آهنگ به طور مجزی وجود ندارد	that the tune comes of itself, and that apart from the words there is no tune
باید فکر کنم به بیم که از چه راهی باید به او بگویم.	I must think of some way to let him know.
همان یک کلمه شما را دچار چنان تعجب و اضطرابی کرد که بدون توضیح دیگری به همراه من تا اینجا آمدید.	was, in itself, almost enough to make you accompany me hither, in wonder and alarm.
اما طغیان درونی او زیادتر از آن بود که بتواند.	but the turmoil within him was too great.
اما اگر آن موقع فکر نکردید حال مثل یک مرد عمل کنید.	but if you did not think then, try to act like a man now.
آزمایش نفس حقیقت دور از حزم و تدبیر است	it is an uncalled for proceeding to make trial of truth itself
فقط برای اینکه از او دعوت نشده بود که وارد این کار بشود.	just because he wasn't invited to come in on it.
تا اینکه چند روز بعد از رسیدنش روزی سر راه بر یکی از چوپانان ما گرفت	until some days afterwards he crossed the path of one of our shepherds
فقط هم شما باید مرا راهنمایی کنید نه هیچ کس دیگر.	I need it from you, and from nobody else in the world.
زنان نیز با عجله لباس پوشیده بودند و در خانه همسایگان را به صدا درآورده بودند و داستان را با آب و تاب شرح داده بودند.	the women, dressing hastily, knocked on their neighbors' doors and spread the story.
ا این که چند ساعتی قبل از طلوع آفتاب همراهان را بیدار کردم.	till, hours before dawn, I had the men up and made them load
تابوت ساز این جمله را با لحن نیمه قطعی بیان کرد	said the undertaker in a tone which half admitted and half disputed the probability of the event.
به بقیه افراد دستور دادم تا از میان خط آهن به پیش بروند تا دشمن را از پشت آبگذری که در آنجا پنهان شده بود بیرون برانند.	I ordered the rest across the line, to drive the enemy away from their shelter behind a culvert.
ناگهان این اندیشه به خاطرش رسید که حقیقة خوب بود	the thought flashed into his mind that it really would be a good thing
ولی کمی سبک سنگین کرد و دید لزومی ندارد همه چیز را لغو کند.	but a little consideration convinced her that every thing need not be put off.
برس کشیده بودند و مقابل آتش نگه داشته بودند.	a clean hair brush and frantic wavings in front of an open fire.
حقیقتش اینست که مدام با یکدیگر در جدال بودیم که کدامیک از احتیاجات ما بر دیگری ترجیح و ضرورت دارد.	for, really and truly, we did not know which of all the things we wanted we wanted most, and we were always quarreling about it
می تونستم صدای صحبتش ون رو که داشتند در مورد اینکه باید به راش گرمش کنند یا نه رو بشنوم.	I could hear them debating whether they should warm it up for her.
چنان ساده سخن گفت که همگان مشتاقانه گوش دادند.	he spoke so simply and so well, that everyone listened eagerly.
چشمان خمارش را به شعله آتش بدوزد و خواب ببیند.	eyes blinking dreamily at the flames.
اما اگر مردی چنین کرد زن او بسیار در خورد ملامت است.	but that a woman is much to blame if he does.
بخواهند یکی از جزایری را که خود مدعیند در دوران زندگی پرماجرای خویش بدست خواهند آورد به من بدهند	is pleased to give me some island of the many his worship says one may stumble on in these parts
حکومت باید بر اصولی استوار و مطمئن تکیه کند و بر استبداد متکی نباشد.	that the government must rest not on authority but on secure bases.
به همان گوشه پناه برد و به دیواره سنگی تکیه داد	he slipped aside, with his back to the pilaster
دسته موی پرپشت موی پر پشت پرکلاغیش را به پشت انداخت.	she swung back her mane of inky hair.
کاش همین طور بشود و من به بستر بیماری بیفتم!	I wish it may prove true.
کسی را که از فتنه و فساد شما مطلع شده و بروز ندهد.	, knowing your conspiracy and not informing against you
که هم به قدر یک روز صبح خوب کار کرده بودم	but that I had done a good morning's work
اما میدانست که در آن جا همه چیز کامل است و او عاشق همین رمز و راز بود.	but he was sure that everything that was done there was very good, and he was in love precisely with the mystery of the proceedings.
