ولی کام لا به دور از ساحل و اقلا در ده مایلی آن.	but well away from the land, at least ten miles out.
وگرنه خشم مرا بر خواهد انگیخت و با قهر من مواجه خواهد شد.	under pain of incurring my fierce indignation.
از ستودن پزشکی که تشخیص داده بود با چه بیماری سروکار دارد به هیچ رو خودداری نکرد.	he was not backward in awarding credit to the medical man who had discerned the quality of patient he had to deal with.
چند قطره اشک هم از آن آب گاه سوراخ و آسیب دیده روی آن بچکانند.	drip a tear on it from their permanently impaired and leaky water works.
بیش از این سخن جناب دانشجو را قطع مکن	don't interrupt the bachelor
از ای نرو زنی رام و فرمان بردار و آماده برای اجرای فرامین مردانه.	therefore, and ready to carry out behests which came from that limit.
ان قدر ترسیده بود که جرأت قبول آن را نداشت.	so deeply scared he hardly dared admit it 'to himself.
بلکه یک فتنه محقق که صدمه تمامی است بر تخت اعلیحضرت شهریاری	a storm which menaces no less than your majesty's throne
من در روزنامه خواندم که شما مایلید احتمالا یک زمرد بخرید.	I have read you are interested possibly in buying an emerald, s.?
که پیرامون آن مانند خطوطی که به نوک یک سپر منتهی شوند	whence ran, as fromthe peaked boss of a shield
مثل اینکه هنوز حالتان کاملاً سر جا نیامده است.	you're right sickly yet.
گاهی بی آنکه سر را برگرداند چپق را که تا آخر کشیده بود	or, without turning round,handing a pipe he had finished to
سرپوش را با چنان احترامی از روی آن برداشت	took the covers off in such a bouncing manner
سپس گفته بود که آن را به خوبی قیر اندود کنند تا آب از آن نتراود	which, being well pitched, to prevent leaking
پس جناب حاکم امید دارم که در حق همکار من رعایتی مخصوص بفرمایید	but I hope governor that you will show him all proper respect
سپس نگاهی به او افکند دستی به سر و صورتش کشید	he looked at him
اما بچه به قدری به او انس گرفته که مجبور شدیم نگهش داریم.	but the baby is so used to her that we've gone on keeping her still.
چون باید در آخرین مرحله به معجون اضافه به شه	because we add those bits last
از آن جا که اطمینان نداشتند خروجشان از قلعه بلامانع باشد	as they weren't entirely sure they were supposed to be out.
از او تقاضای اندکی تسمه کرد تا ننوی خود را مرمت کند.	asked him for some twine to mend his hammock.
حالا ممکن است همه چیزم را از دست بدهم.	I had to keep the mills going!
زیرا هم خودش محظوظ بود و هم دیگران خشنود بودند.	that he was having a good time, and that everyone was pleased.
ولی چون لنگ خیلی درازی داشت و پاهایش بیرون مانده بود	but his legs were so precious long that they stuck out at the top
برای من افتخاری بود که این ماموریت را بپذیرم و افتخار بیشتری خواهد بود که آن را به انجام برسانم.	I was happy to be entrusted with the charge. I shall be more happy to execute it.
زندگی مانند یک حکایت شیریت و داستان پریان بود	that life was more like a great fairy story,
آرزو داشتندکه او در کاری که به وی مربوط نیست دخالت نکند.	she was only desired not to meddle with things that did not concern her.
ولی اطمینان دارم که گلیم خودشو از آب بیرون میکشه.	but I feel sure I can pull him through.
زیرا که دامن قبایش را گرفت و آهسته مرا در آن نهاد	for, lifting up the lappet of his coat, he put me gently into it
اون موقع شو نزده سالم بود و پدرم مجبورم کرد ترک تحصیل کنم.	but then I was sixteen and my daddy made me quit.
اِما زیاد هم خوشش نیامد که شوهر خواهرش او را چشم و گوش بسته فرض کرده	not very well pleased with her brother for imagining her blind and ignorant
چیزی که در داخل آن بود با صدای بلندی بسته را گاز گرفت درست مثل این که دندان داشته باشد.	whatever was inside it snapped loudly ' as though it had jaws.
طبعاً جواب این سؤال را هم سعی داشتم در چهره سی نت جان پیدا کنم.	as naturally, I sought the answer to the inquiry in his countenance.
این اندیشه را فراموش کن و او را ببخش!	forget it and forgive!
همیشه دزدانه بازمی گشتم و پشت در اتاق می نششستم.	I used to slip back and sit outside the door
آنهم بی آنکه به توفیقی که در بدو امر بدان امیدوار بود دست بیابد.	but without the success she had at first hopedfor.
برای تقویت قلب من مفرحی داد تا تسکین یابد	gave me a cordial to comfort me
پس از آن نیز به راحتی به بستر رفته و خوابید.	then to go cosily to bed.
هم تقاضای خود از لیدیا ایوانونا و هم موضوع خواهرش را فراموش کرد	forgetting his sister's affairs, caring for nothing, but filled with the sole desire to get away as soon as possible
الان گارسون را هم صدا خواهم زد و با و خواهم گفت که از فردا صبح مسؤول خرج مهمانخانه شما نخواهم بود	I am about to call the landlord, and explain to him that from tomorrow onwards I shall no longer be responsible for your hotel expenses.
یگانه احساس سوئائی که در او بود حسد بود.	jealousy was his only passion.
زیرا آن اپینت قریب به نوزده گز طول داشت.	for the spinet was near sixty feet long.
من هم به طبقه بالا رفتم تا لباس عوض کنم.	I went upstairs to take off my things.
اما من گرفتار خارش آرام ناشدنی برای چیزهای دور از دسترس هستم.	but as for me, I am tormented with an everlasting itch for things remote.
بدین معنی که کاترین نقش معلم دلسوزی را به خود گرفت و هیرتن نیز کوشید تا شاگرد علاقمند و دقیقی باشد.	as busy as possible in their several occupations of pupil and teacher.
موجود کوچک تیره رنگی که به همت مردی خیرخواه و نیک نفس از گوشه خیابان و چنگال مرگ نجات یافت.	the little dark thing, harboured by a good man to his bane
تا اینکه می فتادن و از خود بیخود می شدن.	till they just fell down an' passed out.
با این همه آرزو دارند دنیا را سیاحت کنند	they long to see the world
آقای گولد لحنش را کام لا عوض کرده بود.	already he had changed his tone.
اگه نجنب ین باید آخرین نفری باشین که از سرسرا بیرون می ره.	we'll be the only ones left here if you don't move.
با احتیاط فراوان مراقب بود حرفی نزند که باعث خجالت و ناراحتی میزبانش شود.	she was taking great care not to say anything to embarrass her companion.
چند بار هم به روی بینی خود زد تا دقت کامل او را جلب نماید	tapping the bridge of his nose with it, to bespeak the exercise of that worthy's utmost acuteness.
شهامت دل بی باک خود را بنما و خویشتن را به میان این آب آتشین در انداز!	prove the valour of thy stout heart and cast thyself into the midst of its dark burning waters
که کسی نفهمید از کجا آمده است یا با که پیوند دارد	no one quite knew where from or to whom he belonged
که در تاهیتی ایشان را به دست قانون بسپرد تا ابد از او جلو بودند.	had he been at all minded to work them legal retribution.
هرچند که تحصیلات دانشگاهی نظراتش را درباره مقام و درآمد تغییر داده بود.	notwithstanding that share in the higher education of the country which had exalted his views of rank and income.
گویی یقین داشت که دیگر موضوع مراقبت از طفل منتفی شده	as if conscious that there was no further occasion for his keeping on guard
که من توانستم نیم ساعت فرصت پیدا کنم تا تو را ببینم و اخلاص خود را نشان بدهم. به شیوه ی کنایه آمیز خود	that I should just have half an hour to meet you, so that I can prove my devotion,' he went on in the same jesting tone.
چنان سر به گریبان غم فرو برده بود که اصلاً به اطرافیانش توجهی نداشت.	the longer he stood, the plainer his reflections revealed their blackness through his features.
همه هم میدونن که شما نمی تون ین این پول رو بپرداز ین.	everybody knows pretty well that you can't pay them.
زن داد زد گفتم که بالاخره یه روزی از دستت می ره.	I told you you'd lose 'm, she cried out.
اما نخواست به روی خود بیاورد که خودش هم ملتهب است.	but she didn't want to show it.
به شرط آنکه تازه باشند خیلی زیاد به کلوچه شباهت دارند.	housewives' dough nuts or oly cooks, when fresh.
توانست تا حدی اعتماد و توجه وی را جلب کند.	had contrived to ingratiate himself
توی آب گرم با دقت و حوصله روش کارکن.	just mull things over in the hot water.
ساعت در حدود یازده شب بود که صدای شکستن شیشه آمد و دیگر صدایی به گوش نرسید.	ended at about eleven o'clock with a tremendous crash of glass.
ژنرال حتی به میز بغل دستش نگاه کرد تا ببیند غذای سرد هم هست یا نه.	nay, that he was even looking at the side table for cold meat which was not there.
ولی هیچ به یاد ندارم شنیده باشم که پدرش را تهدید کرده است.	I don't remember any threat uttered by him against his father.
دوست دارم تو را هر چند وقت یک بار ببینم.	I like having you around.
در حدود یک دقیقه غرق در تماشای خاموش و سکوت آمیز بود.	looked on, for a minute or so, in silence.
نمی تو نه رونقی رو که پدرت به وجود آورده بود به اینجا بر گردونه.	like your father did.
هرکدوم که زرق و برقش از همه بیشتر بوده همونو جدا کرده بود.	picked out the one with the most shiny stuff on it.
هر سه چنان بودند که موجب تعجب و تحسین تماشاگران از عوام و خواص شدند	which were such that they filled all who heard them with admiration, delight
با دست دیگر چشمشان را گرفتند و خیلی آهسته به طرف آن رفتند.	t'other hand to their eyes, walked slow and solemn over there
اما مشروط بر آن که در ارتفاع کمی پرواز کنند.	as long as they didn't fly too high.
سراسیمه در طول و عرض اطاق به قدم زدن پرداخت.	paced violently to and fro, like one distracted.
در این حال آنا دست برادرش را گرفت و به سوی اتاق پذیرایی به راه افتاد.	as taking her brother's arm she walked with him to the high doors
فوراً متوجه شدم که اینجا محل این گونه اشخاص است.	I knew immediately that it was a big bug.
خزان آن را پیش آورد و در آن حال به مزاحم خود گفت	creepingly drawing it back, told his persecutor
وی چگونگی خبری را که خدمتگارش به او داده بود از من پرسید.	he asked me the meaning of what his servant had reported
اما درباره آن جانور غول پیکری که اخیراً گرفتار آن شده بودم	as for that monstrous animal with whom I was so lately engage
بلکه مثل زدم تا او را سرمشق توبه و پشیمانی خود کنید.	but I do place him before you as a model for repentance.
شارلوت همه احساسات خوب را فدای امور مادی کند.	she would have sacrificed every better feeling to worldly advantage.
پنداشتی این لبخند را برای هر نوع اعتراضی آماده کرده بود.	evidently prepared beforehand to meet all objections be they what they might.
این افراط از برای اشخاصی با نام و نشان دیگر مضحک است.	it is quite ridiculous for a young lady of fashion
گرچه هیچ وقت آن جا غذا نخورده بودم. با پیش بخاری قهوه ای و کاغذ دیواری زرد.	though I'd never had a meal there with its brown mantelpiece and its bronzy yellow wallpaper
علت تأخیرش در آمدن به نزد اربابم نیز همین بوده است.	that was the cause of his delay in obeying my master's summons.
قصدم آن بود که این نکته را نیز در نامهء خود متذکر شوم.	this, too, I resolved to state in my letter.
با خود فکر کردم از او خواهم پرسید چه اتفاقی برایش رخ داده است.	I will ask what is the matter, I thought
به شدتی که از تفنگ سر پر ساخته نیست هرچه در معده داشت به ریش مهتر دلسوزش پاشید.	he discharged all its contents with more force than a musket, and full into the beard of the compassionate squire.
فضای باغ را رها کردم و به سوی مهتابی قصر پیش رفتم.در عالم خواب.	I left the drive and went on to the terrace, a dreamer.
چون خود او با رضایت خاطر حاضر است در معیت شوهرش به پیشواز مرگ برود.	for she would lay her own fair head beside her husband's cheerfully.
هنگامی که به آن مردم گفتم که ضامن اجرای قوانین ما همانا کیفرست و هرگز سخنی از پاداش درمیان نیست این را یکی از نقائص عظیم حکومت ما دانستند.	these people thought it a prodigious defect of policy among us, when I told them that our laws were enforced only by penalties, without any mention of reward.
در اتاق رئیس زندان اسمش و نوع جنایتش را در دفاتر ثبت کردند	with, once he was presented to a clerk in the warden'soffice
بعدش هم ابدا دچار عذاب وجدان نخواهید شد. حرف خود را تمام کرد.	then you won't have your conscience to deal with afterwards, either.
فقط اندکی از دیوار فشرده پی مانند به جا مانده بود	leaving little but the dense tendinous wall of the well
ک تابندگی مجهول در چشمان آ بیش افروخته شده بود.	an unaccustomed splendor had been lighted in her blue eyes.
بنابراین جاسوس و خبرچین شدی و آینده مرا برای همیشه تباه کردی.	so you acted the spy and informer, and ruined my prospects for ever.
سپس درباره ماهیت کاری قرار بود در طبقه پنجم به کلاید بدهند توضیحاتی داد.	he proceeded to explain the nature of the work on the fifth floor.
تا دو دقیقه پس از ورودش به او اعتنایی نکرد حس تحقیر وی رو به فزونی رفت.	for the first two or three minutes taking no notice of his arrival.
روی آن یک لاش خور خشک شده قرار داشت.	topped with a stuffed vulture.
هفتاد و دو هزار تن رزمجو از هر طرف.	seventy two thousand combatants on each side.
هر آنچه در هواپیما گفته بودم از روی منظور خاصی نبود.	I didn't mean any of what I said on the plane.
در عوض اینکه بعضی احسانات و خیرات برای آسودگی روح او نمایم و تاریخ این سلسله را بالتمام بنویسم	on condition that I would have anniversary masses said for the repose of his soul and that I would draw up a genealogical tree and history of his house
رمیده و بیمناک از صدای سم اسبان چنان سراسیمه و پریشان شد	scared by the tramp of the many horses, grew so confused
آنقدر خسته و مضمحل بود که بی حال روی تخت افتاد و خوابید.	he fell into bed, utterly exhausted, and slept.
باید به عرضشان برسانم که در این کار هیچ دهقانی دست نداشت است.	I apprehend your meaning to be, that this attempt was not made by a countryman.
اونچه که از خو نه مو نده بود برای مالیات رفت.	the town house went for taxes
که به نظر اکثر مردم عاقل و با شعور حکم پیروزی خیر و خوبی بر تمام اهریمنان و اشرار زمین را داشت.	which to the most sensible minds appears like a triumph of good over all the evils of the earth.
علامت این است که من چه آدم مریض احوالی هستم!	it shews what a sad invalid I am!
پرسید که مگر شاه و ملکه آن سرزمین گوششان سنگین است.	asking me whether the king or queen of that country were thick of hearing.
بدین معنی که عقیده او را درباره پیش آمد مهمی به باد تمسخر گرفتم.	I insulted him on a perfectly extraneous pretext, jeering at his opinion upon an important public event
این کشیش بود که توانست او را وادار به این کار بکند.	it was the priest who succeeded in reconciling him to them.
پس پیشنهاد کردم که به زمین دراز بکشم تا قد او به آسانی به گوش من برسد.	I offered to lie down that he might the more conveniently reach my ear.
برگشتم و سرم را خم کردم تا زیر میز را نگاه کنم	I spun, ducking my head to look under the table.
اما احساس کرد که بیش از اندازه آشفته است.	but he felt too much excited for it.
داستان گرفته بود و رامش کرده بود مجبورش کرده بود بنشیند و گوش دهد و جزییات را از یاد برد.	it had gripped her and mastered her, made her sit there and listen and forget details.
بدین طریق مرد ساده دل به حکایت خود پایان داد.	with this the worthy fellow brought his story to a close.
جعبه داشبورد را باز کردم و گوشی را برداشتم.	I opened the glove compartment and retrieved the phone.
با دقت و سرعت دوباره قایق را به دست او ردیم	carefully and quickly we regained the vessel
آن گاه در اتاقش شروع به قدم زدن کرد	then paced the room
تو بلدی جاهای خوب را به ما نشان بدهی.	you will show us the nest places.
بعدش بهمون گفت که هیچ پولی به هم و نمی ده.	he wasn't giving us anything.
در هیچ یک از محافل بر روی من بسته نبود.	no circles were closed against me.
هری ساکت شد و خانم پا مفری از این فرصت استفاده کرد و او را به تختوابش برگرداند.	he choked, and she seized the opportunity to force him back onto the bed.
که مشارالیه به زانو نشسته و با کمال احترام گرفت.	who received on his knees this striking proof of his sovereign's confidence and friendship.
در اوج آمادگی و چابکی فقط منتظر یک حرکت دست او بودند چنین گفت.	waited with alacrity upon a wave of his hand.
آدم رذل تمام عیاری بود که نه استحقاق ترحم داشت و نه استحقاق بخشش.	an unmitigated scoundrel for whom there was neither pity nor excuse.
از این تیر در فواصل معین زنجیرهایی به طول سه پا آویخته بود	from this beam hung, at short distances apart, chains three feet long
برای مرد هنوز اندکی عشق باقی مانده بود تا از او تقاضا کند پشتش را صابون بمالد.	he still had enough love to ask her to soap him.
به او گفتم بهشت وی رنگ و شور زندگی ندارد.	I said his heaven would be only half alive
که پس از انتشار چند زندگینامهٔ احساساتی در تودهٔ مردم نفوذ کرده بود.	which had been popularized by sentimental and virtuous biographies.
باید بداند که یک غلام حلقه به گوش در دنیا دارد	she should know that she had one slave in the world
سرش سنگین و چشم و گوش و همهٔ حواسش مست و پر همهمه بود.	his head was heavy, his eyes, his ears, all his senses were dumb and throbbing.
در هر کاری بجز آنچه مستقیماً به منافع او بستگی داشت بسیار جدی و با پشتکار بود	as active a creature about everything but his own affairs as ever existed
حتی به شماره افراد قشون و آرایش آن بستگی نداشته است	or even on numbers, and least of all on position.
زنش تنها هنگامی از او چشم برمی داشت که با نگرانی در چهرهء پدر نظری کند	his wife only looking from him to look with solicitude at her father
در این موقع شوالیه فوراً به خودش آمد و سلطان ستمگر را با یک حرکت از پنجره بیرون انداخت و بعد هم پیروزمندانه به سراغ دخترک رفت تا به او محلق گرد.	pitched the tyrant out of the window, and turned to join the lady, victorious,
نمی تونم با چوب دستی مغز کسی رو بکوبم.	I don't maul nobody with a fence stake no more.
بهتر است از رشتن این پشم برای من خودداری کنید من بزدل نیستم.	you'd better stop spinning that yarn to me I'm not green.
دیگر برای بازگرداندن اوضاع به حالت سابق خیلی دیر شده بود.	it was already too late for things to return to their former state.
دیگر برای پیدا کردن وسایل تفریح و سرگرمی نیازمند راهنمائی آنان نیست	which would make it unnecessary even a bit presumptuous for them to suggest ways
کل ماجرا را مثل صبح روز قبل تعریف کرد.	presented the whole case as he had done upon the morning before.
کشتی ما یکه سختی خورد و این باعث شد	our ship felt a terrible shock
میزان سماجت او در پیگیری آنچه در نظر دارد توصیف ناپذیر است	the inveteracy of whose pursuit cannot be described
قوت خود را بازیافتم و از او علت این مصیبت را پرسیدم.	I summoned strength to ask what had caused this calamity.
که او را تکلیف کرد در کالسکه او با او بنشیند.	had offered him a seat in his carriage
با آن ردای سفیدش قیافه یک ملک مقرب زشت را پیدا کرده.	one might fancy him an ugly archangel towering above them in his white surplice.
درباره عدم هدایت کشتی به نحو مستقیم در آن هنگام آن عاج که پیش از آن لرزیده بود چنان پیچ و تاب اضافی خورد	then, the already shaken ivory received such an additional twist and wrench
در زیر آتش شدید دشمن به روی سد آورد و در کنار ایشان به حمله پرداخت.	on to the dam under terrific fire and had charged with them beside him.
که با حس از خودگذشتگی و فراموشی خویشتن در توجه دقیقش به انسان برای مردها بسیار جذاب و خوشایند بود.	which was very fascinating to men by something subtly devoted, finely self forgetful in its lively readiness of attention.
زودتر از یک ساعت دیگر آنان به ما حمله کنند.	before the hour's out, we shall be boarded.
فقط در یکی دو لحظه اول توانسته بود شادی خود را بپوشاند.	only thinly repressed for the first moment or two
از طریق اسرار نهفته در ذات فلزات از او بترسید.	fear him through the metals.
در حالی که کاغذ بیسکویت کرمدار پرتقالی دستم بودسر جا میخکوب شدم	I freeze, clutching an orange cream wrapper.
من با قد کوتاه و لباس عجیب و غریب خود	I was short and abominably dressed
نیازی به آن که حقیقت و زیبائی و زندگی معنوی را دردسترس همه بگذارند وجود داشت که خالی از عظمت نبود.	keen desire to bring truth, beauty, and morality within the reach of all, which was a very fine thing.
اما این که از صخره بیرون به یاد و کاری کنه که صداش به گوش تو بر سه نیازمند مقدار خیلی زیادِ انرژی و سعی و تلاشه.	but to break out of the rock and make herself heard must have required a huge amount of energy and effort.
بعد از این دو مصیبتی که برایتان پیش آمد	after the double catastrophe
نتیجه ی نهایی عدم رضایت طرفین است و زحمات آنها و دامها و خاک عالی بیهوده هدر میشود.	all that was attained was that the work did not go to the liking of either side, and that splendid tools, splendid cattle and land were spoiled with no good to anyone.
اون شرکت مال توئه و تو اختیارشو داری و می تونی هر تصمیمی دوست داری بگیری و حق داری	it's your company and it was your decision and you had every right to make it.
اما او از توجه به کارهای گذشته بیم داشت.	but he feared and disliked this waste of feeling for things past
در حقیقت کسی که پهلوانی سرگردان پیشه کند باید قاضی و حقوقدان باشد و از حقوق خصوصی و عمومی اطلاع کافی داشته باشد	for he who professes it must be a jurist, and must know the rules of justice, distributive and equitable
ما را از آفتاب وجود خود کاملاً محروم نکند.	not quite exiled from the sunshine of his presence.
همسر مهربانش در راهرو خانه به استقبالش رفت و اورا به اتاق کارش کشید.	his good wife met him in the entrance hall and drew him into his private sitting room.
پس معلوم می شه که شمام مثل ما از دیدن دادگستری و پلیس خوشتون نم یاد.	that is because you don't care to have the police and the courts come in any more than we do.
در اینجا روی خود را برگرداندم تا مرد جوان برای رد کردن این دعوت ناراحت نشود.	I turned away so that I should not watch him search for an excuse.
ناگهان مادام دوبوسئان خود را از اطاق بیرون انداخت و باعجله خود را به پنجره توی راهرو رساند	but suddenly she sprang forward, rushed to a window in the gallery
این نقص ناشی از تحقیریست که نسبت به هندسه عملی دارند و آن را خوار میشمارند	this defect arises from the contempt they bear to practical geometry
اما به این جهت من نباید در خانه خود را به روی او ببندم.	but that is not a reason for me to shut my door on him.
صدای نغمه های ناب ویولن ها را میشنیدند که نخستین والس را شروع میکردند.	they heard from the ballroom the careful, distinct notes of the fiddles of the orchestra beginning the first waltz.
اما این عیب را به مرور و با تمرین از میان خواهی برد.	but you will get over that with practice.
دیگر مرحله تحمل خفت را از سر گذرانی ده بودم.	I was spared the humiliation.
کلاچ را گرفتم و پا را روی پدال ترمز فشار دادم.	I declutched, trod on the foot brake
که روی آن را با پارچه پوشیده بودند و فقط دو انتهای هر پله چوبی بود و از این جهت در هر پله مفصلی قرار داشت.	were of cloth covered rope, only the rounds were of wood, so that at every step there was a joint.
هیچ وقت فکرنمیکرد که مطرح کردن موضوع به اینجا بیانجامد.	she had never seen it quite like this.
برخی دیگر معتقد بودند که او به راستی موجودی پایبند به اخلاق است	other people said she really was at heart the highly ethical being,
قصد او فقط گرفتن پول و خریدن ماشین چوب بری بود.	so intent was she upon the money the mill would bring in.
نه به خاطر این که نسبت به شوهر دخترش دید مثبتی داشته باشد	not because he thought well of her husband
گفت که او بیش از حد وقتش را گرفته و او وقت اضافی ندارد که برای او تلف کند.	saying she had already wasted too much time with him.
من مجبور شدم مطلب را به فرانسه سؤال کنم	I hastened to translate.
مشورتهای مخفیانه شان درباره ی بیمار و نقشه ی منصرف کردن او از کار را که پزشک تجویز کرده بود به یاد آورد.	she remembered their secret confabulations about the invalid, their plots to draw him away from the work which was forbidden him,
همیشه فخرفروشی می کرند که مادربزرگی است که بهترین بستر شهر را در اختیار دارد.	so that she boasted of being the grandmother with the best bed in the city.
در حالی که هر کودک فردی خارجی خواهد بود.	every baby an exotic.
نوعی احساس دلخوری که در طرز نامه نوشتنش بود	a something bordering on it in her style
که از تجارب مرگبار صید وال گرداگرد چنان والی نام و شهرت وحشتناکی درباره خطرناک بودن او آویخته است	that from the fatal experiences of the fishery there hung a terrible prestige of perilousness
در ضمن از دل و جرئت خودشان خوششان آمده بود	rather admiring their own boldness
مرا گفت تا آن دو موجود معرض ورا به تماشا گیرم.	bade me contemplate the two beings presented.
خوب کشتن و خوب کشته شدن خیلی از ما کشته شدن .	killin' and a lot of us was kilt.
موقعی که مطمئن شد خشم من به راستی فرو نشسته رهایم کرد.	when she had ascertained that I was really subsiding, she loosened her hold of me
به من که رئیس این مدرسه و مواجب بده و ولی نعمت تو هستم!	the principal of this establishment, and your employer.
صحبتی که سه ربع اهالی پاریس در این شب غیر از این صحبتی نداشتند.	which served as a subject of conversation
همین فراموشی باعث شد که به این دردسر گرفتار شود.	this led up to the trouble in which he presently found himself.
که آن وال سفید را در هر دو طرف خشکی و همه طرف زمین دنبال کنید	to chase that white whale on both sides of land, and over all sides of earth
امیدوارم که همین امروز به طرف پاریس حرکت کنید.	I feel sure that today will see you gone from here.
نهر آبی از زیر پلی که در خاکریز جاده تعبیه شده است جریان دارد.	where there is water which passes beneath an arch made throughthe embankment of the road.
از آن بیم دارم که مبادا بیش از حد تحت تأثیر تمایل آشکار خود در این مورد قرار بگیرم	I fear lest I should be swayed too much by my own obvious interest in the matter
مگر وقتی که با آن که از او یاد گرفته بودم.	except when I spoke to the man who had taught it to me.
مگر آن که قبلاً آن حمله را دفع کرده باشد.	till he had first defended that attack.
محبتی برخاسته از شرایطی که آن را پرورده است.	so belonging to the circumstances in which it has been nurtured
هر چند هردومون می دون ستیم که هیچ وقت این اتفاق نمیفته.	even though we both knew it would never happen.
علامتی را ندیده بود تا نشانه پذیرفتن یا رد کردن باشد.	he could not detect any sign of interest or rejection
بیشتر عمرشان را با هم زیر یک سقف گذرانده بودند	whose home it had equally been the longest part of his life
آن بدگمانی غریزی که در جما به وجود آورده بود به هراسی بی سبب مبدل شد.	the instinctive distrust with which he inspired her deepened into a sense of unreasoning fear.
با ژست مخصوصی به من فهماند که نزدیک بروم	he intimated by a gesture that I was to approach
هر چند که مرد موردنظر بیش از چهار سال با دخترش ازدواج کرده باشد.	even if the man in question had been married to her for over four years.
اون قدر عصبی هستم که دلم می خواد جیغ بزنم.	I'm nervous enough to scream.
من امروز مجبور شدم برای ملآقات تو راه زیادی از منزل تا اینجا بپیمایم.	I walked about, before you came, a great deal for me.
او خود سوگند خورد که از دریا روگردان شود و تا امروز دیگر قدم بر آن ننهاده است.	forthwith forswearing the sea, he has never tempted it since.
تا الان متوجه نشده بودم که روز خوبی بود.	I hadn't noticed till nowit was a nice day.
افسر دیگری که بسیار مایل بود یک کلوچه دیگر بردارد	said another, who would have dearly liked to take another pie
به نحوی که گفتی تمام اهالی شهر به اینجا آمده بودند تا جانی را لعن کنند و دشنام بدهند.	it seemed as though the whole city had poured its population out to curse him.
با وجود این هر دو از آن جاذبه جنسی قوی که میانشان ایجاد شده بود آگاه بودند.	yet both were conscious of the powerful sexual undercurrent between them.
به گمانم اگر بتوانیم آن بانو را پیدا کنیم	I expect if we could lay our hands upon that lady
امیدوارم در بهشت با تاج طلایی و چنگ و رباب خوش باشد	I hope he is enjoying his harp and golden crown
دستهائی که اندکی فربه و در عین حال کوچک بودند.	hands that were plump and yet small.
بی آنکه جرأت نگریستن به پشت سرش داشته باشد گریخت.	fled without glancing behind her
کاترینا در این خصوص شک نداشت مردی که دختر افسونگر برای هوش و احساسات او ارزش خاصی قائل بود.	she knew that very well , and whose heart and intellect she considered so superior to her own.
مثلاً در حالی که خود او در این مدرسة نفرین شده حبس و به دام افتاده است دیوید با زن دیگری ازدواج کند.	like marry another woman while she was trapped in the bloody school.
شاید تا وقتی که بچه به دنیا میاد درسشو تم وم کنه اون وقت ما یکی رو میاریم پیش خودم ون	well, when the baby comes, maybe he'll be all done studyin' an' we'll have a place, little bit of a place.
من که می مباید شاگردهای هاگوارتز باید از بین خانواده جادوگرها انتخاب به شن.	I think they should keep it in the old wizarding families.
دوباره در پیاده رو شروع به راه رفتن کردیم.	we start walking along the pavement again.
موضوعی که تا رسیدن به خانه طول بکشد و او مجبور شود تا خانه بیاید.	which would hold him all the way home
ولی به زحمت توانسته بود آن را قدمی به پیش آورد و محتویات آن را نشان دهد	which he had no sooner stumbled in with, and opened for the purpose of explaining the nature and properties of the various implements it contained, and the peculiar beauties of their construction
طبق محاسبات من یک دقیقه دی گه کام لا آماده می شه.	I estimate that it requires one more minute.
یک راست به مرکز مربع تیرة درون قاب پنجره تابید.	glowed steadily in the centre of the black square framed by the window.
ابتدا باید تو را در جریان برخی از سایر مسائل این وضعیت قرار بدهم.	first of all, I must keep you in touch with some of the other factors in the situation.
این مالیه خو نواده خیلی فقیره تو یه اتاقک که یه قازم توش نیست.	they're very poor folks, and it's a hovel where there isn't a sou.
من خواستم دبارة تو صحبت کنم اما دستور سکوت داد.	I began speaking of you, she begged me not to.
از همه دروترین مرزهای خود اکنون بر من فرو ریزید و بالای این موج بلند و انباشته مرگ من قرار گیرید!	ye bold billows of my whole foregone life, and top this one piled comber of my death!
طولی نکشید که قایق هم ول کرد و رفت ساحل و من هم دنبال کار خودم را گرفتم پاروزنان سرازیری رودخانه را دادم دمش.	then pretty soon the ferryboat give it up and went for the shore, and I laid into my work and went a booming down the river.
شارل با او حرف زد ولی اما چیزی نشنید.	he spoke to her
یکراست به فروشگاه یا انبار میرفت و اجناس مورد نظرش را انتخاب میکرد و بدون آن که کسی جلویش بایستد یا مانعش شود راه آمده را بر میگشت چون کارهای بزرگ و جسارتش در دلها ترس برمی انگیخت.	go straight to the shop or store, select what he wanted, and ride away unopposed because of the terror his exploits and his audacity inspired.
من به نیکی و معصومی این بدبخت آنقدر آشنا هستم	for I know well enough, from the poor fellow's goodness and harmlessness
در این موقع با نگرانی تمام اطراف خود را نگاه کرد	looking hastily round
که در هیچ یک از نظریات متناقض سهیم نبودند	who, without sharing any of those conflicting opinions
با این محاسبه و به کمک پیراهن کهنه من که آن را بجای الگو در برابر آنان روی زمین گسترده بودم	by the help of my old shirt, which I displayed on the ground before them for a pattern
که آیا در دل خود مخفی و مستور داری یا به کسی اظهار نمایی.	to know if you ought to expose or conceal this secret.
جدا از دیگران در گوشه تاریک کلبه پشت بخاری نشسته بود.	sat apart in a dark corner behind the oven.
حال خود را بازیابد و آنچه را دیده و احساس کرده است درک کند.	he be able to understand himself and all he had seen and felt.
محال بود بتوان تصوّر کرد که یک چنین گل پاکی و شعر قهرمانی هرگز توانسته باشد در این سرزمین بروید.	he found it impossible to conceive such a flower of purity and poetic heroism ever springing from such a soil.
من یگانه پسر اشخاص پولداری هستم از اهالی غرب میانه که حالا هیچ کدام زنده نیستن.	I am the son of some wealthy people in the middle west all dead now.
ارباب من پس از بازگشت شرحی مفصل از آن شورا بر من بیان کرد.	whereof my master, after his return, give me a very particular account.
از واکنش تحقیرآمیز زن که شهرت او را چیزی را که به سختی به دست آورده بود و آرزو داشت حفظش کند به هیچ گرفته بود به شدت حیرت زده و مبهوت شده بود.	with the usual sense of having been somehow baffled by this woman's disparagement of this reputation he had obtained and desired to keep.
ناگزیر باید امیدوار بود که تاکنون از بسیاری از مفاسدی که در وطن تو وجود دارد برکنار مانده باشی.	I am well disposed to hope you may hitherto have escaped many vices of your country.
هر نوع نوشتجات یا سندی که دلالت سیاسی یا ایدئولوژیکی داشت.	to every kind of literature or documentation which might conceivably hold any political or ideological significance.
من تا هنگامی که در آن شهر اقامت داشتم در آنجا ماندم	where I continued during my stay
از آنجا همگان نتیجه گرفتند که این ماجرا با اطلاع قبلی و با رضا و رغبت هر دو وقوع یافته است.	whence they all concluded that the affair had been planned by agreement and understanding between the pair
همچی به نظرم میاد که دی گه فکرم کار نمی کنه	I jus' can't seem to think no more.
از آن شهریار خواهش کردم به من رخصت دهد تا عجایب آن جزیره را بنگرم	I desired leave of this prince to see the curiosities of the island
وقتی می خوان یک خورده بهتر با شن میرن شکار	when they'd be better spending their time hunting
اگر او بگذارد که یکی از ملاحان اطاق مخصوص مرا به اطاق او بیاورد	if he would let one of the crew bring my closet into his cabin
تراس کام لا روشن و مملو از جمعیت زیاد و پرجوش و خروش است.	that a large number of people were assembled on his verandah, which was brilliantly lighted up.
فقط چند بار بادبزن خود را بوسید و به روی دست دکتر زد.	go several times through that operation of kissing the sticks of her fan, and then tapping his hand with it.
در همین موقع ضربات دوباره تکرار شد و او نتوانست حرف دیگری بزند.	that the knocking was twice repeated before he had finished.
باد چندان شدید بود که ما را یکسره بس وی او افکند.	the wind was so strong, that we were driven directly upon it.
قسمت عمده ۵۰۰ مایل راه را لنگان و با سه پا طی کرد	limping most of the last five hundred miles on three legs
در نتیجه اصابت با چیز نرم و آبکی قطع شد و صدای شلپ به گوش رسید.	which suddenly ended with a thud into something soft. f f flop!
به هم ون شکلی که متهم توصیف می کنه.	take any position which he describesas having been taken by her.
اگر دیدی قصد دارد دوباره زانو بزند مرا صدا کن.	if you see any signs of more flopping, give me a call.
در آن جریان داخلی و مجموع که با هم دارند نوعی وسعت و فراخی اقیانوس مانند دارند	possess an ocean like expansiveness, with many of the ocean's noblest traits
مرا به زور تا کمر در آن استخوان فرو برد و من مدتی در آنجا میخکوب شدم.	wedged them into the marrow bone above my waist where I stuck for some time.
سوئیچ را برداشت و صندوق عقب ماشین را باز کرد.	went around, and opened the trunk.
اما هدف هنری تیلنی اول از همه توضیح دادن احساسات خودش بود.	but his first purpose was to explain himself
این بار با پنج پسربچه مواجه شده بود که چهارتایشان خواب بودند.	this time he had been facing five unarmed boys, four of whom were asleep.
پدرم به همین مرض در حمله سوم مرد و همچنین جدم	both my father and grandfather died of it in a third attack
خیال دارد در نخستین فرصت مساعد از دست مسلمانان بگریزد.	is anxious to escape on the first opportunity that may present itself.
با این همه زحمت آن را نخواهم کشید که شما را از این عقیده منصرف کنم.	I shan't trouble myself to convince you of the contrary.
کاروان درست موقعی به محل رسید که چوپانان تخت روان را بر زمین نهاده بودند	did so by the time those who came had laid the bier upon the ground
من خودم مکرر از سوراخ کلید او را دیدم بیشتر از یک دفعه.	I watched him too, through the keyhole, more than once.
فنجان قهوه ای که همراه آورده بودم را به دستش دادم	I handed her the coffee we'd brought.
زیرا ایشان پست و احمق و از وضع خویش راضی و خشنود بودند.	they were empty, stupid, contented fellows
هر لحظه انتظار داشت سرش از شدت درد بترکد.	thought his head would burst with the pain.
فقط برای اینکه مقام ناچیزش را حفظ بک نه.	in order to keep his seat
آن وقت چنین معلوم بود که باز هم چیزی داشتم.	I was still worth something, they thought.
چراغ و شعله آن با آنکه اندک حرکتی دارد	the lamp, flame and all, though in slight motion
اما شاید به این صورت مرتکب اشتباه شده باشیم.	but in this we may well be wrong.
هوا هم آن قدر ملایم است که من باید از این بخاری گنده خودم را کنار بکشم.	so mild that I must draw back from your great fire.
پس معلوم است که از اصل این بار مودت در شما نیست	you must be entirely devoid of them
که برای قدرت نمایی در برابر قویترین رئیس صحرا خود را به باد تبدیل کرد و یک اردوگاه نظامی را تقریباٌ از بین برد.	who had turned himself into the wind, almost destroying a military camp, in defiance of the most powerful chief in the desert.
ولی به خاطر این که از گزند ما در امان باشند همه را به صحرا فرستاده بودند.	but drove them away for safety.
من مجبور بودم که تمام صبح را بارها و بارها به داخل آب بپرم.	so I had to dive and dive and dive all morning.
با این همه سعی خواهم کرد به طور اجمال در این باره اطلاعاتی بدهم.	I will try, however, to give a superficial account of it in a few words.
من موضوع خاصی ندارم که به اطلاع دادگاه برسانم.	I have nothing particular to tell the court.
اما بالاخره به خیر و خوشی پشت میز غذا نشستند و لبخندهای متین ژنرال و گرسنگی خود کاترین سبب شد بار دیگر احساس آرامش کند.	till they were happily seated at the dinner table, when the general's complacent smiles, and a good appetite of her own, restored her to peace.
که در آنجا بتواند درباره مصیبت هولناکی که به ناگاه از آسمان بر سرش نازل شده بود فکر کند.	he could thinkabout this terrible thing that had descended upon him so suddenlyout of a clear sky.
مشروط بر اینکه تمکین بر این مزا وجه نمایید و اعتبارم تثبیت شود	if the marriage should take place and confirm my credit.
من سعی خواهم کرد شما را زیاد کسل نکنم.	I will try not to bore you too much.
لیکن این داستان شیرین درست در همین ای حساس معلق و منقطع ماند بی آنکه مؤلف آن به ما راه نموده باشد که سراغ مابقی داستان را از کجا باید گرفت.	at this so critical point the delightful history came to a stop and stood cut short without any intimation from the author where what was missing was to be found.
او نیز به زمین افتاد و از جایش بلند شد.	drop to the ground and straighten up
ولی از آنجا که شایستگی چنین کرامتی را نداشت با پلیس تماس گرفت	but who, proving unworthy of his confidence and evincing a desire to communicate with the police
من از ریخت شماها دی گه حالم به هم می خوره!	I'm sick of the sight of you.
آمادگی برای مدیون ساختن و سختگیری نسبت به اثر آن.	ready to confer obligations, and severe in watching the result.
حالا هم از اشاره به آن احساس شرم کنی.	now you should blush to allude to it.
مردم در ده دوازده قایق سوار شدند و به طرف غار مک دوگال راه افتادند.	a dozen skiff loads of men were on their way to McDougal's cave
کارت را برداشت و آن را در جیب خود گذاشت.	for the present he took the card and put it in his pocket
ولی امکان نداشت که در مورد کارهایشان با هم صحبت کنند.	but there would not be a question of discussing each other's business together.
تا آن موجود غرق در جوانی را که تاجی از انواع زبر جعدها بر سر داشت و یک شنل از پوست قاقم پوشیده بود تماشا کنند.	in order to get a better look at the dazzling creature with a crown of emeralds and an ermine cape
کلیهٔ کسانی را که احیاء شده بودند دیده است	all those who took part in the first resurrection
دیروز که دوازده هزار فرانک نداشتم با و بدهم آنقدر شرمنده شدم که حاضر بودم بقیه این عمر کثیفم را برای جبران این تقصیر فدا کنم.	I felt so humbled yesterday when I had not the twelve thousand francs, that I would have given the rest of my miserable life to wipe out that wrong.
من به عنوان یک مادر این حرف را زدم.	I spoke as a mother.
زیرا که والانتین شروع کرده بود که خود را بیدار بداند.	she began to believe herself really alive and awake
کاش هر چی توی دنیا وجود داشت و همین طور خودم را نابود کرده بودم.	the whole damn lot of it, myself as well.
چون به در خانه نزدیک شد اصوات درهمی از خنده و گفتگو به گوشش رسید.	inside as he approached the door he could hear voices, laughter and conversation commingled.
این واقعه ظاهراً تأثیر بسیار بدی بر ذهن او باقی گذاشت.	the incident appeared to make the worst impression upon his mind.
آهی عمیق کشیده از اتاق پذیرایی بیرون آمد و در ورودی را بست.	with a deep sigh left the drawing room and locked its main door.
مگر آنکه بخواهد مرا در آغوش بگیرد یا به دوش بردارد.	except to overwhelm me with embraces, or carry me in triumph.
بلکه برعکس به شیوه کسانیکه شاهد نزدیکی خطرات بزرگ هستند	but on the contrary became even more frivolous
در دریا ناپدید شده و چینی هم بر سطح آن نینداخته بود.	he had disappeared in the sea without leaving a ripple
یکی ازآنها پیرزنی بود که مقدار زیادی جواهرات سنگین وزن به خود آویخته بود	an old woman wearing a lot of bangled jewelry
که هری از پدر و مادرش به ارث برده بود.	that his parents had left him.
نه مردی چون او بلکه خود او رام یخواست.	her man no, not someone like.
بر استی شایسته آن همه مراحمی هستم که در گذشته به من نموده است و ممکنست در آینده نیز بنماید.	well deserve all the favours he had already conferred upon me, or might do for the future.
من اطلاع نداشتم که او تقاضای طلاق کرده است.	I did not know about a projected divorce between herself and her husband.
فقط باید بفهمم که چطور از آن استفاده کنم.	I just have to figure out how to use it.
نور حقیقت لعنتی با هیچ یک از ما تناسبی ندارد.	the light of truth is damnably unbecoming to us both.
فردا صبح به گوش اعضای شورای حکومتی شهر کاست یل برسد	have it reach the ears of the lords of the council to morrow morning
حتی یک اونس دینامیت ندارم که به خاطر دیگران هدر بدهم.	I shan't have an ounce to spare for anybody.
بعد او را به طرف کری دور پایین بردند و به داخل زندان موقت انداختند و در را پشت سرش قفل کردند.	then led down a corridor and locked in a holding cell, by herself.
تا در مورد افراد بهتر از خودشان جاسوسی کنند او را دیدند.	who go there to spy upon their betters.
انگار تصمیم گرفته شده بود که قبل از بیدار شدن ژنرال کاترین رفته باشد تا چشم ژنرال به کاترین نیفتد.	as if resolved to have her gone before he was stirring in the morning, that he might not be obliged even to see her.
بسیار بیش از آنچه او می پنداشته مهم است.	than she had previously thought.
حداقل با دست خودم حاضر نیستم خود را با این سرنوشت وحشتناک قربانی کنم.	I'm not going to willingly sacrifice myself to such a miserable fate.
گفتم یک پایم را آزاد کرده و دور کمرش حلقه کردم	I kicked one leg free and wrapped it around his waist.
بدین قرار که دست خود را دراز کرد و به پنجره ضربتی وارد آورد	he put out his hand and softly knocked on the window frame.
کارشان این بود که رنگهائی را که مورد حاجت نقاشان بود درهم بیامیزند	their employment was to mix colours for painters
راستی راستی باید برای خودت به فکر پرستاری باشی.	you really ought to think about a nurse.
چهار تیر چوبین به زیر چهار گوشه پالان زد چنان که من همچنان بر سر پالان سواره ماندم	which he put under the four corners of the pack saddle in such a way that he left me mounted on it
او که از درد بیتاب شده و عنان شکیبایی از دست داده بود	who, irritated by the pain and flinging modesty aside
در فکر است که خونسردی ظاهری خود را در رفتار و گفتار چگونه حفط کند.	thinking of what he would do, what he would say, in anoutwardly calm way.
شاید دو ساعت تمام این دو سر را زیر و رو کنید و عاقبت هم آن عضو را نیابید.	you might hunt over these two heads for hours, and never discover that organ.
با چیزهایی ساده و دفتر کار خود خوش بود.	he was cheerful in thefamiliar simplicities of his office.
با چشمان آبی رویازده به آب خیره شده بود.	staring at the water with his dreamy blue eyes.
دیگر چیزی نمانده بود که برای دومین بار ناامید شویم و کار را رها کنیم	we had almost for the second time given it up in despair
صورتی ملایمی که در دل قرمز آتشن پنهان است.	the dainty pink which lurks at the heart of the sulphur rose.
به این قصد که بعدا به آن نقطه باز گردد و سر فرصت کت و شلوارش را به خش کشوئی بدهد.	intendingto return and secure it and have it dry cleaned.
من بسیار خوشحالم که اسم خود را تغییر دادید بسیار خوشحالم.	I am very glad you have changed it very very.
منظورم این است که حتی اگر یک آدم بی سر و پا هم به گالری قدم نگذارد آن وقت چه	I mean, what if not one single, bloody person shows up?
در این مورد خاص من بیم آن را دارم که بعداً به چیزی برخورد کنید که هم خلاف انتظار خودتان و هم خلاف انتظار من باشد.	in this case I do fear there will be something found to be different to what either you or I expect.
اما هرگز از دل دادن به این و آن دست برنداشته بود.	but from that time she had never given up being in love with someone.
به طور مبهم دریافت که ایشان اینجا مشغول غارت و چپاول هستند	he vaguely understood that looting was going on there
هرچند این عمل بسیار وحشتناک است ناگزیر باید سرنوشت خود را با او بپیوندد.	that though it would be a terrible thing he would have to unite his fate with hers.
آهوان و پرندگان وحشی را رمان ده و به جایی رسیده که تک درخت بلوطی بر آن خیمه زده بود.	startling deer and wild birds, to a place crowned by a single oak tree.
وضع کارگاه را برایش شرح دادم و مش گل سیاهان را گفتم .	about the trouble we were having getting any work out of the darkies
بلکه اساس مطلب را با تو در میان خواهم نهاد.	I'll only tell you the idea, without details
که به محض دریافت این پیغام فوراً این تیغستانها را ترک کنید	on sight of this present, to come out of these thickets
اما این روابط کماکان به قدرت خود باقی هستند.	are not thereby annulled in their character of determining antecedents.
من فکر کردم تو آدم نسبتاً صاف و راستی هستن .	I thought you were rather an honest, straightforward person.
مارتینی نیز خاموش در انتظار ماند تا او تسلط بر خود را باز یابد.	he waited silently till she should recover her self command.
کسی دیگر با ما جنگ ندارد و تمام تسلیم شدند.	every one has yielded.
لیکن نتوانستیم در آن روز از آن عبور کنیم.	but to day we fell short of this
محض اطلاعت به گم که آخر این هفته هردو طرف رودخونه آفتابیه.	FYI, it's going to be sunny on both sides of the sound this weekend.
ولی موضوع گفتگوها و اظهارنظرها با یکدیگر تفاوت داشت	will often include a total change of conversation opinion and idea
از لحاظ اجرای موسیقی که به راستی نظیر ندارد.	while her musical execution was quite exceptional.
اما تا ان زمان هیچ کس با چنان ثروت هنگفتی پا به ان جا نگذاشته بود	but no one of such obvious wealth had ever arrived there before.
ما به تدریج چنان هوشیار برپا خاستیم که ناچار شدیم	by and by we scrambled down, so sober
دی گه نمی ذارم شماها گرسنگی بکشین. دی گه دست کمک به سوی تو دراز نخ وام کرد.	I won't have you all starve, simply because I've thrown myself at your head.
من از هم ون اولش بات مث یه رفیق رفتار کردم	I cottoned to you from the first.
آن قدر قوی بود که سرهنگ آزرده خاطر را راضی سازد.	was strong enough to have satisfied the offended officer.
که یک سیخ بلند را مثل شمشیر در دست گرفته بود	holding a long poker like a sword.
بدین معنی که گروچنکا را از دست داده بود	he had lost her, given her up.
کلاه مچاله شده هوسارها را با جلفی به عقب سر گذاشته بود.	he wore a crumpled hussar cap stuck jauntily back on one side of his head.
سپس راستوف را در سورتمه نشاندند و تا اولین منزل وی را مشایعت کردند.	then they put him in his sleigh and escorted him as far as the first post station.
مثل این است که فقط بخواهید یک مشت از بهنی که شروع به غرش کردن است به سرتان بریزد.	it is like asking for a bit of an avalanche which has already begun to thunder
این بود که درد شدید خود را آشکار کرد	so, making a show of severe suffering
بعد سعی کرد هر طور شده چمدانش را کشان کشان به طرف در قطار ببرد.	then started to shove and heave his trunk toward the train door.
ما باید مقداری اسلحه را سوار یک قایق کنیم.	I need some guns taken on board a boat.
من فقط خندیدم و ظاهرا اطاعت کردم چون فعلا نمیخوام با من سر لج بیفته.	I just laughed and agreed because I don't want to aggravateher just now.
نمی تونم مطمئن باشم من نمی دونم چطور باید ذهن کسی رو خو ندا.	I can't be sure I don't know how to read mind
ولی روز بعد خود او حاضر است به نخست وزیر سیلی بزند.	to morrow, he will take the wall of a prime minister.
همه گمان بردند که از شدت بدبختی عقلم زائل شده است.	they all conjectured that my misfortunes had impaired my reason.
من همان بشقاب سابق خود را در جل وم دیدم	I had my own old plate
او مد تا دم خو نه با تراکتور به خو نه کل زد.	he just come on, an' bumped the hell outa the house
آخر گفت که چنین پذیرشی ممکن است در نظر مردم عجیب جلوه کند.	finally declared that perhaps it would look odd.
یک صد و پنجاه هزار لیور فایض سالیانه در حق من برقرار نماید	150,000 livres per annum from
بدون هیچ تردید پدر مهربان من درست فهمیده بود	no doubt my good father hit the truth in every particular
به نظرم لااقل در مورد حشرات کارم خوب باشد.	but I have at least done my insects well.
صرفاً به خاطر این که بفهمد در آن نامه چه نوشته است.	just so she could know what it said.
من صرفا حکم پروژه تحقیقاتی بازار رو به راش داشتم.	I was just a ' a market research project.
زیرا ایشان از آن زنانی نیستند که از گوش ایستادن به سخنان آن دو صرف نظر کنند.	for they are not the ones to forget to listen.
اندک اندک جرأت پیدا کردم و بلند شدم پ	I began after a little to grow very bold
من یکی از اولین کسانی بودم که اینجا آمده بود.	I was one of the first there.
خودت میدانی که من حسادت را به چشم عاطفه ای خجالتآور و تحقیر کننده میبینم	I consider jealousy, as you know, a humiliating and degrading feeling,
به جای جواب دادن به سوال من خواهش دیگری کرد	she entreated instead of answering my demand.
زیرا حماسه ممکن است هم به نثر نوشته شود هم به نظم.	for the epic may be written in prose just as well as in verse.
اما گفتند که ناخدا به اصطلاح مصمم بوده است که پس از فروش کالای کشتی همین که به اولین خشکی رسیدند دفع شر مرا بکند.	but said, that the captain as they called him was resolved, after they had sold the lading, to get rid of me in the first place where they could discover land.
از این روی بی آن که وقت را تلف کنم	now I lost no time
در آن صورت شما حق دارید پیشنهاد مرا قبول کنید.	then so much the more reason for acceding to my proposition.
حال اگر کشف این حقایق موجب شده باشد که از احترام من نسبت به آنان کاسته شود امید عفو دارم.	I hope I may be pardoned, if these discoveries inclined me a little to abate of that profound veneration
رخ را برگردانده به شمارش نبض بیمار پرداخت و به فکر فرو رفت.	turning sideways felt the pulse and reflected a moment.
به اربابش که سی سال دوستانه با او زیسته بود نگریست چون دریافت	kept glancing at his master with whom he had lived on the best of terms for thirty years
ضم نا مجبور بود برای آنکه سگ را دور نگاه دارد	being obliged, in order to keep the dog respectful
او پس از نیمه شب به خانه رسید لباسش ار از تنش خارج کرد و به بستر رفت.	he arrived home after midnight, undressed and got into bed.
اطمینان داشت ناگزیر خواهد شد پیشنهاد ازدواج این مرد جوان را یک بار دیگر رد کند.	feeling sure that she should have to reject this young gentleman a second time.
اما نتوانست دل و جرأت گفتن این حرف منطقی را پیدا کند.	but he never quitenerved himself to that reasonable comment.
تعجبی ندا ره که اون یه نفر الان هم دنبال ماباشه.	I wouldn't be surprised if that was what was on for us.
موقعی که تو با آن سادگی قابل ستایشت به من گفتی که صورتت را لای موهای درازش پنهان کرد نبضم شدت بیشتری یافت.	I felt my pulse go faster when with your adorable simplicity you told me that you buried your face in her long hair.
بهتره قبل از این که برم دنبالش تکلیفمونو با هم روشن کنیم.	we need to get a few things straight before I go and collect her.
اما هرگز کسی را گرفتار تر از این دختر هفده ساله که اکنون مقابل او ایستاده بود ندیده بود	but never anyone in more trouble than the seventeen year old girl who stood before her now.
دیگر در همه وجودش جز یک رغبت برجای نمانده بود.	he had but one desire remaining
که هیچ ممکن نیست کسی بدتر از او بنوازد.	that there never can have been anybody in the world who played worse.
بندهائی که طرف چپ سرم را بزمین وصل کرده بود گسیختند.	cut the strings that fastened the left side of my head.
چه او روا داشت که خود را چنین بخواند	so he thought fit to express himself
آن قدر بمب ریخته بود که تمام سطح آن در زیر شش اینچ آهن پنهان بود.	enough bombs were being dropped to cover all of it in six inches of steel.
اما از خوردن شام و ناهار در خانه پرهیز میکرد.	but avoided dining at home.
دو نگین چهار قیراتی حلقه بر دو قلب پلاتین نشسته بود.	its twin quarter carat stones set in a pair of platinum hearts.
با وجود تمام تعرضات درباریان در ساعت دوازده از دنبال ستون سوم جدا شده به طرف طلایه تاخت.	in spite of the remonstrances of his courtiers, at twelve o'clock left the third column with which he had been and galloped toward the vanguard.
اوضاعی را حس کرد که در اثر ورود اورسولا به وجود آمد و موجب تحولی در او شد.	he had the impression that only at that instant had they begun to exist, conceived by 'rsula's spell
با این حال مواظب بود حتی در یک نامه نیز مرتکب اشتباه نشود.	he preferred that it not happen even once.
ایشان را به همان وضعی یافتند که در چند لحظه قبل خوابشان برده بود.	in the same posture they were in when sleep fell upon them.
می تونی برگردی قلعه و اسباب و اثاثیه تو جمع کنی و بری.	then get back off ter the castle an' pack.
پس حالا وقت آن است که تو هم در انجمن نا منویسی کنی.	so it's time for you to put your name down.
از نواختن دست نکشیدم فقط با دقت به سوی کلیدهای اصلی تغییر جهت دادم	 I didn't stop playing, just modulated carefully into a major key.
از ای نرو نتوانستم بر این تصمیم خطرناکی که گرفته بودم باثب بمانم آنهم در چنین بحران و در برابر چنین دشمنان نیرومند.	I durst not rely on so dangerous a decision, in so critical a juncture, and against such powerful enemies.
پهلوان در آنجا به حضور ملکه و شاهزاده خانم دخترش که قطعاً به زیبایی و دل فریبی او در سراسر ربع مس کون مشکل پیدا خواهد شد بار یابدو.	where the knight will find her with the princess her daughter, who will be one of the most beautiful and accomplished damsels that could with the utmost pains be discovered anywhere in the known world.
اندکی بعد به خانه بازگردد و کار را از سر بگیرد.	without prejudice to his galvanism, to which he would presently return.
لبخندی طنزآمیز و در عین حال فروتن و مؤدب زد	quizzical and simultaneously respectful smile
رفتار و گفتار او به قدری طبیعی و مناسب بود که گویی از آن رفتار و گفتار بهتر ممکن نیست.	but in everything an indescribable lightness, a seeming impossibility of doing anything else, or doing anything better, which was so graceful, so natural, and agreeable
که باید به عنوان قطعی ثبت و تحریر شود و قباله عقد به امضا برسد.	, which will enable us to draw up the contract immediately
درست شکل الهه ای شده بود که تاج گذاری کرده باشد.	that made her look like a crowned goddess.
او بی آنکه نامه را بگیرد اشاره کرد که روی صندلی بنشینید.	she waved him to his seat without taking it.
در این ضمن مهر و دلبستگی گذشته به قلبش بازگشت.	the interval had left time for repelled tenderness to return into the old course.
خوب شد که صبح این قدر به تو سفارش کردم!	you know, there's too much to be done.
سرانجام خیلی زودتر از آن که انتظارش را داشت او را پیدا کرد.	rather sooner than he had expected he found her
7 آخری را خیلی دوست ندارم بگویم ولی میگویم	VII. I don't much like to confess this last item, but I will.
باز هم نمیدانم چرا من باید به خودم زحمت بدهم.	still I don't see, all the same, what I'm to worry myself about it for.
هیچ کدامشان مانند نام بخش بزرگشان سر و کار با وال نداشته است	none of whom, I venture to say, have ever had to do with a whale like their great patron
هوای گرگ و میش و غروب آفتاب را هیچ دوست ندارم.	I detest this mongrel time, neither day nor night.
بو جود آورد و مدت هزار و چهار صد سال است که برقرار است.	has been in existence for fourteen hundred years.
خانمم برای من در دنیا از هر چیزی عزیزتر است.	my lady's dearer to me than anything.
آنچه گفت صحیح و به جا بود اما شگفت آنکه هم مهمان و هم کنتس تعجب کردند که چرا این سخن را گفت و مضطربانه به وی نگریستند.	what she said was true and appropriate, yet, strange to say, everyone the visitors and countess alike turned to look at her as if wondering why she had said it, and they all felt awkward.
حال آنکه دلم از مرگ نخستین سرشار از غم و اندوه بود.	the sorrow of the first was still fresh in my heart.
باری من که پدر او هستم شما را عفو کردم.	yet I, her father, forgive you
همچنین گفتم بر آنم که اگر بخت با من یار شد و توانستم دوباره به وطن اصلیم بازگردم به نقل سفرهای خود در ین سرزمین پردازم.	I said farther, that if good fortune ever restored me to my native country, to relate my travels hither, as I resolved to do
حد شما نیست که با نیات و تصمیمات ایشان مخالفت کنید.	it is not your place to argue with his sentiments or his decisions.
سر آن را چون مردی که بارها این کار را کرده باشد شکست	knocked the neck off the bottle like a man who had done the same
اما آجودان با تمسخر به وی نگریست و گفت که نوبت او هم خواهد رسید.	but received an ironical look and was told that his turn would come in due course.
این اطلاعات که پر از نوید و مسرت بودند	which was quite as consolatory and full of promise
من برای حفظ آبرویم اقدامات لازم را انجام دهم و تو را باخبر کنم.	as I may take measures to secure my honor and communicate them to you.
باید هشت تا نارگیل و هشت تا بادام زمینی را با هم جمع کنم.	I've got to add up eight coconuts and eight monkey nuts
بعدا اجسادشان را کاملا لخت و عور کرده و به دست پست ترین ارذل و اوباش از پنجره ها به بیرون پرتاب کرده بودند	their bodies were afterwards stripped naked and flung into the plaza out of the windows by the lowest scum of the populace ,
که به طور تصادفی به پهلوی کشتی فشرده شده و در نیت جه همه فک را در بر گرفته است.	pressed by accident against the vessel's side, so as firmly to embrace the jaw.
سعی می کنن جدا جدا به حسابم ون بر سن	I imagine they'll try to pick us off separately.
گذشته از اینکه مثل آدم مست به هیجان آمده بودم.	I was in a frenzy, as though I were drunk.
سپس هر دو در اطاق دن کیشوت خلوت کردند	the pair shut themselves up in his room
شاید بهتر با شه قبل از رسیدن به قلعه او نو به هوش نیاریم.	perhaps it will be best if we don't revive him until we're safety back in the castle.
چون که دنیای کوچک وی پر از دوستانی خیالی بود	for her little world was peopled with imaginary friends
من بیشتر از هر کس دی گه در این مورد فکر کرده بودم.	I'd put a lot more thought into this than any of them.
کینه دیرینه خود را بر سر او خالی کرده	to vent upon it the hatred that I deeply felt
البته درست کردن بلند نیستم ولی کتاب آشپزی این قضیه را حل خواهد کرد.	I don't know how, but the book tells.
که تا آن روز به جهت حضور پسرش نگهداری کرده بود	which had been so long restrained by the presence of her son.
روزنامه را به زیر تشک صندلی پنهان کردم .	I hid the paper under the cushion of the chair.
بااینکه هرگز یکی ازکارهایی را هم که حرفش رازده بودند انجام نداده بو	though he had never done a thing that they talked of
ولی هنوز آن چهره عجیب در مقابل وی ایستاده بود.	the strange face was before him.
آقای دور سلی ساعت پنج هنگام خروج از ساختمان شرکت چنان مضطرب بود	when he left the building at five o'clock, he was still so worried
با این تدبیر موفق بر رعایت عدالت خواهد شد	he humbly conceived, that by this expedient justice might in some measure be satisfied
که قصه خود را با لرز و اضطراب شروع کرد	, who began his story with trembling
رویه مرفته رفتارش چنان توأم با لطف و مهربانی بود	his whole deportment was so obliging
آن وقت من اسبم راهی کردم و به او رسیدم.	I spurred my horse and caught up with him.
که به زحمت ممکن است صدای زنان تا آن حد پایین آید.	that the voices of women can hardly descend to such adepth.
شاید عطوفتی که نسبت به جانوران داشت او را از کشتن منصرف کرد	her kindness for the dumb creatures would not have permitted it
هنگام نوشتن جواب این نامه عنوانی برای او پیدا کنند.	was that we could not think how to address the reply!
اگر این یادداشت به موقع به دستت رسید خودت را فوری به من برسان.	if you get this in time will you get the car and follow me.
مثل کسی که دست چپ و راست خود را نتواند تشخیص دهد من هم گیج و مبهوت شده بودم.	I should not know my right hand from my left
اما تا به یاد سقفشو بازه لال اقل یه سال دی گه طول میکشه.	I suppose it'll be another year before he gets the roof on.
بنابریان چون در معاشرت دریایی تمامی جاشو ان قایق باید از کشتی بروند	therefore as in gamming a complete boat's crew must leave the ship
خانواده او و پدرم حتی سن واقعی او را هم به من دروغ گفته بودند	her family and her father had lied to me even in the particular of her age
روستاییان به او اعتماد داشتند و به شعاع سیمیل از اطراف برای مشورت با او میآمدند	the peasants trusted him, and for thirty miles round they would come to ask his advice ,
اما ممکن بود این اظهارنظر به صورت ملامت و سرزنش تلقی شود و له وین خواهان گفت و شنودی گرم و دوستانه بود.	but that was like blame, and he longed for friendly, warm talk.
تغییری که صدها سال به درازا کشیده اکنون چهره او را یکسره دگرگون کرده بود.	the image had been hammering into this for hundreds of years,and the last finishing blows had told mightily on the expression.
حتی مسئول پرداخت مزد و سایر حقوق من نیز خود اوست.	for my salary and dues as well.
در آن حال بینواترین مردم خشکی نشین میوه تازه به هر روز در دست داشته و نان تازه جهان را در قبال نان خشک کپک زده من در کام نهاده	when the poorest landsman has had fresh fruit to his daily hand, and broken the world's fresh bread to my mouldy crusts
سرم را بالا آوردم و سعی کردم متهورانه به اطراف آن اطاق تاریک نگاه کنم.	I lifted my head and tried to look boldly round the dark room
سخاوت او نسبت به شخصیت او بسیار بیشتر از سخاوت دیگران در ارتباط با پولشان است همان دیگرانی که در حال حاضر دارند از او استفاده میکنند.	more generous with his personality than the people who make use of him are with their money.
که فشار حمله بیشتر از سمت شمال خواهد بود	the attack would be developed from the north
توی چادری که از کهنه و پاره زده بودند	in tents made of rag carpeting
از فکر چیزهایی که ممکن بود بر سرشان به یاد	at the thought of the dreadful possibilities.
ولی حتی یک بار هم تصویر صحیحی از او چاپ نکردند.	but at no time a single correctpicture of her.
شک دارم که هیچ دو نفری اعم از خدایان و فناناپذیرها تا حالا ان قدر واضح چیزی را دیده باشند	I doubt whether any two among gods or mortals have ever seen quite so clearly.
اول برای حفظ خود و ثانی برا حفظ من	for your own sake as well as mine
چون هر بلایی بس رم بیاورند بدتر از آن نخواهد بود که از کمک شما به من رو خواهد کرد.	which will not be so great but that a greater will come to me by being helped by your worship
به خاطر برادر و مادر خود را خواهد فروخت!	for her brother, for her mother, she will sell herself!
در همان حال مشت خود را محکم روی میز کوبید	banging his fist upon the table
با سرعتی که هرگز در خود ندیده بودم پای به فرار نهادم.	I ran as I never ran before
در سرزمین کوچک ما مردم کمی از فنون کشتی سررشته دارند.	we know some wrestling tricks in my little country.
این مرد اگر به نوازندگی زن مورد نظرش گوش کند قاعدتاً نباید خوشش بیاید نوازندگی یک زن دیگر را بشنود.	never seemed to like to hear one if he could hear the other.
در اتاق بقیه حاضرین همگی به سمت آن گروه از مردان خیره شده بودند	everybody else in the room looking towards the group
مفاصلش خشک شده بود و چشمانش آب آورده بود.	stiff in the joints and with a tendency to rheumy eyes.
حتی در حال دویدن به بالا خیره شده بود.	sending his gaze up even as he began to run again.
در عمرم هنوز در قسمت درجه یک هواپیما ننشسته بودم.	I've never been upgraded before in my life!
این بگفت و با دست راست دو ضربه بر روی شانه چپ خود نواخت.	then with his right hand he gave a couple of slaps on his left shoulder
من خودم با خواهش پاکنویس آن را به عهده گرفتم	I begged him to let me copy it out
شمشیری که چون سر دشمن شما را به پایتان اندازد در همان حال تاج شما را نیز بر سرتان باز خواهد نهاد.	I will bring your enemy's head to the ground and place on yours the crown of your kingdom.
مبهوت و متبسم چشمای درشت و زیبای خود را به گوشه آن میز دوخته بود.	he smilingly and absent mindedly fixed his large and handsome eyes.
زیرا غصه و اندوه او را از احساس ترس و بیم نگهداری نموده بود.	grief seeming to deprive her of all fear
خوشی یا ناخوشی ایشان بسته به آن است که چه کسی به ایشان اظهار عشق و محبت کند.	how their moods depend solely on who happens to be paying court to them.
اکنون نیز قصد داشت به محض پایان یافتن این جلسه صرف نظر از حکم دادگاه بی درنگ دست به کار شود.	assoon as this was over whatever the sentence might be she wouldbegin with her work.
اما نه اظهار خشنودی کرد و نه نا رضایی ظاهر ساخت.	without giving any sign of approbation or pleasure
بالاخره تخته را به هم زد و بست و از بازی با او طرف نظر کرد.	shut up the board, and declined to play with him any more.
چند دفعه قول داد که خودش را درست کند	promised to reform over and over again
چشمانم را در نور شدید باز و بسته کردم تا بهتر ببینم.	I'm blinking dazedly against the bright light, trying to see.
ناگهان پس از مرگ پدرومادرش بدنش پر از کهیر شده بود ول حالا آن مشکل حل شده بود	she had suffered a sudden rash of skin outbreaks after the deaths of her mother and father but that had now subsided
ولی شاید دلایلی برای این کار در میان بود.	but perhaps they had their reasons.
ولی هیچ بلایی سرم نیومد تا وقتی هشت سالم شد.	but nothing happened until I was eight.
آهن ربائیست بسیار عظیم که شکل آن مانند دوک نساجی است.	is a loadstone of a prodigious size, in shape resembling a weaver's shuttle.
از روزی که دانتس قدم به زندان نهاده بود شماره ایام و اوقات را فراموش کرد	he had till then forgotten the date
سرآنجام به میز خالی رسید و روی صندلی نشست.	he finally reached the table and sat down at it.
اما له وین با احتیاط حشره را آزاد کرد.	but he carefully extricated it.
که در حدود بیست سال سن داشت ولی قوزی و بدترکیب بود	a young girl of about twenty, but hunchback and crippled
آن هم تنها به خاطر این که از یک آمریکایی دعوت کردیم تا از موزها بخورد.	just because we invited a gringo to eat some bananas.
چیزی چنان تیره و یخ که پوست پشت گردن رالف کشیده شد.	something so dark and chilling that the skin on the back of his neck crawled.
آگلائه جمله اخیر را با نهایت خشم ادا کرد.	she cried, with annoyance.
به خانه تو بازگشتم و روی میزت یک کارد دیدم.	I came back to you then, remembering that you had a dagger lying on your table.
بلکه چیزی بود صرفا مفید به حال او و در تمام موارد عملی که جنبه حیاتی داشت همواره در دسترس او بود.	but a thing simply useful to him, and always at hand upon all mortally practical occasions.
به جهت امتحان چند بار بالا رفته و فرود آمد.	placed his foot on the first step
بگذارید من این نوار را از موی شما باز کنم	let me take this ribbon from your hair
تعجب من در این است که شما چگونه از مخالف بودن من با کلیسای انگلستان تعجب کردید.	I don't see why you should have been so surprised because I was a dissenter.
از اون ریش و سبیل سفید و پارچه روی چشم	by his white whiskers and the patch on his eye
طوری که اِما اول فکر کرد مبادا پدرش بویی ببرد.	as she thought, at first, could not escape her father's suspicion.
چنانچه تغییر عقیده دادید محلی برای نشستن شما باشد.	in case you should change your mind.
حقانیت درخواست پسرش را اعلام بدارد و با برانگیختن همدلی مردم متعصب بکوشد	seek to obtain the sympathy of the prejudiced public and incidentally
از این همه عشق و اعتماد تا چه حد سپاسگزار.	how grateful for all her love and faith
لوک دست دراز کرد و لیوانک خالی را از او گرفت.	he reached out and took the empty cup from her.
سپس گفت که در آخرین جلسه شورا هنگام طرح مسأله یاهوها نمایندگان ملت از اینکه او یاهوئی در خانه خود نگه داشته است رنجش خود را آشکار کرده	that in the last general assembly, when the affair of the _Yahoos_ was entered upon, the representatives had taken offence at his keeping a _Yahoo_ in his family
از سمت مقابل دریا خود را به پشت پناهگاه چوبی رسانیدم	until I had regained the rear, or shoreward side, of the stockade
از یک دریاچه زیرزمینی که از زمین و سقفش استالاگمیت استالاکتیت بیرون زده بود گذشتند.	passing an underground lake where huge stalactites and stalagmites grew from the ceiling and floor.
جمعیت نیز با شتاب از کنار جسد خونین او که روی زمین افتاده بود دور شد.	measured death rattle did the crowd around his prostrate, bleeding corpse begin rapidly to change places.
چوب دستی چند بار به سختی بر سر و کله بسیاری از آنان فرود آمد.	his stick sounded heavily on more than one.
ژیل چشمانش را باز کرد من خواب نیستم. و دوباره چشمانش را بست.	I'm not asleep,' he muttered, opening his eyes, and shutting them again.
امری که کاملاً مفهوم و با کلمات قابل بیان نبود.	but it was something he could not clearly understand or put into words.
سرم را پایین انداخته آهسته آهسته به طرف پلکان حرکت کردم.	I walked slowly up the stairs, one step at a time.
او حتی پیشنهاد کرده بود هری را از مدرسه اخراج کنند.	or even to suggest that he should be suspended from the school.
من خیلی بیشتر از ای نا می تونم برات پول خرج کنم.	I could spend a lot more on you than they could.
اشارة بعدی او خیالم را تا حدی راحت کرد.	his next remark took a weight from my mind.
اما پاسخش به آقای کازوبن هیچ ارتباطی به آزردگی واقعیش نداشت.	her reply had not touched the real hurt within her.
یعنی از رنجی که بهبود یافتن از آن محال بود.	from which he would not recover.
بارها متحیر مانده بودم که آن جفت ناجور چرا ازدواج کرده بودند	I had often wondered why that ill assorted pair had married
بعد از آن چشم را گشوده و فی الحقیقه خیره ماند	then he re opened them and stood motionless with amazement
زیرا در این اواخر هم رای و هم عقیده نبودند.	because of late there had been no agreement between them.
یکی از آنان که شرورتر یا شاید مستتر از سایرین بود	one more wicked or, it may be, more drunken than the rest
الان دو روزه که دو کلمه هم حرف نزد ین	here you ain't said ten words the las' couple days.
تو مخصوصا به این جهت در نظر من عزیز و گرامی هستی که یگانه مرد زنده در میان محفل ما تویی.	I am fond of you, especially as you are the one live man among our whole set.
در سرزمینی غریب بمیری. تازه کارت هم ناتموم میمونه.	you'll die in a strange land with the work not yet finished.
وقتی رنگ صورتش تغییر پیدا کرد من نفسم را حبس کردم.	I held my breath while his skin changed colors
همین الآن به چو پیشنهاد کردم که با من به جشن به یاد	I asked her to go with me just now
درست قبل از باز شدن دانشکده کتاب را تمام کردم و آن را برای یک ناشر فرستادم.	I just finished it before college opened and sent it to a publisher.
نه تا زمانی که هنوز سال نو از راه نرسیده.	not while the year is old.
گرچه نتوانستم کسی را در پشت پنجره ببینم که آن را نگاه داشته باشد	although I could not distinguish who put it out
مجدداً مانند روزگاران گذشته به فکر کارهای کیمیاگری خودش بیفتد	carried him back to his old days as an alchemist.
اغنیا به فقرا کمک نکنند در نظر شاهزاده خانم ماریا عجیب بود.	there could be rich people and poor, and the rich could refrain from helping the poor.
در این امید که درختی یا آسیابی در صحراها یابد و به آن پناهنده شود.	hoping to find some tree or haystack in the fields which would afford him shelter.
لینتون پس از این سخنان بار دیگر از راه دلسوزی به حال زار خود با صدای بلند شروع به ناله و ضجه کرد.	he began to wail aloud, for very pity of himself.
دست و بالش را بست و خود را به صورت یک بره درآورد.	he had tied himself down, had made himself a slave.
ما داستان عوض شدن احساس تو رو درست کردیم.	we've inventedthis other story about a change of heart.
هنوز یک سال از اقامت من در آن سرزمین نگذشته بود که چنان عشقی و تکریمی نسبت به ساکنان آن دیار در خود یافتم	I had not yet been a year in this country before I contracted such a love and veneration for the inhabitants
باید ببینم می تونیم ماشین قبل رویه مدت بیشتر نگه داریم	I'll have to see if we can keep your 'before' car for a little longer
ولی ببینم اون کیه که به خودش اجازه می ده از تو بدگویی کنه .	because of the convicts, but who is he to criticize you?
یک مرد بیگانه هم با موهای سیاه و زیبا و ریش دو سو در کنارش بود.	with her a gentleman with beautiful black hair and whiskers
حاضرم شرط ببندم که بقیه فکر می کردن من خوابیدم.	I bet the others think I fell asleep.
شاید هم کارمندان شرکت کل قضیه را فراموش کرده بودند.	everyone at work will already have forgotten about the whole thing.
این مطلب تازه نیست و اکنون قریب یک سال است که ادامه دارد.	but he lets it go on for months.
البته غیر از کارهای دستی و ماشین نویسی و بسکتبال و رقص	except the manual training and typewriting and basketballand dancing
من با هر کاری که تو برای خود انتخاب کنی موافقم.	I will agree to anything.
خلاصه بهترین انضباط نظامی را که من تا آن هنگام دیده بودم از خود نشان دادند.	in short discovered the best military discipline I ever beheld.
مانند کودکی که مجبور شده کاری انجام این حرف را کسی	like a little kid being forced to do something.
هیچ معلوم نبود که با فهم و تشخیص خودم بتوانم رفتار و اخلاقم را اصلاح کنم.	I doubt whether my own sense would have corrected me without it.
چنانکه گویی از حلب ساخته شده است نه از مس.	as though it were made of tin and not of copper.
تا اگر من خوشم نیامد که در آن سکونت کنم	so that if I don't like the life
رفته بود ادار کند و از پنجره مدور دست شویی چرخ پره دار عظیم را دیده بود	when he went to the stern to urinate and saw, through the opening in the toilet
بدین گونه کاروانسرا دار با اطمینان کامل تأکید کرد	he might regard it as certain
هنوز مطمئن نیستم که بخواهم دوباره به فضای بدون درخت برسیم.	I am not sure that I want to come out into the open yet.
گرچه در آن ساعت دیوانه خشمگین کاملاً آرام و ساکت بود	though just at that moment calm and quiet
بقیه عمرشان را با عوارض آن به سر برند.	they spend the rest of their lives kicking against it.
که من در ژانینا در خانه صرافی منزل کردم.	I went, of course, to the chief banker of the town to make inquiries
به این نتیجه رسید که بهترین راهش آن است که یکی از اعضای باشگاه را ترغیب کند که مجلسی ترتیب دهد	if some one other than herself who belonged could be induced to get up something
خود پیشنهاد کرد کسی با اسب به دنبال پزشک برود.	herself proposed that some one should ride off for a medical man.
ضم نا به اسم کشتی صادر کننده کالا هم برای پر کردن تقاضانامه برای اجازه صدور نیازمند خواهم بود.	I would also need the name of the exporting vessel, to fill in the application for export permit.
از ای نرو از هر گونه بدرفتاری که ممکن بود سایر اسبان در حق من روا دارند مانع شد.	thereby prevented any ill treatment which the others might have given me.
من اصلاً در مورد ساخت و ساز اینجا چیزی نمی دونم.	I don't know anything about the set up here.
که با سلطان در باب او مقاوله و مذاکره نمایی	to treat with the emperor for the life or death of your benefactor
شاید هم پول شوهرش بود که در مستی از جیبش بیرون آمده بود.	had taken his, I dare say, while he was drunk
مردی با تدبیر و پرگو که در قالب نصایح ظریف و دقیقش حزم اندیشی و خردمندی بسیاری نهفته بود	the diplomatist with his loquacity covering much caution and wisdom in delicate advice
که تنها صدایی بود که در این اتاق غیرم سکون بود.	the only sound in that deserted room
فقط صفوف سربازان از رنگ خاکستری به رنگ سیاه مبدل شده بود.	only the squares had become gray instead of black.
در جواب دو سؤال اول نام هنگ و فرمانده خود را گفت	answered the two first questions by giving the names of his regiment and of his commanding officer
افراد کلاه ایشان را به آن صدا بالا انداختند و چیزی نگذشت که آن صدای گرفتگی خاص نفس بلند شد	the men tossed their hats off to it, and ere long that peculiar gasping of the lungs was heard
در فکر آن بود که تا بازگشت دخترک بخوابد.	composing himself to sleep away the time until the young lady's return.
به جای تعجب بهتر است شتاب کنم در پوشیدن لباس.	instead of being astonished, let me dress myself.
او را راضی کرد تا در آن واحد هر دو با هم تنقیه کنند.	who convinced him to share them with her
شاید هم رالف پیر شده و تغییر کرده بود	he was changing, growing older perhaps
اما برای اطمینان بیشتری پیش او خواهم ماند تا بنویسم.	but, all the same, I mean to sit by her side while she writes, so as to be quite sure that she keeps her word.
حتماً مقصودش اینست که تو را از نزدیک ببیند.	I suppose she wants to have a look at you.
این لرزش کافی بود تا تمام هیکل دالوخوف را که روی رف سراشیب پنجره قرار داشت بلغزاند.	this was sufficient to cause his whole body to slip as he sat on the sloping ledge.
این حیوان درنده سرش را با پیشانی بزرگ و چوب دستی که در دهانش فرو رفته بود	all came to look at the wolf, which, with her broad browed head hanging down
لیکن همچنان به پیشروی ادامه دادیم تا آفتاب طلوع کرد.	but kept moving until dawn, so that half an hour after sunrise
به این ترتیب درست سه روبل سهم تو خواهد شد.	three roubles come to you for your share.
که بمو نی در قلعه بعد از پایان ترم	to remain at the castle when term ends.
اما همین که کشتی از دید ساحل دور شده بود جنون او همچون فواره بیرون زده بود.	but straightway upon the ship's getting out of sight of land, his insanity broke out in a freshet.
خوب میدانم که سرانجام من نیز راه نجات را خواهم یافت	I know that at the end of all things I shall be reconciled.
این هزار فرانک سهی مه من از برد قمار است.	this is a banknote for a thousand francs that she wanted me to keep out of our winnings.
آن را هل دادم تا باز شود و پلک زدم.	I pushed it open and blinked.
از این همه گذشته در خنجر بازی چنان ماهر است که دست کم از استادان معروف این فن ندارد.	above all, handles a sword as well as the best.
باید الساعه پایین بروم تا با رئیس دفتر صحبت کنم.	I ought to be in the office now, changing the reservations.
اسکار لت حس کرد چرخ کالسکه از روی چیزی نرم عبور کرد.	she felt the wheels pass over something soft, something resistant.
چنان محکم بسته شده بود که تنها اندکی آب در اطاق رخنه کرد.	which kept my closet so tight that very little water came in.
او دنبال کار خود رفت و مرا به حال تفکر گذاشت.	he went about his business, and left me in a brown study.
قدری هم چیزهای دیگر داد و دو تا بلیت آبی گرفت.	some small trifle or other for a couple of blue ones.
من امشب خیلی چیزها را بروز داده بودم بیش از آنکه انتظار داشتم.	I had been given so much tonight more than I'd expected.
قشر نازکی از خاکستر نرم در تمام پهنای راهرو در یک فاصلهٔ دو تا سه متری پاشیده شده بود.	a thin layer of ashes had been spread for the space of a few yards across the passage.
بر من بسیار سهل بود که او را از این گونه تعارف معذور دارم .	a compliment I could well have excused.
از لحاظ مالی و اخلاقی توانایی اعتراف به آن را ندارند.	gentlemen so conducting themselves could not afford either morally or financially to avow.
از پشت چنان تخته کوبی کرده بودند که حتی منفذی برای عبور نور باقی نمانده بود	the bars which held them were screwed tight into the wood
حدود یک هفته است که با دوست شما آشنا شده	he has had about a week's acquaintance with your friend
اقدام به ازدواج مجدد در صورت حیات شوهر اول با صراحت منع شده است شاهد آورد.	plainly remarriage while the husband is alive.
همدیگر را بوسیدیم و بار دیگر با هم آشتی کردیم.	we kissed each other and were friends.
انگار ماشین زمان او را دوباره شاگرد کلاس اول کرده بود.	as if he was regressing back to early grammar school days in his own private time machine.
سگی داشتم اقلاً در چند روز اول که هنوز فرار نکرده بود	I had a dog, at least I had him for a few days until he ran away
به رغم سردی هوا نتوانست از گشودن آن چشم بپوشد.	in spite of the cold could not help unlatching it.
سپس با صدای مهیبی روی سنگفرش نفیس بالکن فرود آمد.	then defenestrated itself on the balcony's slate flags with a loud crash.
در واقع نگرانی من از این است که مبادا برای این کارها اهمیتی بیشتر از آنچه دارند قائل شده باشی.	he feared, indeed, I must have bestowed more thought on the matter than it was worth.
خانم مو رلند که بدون پشتیبان مانده بود بعد از یک ربع دیگر حرفی برای گفتن نداشت.	being thus without any support, at the end of a quarter of an hour she had nothing to say.
اون وقت با عجله اومدم اینجا که تبریک به گم.	so I hastened here to congratulate you.
تمام احتیاجات او را بهتر از شما فراهم سازد.	satisfies your father's requirements better than you could
بیا دوتایی بریم و سر و ته شو هم به یاریم.	let's get together an' frame it up.
متصل باید مراقب بوده و نگذارید کسی از قرارداد تخلف نماید.	will yourself see that no one deviates from theM
او با اینکه آن همه موجب برای ناله و شکوه دارد	for having so many other things to complain of
خیال نداشتم بابت این مساله اعصابم را خرد کنم.	I'm not going to stress about it.
شاید هنوز از خواب خود به طور کامل بیدار نشده بو	whether it was that he was not yet half waked from his sleep
به تدریج یکی بعد ازد یگری سر از خواب برداشتند.	so they gradually one by one awoke.
ماشی نوار آن را دو بخش کرد و یک بخش را به طرف من راند و گفت آن مال من است.	mechanically dividing them into two equal portions, pushed one of them towards me, and said it was mine.
بسیار خوب است که ما بخواهیم تا بی درنگ به مردم کمک شود.	he said, looking round upon the red hot radicals with his calm and pitying air.
گفتی به رغم اردة خویش ناگزیر است در دل اضافه کند	as if he were compelled against his will to add, internally
زیرا مستم ولی مانند همه مستان راستش را میگویم.	because I am drunk but truthful!
همهٔ شیرهءزندگی در آن به صورت عقاید خشک در آمده است.	all the juices of life are wasted in ideas.
دیشب از این پس ره خواستم که مواظبشون باشه	I left this kid with them last night, but I had no business doing it
اما جاروی او از معدود جاروهایی بود که درست حرکت کرد.	but it was one of the few that did.
ولی در طی مرور زمان از آن اقدام پشیمان شده عرض حال داده بود که مجددا مالک آن زن شود.	but in the course of years, repenting of that step, he instituted an action to recover possession of her.
زیرا من هنگامی که به دریا افتادم بیش از دو ساعت نبود که از آن دیار دور شده بودم.	for I had not left the country whence I came above two hours before I dropped into the sea.
من حاضر نیستم خانه و زندگیم را به خاطر برکت از دست بدهم.	I ain't a going to be blest out of house and home.
در همان جیب سمت راست که پیرزن دفعة پیش کلیدها را از آن بیرون کشیده بود.	the same right hand pocket from which she had taken the key on his last visit.
بهتر است بگویم شایعاتی در مورد یک خبر پخش شده.	I should rather say rumours of news.
با دیدن آنا ساکت شدند و او را ورانداز کردند.	stared at her as she reached them.
زمین را به بوش زیرا تو در مقابل زمین گناهکاری	kiss the earth, for you have sinned against it too
بنا شد که فردا صبح پیش از رفتن به کارخانه از جلوی اتاق ربرتا عبور کند.	his plan in this instance was to pass by the following morning before work.
به این صورت آن را دستگاهی در نظر گرفت که مانند یک دیکشنری چرخان روی محوری سوار شود.	the totality of knowledge acquired during one's life.
که گویی در سراسر عمر جز این کاری نکرده است.	, as though he had done nothing else all his life
نخستین زنی که قلب جوانش را به او داده بود	the first to whom he had given his young adoration
پس از اینکه اندکی عضلات چهره خود را منقبض ساخت نشست	seated himself, after undergoing several muscular affections of the limbs
چند ساعت بعد دعوت برای صرف صبحانه را نپذیرفتم و بلافاصله از عمارت خارج شدم.	I declined joining their breakfast, and, at the first gleam of dawn, took an opportunity of escaping into the free air, now clear, and still, and cold as impalpable ice.
اما همین که شروع کردید قطعاً باید سخنرانی هم بکنید.	but being once undertaken does absolutely demand some speechifying.
زیرا که تقدیر جز یک طرفشان را نشان نداده است.	because destiny has only exhibited one side ofthem.
آنگاه همه برجستگی آب فرو نشست و کفن عظیم دریا به کردار پنج هزار سال پیش تلاطم خود را دنبال کرد.	then all collapsed, and the great shroud of the sea rolled on as it rolled five thousand years ago.
ولی پس از اندک مدتی فهمید که آن فریادهای هولناک از مهترش سانکو است.	until he clearly perceived that it was his squire who uttered them.
برای من مشکلی است که قبول کنم ملت من برای همیشه به زندگی در بردگی ادامه دهند.	I find it hard to believe my people will continue to live in servitude forever.
حتی ممکنه در صورت لزوم پسر خودم را هم بکشم!	I'd even kill I'd kill my own son.
کاغذهایی که شاید از فروشگاه یا انباری روستایی غارت شده بود	perhaps looted in some village store
چنانکه به شما گفتم وظیفه اصلی ماسون حقیقی کوشش در راه تکامل خویش است	as I have told you, lies in perfecting himself.
چون که چیزی را که مال خودم بود فروختم.	for I only sold what was my own.
خواهیم دید که این جوان لیاقت دارد یا نه.	that is what we shall see.
پیکر خون چکان سگ را از زمین بر گرفت	he picked up the bleeding mass
چنان ناراحت شدم که اشک از دیدگانم سرازیر شد.	I had my first attack of tears. I am afraid.
این بود که حتم کردم دعوا هنوز ادامه دارد.	so I reckoned the trouble was still a going on.
حتما وقتی استراحت کرد حاضر است برایت توضیح بدهد.	I'm sure when he'srested he'll be glad to explain it to you.
ساقه خشک شده گندمی را از پشت گاری برداشت	picking up a straw from the bottom of the wagon
تا هر چه بیشتر حواسم متوجه گرمی و پناه رختخواب بشود.	in order the more to concentrate the snugness of being in bed.
با صدای جیغی عجیب و گوش خراش آمیخته شد	by a strange, piercing shriek
من عمدا به او چنین گفتم که بار دیگر او را بیازارم	I said that malicious thing on purpose to wound him again.
با چوب دستی خود شروع به حرکات شمشیر بازی کرد	began flourishing his stick
داروهایی را که به او داده بودم دیگر بار تکرار کردم	I repeated the medicines I had given her
اما به جای او سه مرد در آنجا بودند که یک به یک میخانه را ترک کرده بودند.	but, the three men were there who had gone out of the wine shop singly.
صدای نواخته شدن زنگی ناقوس کلیسا توجهم را جلب کرد.	I heard a bell chime a church bell.
تمام اسباب و اثاث آن نیز به نحو همیشگی سر جای خود بردند.	each in its accustomed place.
اقبالت بلند بود که عقب جستی وگرنه کارت را ساخته بود.	aside, or it would have wiped you out!
بعد چنان با ملاطفت به طرف خانم خم شد که هرگونه سوءتفاهم را در او از بین برد.	bent down to her with a special tenderness the lady could not mistake
تا آنکه دستکم سه روز بدین ترتیب سپری شد.	until at least three days had gone by.
از پلکان رنج و درد چندان بالا رفته بود که به مراحل آرامش و درک فوق بشری رسیده بود.	to have mounted pain and suffering like steps into a high calm and a superhuman understanding.
اینک ابری از رطوبت و دود باروت ایستاده بود	there now spread a mist of damp
اتاقکی قابل حمل و نقل برای عوض کردن لباس	a portable bath house for dressing
فهمیدم که مدت شش ماه هر روز با یک بطری شیر و یک گرده نان زندگی کرده است.	I learned that for six months he had lived on a loaf of bread and a bottle of milk a day.
به خوبی آگاه بود که بجز گذشت زمان هیچ چیز یاور او نیست.	the cornet was suffering and knew that only time could help him.
برای گریز از این گرفتاری و پیدا کردن راه مناسبی چند دقیقه مشکوک ایستادم.	I hesitated, at the edge of the lawn.
همین امر سبب خواهد شد که راز من از پرده بیرون افتد.	whereby the whole secret would be known.
چون هنوز در شرکت مناسبی برای عملیات مخصوص من پیدا نشده است.	because a suitable vehicle for my particular operation has not yet come to light.
دلهره بر او چیره میشد و این افکار را از خود میراند.	a horror came over her and she drove those thoughts away.
من تا یکی دو روز دیگر نتایج را دریافت خواهم کرد.	I'll have the results in a day or two.
اعتراض مردم به این عمل موجب هیاهو شده است.	that there was popular objection to this funeral, which engendered uproar.
که دخترش را به پسری بدهد که ثروتی از خود نداشت	to give his daughter to a man who was not rich
که در این قسمت شیب تندی داشت و سنگلاخ بود	which was here steep and stony
ولی با این وصف از همین بی تصمیمی چیزهای زیادی آموختیم.	yet we learned much from this very indecision.
بوریس در آنجا در انتظار اوست تا نامه و پولی که برایش رسیده به او تحویل دهد.	that he wanted to see him as he had a letter and money for him.
هریت مخالفتش طوری نبود که بیشتر از چند دقیقه در مقابل اصرارهای دونفر مقاومت کند.	she had no scruples which could stand many minutes against the earnest pressing of both the others.
زندگی خوبی خواهم داشت و فرصت کافی هم به دست خواهم آورد که در کارهای دیگر امکانش نیست	but I'll earn a good living, and have plenty of time to myself, which I wouldn't have in any position.
بدون این که وکیل پاتر سؤالی از ایشان بکند	without being cross questioned.
زیرا از قرار معلوم یک ماه زندان زیاد هم برایش ناگوار نبود.	who was frankly not troubled by the prospect of a month in jail.
اما ما حساب خود را با این تبهکاران فرانسوی تصفیه خواهیم کرد!	we will deal with villains in our own way!
کادروس از جیب جلیقه کاردی همچنان باز بیرون آورده	drawing from his waistcoat an open knife
اگر پنجاه لیره داشته باشی شاید سه ماه آنجا بمانی.	you would, perhaps, stay away three months if you had fifty pounds.
توجه همگان را به خود جلب کرد و موجب خنده ایشان شد	arousing general attention and laughter
خودش قبلا میدانست که قادر به این اقدام نخواهد بود.	that he knew beforehand he was incapable of doing it!
او دستش را گرفت و آن را به صورتش فشرد	she grabbed his hand and held it pressed against her skin.
هر لحظه بیم آن است که زندگی من و کسانی که همراه منند به خطر بیفتد!	I'm risking my life and the lives of these good gentlemen every second.
چاقو را درآوردم و طناب را بریدم و راه افتادیم.	I out with my knife and cut the rope, and away we went!
از صندوق یک دستمال ابریشمی که مادرم به من داده بود برداشتم	I got a soft silk handkerchief of my mother's.
ناچار بر دو آرنج تکیه کرد و به فکر فرورفت.	so that, resting on his elbows, he began to reflect.
چون مصمم بودم از گرفتاری و بدبختی خود چیزی به پدرم ننویسم.	for I was firmly resolved not to write to my father telling him of my misfortunes.
سر نیزه انگشت اشاره خود را کام لا به طرف هدف نگاهداشت.	with the fixed bayonet of his pointed finger darted full at the object.
سرانجام مادرم یکی را چید و به دست او داد.	so she plucked it for him, and gave it into his hand.
کنارش زانو زدم و دستش را به دست گرفتم.	I went and knelt down by his side and put my face close to his.
اما وال مرده آن کتاب کافی است کسی یک نگاه بدان بیندازد و خیره بماند	as for the narwhale, one glimpse at it is enough to amaze one
به خاطر آتیه درخشانی برای دخترش آن طور که خودش مایل بود بگوید	in search of better opportunities for his daughter' s future, as he liked to say
چون در این میان پول هم مسئله بزرگی بود.	for that certainly would be a point in connection with all this?
را که سزاوار محبت و عنایت بودند مورد لطف و تفقد قرار داد	princes who had deserved it, reprimanded
بلکه حتی در پاسخ سوال او دلیل عشق خود را نیز شرح داده بود.	but had gone so far in answer to his question, what she loved him for as to explain what for.
شما تا دستور بعدی باید مرا ناخدای خود بدانید!	you'll please regard me as your captain until further notice.
این بهتر از این است که خدای نکرده باز به سرفه بیفتد.	than run the risk of bringing on your cough again.
من تازه به دو تا ارباب عادت کرده بودم و اگر بنا باشه یه خانم هم اضافه به شه و سه تایی بخوان به من دستور بدن مجبور میشم از اینجا برم.	just when I getten used to two maisters, if I mun hev' a _mistress_ set o'er my heead, it's like time to be flitting.
امپراطور را دوست ندارد و آرزومند نابودی همه ما است.	does not love our sovereign and desires the ruin of us all.
سرانجام آن گفت و شنود این شد که هر دو به ریش یکدیگر آویختند	the altercation ended in their seizing each other by the beard
دارم می گم که قاعدگی من پنج روز عقب افتاده	I'm trying to tell you that my period is five days late.
مگر الفاظی که وسیله بیان صفات مذموم یاهوهای خودشانست.	except those whereby they describe the detestable qualities of their _Yahoos_
دیری نپاید که سوار بر موجی آشنا شناور شد	soon, buoyant, rising again on a tide grown quickly familiar
بالاترین بدبختی این است که حتی یک نفر نیست که قادر باشد شما را درک کند!	the worst misery of all is that there is not a single man who can understand you!
برای آنکه این حق مانند یک حساب ریاضی روشن است بهتر است این شهود از دوستان شما باشند	it is just as well that the witnesses should be your friends.
نور شمع در آن تاریکی از چارچوب در بیرون تابید	the light of the candle framed it in the darkness
ولی مرد فرصت را در آن زخم گشوده غنیمت شمرد.	but he took advantage of the opportunity to speak through his own newly opened wound
از جهت کیفیت قابل خوردن و از جهت کمیت اندک بود.	the quality was eatable, the quantity small.
باز اگر چشم خود را بدین پوسته شانه مانند خشکیده عجیب یا این چیز دهانه بسته سبز رنگ بدوزید	again, if you fix your eye upon this strange, crested, comb like incrustation on the top of the mass this green, barnacled thing
جایی که کار در آن تا حدی شبیه کار در معادن بود چون در این مراکز نیز ماده خام ارزشمند از دل رمین بیرون کشیده میشد.	where the work resembled mining in so far that it also was the tearing of the raw material of treasure from the earth.
اما اینجا خاکی به جز گل ملعون جاشوها نیست.	here there's none but the crew's cursed clay.
بیزاری از دروغ و ریاکاری را هم از و سرمشق گرفته بودم	I had likewise learned, from his example, an utter detestation of all falsehood or disguise
دو بار هم کلید اتاق را برداشت و شب که همه خواب بودند از آنجا بیرون آمد.	twice to possess herself of the key of her cell, and issue therefrom in the night time.
مرد هم چنان کرد و گویا کمی در شگفت شد.	he followed her, seeming rather surprised.
که سرانجام نیک بختی و آرامش همهٔ آنان را تأمین کنی	in the end, giving them peace and rest at last
فکر کنم دیگران برات اوقات سختی رو به وجود آوردن	I know the others must give you a hard time.
او برای من در این باره قسم خورده است.	he swore he would
مثل آنکه نیروی تکلم را از دست داده است.	but said nothing as though his feelings were too strong to permit of words.
اما اکنون آخرین گفت و گوی خود با او و اهانت وحشتناکی را که به آن پایان داد به یاد آورد.	but now he recalled their last interview, and the deadly insult with which it had closed.
کشتی سبک بار بود و جریان آب رودخانه هم موافق بود.	the boat was light and the currents favorable
خلاصه به او بگو دود نکند تا من با او بخوابم.	tell him to stop smoking, in short, and I will turn in with him.
کاترین در حالیکه لباسش را پوشیده و آماده بیرون رفتن بود نزد من آمد	my young lady came down dressed for going out
عجب شما والانتین این قدر سلیم الفنس و پاک ضمیر هستید	are you so kind so good so unsuspicious of ill
که حتی بی چوب زیر بغل هم چون میمونی چست و چالاک بود	, agile as a monkey even without leg or crutch
قبل از باز شدن طناب وزنش را تحمل کند.	to support his own weight before the ropes were untied.
با این حال تردیدی وجود ندارد که پیشرفت و سعادت سراسر این منطقه روستایی فقیر و ماتم افزا در گرو حضور اوست.	yet it cannot be denied that the prosperity of the whole poor, bleak countryside depends upon his presence.
چنانچه او زکام نداشت دستورهایش قبل از شروع نبرد	that if he had not had a cold the orders he gave before
به او گفتم بی سر و صدا وارد شود و کاری نکند که ارباب از خواب بیدار شود و سپس در حالی که منتظر بودم تا لباسهایش را عوض کند و شمع را خاموش کنم به صحبتهایش گوش دادم.	I bid him beware of rousing the master, and while he undressed and I waited to put out the candle, he continued
که مست از روی ارابه افتاده و از پای درآمد است.	he had fallen from the wagon.
ببرد تا در آنجا بتواند با آزادی بیشتری با هم حرف بزنند.	in order that he might talkwith him and get his advice.
امیدوارم که این تأخیر به مشکلات تأمین آن شغل اضافه نشود.	I hope this delay will not have increased the difficulty of securing it.
شاه اوامری مؤکد صادر کرد که اگر بار دیگر کشتی پیدا شود آن را به ساحل کشند	the king had given strict orders, that if at any time another appeared, it should be taken ashore
فکر کرده بود دیگر کلید آن را گم کرده است.	thinking he had lost the key forever.
خلاصه آنکه چیزی جز مزاحمت برای شما نخواهد داشت.	you would never be happy with him.
در زمینه رمز و رازهای پنهان آینده راه به جایی نبردند.	are yet unable to penetrate the veiled mysteries of the future
سال آفت زده و بی بار و ثمر زودتر از معمول به سرما گراییده بود	the blighted and unfruitful year was prematurely cold
درست مثل ای که کسی او را از روی نیمکت به زور کنده باشد	as though someone had pulled him off the sofa.
او تنها کسی بود که از قدرت رعب آور او واقعا خبر داشت.	only she had been given a clear vision of his terrible power.
نتوانست آن حیوان را یک انگشت از جایی که در وسط تاخت ایستاده بود جلوتر براند.	without being able to make him stir a finger's length from the spot where he had come to a standstill in his course.
طوری قیافه گرفت که انگار با مسائلی درگیر است	the face and air of one who was vastly preoccupied with matters which had little, if anything
یا محبت کنی و این یا آن وسیلة آسایش را برایم بیاوری	or in your kindness you would have brought me out some comfort or other
علاوه بر این آن یک نفر بدخواه شما نیس	also, that someone is not ill disposed towards you
او را متهم کرده بود که وی را دچار مرض سوزاک کرده است	because he had given her what she called a low life sickness.
به هم گفت من می خوام با تو بمو نم	I want to stay with you, she told me.
این بود که از دلجویی و پند و اندرز کشیش که مردی باتدبیر و پاک دل بود تسلی یافت و آن مرد روحانی توانست آتش خشم کاماش و یاران او را فرو نشاند.	so the counsels of the priest, who was a wise and kindly disposed man, prevailed with him
لیکن چون زیبنده پهلوانان سرگردان نیست که مدتی مدید از وقت خود را به بیکاری و تن پروری بگذرانند	but that, as it did not become knights errant to give themselves up for long to idleness and luxury
این مطلب با توجه به ابعاد پنجره امری است مسلم و محقق!	that's plain from the size of the window.
مدت مدیدی بود که در صدد ملاقات کردن شما بودم.	I've long been eager for this meeting.
هنوز درباره سهوی بودن آن ضربه اندک شک داشتند.	were still a little dubious as to that unintentional blow of his.
آن گیجی مدام و آن سؤال و جواب ابدی.	of her confusions of questions and answers
برای نخستین مرتبه به یاد تمام گناهان خود در برابر ایشان افتاد	realizing for the first time how wrongly she had acted toward them
منظورت ای نه که و او را آن چنان محکم بغل کرد که تنش درد گرفت.	you can't mean that you and his hands closed over hers in so hard a grip that it hurt.
به طور موقت چیزی خالی و وجودی بی قالب و خواب رو و شعاعی از نور زنده بود	was for the time but a vacated thing, a formless somnambulistic being, a ray of living light, to be sure
دائما در فکرم که وضع شما از چه قرار است.	I keep wondering how you are.
ساحلی که همچون هلال زردی درمیان خرسنگهای عظیم قرار گرفته بود.	a yellow crescent between beetling cliffs
من به زنجیری از این بیچارگان مظلوم برخوردم که غمگین و دردمند بودند	I encountered a chaplet or string of miserable and unfortunate people
به دشواری با شلپ شلپ از میان آن گذشتم	I waded through with some difficulty
ولی قبلا باید دوران انزوای افراد بشر سپری شود.	but first we have to go through the period of isolation.
به محض آنکه او قدم به داخل اتاق گذاشت	as he did so
وی این دلبستگی را مربوط بدو ستی دیرین پاولیچف با پدر خودش دانست	probably by virtue of the old friendship with his father, he thought.
سپس از پنجره اتاق به ازدحام مردم چشم انداخت.	then out of the nearest window through
که تاس شده بود و فقط چند تار موی سفید روی سرش داشت	bald except for a few wisps of white hair
به جائی رسید که از فراز پنجره اطاق چشمم به روشنائی افتاد.	that I could see light from the tops of the windows.
چنان کسی که جناب عالی یک وقتی کمال مرحمت را به وی داشتید.	in whom your eminence had the kindness to interest yourself formerly.
که برای پر کردن آنچه در میز ناخدا خالی شده بود	that to fill out the vacancies made by the previous repast
واقعاً متشکر خواهم شد اگر ترتیبی بدهید که من با قایق پست کشتی را ترک کک نم.	I'd appreciate it if you could arrange for me to leave on the mail boat.
پیرزنی درشت اندام با چشمانی کوچک امّا هوشیار و زیرک چون فیل.	a huge old woman with the small shrewd eyes of an elephant.
زیر زبانی شروع کردم به تلفظ کردن تعدادی الفاظ دال بر تشویق و تحسین.	I murmured my admiration and approbation.
دراونجا خانومه از مصرف بیش از حد قرص خواب آور مرد.	there the lady OD'd on sleeping pills.
پتیا قبل از همه خواست او را از سر راه خود کنار بزند	who was the first against whom he directed his efforts
نتوانستم آنچه را که در نظر داشتم به خواننده تلقین کنم.	I did not succeed in suggesting what I was driving at.
سهم او را در این پرونده به مشتی پوشال بدل گردید.	shiver his part of the case to useless lumber.
سه تیر تفنگ از طرف بوته زارها خالی شدند.	three musket shots flashed out of the thicket.
کلاه جادوگری نوک تیزش به طرز جالبی روی موهای مجعدش قرار داشت.	his pointed wizard's hat was set at a jaunty angle on his wavy hair.
کلاه حصیریم را به سر گذاشتم و بندهایش را بستم. به شالم سنجاق زدم.	I tied on my straw bonnet, pinned my shawl, took the
فردیچنکو دوچار وحشت شده و مهر سکوت بر لب زد.	whereupon he relapsed into alarmed silence.
به جان همرزمان خود افتاده ایشان را چندان مورد ضرب و شتم قرار دادند که خود عاقبت در اوج هیجان از حال رفتند	striking and tearing at their own friends until they dropped into a passionate swoon,
نزدیک بود او را از روی زین سرنگون سازد.	its breast against the hindquarters of the officer's horse
هیچ کس به قدر من از این آگاه نیست	nobody knows better than I do
آنگاه چرخید تا به راه رفتن خود ادامه دهد.	turned to walk again.
از ریش او گرفت و او را با همین حال رسواکننده به خیابان برد و مدت مدیدی او را به این حال نگاه داشت	seized him by the beard and dragged him out into the street and for some distance along it, in that insulting fashion.
بخش اعظم سرمایة من به کلی از بین رفت.	much of my capital was irretrievably swallowed up.
زیرا به شنیدن فریاد او یک گله از یاهوهای بزرگ بر ما گرد آمدند	for a whole troop of old ones came about us at the noise
اگر حالا میتوانستم به فِرد بگویم که کار تمام است	if I could tell him it was all settled.
لیکن از تقدیم آن عاجز بیشتر تحریکشان خواهد کرد.	for they would arouse in them still more keenly a flaming thirst for responsive, active and grateful love which is now impossible.
بلکه روحاً در اثر نسیم تند زندگی که در باغ دخترانگی محفوظش به وزش درآمده بود یکه خورد.	but shocked in spirit by this rough blast of life in the garden of her sheltered maidenhood.
می دونی به خاطر من چی با به یاد آوردنش احساس خجالت و گناه کردم.	I cringed at the dim memory of shame and guilt.
چیزی که برای او عزیزتر از همه بود و او بایستی بر فقدان آن بیش از هر چیز تأسف بخورد.	that which he so lightly treated and so highly prized.
مطمئناً گاهی اشکال نداشت چیزهای مضحکش بر چیزهای خوب بچربد.	I could allow much for the occasional prevalence of the ridiculous over the good.
پس فرصت را برای فروگذاشتن احتیاط و برای تند تر رفتن مناسب دید.	he took advantage of this fact to abandon all dissimulation and to walk very rapidly.
اینک تنها در حضور او با هم جمع شده و به خاطر او روش زندگی عادی خود را تغییر داده بودند.	who changed their habits for his sake and only met because he was there.
به چیزی فکر کردم که او امروز پیش از این از من خواسته بود.	I thought of what he'd asked me for earlier today.
در آنجا تنها به سبب گرفتن آب آشامیدنی توقف کردیم.	where we staid only to take in fresh water.
اما موفقیت در این کار احتیاج به شخصیت قدرتمند داره و این چیزی نیست که هرکسی داشته باشد.	but it takes real strength of character, and not everyone's got it.
انگار به غیر از حرف زدن کار دیگری کرده بودند.	as if he had found them doing something rather more personal than talking.
در خانه تاجری تعیین گردید که ریشی بلند داشت و مسئول خانواده کثیری بود.	to the house of a merchant with a large family, and a long beard
هر کس باید مواظب گفته و نوشته خود درباره اشخاص باشد	let everyone mind how he speaks or writes about people
از اینکه این موجود رنجدیده را آزار نداده است خدا را شکر کرد.	she felt something like the thankfulness that might well up in us if we had narrowly escaped hurting a lamed creature.
سوار اسبی لاغر و کبود سیر بود و دیگری شنل پوشیده و پیاده بود	dark gray horse, the other in an overcoat and on foot
تا او را در جریان کارهای پدر زنش بگذارد	to bring him up to date on the excesses of his father in law
البته این شهرها از لحاظ تحقیقات علمی غنی هستند اما نتایج تحقیقاتشان معلوم نیست درست باشد.	where observation might be abundant indeed, but hardly sound.
اما لباس بر تنش تنگ و حرکاتش خشک بود.	but her clothes were very stiff and tight, and she was cramped in her movements.
اگر تو تا این اندازه او را دوست داری ممکن است اصرار نداشته باشی احترام او را جلب کنی	if you love her so much, surely you must be anxious to earn her respect?
چون از نقطه نظر مادی به نفع من است.	because it would have been a bad thing for me in a worldly point of view
این خبر عبارت بود از اینکه اثاث و موجودی خانة سابق ما فروخته شده است	namely, that there had been a sale of the furniture at our old home
با این حال از دیگران در نیرو و کار و کوشش بسی برترند.	whom yet they much exceed in strength and activity.
اگر چه چنان نیرومند بود که حتی اکنون با عشق او سر ستیز داشت.	though it was so strong that now this passion was even doing battle with his love.
اما امیدوار بودند به این ترتیب از شر مراقبت چشمان خصم در امان بمانند.	but they hoped in this way to escape the notice of unfriendly eyes.
این طرز حرف زدنش نفسم را بند او رده بود.	I almost can't breathe.
زمانی من از بانک و گنجفه و آ تو و امثال آن اطلاع داشتم	I used to understand what a 'corner' and the stakes at cards meant
اگر قول شرف بدهی که با صورتی و نارنجی پرش نکنی.	if you promise faithfully not to deck it out in pink and orange.
به ادیان گوناگون زمان حاضر رسیدم و در تمام مدت کوشیدم	coming down to the various religions of the present time
سانکو این بگفت و بار دیگر به ماهیتابه خود حمله برد	so saying, he began a fresh attack on the bucket
آن خواستگار خوشبخت که مقدر است روزی موفق به رام کردن خوی سرکش این دختر شود و چنین سرآمد جمالی را تصاحب کند کیست.	who is to be the happy man that will succeed in taming a nature so formidable and gaining possession of a beauty so supreme.
نهایتاً تصمیم کرفت که درخلوت ازپدرش بخواهد مانع رفتن لیدیا شود.	she could not help secretly advising her father not to let her go.
یک میزکشودار بود که در اتاق نشیمن قرار داده بودند. این میز از یک نوع چوب تیره رنگ ساخته شده	a certain old bureau of some dark wood in the parlour
ولو نمای آسانی در حد این کتاب باشد و بعدا در هر قسمت توسط زحمتکشان بعدی پر شود.	if only an easy outline one for the present, hereafter to be filled in all its departments by subsequent laborers.
چه برای این کار به دنیا آمده باشی و چه نیومده باشی.	whether you were raised to it or not.
اربابش به او دستور داد تا ببیند محتوی جامه دان چیست.	his master directed him to see what the valise contained.
نیم رخ وحشیانه و پر فراست این مرد آدمی خوار ظاهر گردید.	the fierce and sagacious profile of the man of prey reappeared.
سربازان یا موژیکهای شورشی بیفتیم بسیار وحشتناک خواهد بود.	the soldiers or of riotous peasants would be terrible.
با همان ملایمتی که به آنجا رفته بود بازگشت.	returned, stealthily and in the shade of the wall, in the same manner as he had descended.
به ترتیب سه بار دود غلیظی تقریبا در یک لحظه ظاهر شد	a cloud of smoke appeared, then a second
ظاهراً به این دلیل جیبنهای شلوارش را سوراخ کرده بود	apparently with the ultimate view of thrusting them into the pockets of his corduroy trousers
پس از آنکه کیف را باز کردم و محتویاتش را بازرسی نمودم در آن را بستم و مجددا زیر صندلی گذاشتم.	I took the purse, and opened it, and counted the money, and shut it and put it down again under the chair.
سپس افسری ظاهر شد و با بلند کردن هردو دست به آسمان اهریمن را طلبید.	then a captain suddenly came on, who evoked the spirit of evil by lifting both his arms to heaven.
بعد مثل جادو و جن بل در باز شد	then as if by magic, the door clicks open.
بالاخره در گوشه چون قراول فراموش شده درخت کاج بزرگ و بلندی است	while lone and solitary like a forgotten sentinel a tall pine raised its melancholy head in one of the corners of this unattractive spot
اما چهار روز بعد همه چیز برای او روشن شد.	but the next four days gradually enlightened her.
تعادلم را از دست دادم و روی صندلی جلو افتادم.	I wound up balanced on the back of the seat in front of me.
همان یادبود خفت و ذلتی که در باغ فرشته تحمل کرده بود	the memory of his humiliation in this angel's garden
برای آنکه گفته شود که سرانجام به این ریاضت	that it may be said at last, that a little happiness has been attached to the penance
ده سنت به هم می دی برم از سر چهار راه بستنی بخرم!	I wana' go up to the corner and gitan ice cream cone.
اگر به هوش آمدید و خود را در هرمکانی دیدید متوحش نشوید.	though you should awake and be ignorant where you are
با خود اندیشید شوهرش در این باره نظر دیگری دارد	began to reflect that her husband felt differently from herself
نفرت منو کور کرده بود و به من اجازه نداد موضوع رو با دید بازتری بررسی کنم. نمیدونستم که اگر با یه هم چین چیزی روبرو به شم چی کار باید بکنم.	I'd blinded myself with that hate. I hadn't let myself look at it carefully, because I must have known what I would see if I did.
همچنان که رسم شهرهای کوچک است در اندیشه خواستگاری دوباره بودند.	as is the fashion in country towns
تنها در برخی لحظات نیز دوست ندارد بلکه همیشه میل به جنایت دارد.	they love it always, not at some 'moments.
من در فهم کردن این مسائل خیلی کندذهن هستم.	I am so stupid in these things.
کاری در مارسی ندارم و میل هم ندارم که به مارسی بیایم	I will not
چنانچه گوئی من مسئول آمدن یا نیامدن او هستم.	as though I were to blame for it.
تا آن موقع هرگز اتفاق نیفتاده بود که او دو ساعت متوالی با خانمی صحبت کند.	he had never till then talked for two hours consecutively to a lady.
شبی محکومین به اعمال شاقه مانند من و شما گرد هم فراهم آمدند.	one night the convicts were gathered just as we are
به گریه افتاد و به طرز مبهم حس کرد که در دور و بر او چیزی شوم و غیر قابل درک در جریان است.	weeping, and vaguely feeling something fatal and incomprehensible whirling round him.
چون دید که دیگر کسی حاضر نیست چیزی به او بدهد	seeing that nobody gave him anything more
گفتم که بهتر است به من قدری آب بدهد.	said I thought I had better have some water.
از چکیدن آب از گلفهشنگی که از طاق آویخته بود درست شده بود	builded by the water drip from a stalactite overhead.
ولو شما با تمام قوای ژاندارمری خود از او حفاظت بکنید.	even if you were to tell off the whole force to protect him.
زیرا این زن در نظر او تجسم همان نیروی بیدادگری بود که بر زندگی ظاهری او حکومت میکرد	who to him stood for the incarnation of that brute force which would inevitably control him in the life he led in the eyes of the world,
که اگر او بخواهد و در خانه باشد مایل است همان شب به دیدنش برود.	that he was coming around that night if she were going to be home.
شما را راهنمایی خواهم کرد که چه کار کنید.	I will direct how you shall act.
که درونش برای خفتن بسیار کوتاه است و برای سر بل دن کردن بسیار پست.	too short for a person to lie down in, too low for him tostand upright in.
در انتظار علاماتی بود تا راه نجات را بیابد.	trying to find the secret signs that would show him the road to salvation.
من می تونم ذهن همه رو در آن واحد بشنوم	I can hear everyone at the same time.
اما دست کم دو یا سه روز وقت لازم است.	but it will take two or three days at least.
هرچند بجز آن مقدار که یافته بود چیز بیشتری پیدا نکرد	though he found no more booty
برای عقل فقط احساس آنی و نامعین زندگی است.	for reason, it is only a momentary undefinable sensation of life.
من از این همدردی شما بی اندازه ممنونم. ولی دیگر باید بروم.	I am very grateful for your sympathy, but I must be going,' he said, getting up.
چند تن از آشنایان خود را در بین این افسران عالیرتبه مشاهده کرد.	recognized several acquaintances among these notables
کاری کردم که احساس کنید یکی از افراد گروه رقت انگیز تون هستم.	I had you thinking I was one of your pathetic group
سپس حوله را تر کرد و شقیقة خود را شست.	then wetted a towel and washed his temple.
یعنی مجاملات بیسروته با خانمها و تعارفات مؤدبانه با کارهنین و به تیزهوشی و فرهنگ شهره بود.	that is to say, jesting with the ladies and dealing out friendly greetings among the men.
چون هیچ یک از بومیان حاضر نبود به آن خانه آلوده نزدیک شود	for none of the natives would approach the infected house
در زیر گزارش امده بود مایل به فروش نیست.	nis, the sheet read.
عزیزم دل قوی دارد و ضعف نفس را به خود مستولی مساز.	take courage, my friend
حس کنجکاوی آنان را برانگیخت تا ماجرای سفر و شرح حال مرا تحقیق کنند.	they were curious to inquire into my voyages and course of life.
ظاهرا تردید داشت که آیا چنگ زدن را موقوف نماید یا آهنگ جدید را شروع کند	evidently uncertain whether to stop or to play something else.
در وجود او فقط در جستجوی وبا بود و بس.	he had eyes only for the slightest hint that she might be a victim of the plague.
دفترچه یادداشت خود را بیرون آورد و روی یک ورق کاغذ بزرگ که چهار تا شده بود چند کلمه نوشت	he took out his notebook and wrote a few words on a large sheet of paper folded in four .
که خود را روی پاشنه بلند کرده و دائم لبانش آماده ی بوسیدن است.	who stood craning forward his lips ready to be kissed.
البته متاسفانه من تمایل دارم افکارم را تغییر دهم تا با افکار او جور دربیاید!	I am afraid I have a tendency to make over my ideas to match his!
به خاطر سرزمینی که او را ثروتمند کرده و به او آزادی داده بود.	for the land in which he had become rich and free and where
به دفتر رفت و کشوی میز را باز کرد.	went out into the office, and opened the desk drawer.
همین مانده بود که این یکی را با او مقابل نهند!	as though a fellow like that could be put on a level with him!
حداقل باید قبول کنیم که ممکنه اون عقاید خودشو داشته با شه.	at the very least we have to accept the possibility that she may have her own ideas.
گروهی از افسرانی را که شتابزده در کلبه ای چوبی گرد هم آمده و از ترس جان خودشان کاملا شقی و بی رحم شده بودند به سراغ آنها میفرستادند	were administered to them by a commission of officers hastily assembled in a hut of sticks and branches, and made pitiless by the fear for their own lives.
دو انگشت خود را بط رف توله سگ دراز کرده	I reached my finger and thumb over towards the poodle
در واقع چنان کامل او را اسیر خود کرده بود که گویی قالب درونی هر حرکت برونی او بود.	so completely possessing him, indeed, that it all but seemed the inward mould of every outer movement.
به سرعت خود را به آن سوی اتاق رساند.	shuffled rapidly across the room.
اگر نور بیشتری به اتاق بتابد مجبورم آن را تحمل کنم.	I must bear it, if you let it in.
به خصوص اگر مستأجرش مایل باشد صبحانه و شام خود را با افراد خانواده صرف کند.	one who would be glad to have her breakfast and dinner along with her family.
نامشان باید بدست خدای شهرت در معبد ابدیت حک شود	will place their names in the temple of immortality
توضیح آنکه دست خود را بط رف جلو دراز کرده بود چنانچه گفتی عزم دارد همه کسی پولش را مشاهده کند.	he had them in his right hand, and held them outstretched as if to show them.
آخر دیده بود که ناچار است به راه خود ادامه بدهد.	but it had been necessary to go on.
خود را سرگرم گوش دادن به تنفس بیمار کرده از پاسخ گفتن طفره رفتم.	I listened to the patient's breathing, and avoided answering.
مواظب خود باشید و از او به نفع خود استفاده کنید .	I think he is honest.
آنگاه خم شد و سگ کوچک سیاه را به سوی خود خواند	then stooped to beckon the tiny black spaniel
با این حال گویی چیزی از آقای رمزی به زنش منتقل شد.	but something seemed, nevertheless, to go from him to her.
به جهت اینکه من همان که ان کیسه را به خواهر فرستادم	because I am the man who sent the purse to your young sister
تا بدین گونه بتواند نسل خانواده را اصلاح کند و مانع از انقطاع آن شود.	in order to improve and continue the breed.
این بود که با عجله هر دو را با خودم آوردم.	so I just brought them along in a hurry.
از نگهبان آنجا درخواست کرده بود تا به ملاقات وی بیاید	asked the sentries' permission to see him.
من می خوام همه چیز و راجع به تو بدونم.	I want to know everything about you.
با رغبت تمام حاضر بود سر اسبش را برگرداند.	would have been right glad to have turned his horse's head.
که زیر چشمان آشفته و بینا به کار مشغولند.	if not painful, consciousness of being under a troubled master eye.
او مثل همیشه در را به آرامی باز کرد	he came strolling out as usual
بهتر است تشریف ببرید و فردا در اداره او را ملاقات کنید!	go round to the estate office in the morning.
گفتی وجود او ایشان را تنگ دیوار قرار داده بود.	as though he squeezed them against the wall.
آنهم درست پس از اینکه پول هنگفتی از مانگانز به چنگ آورد	after he had gained so much by manganese and things
سه تا سگ من در ظرف یک سال رفتن زیر ماشین و له شدن	I had three dogs run over in a year.
از آن گذشته خانه و زندگی من در اینجا نیست.	then my home is not here.
وی به جای آنکه کوشش کند تا خودش را به من برساند کاردی از روی میز ناهارخوری برداشت و به طرف سر من پرتاب کرد.	so instead of endeavouring to reach me, he snatched a dinner knife from the table and flung it at my head.
شالی پشمی به روی شانه او انداخت و در کنارش نشست.	placed a woolen shawl around her shoulders, and sat down beside her.
اما تقلید او از نژاد اصیل قابل قبول بود.	but the imitation of fine breeding was creditable.
من به شما گفتم که دشوارم است بهتر از این توضیح بدهم.	I have told you that I find it difficult to explain myself.
باید به خودش قوت قلب بدهد و بعد نوازندگی کند.	she must reason herself into the power of performance
بسا که او را زیر تیغ آرایشگر دیده بودم	had often seen him under the barber's hand
چون من اسم او را خوب به خاطر ندارم	for I do not very well remember.
هیچ گونه خود بزگ بینی و فخر فروشی در رفتارش نبود.	there was no hint of superiority.
حالا مقاومت آن در برابرش او را نگران و ناامید ساخته بود	she began now to have the anxiety which borders on hopelessness
ندارم اما به جهت تکلیف خودم ناچار است که امتحان دیگر بنماییم تا محقق شود که محبوس مرده است	but in discharge of my official duty that we should be perfectly assured that the prisoner is dead
که نیروی تخیلش را کام لا به خود مشغول ساخته بود	that so appealed to his imagination
با وجود این مثل این بود که زبانش تصمیم گرفته بود	yet his tongue seemed determined
در این لحظه بود که اتفاقی بسیار عجیب و غیر مترقبه روی داد.	it was at this moment that there occurred a most strange and unexpected thing.
همان طور که مرد مرده با لباس خاکستری نزدیک تر می آمد	as the dead man in the grey suit came nearer
من وقتی به خود آمدم و این افکار را از سر بیرون کردم که خود را در آتش خشم و غضب دیدم.	I recollected myself and drove away that thought only when I found myself glowing with anger
تحت هیچ شرایطی حاضر نیستم تا اون موقع صبر کنم.	once she had heard her say that under no circumstances would she wait that long,
شما که روزگاری خدمتکار او بودید مسئول نگهداری او شدید.	you, his old domestic, had the charge of him, I know.
از یک جانب از درون تاریکی توفانی صدایی خشمگین برخاست	came an angry voice out of the stormy darkness on the other side.
چون یادم نیست چه طوری می شه طلسم و باطل کرد.	because I can't remember how to block them.
همیشه هم نشانة خبر شومی برای کسی بوده است.	it has always boded ill to somebody.
مع هذا باز به قدری که در چنین حالت از برای من ممکن بود گفتم	I said all that a man in such a state could say
در مقابل ستایش بیش از حد جمعیت خود را مجبور به انجام نمایشی دید.	unabashed public adulation, he felt obliged to perform.
تزئینات ٱن نه شلوغ بود و نه کمتر از اندازه	her rosettes were not crushed nor torn off
که شوهرش از بیم رسوایی خود را کشت و پسرش و خودش رسوا شدند	through her husband and son.
زنی فربه و میان سال و خوش خلق بود که کنار تخت او نشسته بود.	middle aged woman seated at the side of his cot.
هرگاه تقلید از تاریخ جزو ارکان اصلی کمدی باشد	if truth to life is the main thing the drama should keep in view
من خیلی خوشحالم مادر که شما درست به موقع و قبل از این که شروع کنیم سر رسیدید .	I'm so glad you came before we began!
مثل این بود که جلو جماعتی سنگ بدست لختش کرده باشند.	which was like being stripped naked in front of a crowd armed with stones.
پارو بزنی را سرنگون ساخت و خود را به دریا کوفت و در اعماق ناپدید شد.	knocked down an oarsman, and smiting the sea, disappeared in its depths.
این وضعیت بیشتر از اون چیزی که برای تو لذت بخشه برای من نیست	I'm not enjoying this any more than you are.
جز آنکه برخی قوانین عمومی از مدون و غیر مدون لکن قاطع هست که در تمامی موارد طرف استفاده است.	were there not some written or unwritten, universal, undisputed law applicable to all cases.
پس از چند هفته که در اینجا و آنجا و در نقاطی ملاقات کردند	after several weeks in which they met here and there
لیکن دخترک هرگز بویی از آن عشق نبرده و هرگز نیز پروای آن نکرده بود.	though, so far as is known, she never knew it nor gave a thought to the matter.
اندکی با مرد تلاش و تقلا کند و بالاخره اندام و هیکل جوان خود را نجات دهد.	make one struggle for his young life
آن اینکه شاعر فطری وقتی از صنعت شعر یاری طلبید به مراتب بالاتر از کسی خواهد بود که قریحه خداداد ندارد	the poet by nature who calls in art to his aid will be a far better poet
معذرات میخ وام که نمی تونم در این مورد چیزت بهت به گم.	I'm also sorry I can't tell you anything about it.
هنوز دویست قدم نرفته بودند که صدای مهیبی شبیه به صدای ریختن آبشار از بلندی بر سنگ به گوششان رسید.	but they had not gone two hundred paces when a loud noise of water, as if falling from great rocks, struck their ears.
از دیدگاهی به کلی متفاوت شروع به بررسی ماوقع کرد.	he began to see what had happened to him in quite a different light.
هنگام ادای این سخنان سروان بازنشسته چنان به هیجان آمده بود	the captain said hotly again with a sort of frenzy
چون از هر دو طرف بالا آمده بود فقط فضای باریکی برای ورود هوای شبانه بازمانده بود.	rising high on each side, it left only a narrow space for the night air to invade.
با طناب به بالای دکل کشیدند و محکم به سر دکل پایین بستند	this vast bunch of grapes was swayed up to the main top
در ضمن میل دارد من هم به صورت آدم کودن و بی خبر از همه جایی باقی بمانم.	he wants me to sink into a dunce, meantime,
بعلاوه مسلح به کلنگی است و شاید چون او را بشناسد	armed with a pickaxe, and thathe would probably knock him over the head on recognizing him
ه آن چشمان سیاه و آرایش زنانه نگریست .	heart shaped face with its long widow's peak and serious dark eyes.
به علاوه از پدر شوهر و از شوهرش شکایت کرده بود.	had complained of her fate, her father in law, and her husband.
پیراهن ساتن صورتی که دور تا دورش تور دوزی داشت تن کرده بود.	dressed in a crinoline of pink satin with cream lace frills all over it.
مرگ قاطر در آن زمان نامناسب باعث شد توجه افراد به سوار نگون بخت قاطر جلب شود.	the ill timed end of that mule attracted attention to the unfortunate rider.
اصرار دارم که دیگر او را نپذیرید و از خانه اخراجش کنید	I insist on your never letting him come to the house again.
چون همچنانکه به من گفته بود امیدوار بود که شناختن راه و رسم کشور ما وی را سودمند افتد.	because he hoped, as he told me, that the knowledge of our conduct might be useful to him.
به سختی می تونم باور کنم که اون مرده باشه.	I can hardly believe he is, you know.
هرگز کاری نیک از پیش نبرده و از پیش هم نخواهد برد.	has never done any good, and never will.
خادم کلیسا یک تکه پارچه ابریشمین گل رنگ را جلوی میز خطابه وسط کلیسا گسترد	the beadle spread before the lectern in the middle of the church a piece of pink silken stuff
همین طور بی آن که شوهری اجباری در افق زندگیش خودنمایی کند.	therefore without an obligatory husband looming on her horizon.
هرچند که پیام دوم احتمالاً با مقداری سر و کله زدن با لیست ارقام بود.	though the second one would probably mean some tedious wading through lists of figures.
ولی حاضر نبود از این فرصت برای آشفته ساختن فکر حریفان بهره نگیرد.	but he could not resist this opportunity to throw so disrupting a thought into the opposition camp.
امیدوارم هر وقت خواستم ازدواج کنم یک نفر برای من همسر انتخاب کند.	that whenever I marry, I hope some body will chuse my wife for me.
به او درسی خواهم داد که دیگر اگر سرش را بزنند حاضر نشود عمل خود را تکرار نماید..	I can tell him that he wouldn't do it a second time!
با این همه من چیزی دیگر جز کابوس خودت نیستم.	yet I am only your nightmare, nothing more.
جادوگرهای زیر سن قانونی در خارج از مدرسه حق استفاده از سحر و جادو را ندارند.	underage wizards are not permitted to perform spells outside school
مطمئن بود که تا فردا صبح پولش را بس رقت خواهند برد و یا احتمالا او را بقتل خواهند رساند.	he would almost certainly be robbed, and perhaps murdered, before morning.
او باید شخصا آن مرد را پیدا کند و با او صحبت کند.	he must find that man himself and tell him.
ولی دیگر روزگار سکونت و اقامت کردن در آن خانه برایم سپری شده بود.	but the days of my inhabiting there were gone, and the old time was past.
کاملاً عاری از هرگونه درس عبرت یا تعصب خانوادگی.	entirely devoid of lessons or nostalgia
یعنی آن موقع که شوهرم هنوز فوت نکرده بود	I mean, beforemy husband passed on
نمی تونستم هر شب سر میز شام حضور داشته باشم.	I couldn't sit across the table from you every night
فوری قهوه امرا برداشتم و با عجله به راهرو دویدم.	I pick up my coffee and hurry along the corridor.
با این وداع از رفقای خود کاری جالب و باشکوه انجام داده باشد.	to make something touching and solemn out of this address to his comrades.
شک ندارم که ما هم باید به زودی راه او نارو پیش بگیریم.	I'm sure we will all feel the same way soon,
تقریباً در همان اوان باد شدیدی از پهلو وزیدن گرفت	but now a stiff breeze began to blow
من هیچ حاضر نبودم دلم را به حال بلانش بسوزانم.	I was not prepared to feel any great sympathy for her.
ولی بچه بهتر از آب درآمده است و من آن را خیلی دوست دارم.	but the baby is done better, and I love it very much.
زیرا روبرو شدن من با دشمن حضرت علیه همان و برآورده شدن کارها به نحوی که منظور نظر آن حضرت است همان.	for your highness is only kept from enjoying it as fully as you could desire by my delay in encountering your adversary.
تمام فکر و ذکرش این بوده دل را به دریا بزند و کار را یکسره کند.	he was too busy screwing up his courage for what he was about to do.
بروید توی حیاط تا پدر و مادرهایتان بیایند دنبالتان.	into the playground and wait for your parents to come and take you home.
بالاخره به او نوشتم که از این اقدام خودداری کند. اما او با تقاضای من موافقت نکرد.	finally wrote him, but nothing would induce him to consent.
ولی ورق برای یک لحظه تقریباً به زیان او برگشت.	but for a moment the tide almost turned against him.
دروغی پیش پا افتاده و بی شرمانه که پلیس از خود ساخته بود.	a common glaring lie that the police had invented.
دور اتاق گشتی زد و بعد روی نیمکت کنار تانیس نشست.	he wandered about the room, hedropped on the couch beside her.
اما این قسمت از وجودم اختیار هیچ کدام از حواسم را در دست ندارد.	but that part of me has no control over my senses any more.
ولی به هر حال کنجکاوی بر او غلبه کرد تا قبل از سوزاندن بار دیگر نگاهی به آن بیندازد.	but she could not resist the temptation of looking it over first.
با نگاهی انباشته به انزجار در چهرهء تازه وارد خیره شد.	regarded his new visitor with an undisguised look of abhorrence.
از بدبختی و بدشانسی که در زندگی من جریان داشته.	for misfortune to have an undue power over me.
