ارباب را مطمئن کردم که یک کشتی دست کم باید سه دور این کره زمین را بپیماید تا بتواند چاشت یکی از ما بهتران یعنی یک یاهوی مؤنث یا شراب او را فراهم کند و تنها در این صورت اجازه دارد که وارد بندرگاه شود.	I assured him that this whole globe of earth must be at least three times gone round before one of our better female _Yahoos_ could get her breakfast, or a cup to put it in.
مشروط بر اینکه آنان به حماقت و رذائلی که طبیعت در نهادشان آفریده است قانع باشند.	if they would be content with those vices and follies only which nature has entitled them to.
یکی پهنه جلگه ساحلی که درست دریائی رودخانه است	there is this strip of coastal plain to the seaward side of the river
این شهر در قسمت غربی ژاپون قرار گرفته است	the town lies on the western point
کشیشان مجمرها را آتش زدند. و خواندن ادعیه شروع شد.	the chanters relit their censers, and service began.
وی احتمالا کاغذها و مدارکش درست نبود و با ین کار احتیاج داشت.	whose papers were probably not in order and who therefore needed the job.
یادم نبود که بزودی هیئت ترویج کشاورزی به اینجا خواهد آمد.	there's the agricultural show coming on.
که رگبار شروع شد و همه را پراکنده کرد.	the deluge came and the funeral procession dispersed in a wild stampede.
من هم بیست بازدید دارم و همان قدرها هم کاغذ باید بنویسم.	I have twenty visits to make and as many letters to write.
که دیگر احتمال تماس و معارفه و توضیح در برابر دوستان و آشنایان مهمی که ممکن بود	without the likelihood of contacts, introductions and explanations to such of their more important connections
سرمای خیلی بدی خورده بودم که مجبور شدم یک هفته توی خانه زندانی شوم .	I've had a bad cold, and been shut up a week.
بنظرمن میتونه تا ابدیت شارژ به شه و ظرفیت اون بی نهایته.	I think it can take a charge almost to infipity.
تنها میدانم که شهود دادستان در آغاز صحبت کردند.	I only know that the witnesses for the prosecution were called first.
آن را به شکل خمیر یا گرده نانی در آوردم	made them into a paste or cake
یک رقاص مرد کاتاکالی با صورت سبز و دامن چرخان.	a kathakali dancer with his face green and skirts swirling.
تابوت زردرنگ با پرچم پوشیده شده بود و جلوی یک توپ قدیمی قرار داشت.	the flag draped yellow coffin on the gun carriage of a historic cannon
من قبل از شروع تعطیلات کارهای زیادی رو باید انجام بدم.	I have a lot to do before the holidays.
زیرا در اینجا دستمزدها خیلی بالاتر از زادگاهشان است	for wages were really much higher
اما هرگز مشخص نشد آیا که پاسخی هم دریافت نموده یا نه.	but it was never said whether she received any reply.
یک زن دارم با دو تا یخدان که تقریبا هشت پوطوزن داره.	I have my wife with me and a couple of boxes.
جامدات و مایعات را در مقعد خود فرو برد و مزاج را بر آن داشت که از دهان عمل کند.	forcing solids and liquids in at the anus, and making evacuations at the mouth
که قادر باشد تصمیماتی را در مورد شرکت اتخاذ و اجرا نماید.	able to pass a resolution binding on the company.
اگه بخوای می تونم آدرس و نشونیشو بهت بدم.	I can give you his address if you want it, and directions.
به همین دلیل ما به توافق رسیدیم که به هر قهرمان چند امتیاز از پنجاه امتیاز و بدیم.	we have therefore decided to award marks out of fifty for each of the champions, as follows
تعدادی کارگر اجیر کرده و ابزار لازم را فراهم نمود	recruited men, bought tools
افرادی که بر سر قرقره بودند در این هنگام از بلند کردن طناب باز ایستادند	the men at the windlass then cease heaving
مهم این است که آدم بتواند با چیزهای کوچک خیلی خوش باشد.	it's making a great deal out of the little ones
اما من که بجز فکر خود هیچ چیز ندارم باید آینده خود را تأمین کنم	but I who have nothing but my brains have to make a career and must not miss opportunities
این برای دریانوردی پیر چقدر سخت و سنگین است	which comes hard, for a master mariner
املاح معدنی که در دل خاک نهفته و در دریا به مساحتی قریب به پنج فرسنگ از ساحل قرار داد	that the mineral, which acts upon the stone in the bowels of the earth, and in the sea about six leagues distant from the shore
مختصر آنکه هر عضو داخلی یا خارجی بیماری مخصوص به خود را دارد	in short, every part, external and intestine, having diseases appropriated to itself.
به سرعت نسبتاً بسیار پیش رفته بودیم و آب بسیار در قایق نریخته بود.	we had shipped but little water in the process.
به همین دلیل در این باره با مقامات موجود در مرکز آن ایالت نیز وارد گفتگو شدند.	so they consulted the authorities in the capital of the province.
عنکبوت تلوتلو خورد و به پهلو روی پرچین افتاد.	flattening a nearby hedge
از پولیکه بدست آوردم هرچه را که مقروض بودیم پرداختم.	I paid up all the old scores out of it before they let me have the things.
در سراسر صفحات آن که با حروف ریز چاپ شده بود هیچ مطلبی که برایم جالب باشد پیدا نکردم.	no bright variety seemed spread over the closely printed pages.
بعضی اسناد وارده را در باب وضع قشون بود	for some papers relating to the condition of the troops on their arrival
من به اسم یک آژانس صادراتی خوب احتیاج دارم.	I need the name of a good export agent for shipping.
که هم به خانه و هم به دفترت نزدیک باشد	somewhere convenient to either your home or office
این بندر واقع است در شمال غربی و تقریباً در 29 درجه عرض شمالی و 140 درجه طول جغرافیائی قرار گرفته است	situated to the north west about 29 degrees north latitude, and 140 longitude.
99. 1% آنها زن بودند یعنی فقط ۱۳ ۵۹ منشی مرد وجود داشت.	99. 1% were women there were only 5, 913 men.
کاخی به مدت یک هفته ساخته شود آنهم با مصالحی چندان با دوام که هرگز محتاج تعمیر نگردد.	a palace may be built in a week, of materials so durable as to last for ever without repairing.
اسب یدک و دو اسب اصلی با یورتمه ی بلند کالسکه را از میان گل و لای میکشیدند	his shaft horse trotting at full speed and dragging the trace horses galloping through the mud, with their reins hanging loose,
از این قلعه و بارو نخواهم توانست بالا بیایم.	I can't scale the ramparts on this side!
شاید در روزهای آفتابی سی ایالت را و شاید هنگامی که هوا بسیار آفتابی بود چهل ایالت را.	on clear days thirty or perhaps forty, if the weather was very fine.
ارتباطی با زندگی روزمره و بدون تفکر و سنجش تأثیر مرگ خود در دیگران	not in relation to any worldly matter or with reference to its effect on others
فرد زیمر متهم است که مادر دانیل کوپر را کشته است.	accused of the rape murder of the young boy's mother.
مفید میدانم که این مراحل را قدم به قدم دنبال کنیم و همه را باز نماییم.	we think it will prove useful to follow these phases step by step and to indicate them all.
زن به سخنان پر هیجان و پر از احساس ان مرد جوان و خوش قیافه لبخند زد.	woman smiled at the intensity of the handsome young boy.
سپس آنی سیا فیودورونا مربای عسلی و شکری و گوشت ران خوک و مرغ بریان آورد.	still mead and sparkling mead, apples, nuts raw and roasted , and nut and honey sweets.
فکر کنم که توافق بر سر این موضوع تحت هم چین شرایطی کام لا عاقلانه با شه.	I think a compromise on this one point is certainly acceptable, under the circumstance.
او پیشنهاد کرد که دو لیره نقداً کارسازی کند و بقیه را به جنس یعنی سرکه بدهد.	who offered two pounds in cash, and the balance in sherry
آن را بر خلاف یک موی فر پهن کردم.	flattening it against a curl.
شهر کوچک در کنار ساحل سفید و پاکیزه است	the little town along the bay is white and urbane
اگه معطل کنیم جای خوب گیرم ون نم یاد.	or we won't get decent seats.
به خوبی میدانم که اگر نویسنده در نوشتن چیزی به راستی محتاج نبوغ و علم و سواد و هیچ قریحه و استعداد دیگر نباشد شهرتی بس ناچیز خواهد یافت.	I know very well, how little reputation is to be got by writings which require neither genius nor learning, nor indeed any other talent
اما حالا به اندازه ده برابر در سراسر شهر جمع شده بودند.	now there were thousands for every hundred then.
دیگر مانند چند لحظه پیش شلیک دو یا سه تیر در فواصل نامنظم و یک یا دو غرش توپ نبود	not two or three musket shots at irregular intervals as before, followed by one or two cannon shots
که عبارت بود از یک ظرف پر از مدفوع آدمی	of a vessel filled with human ordure
باید کسانی را به کار بگمارند که شایسته انجام دادن آنند	of choosing for employments persons qualified to exercise them
نام فامیلی مادر هر کدامشان را نیز به آخر آن افزودند.	the last name of the mother
نیز نوعی روغن وال که اهمیت آن از حیث تجاری بعد از روغن وال سر زا واقع شده است.	the oil specially known as whale oil,an inferior article in commerce.
حلقه درونی از درختان ما لورن بسیار بلند تشکیل شده بود که هنوز پوششی به رنگ طلایی روشن داشت.	the inner were mallorn trees of great height, still arrayed in pale gold.
برای ساعت دو بعد از ظهر آمادهء حرکت باشند.	so that they may be in starting trim at two o'clock in the afternoon.
به احتمال زیاد به دخالت او نیاز نخواهد داشت.	but likely enough never to vex him with a demand for his vote.
سنگفرش نامنظم شهر را یورتمه کنان درنوردیدند و راه پرگل و لای بیابان پی گرفتند.	clattering at a heavy dragoon trot over the uneven town pavement, and out upon the mire deep roads.
قفسه سنگین و بزرگی کنار دیوار قرار داشت که درونش ظروف نقره چیده بودند	the massive sideboard and buffet weighted with heavy silver
این زن پتریتسکی را به مناسبت نام خوانوادگی اش پییر میخواند و رابطه اش با اورا پنهان نمیکرد.	whom she called as a contraction of his surname, making no secret of her relations with him.
با آنکه در این خانه آثار ویرانی مشهود بود اما وضع عمومی آن تغییر نکرده بود.	it showed signs of damage but its general aspect was unchanged.
پهلوانی نیز مکتبی است مذهبی و پهلوانان مقدس در بهشت بسیارند.	there are sainted knights in glory.
با موهای صاف و چشمانی روشن و شفاف بود که حدود سیزده سال داشت.	smooth haired, bright eyed girl of thirteen
آیا ممکن است که راه و رسم جهان چنین باشد	is it possible that such things can be in the world
اگر یک تشک کاه انباشته سوراخ سوراخ کاه نما	if one can call by the name of bed a straw pallet so full of holesas to display the straw
او خواسته بود طی این همه سال به آواز قدیمی زمزمه وار جنگل بدهد	she had made all these years to the old crooning song of the woods
اهل مجلس تمام به وحشت پس رفتند و انقلابی در مجلس شد.	the crowd of guests rushed in alarm into the principal salon
بخاری را زیاد کردم تا بیشتر احساس راحتی کند و صدای موزیک را کم کردم.	I just turned up the heater so she wouldn't be uncomfortable, and set the music to a nice background level.
از موقعی که آنجا دست تو بود تا کنون خیلی تغییر کرده است.	it is so changed since it was in your charge.
کیک اسفنجی را آما قراربود تا باهم مایه ده کنند	where the two women were trying to get a sourdough sponge started
که مزدوران استبداد را چون کاه و پوشال در برابر طوفان شدید از مقابل خود فراری داده بود	who had made the mercenaries of tyranny fly like chaff before a hurricane
زیرا وقتی که به آن گوشه تاریک و پر علف حیاط کلیسا رسیدند	for when they reached the obscure corner of the churchyard in which the nettles grew
دیگر آن که آن را در شش خط خلاصه کنی.	the other is to squeeze it into six lines of the length of this one.
بر اساس مجوزی که برایش صادر کرده بودند این مدرسه برای دختران ثروتمندان و نجیب زادگان تاسیس شده بود.	according to its charter, was founded for the daughters of noblemen and gentlemen.
پسر درشت هیکل پشتش را به در بسته کرد	the large boy, backing against the closed door
بیش از سه هزار نفر را در خاک و خون غلتاند.	three thousand workers penned up by the station
من می گم که زنان یانکی همش ون که بد نیستند .	they can't all be bad!
در اصل به یک نحو و بر یک اساس به مالکان خود تعلق یافته بودند.	were originally claimed by their proprietors upon similar grounds.
سمت چپ سرتاسر علف زار است و سمت راست یکپارچه کشت و زرع.	all on the left is pasture land, all of the right arable.
که مسابقه دهندگان به جایگاه خوانده شدند تا شماره و محل استقرار خود را به حسب قرعه تعیین کنند.	when the competitors were summoned to the pavilion to receive their numbers and places in the row at starting.
آن روز به غذای معمولی دن کیشوت دو جوجه کبوتر افزوده بودند.	a couple of young pigeons were added to the ordinary fare
بعد از این هم فرامین دیگری به دنبال آن خواهد آمد که همه مهاجران را تبعید شده اعلام خواهد کرد	that there will be others'if there are not already banishing all emigrants
تو را دوست خواهم داشت پسرم هم به خاطر دل خودم و هم از طرف پدرت تو را دوست خواهم داشت.	I'll love you, my son, for me, and I'll love you for your father.
من بیشتر به یک وضعیت روحی فکر می کن تا شرایط جسمی.	I think it's more a mental condition than a physical one.
فردا شب چند نفر از دوستانم به دیدنم خواهند آمد.	I may have one or two people coming in tomorrow evening.
دوست دارند که حتماً خودشان هم اظهاری بکنند و مطالبی به آن بیفزایند.	how long stories spread in country districts.
چون مجبور نیستید که با یک دسته دختر فضول و پررو به مدرسه بروید	for you don't have to go to school with impertinent girls
پس از جدا کردن آنان که طغیان کرده بودند از کسانی که در طغیان شرکت نداشتند	separating those who had rebelled from those who had taken no part in the mutiny
50 بنابراین شایسته آن است که پیشوای نیکوکاران بعد از خویش قرار گیرد	50. he is ,as well ,a good leader for his successors
دو تا هم در داره که یکیش به دیر باز می شه و یکی دیگرش به کلیسا.	one leads into the convent, the other into the church.
هر طرف این مربع به طول پانصد قدم است.	each side of the square five hundred feet in length
چون که آن سه دختر جوان سخت مشغول تهیه و تدارک اوقات خوش بودند.	for the three young girls were busily employed in having a good time'.
من که دوست ندارم هیچ کد وم از پسرهای خودم تو هتل کار کنن خدا میدونه این مردم بی حیا تو هتل چه کارها که نمیکنن.	I certainly wouldnt want any of my boys to work in em the way people act.
ممکن است نقایص غیر قابل تحملی داشته باشید که اثر چند صفت خوبتان را خنثی کند.	you may have intolerable defects to counterbalance your few good points.
از چند طعم مختلف در لیوانی بزرگ و چند رنگ.	with layers of ice cream, each a different color
تا اینکه تابلوهایی این قدر شبیه هم در یک جا نباشند.	so that there might not be so many pictures almost all alike in the same place.
چون هنرمندان گمنامی هستند که اغلب ارزششان بیش از مشاهیر است.	for there are artists of no reputation, and who are often better than the celebrities.
همچنین مقداری علف دریائی و علف خشک تهیه کردم	got a quantity of dry sea weed, parched grass
از مادر خود سرشتی سست و دیرجوش به ارث برده بود.	she had inherited something of her mother's slow, unresponsive blood
هرگاه لازم باشد و شما مرا مطمئن سازید که امیدی به موفقیت وجود دارد حاضرم تا یک سال هم در اینجا بمانم .	I am content to remain here, if it be for twelve months, so long as you assure me that any hope remains.
اطاقی بود با ابعاد کم که به سبک مدرن معمولی مبله شده بود.	to find it of small dimensions, and furnished in ordinary, modern style.
دوست دارند که هرچه زودتر به میان سالی برسند	they merely want to slump into middle age as quickly as possible.
شلواری تیره رنگ پوشیده و کفش و جورابی هم برپای داشت	a man in a velveteen coat, drab shorts, half boots and stockings
نه هیئت رئیسه راه آهن و نه شرکتی صنعتی.	no mere railway board or industrial corporation.
ضمناً محل روشنایی و گرما را مشخص و ثابت کرده	rsula fixed the position of light and heat
که سطح آن قریب سه گز و نیم و ارتفاعش سه گز باشد .	of about twelve feet square, and ten high
ولی چیزهایی توی این بسته هست که خیلی برایم ارزش داشت.	but they are things that I have valued very much.
که در یک فرسخ و نیمی آن محل بود	which was a league and a half distant.
خیلی از این وظایف اجتماعی اخیراً به ذهنم رسیده.	I'm afraid that we have too many of these public duties in these latter days.
زیرا این دو از دوران طفولیت با هم بزرگ شده بودند	for they had been brought up together from childhood in her father's house
ولی در عین حال باید آن را برای کسانی که اجازه استفاده از آن را دارند ساده نگه داریم.	yet we want to keep it simple enough for people who are authorized to use it.
میگویند این وضعیت در موارد تنگی نفس و مرگ بر اثر ایست قلبی غیر عادی نیست.	it was explained that that is a symptom which is not unusual in cases of dyspnoea and death from cardiac exhaustion.
با عزمی راسخ با کارد خود زنجیر لنگرها را گسستم	I resolutely cut with my knife the cables that fastened the anchors
که سر دو کتف و در شیار میانی پشت خیس عرق بود	the outlines of shoulder blades wet with sweat.
در پاکت هوایی گذاشت و نشانی گیرنده را نوشت.	put them in an airmail envelope and addressed it.
تازه زیاد هم اصرار ندارن که نادانی خودشو نو ظاهر کنن	they aren't so keen on showing their ignorance.
کاروان بی آنکه بیش از آن درنگ کند پا در راه نهاد.	with the same they all set out forthwith.
قلاب بزرگ پیه کنی که یک صد لیور وزن آن است به همین صفحه آهنی بسته بود.	to this block the great blubber hook, weighing some one hundred pounds, was attached.
که برای کالای مزبور جواز صدوری هم اعطا خواهد شد	that the goods would be granted an export license
در یک گوشه پسرکی بود نقشه بزرگ شهر در دست گرفته	in one corner a boy was holding a large map of the town
ولی جرأت نکرد به سکوی نه و سه چهارم اشاره کند.	but didn't dare mention platform nine and three quarters.
دو مرد با هم خارج شدند و مدتی در باران با هم صحبت کردند.	the two men went out into the driving rain and stood for a moment, talking on the back porch.
ارتباطی به درویدا که برایشان مرکز دنیا بود نداشت.	which was the center of the universe.
در رأس جاشویانی نیز قرار داشت که عمد تا از ولگردان و افراد متروک و مطرود و آدمی خواران درهم آمیخته تشکیل شده بودند	at the head of a crew, too, chiefly made up of mongrel renegades, and castaways, and cannibals
اتوموبیلی که بیرون دروازه شرقی منزل از حرکت با ایستاده بود.	a motor that had stopped outside the large east side entrance.
ماه کم نوری باشد تا چندان زندگیش را آشفته نسازد.	be a little moon that would cause hardly a calculable perturbation.
وقتی جنگ شروع شد من درجه ستوان یکمی را قبول کردم.	I accepted a commission as first lieutenant when it began.
ولی ما مطمئنیم که فقط خودم ون ای نا رو بلدیم.	but we're sure we're the only ones who know about these.
با یکی از خویشان خود مصادف شوید که بخواهید درباره همه مطالب با او گفتگو کنید	meet one of your own people whom you want to talk everything over with
آن را کمی به شکل خمیدگی عریضی در آوردم که قوس آن جمعیت ما را احاته کرده بود.	I flexed it now into a low, wide dome that arced over our company.
که از سمت خارج دو پا بالای رودخانه است	is two feet above the level of theriver
اگر درباره کم و کیف وظیفه و حقوق خود سخنی به میان آوردم	if I have been bargaining more or less about my wages
خود هشت گره در هشت گره هست و به صورت مثلثی است که قاعده آن به طرف پایین باشد.	being eight in height, and of a triangular figure with the base downwards.
می تونم هر دوی این کارا رو انجام بدم و بازم ازت ببرم	I can do both and still kick your butt.
در اینجا ناگفته نماند که در طی این توصیفات هر کجا لازم آمده است	here be it said, that whenever it has been convenient to consult one in the course of these dissertations
حیواناتی را هم خریده بود که تا قبل از ورودشان به مزرعه هرگز چنین چیزی به گوششان نخورده بود.	others had been bought who had never heard mention of such a thing before their arrival.
ولی این جور افراد ارزش ندارن که آدم بخواد بهشون اهمیت بده.	but they're not worth botherin' with.
داروسازان خود را که با داروهای مناسب مجهزند همراه بیاورند	attended by their apothecaries stored with proper medicines
امنیتی را که حق قانونی من است تأمین نکرده.	it has not afforded me the protection to which I am entitled.
این سه ستون است که هر یک حاصل جمع متفاوتی دارد.	three columns which all give different totals.
من دیگر کسی را در نظر ندارم که برای هریت قابل قبول باشد	I am sure I have not an idea of any body else who would be at all desirable for her.
یکهو حیوانات صدای شلیک تفنگی را از سمت ساختمان مزرعه شنیدند.	the animals heard, from the direction of the farm buildings, the solemn booming of a gun.
که نسلا بعد نسل میان اولاد و ذریه ما برقرار است.	which shall be transmitted to our children's children
مردی که شلوار ابریشمی چسبانی به پاهای کلفتش داشت با کلاه پر دار و خنجری به وی نزدیک شد	a man with tight silk trousers over his stout legs, and holding a plume and a dagger
از اسرار مالی بیشتر تجار این شهر کوچک خبر داشت	knew the financial secrets of most traders in the town
همه را با هم در یک اتاق باریک جای دادند و پول سه اتاق را حساب کردند.	they were accommodated with one small room for which they were charged the price of three.
از چل یک بیرون خزیدم و خود را به پشت دکل بزرگ رسانیدم	slipping in an instant outside my barrel
آیا امیدی هست که با سه ماه کاهش مدت انتظار موافقت نماید.	whether there is hope that he may consent to reduce the term by four months.
که مردم سراسر کشور با علاقه و کنجکاوی بیشتری جریان محاکمه را دنبال کنند.	the generalpublic from coast to coast taking more and more interest.
بالاخره کار به اینجا رسید که به پار کردم!	I have finished by getting it on!
من مواظبت خواهم کرد که تو بهتر از پدرت تربیت شوی و به سرانجام شوم وی دچار نگردی!	we'll see if one tree won't grow as crooked as another, with the same wind to twist it!
دیگر اهمیت عمل اختیاری و آزاد را ندارد بلکه به صورت حادثه مقدر تاریخی ثبت خواهد شد.	in which it has not a free but a predestined significance.
بعد از این کلمات را نزدیک به هم بنویس.	joint handwriting in future, please!
کمیسیون علمی دیگری برای مطالعهی علل وضع نابسامان آنها از نظرگاههای	that another new scientific commission should be appointed to investigate the deplorable condition of the native tribes from the
فردا در اولین وهله با گزارش خود نزد شما خواهم بود.	I'll be with you to morrow morning as early as possible with my report.
از روی یک سراشیبی لیز خورد و به یک تونل تنگ و کم ارتفاع رسید.	slid down an earthy slope to the bottom of a very low tunnel.
دیگر لزومی ندارد به خصوصیاتی که مختص این خانه است فکر کنم	I have by no means made up my mind as to the privileges to be annexed to it
هر روز دو سه ساعت به من درس دهند	every day, for two or three hours
می تونیم یک هفته تمام از این شهود استطنطاق کنیم.	we cancross question them by the week
هرچند حاکم شهر تمام هم خود را مصروف این کرده است که رد پای ایشان را پیدا کند.	though the governor has been very active in searching for them.
با پاهائی چوبین و لباس آبی دامن دراز و عصا به دست.	a man who was dressed in a blue frockcoat and carrying a staff.
اگرچه در این ناحیه گود موقعیت ما تعریف چندانی نداشت.	though in this shallow country our position held little of advantage.
منظورم حقیقتی مؤثر است چیزی که برای آن در سیاست یا روزنامه نگاری هیچ جایی نیست.	I mean some effective truth, for which there is no room in politics or journalism.
چون از بسیاری از ایالات دور و متفاوت امده اند.	they come from so many different distant provinces.
سینی عصرانه را بیاور و برای این دو خانم جوان هم دو فنجان بگذار.	bring the tray and place cups for these two young ladies.
حاصل جمع این اعداد برابر با ششصد و شصت و شش است	it appears that the sum of them is 666
ممکن است اسلوب آن به مرور زمان تغییر یافته باشد	it may be that in the course of time they have been changed one for another
من میخ وام که هر کد وم از دخترای کلاس اسم همه او نارو یادبگیرن.	I want every girl in the class to know the whole lot of them by the end of the term.
که با سه ستاره و پنج نشان آراسته شده بود	ornamented with three medals and five crosses in fact
اما ظاهراً این کار به موجب قانون اساسی آن کشور ممنوع است	but this, it seems, is forbidden by the fundamental laws of the kingdom
اگر که این امر در حال صورت گرفتن است	if they are disposed to do so
هرگز حتی اسم آن معجون هم به گوش او نخورده بود.	who had never even heard of it by name.
از قطعات بزرگ و دراز استخوان نرم و سیاه میان و بالای فک وال گروئنلاندی گرفته شده بود.	consisting of the long, huge slabs of limber black bone taken from the middle and highest part of the jaws of the right whale.
که اساس آن را اعتقاد عموم باستانش ناسان استوار ساخته است	is an assertion based upon the general belief among archaeologists
به فکر این معدن افتاد و در عین حال مطمئن بود که این معدن با کمی بصیرت و ابتکار کاربردهای گوناگون دیگری هم دارد.	but with an ingenious insight into the various uses a silver mine can be put to
به جایش یک انبار نسبتاً بزرگی ساختند تا هیچ وقت با کمبود مواد غذایی مواجه نشوند.	another twice as large built so that there would never be a lack of food in the house.
خاک سفید اطراف مخازن و چمن سبز که آن طرف تر بود	the white gravel circles around the tanks, the green grass beyond the gravel.
زیرا اشتیاق من به بازگشت به کشوری که دوستش دارم آنقدر زیاد است	for the longing I feel to return to my country and to those I love is so great
سعی کنید آن را بپذیرید و بعد مصمم شوید که از بروز این اتفاق جلوگیری کنید.	resolve to accept it, should it occur, and then get busy making sure it doesn't happen.
که گوینده آن شعر همان کسی است که ادعا داشت شعر را سروده است.	that the writer of the sonnet was in fact who he said he was
نه بلکه از راه علم الیقینی بود که او را حاصل شده بود که گزندی بر این خانواده نیست	on the contrary from a firm conviction
زیرا هنوز بخار خون دشمنانی که کشته بود از تیغه شمشیرش بلند بود.	for the blood of the enemies he had slain was not yet dry on the blade of his sword
بقیه 26000 دلار معامله مهمات و نام کشتی را به شما بدهم.	give you the remaining twenty six thousand dollars for the ammunition deal, and the name of the ship.
جانشین آن شد و میخانه آن را هم به ارث برد.	succeeded to it, and inherited that famous dram
چیزی غیر از است خون به آدم نمی دن!	one can't afford anything but the poor cuts nowadays.
اما بعض یا تو انحرافات و گمراهی دنبالش می گردن	but some people take it in such perverted forms.
در همان وضع کذایی و با همان همکاران سابق و همان احساساتی که ناشی از تنزل زندگی من بود	in the same common way, and with the same common companions, and with the same sense of unmerited degradation as at first.
توی یه کلبه در محوطه مدرسه زندگی می کنه.	lives in a hut on the school grounds
اگر باز هم در قمار بردی فراموش نکن که پیش من بیائی اگر بیائی خوشحال خواهی شد!	if you win again, do not fail to come to me, et tu seras heureux.
همین قضیه را مثل یک اهرم به کار گرفتیم تا آن بار سنگین را از از خانه بیرون بیندازیم.	we employed it as a sort of lever to hoist our dead weights from the house.
شماره اشراف و سواد داران نیز بسیار قلیل بود.	also very few domestic or literate serfs
از ستایش سردبیر از داستانش گذشت و به جان کلام رسید	dashing through the editor's praise of his story to the meat of the letter,
ما هر سه از در کاخ وارد شدیم و از میان دو صف از پاسداران گذشتیم	we all three entered the gate of the palace between two rows of guards
هیچ واژگان درهم و بی ترتیبی در اختیار ندارد.	has no random words at its command.
چرا ناخواسته نصف محتوای فنجان را توی نعلبکی ریختم.	why I involuntarily spilt half the contents of my cup into my saucer
من صرفاً به این دلیل که اطمینان داشتم تو به علت بیماری ناچار بودی در بستر بمانی سئوالی نکردم	I have made no enquiries because I concluded you must have been obliged to give up the party
به حساب شخصی که مسئول کار بود از همه جهت رسید	checked the serving man in every possible way
هیولاهای دیگر حاضر نبودند نامش را بر زبان بیاورند.	even other monsters didn't want to name it.
ممکن است مقامات صدور آن را به عنوان سفینه مناسبی برای حمل محموله اسلحه قبول نکنند.	she might not be accepted by the exporting authorities as a fit vessel to take on board a load of arms.
هدف یا مسئله را به شکل یک سوال بنویسید و برای آن ۲۰ پاسخ پدید آورید.	write your goal or problem as a question and then generate 20 answers to it.
توسط گروهی که من و یارانم در آن قرار داشتیم	on board of which I and my company were placed
همان ریش پرپشت و همان صدای بم و عمیق.	the same luxuriant beard, the same deep bass voice.
چنانکه سبب هلاکت چند تن دیگر نیز همین بوده است	as it has been with several others
طبعا سخت مشتاق آن که این جزئیات را بشنوم.	I naturally have a strong and eager interest to know what they are.
بالاخره دسته چهارم که تعداد آنان از همه بیشتر است	then there are those and it is they that are the most numerous
این هفته رو زی نیست که قرار نداشته باشم.	with all the dates we got ahead of us this week.
تا من موافقت نکنم محاله بتونی یک سنت هم بگیری.	if I can manage it, you'll play hell getting a cent from any of them.
من تو را در تمام دوران زندگی ام بسیار دوست داشتم.	I have loved you so much for all my life.
باید این ماشین سواری بیست و چهار ساعته را کمترش کنم.	every noon cut out this motoring all the time.
خواستن چیزی غیر از آن هوسی است مانند ویار زنان باردار.	that anything beyond this is affected refinement.
اما تو چه حقی داری بگی او نو دوست دارم.	but what right have you to say I like him, anyhow.
در حالی که از جیب خود تکه کاغذی را بیرون آورده	producing a scrap of paper
که امکان وجود ویروس بیماری هنوز وجود دا رد.	that the superflu germ or virus might still be around.
همین حالا هم با زمین و دام آشنایی دارم.	I know a good deal about land and cattle already.
باید در حضور و یاب ساعت چهار حاضر باشم.	it is nearly four o'clock, and I must be in to answer to my name.
در زمان امپراطوری او همه بردگان آزاد خواهند شد	time, when everything would be made free
به طور روزافزونی از نظریه جهانی آگاهی یافته و تصمیم گرفته بود که به آنجا استقلال اعطا نماید.	increasingly conscious of world opinion, had decided to grant independence.
یک سگ پشم آلود سپید کوچک که از آن یکی از سر باغبانان بود بر حسب اتفاق به باغ درآمد.	a small white spaniel that belonged to one of the chief gardeners, having got by accident into the garden.
اطلاعات منظم شده را به نواری زرد رنگ تبدیل کرده بود.	turning organized information into yellow lace.
غیر از این یکتا پیرهن چیزی تنم نیست و خودت می دونی که روی اینم باهاس خاطرات بنویسم.	I hain't got nuffn but dish yer ole shirt, en you knows I got to keep de journal on dat.
با زحمت زیاد آن را در آنجا محکم ساخته	as close as it would go and ground it against it
این بود که با خودم عهد کردم که دیگر به خودم زحمت ندهم و موضوع را فراموشش کنم برود.	so at last I reckoned I wouldn't worry about it any more, but just let it go.
زیرا شهرت و نام نیک زن پرهیزگار تنها به خاطر این نیست که واقعاً پرهیزگار است	for a good woman does not win a good name merely by being good
مردی کنار پنجره به حالت نشسته به خواب رفته بود.	a man sitting fast asleep next to the window.
کلید را در سوراخ قفل بگذارید و کلون پشت در را نیز محکم کنید.	put the key in the look, and draw the bolts.
آتش در دودی که خود ساخته بود ناپدید شده بود.	the fire lost in its own horizon blotting smoke behind.
فکر کردم اکنون بهتراست با هم رفتاری صمیمانه داشته باشم.	I've decided openness is better between us,
به همین جهت در کف اتاق من آب راه انداخته و آن را به صورت یک خیابان پر رفت و آمد درآورده	by the same token, it has streamed on to my floor, and made it like a trampled street.
یعنی فقط و فقط یافتن آنچه در حال حاضر به کار میاید و مفید است.	to see only what may be of practical use at the moment.
بلکه بر آن شدم که اگر دست دهد آنجا را نخستین تبعیدگاه خود قرار دهم	but resolved it should if possible, be the first place of my banishment
با استعانت از این و آن پول لازم را برای هزینه دادگاه استیناف فراهم آورند.	that they might throughappeals of various kinds raise at least sufficient money to defraythe actual costs of such an appeal?
به دری که تابلوی دست شویی خراب است روی آن نصب شده بود	the door bearing its OUT OF ORDER sign
زیرا به موجب قانون اساسی آن کشور هر کس از هر طبقه در پیرامون کاخ امپراطور ادرار کند کیفرش مرگ است.	for, by the fundamental laws of the realm, it is capital in any person, of what quality soever, to make water within the precincts of the palace.
مخلوطی از بوی جوراب و بوی چاه توالت بود.	a mixture of old socks and the kind of public toilet no one seems to clean.
ولی ببین که در عوض چه چیزی بدست آوردیم!	but look what we have gained instead!
اما در همین اوقات مشغول هستم که او را تکمیل نمایم	but I am still trying to improve myself
تازه الان که نمی تونی از اون طلسما استفاده کنی	anyway, yeh couldn' work any of them curses yet
با خود میگویم که محال است که شما در آینده از یکدیگر جدا باشید.	I say to myself that it is quite impossible that the future should separate you.
که دویست و پنجاه هزار فرانک او را نیاز خدمت نمودم.	, from which 250,000 francs were paid to you for pin money
تا در خارج از کشور نسبت به خودمان احساس خوبی ایجاد کنیم.	to maintain a favourable impression abroad.
در حدود یک ساعت و نیم به راه خود ادامه دادیم.	I had ridden about an hour and a half, easily
یقین دارم که اگر به آن گوش بدهید شما را گرفتار وضع بدتری خواهد کرد.	I feel sure it will work you more misery if you listen to it.
چون که آتش گرممان کرده بود و راحت بودیم.	because of our warm fire.
به نظر من بهتر است ما شما را برسانیم.	I think it will be better if we drop you.
زیبا رویان مقیم کاروانسرا نیز به مسافر زیبا خیرمقدم گفتند.	the fair ladies of the inn gave the fair damsel a cordial welcome.
در نتیجه به سختی می شه باور کرد که قصد داشته با شن راز ما را بر ملا کنند.	they can hardly expose us.
به نظر من هیچ کس نیست که واقعا به مسئله بی علاقه باشد	I suppose nobody is really disinterested
صدای تق و تق شمشیرها در سر تا سر ساختمان طنین انداز بود.	the clanking of sabres and spurs resounded all over the building.
ده افسر مرده و چهارصد و پنجاه سرباز مقتول داشت.	10 officerskilled, 450 soldiers killed.
فرسودگی روح خود موجب خستگی و فرسودگی جسم خواهد شد.	these sometimes tend to produce bodily fatigue
با این کار راه او را سد کرده بود.	blocking his progress.
تم اما پر از شرح و بسط مربوط به سفرشان بود که همه کوتاه و فشرده و مثل برات تجارتی مختصر و مفید بود.	they were full of explanations relating to their journey, short, technical, and urgent, like business notes.
بر نوک کلاه خود پهلوان ناشناس چند پر مرغ به رنگ سبز و زرد و سفید در اهتزاز بود	above his helmet fluttered a great quantity of plumes, green, yellow, and white
به هر حال من مجبورم از شما بخواهم همین جا بمانید تا پلیس بیاید.	I'll have to ask you to please wait in the security office until the police get here.
که با شما مبادله کلمات منافقانه و اظهار خصوصیت دروغی نماییم.	sir, to exchange hypocritical expressions of politeness, or false professions of friendship
من بهت می گم که او نا اصلاً عجیب به دنیا اوم دن.	I tell you they're born queer.
دلیلش این است که تا امروز موضوع مهمی وجود نداشت که ارزش گزارش کردن داشته باشد.	it is because up to today there was nothing of importance to relate
به حمام بروند بد مستی کنند و به یکی از اماکن تفریحی شهر سر بزنند	have a bath, get drunk and visit one of the town's brothels usually in that order.
شکل آن سه گوش است و انتهای بسیار تیزی دارد.	of an angular shape, and with a very sharp pointed end.
از سمت شرق لنگرگاه را در میان گرفته بود	encloses the anchorage to the east
هر بار دیدار آنان نباید بیش از یک ساعت باشد.	the visit is to last but an hour.
علاوه بر فرایند فلاکت بار استخراج فلز از قعر زمین	apart from the sordid process of extracting the metal from under the ground.
در پرتو نور ماه که آن شب در کمال درخشندگی بود	saw by the light of the moon, which then was in its full splendour
به جز پدر و مادر همه چیز پیدا می شه!	except father and mother, there's everything!
مطمئنم که بین خودم ون پنج نفر می تونیم از خونریزی جلوگیری کنیم.	I'm sure, between the five of us, we can keep it from turning into bloodshed.
قلبم که وزنه تمام بدنم است کلیدش را ندارم که باز راهش بیندازم.	my heart the all controlling weight, I have no key to lift again.
به شدت به مطالعه پرداخت و آنچه را که میسر بود در مورد انواع و اقسام مرض وبا فرا گرفت.	he learned all there was to know about the different forms of cholera
گمانم شما باید به اقوام و خویشان خبر بدهید.	I suppose you'll communicate with the relatives.
آن مرد روستایی درختان زمین وی را شکسته بود	farmer's man breaking into his orchard
کارگران زورگوی خارجی را به جای کارگران بومی جایگزین کردند.	the local functionaries were replaced by dictatorial foreigners
این درست و پسندیده نیست که بنشینند و فقط درباره هنر و ادبیات با هم گپ بزنند.	it was absurd that they should talk of nothing but art and literature.
گفتم غایت و هدف علم این است که عدالت فردی را چیره گرداند	the end of which is to establish distributive justice
پس یک لقب و یک شغل شما را به سلطنتی مربوط نموده است	a title and promotion attach you to the government
نوشتن نخستین تذکاریه خود را درباره آئین دادرسی تازه آغاز کرد	he began writing his first note on the new judicial procedure
اگر در امعاء لویاتانهای مختلف فرو رویم علائم مشخصی نخواهیم یافت	if you descend into the bowels of the various leviathans, why there you will not find distinctions
دو توپ از کار افتاده بود و قوای مدافعی وجود نداشت.	two guns smashed, and no supports at all.
هیچ خدمتی بالاتر از این نیست که او را مجبور کنند تا خود را با دنیای فعالیت و کار وفق دهد و تخم لجبازی و جسارت را در او خرد کنند.	to which no greater service can be done than to force it to conform to the ways of the working world, and to bend it and break it.
این روغندان است و آن هم حلبی جای آن.	it's a lamp feeder and an oil can.
زیرا تصاویر موجود در عکس سیاه و سفید آن متحرک بودند.	because the people in the black and white picture were moving.
زمین و زمون رو گشتم و این پیرهن صاحب مرده تو پیدا نکردم.	I've hunted high and I've hunted low, and it does beat all what HAS become of your other shirt.
تمام اثاثیه مزاحم را از آن بیرون برده بودند مشغول نواختن آهنگی برای رقص فاکس ترات شده بود.	the strains of a preliminary fox trot were already issuing from the adjacent living room
مدیون این حقیقت بود که قبلا در روایت خود به آن اشاره کرده بودیم	is entirely due to a fact to which we drew attention earlier in the narrative.
او نایی که می تونن بشریت رو از زمین محو کنن.	those who could wipe out mankind.
هر بار به چه منظوری از قایق پیاده شدید.	how long you stopped andfor what.
فقط میخ وام بی اینکه نارو زده باشم خودمو بهت بشناسونم.	I'm just tryin' to get along without shovin' nobody around.
من بدون طناب به سفر آمدم و از آن وقت تا به حال همیشه نگران بودم.	I came without any and I've been worried ever since.
در آغاز نمک به جهت برانگیختن عطش به کار رفته است	was first introduced only as a provocative to drink
من نمیخوام پیشنهادی بدم که ما خبردارید ولی فقط شما هم از برنامه برخلاف دموکراسی باشه و همه میخوای م تائید کنی م که باید یه نفر مارو نامزد کنه و نفر دیگری هم نامزدی مارو تائید کنه	I'm not going to suggest anything that isn't perfectly demo cratic and you all know the plan anyway but I just want to re emphasize that each of us has to make sure we have someone who will nominate and second us
مثل یک شیلنگ ضخیم و سیاه رنگ رام و مطیع شده بود	docile as a thick, black garden hose
انهدام قشون افزون از پنجاه هزار نفری او و سقوط امپراطوری وی بود.	the destruction of the invading army of five hundred thousand men
هر چند که هیچ یک از پیشینیان او اشراف زاده نبودند.	although there was nothing aristocratic in his descent.
لکن اکثر کارگران کشتارگاه بعد از کشاه دستمزد و اعصاب بزرگ از اینجا رفتند.	but most of those who were working in the packing houses had gone away at the next drop in wages after the big strike.
تا خود را به پشت درخت بزرگ کاج برسانند.	making the diagonal across the island to be at hand beside the pine.
دیگری هم چندان مدتی پس از اولی در کشتی نخواهد ماند.	the other will not be very long in following.
شما اصولی خاص و قوانین هندسی دارید و حال آنکه در قلمرو ما همه چیز معادلهٔ نامحدود است.	here all is formulated and geometrical while we have nothing but indeterminate equations!
که من آن اتاق را به شما نشان دهم.	I will show it to you
نوعی حیوان زیبا که به بزرگی خرگوش است و ننه نه نام دارد	of a certain beautiful animal, about the same size, called _nnuhnoh_
آهن و سرب مذاب که از شدت حرارت به رنگ سفید درآمده بودند بر سطح زمین جریان داشتند.	the molten lead and iron poured down, white hot, upon the ground.
قرار ملاقاتی بی عیب و نقصه که یهو مثل شعبده بازی سر و کله یه بطری شامپاین سر میز پیدا به شه.	your perfect date would start off with a bottle of champagne appearing at your table as if by magic.
مهمانان کنت در دو اتاق پذیرایی و تالار و کتابخانه جای گرفتند.	the count visitors settled them selves, some in the two drawing rooms, some in the sitting room, some in the library.
ولی من هرگز نتوانستم اشتقاق این لغت را دریابم	whereof I could never learn the true etymology
در این هنگام کارگری خاکستری موی به جمع ما ملحق شد	when a grizzled mender of the roads joined the group.
سطح آن مثل آبی که باد بر سطح آن بوزد متلاطم شد.	the surface of it became ruffled like water beneath wind
من هرگز این همه کتاب در جائی ندیده بودم!	I never saw so many.
به دوستان نزدیکش گفته بود که از خدمات دولتی به کلی کناره گیری کرده و دیگر کاری به اینکارها ندارد	he told close friends that he had definitely retired from public life.
بنابراین به همراه جنازه کاترین به غیر از شوهرش فقط خدمتکاران منزل و معدودی از همسایگان روان بودند.	so that, besides her husband, the mourners were wholly composed of tenants and servants.
اما او از آن مردان احمقی نیست که فقطبعقاید شخص خود مقید باشد.	he is not one of those fools who never change their opinions.
در حدود صد قدمی خانه دیده و چون متوجه شده بود	standing less than a hundredfeet from the house
مستقیم به آپارتمان سوت و کورم رفتم و برای خودم شکلات درست کردم	I go straight home and make myself some hot chocolate
ولی من میل دارم که مکبث را تمرین نمایم.	but I'd like to try McBETH
اما زحمات و خدمات مرا یک کشیش نشین جبران خواهد کرد و ارباب من هم این کشیش نشین را به من داده است.	I shall be satisfied with a canonry for my services, and my master has already assigned me one.
دختر عمویی دارم که تنها خویشان وند من و مثل خودم یتیم است	I have a cousin, an only relative and an orphan, like myself
اتاقی بود که جهیز و جواهرات عروس را نهاده بودند.	the trousseau of the bride elect was on exhibition.
اگر چه هزاران مردم را بر آن گواه یابند.	although attested by millions.
به جز مهمانان قصر که تقریبا ده دوازده نفری بودند کسی نمانده بود.	only the guests staying at the castle were still there, about a dozen persons.
ولی بهتر بود آقای التن کمی نگران باقی بماند.	but as there must still remain a degree of uneasiness
صبح روز بعد هم در یک کلیسا دعا خواهند خواند.	say their prayers in the same chapel the next morning.
اطاق کوچکی دارد که دیوارهایش با دوغاب گچ سفید شده و کف آن شن پوش است.	a little room with whitewashed walls and a sanded floor
در کنار واگن به تماشای سکو و ایستگاه روشن ایستاد.	standing near the carriage looked about the platform and the lighted station.
بیست و هفت نفر از سیاهان به مجلس قانون گذاری ایالتی راه یافتن	twenty seven negroes were in the legislature
چهار شیلینگ برای این مجموعه معماهای عالی با بقیه چیزها.	four shillings for this remarkable collection of riddles with the et caeteras.
می دونی شاهم یکی دو تاش زیاد عیبی ندا ره.	I doan' mine one er two kings, but dat's enough.
همچون برجستگی که از برخورد دو جریان آب مخالف پدید آید.	like the swell formed when two hostile currents meet.
سر وقت دیگرانی که بهتر است از ایشان نام نبرم.	I will go to others whom it is better not to name.
همین زشهرتش را میان سیاهان افزایش داده بود .	his fame spread far among the black population.
حال آنکه از اینجا تا آنجا لااقل سی فرسخ شیرین راه است.	though it is more than thirty leagues from here to there.
ولی خیلی اتفاق میفته که زنی عادتشو یک ماه عقب بندازه.	but it's not unusual for women to miss a period.
با این حال این طبقه مورد احترام همگان است.	in spite of all this it is the highest class, respected by everyone.
زورق را با لاشه صد گاو و سیصد گوسفند و نان و نوشابه بالنسبه کافی و گوشت پخته به قدری که چهارصد آشپز توانسته بودند فراهم کنند انباشتم.	I stored the boat with the carcases of a hundred oxen, and three hundred sheep, with bread and drink proportionable, and as much meat ready dressed as four hundred cooks could provide.
هرچند حالا که تو سالمی و همین مه مه.	but you're safe, and that's what matters.
کافی است آدم در را ببندد تا میان خودش و هر خطر احتمالی یک مانع درست کند.	a door is soon fastened, and it is as well to have a drawn bolt between one and any mischief that may be about.
چون برای دریانوردی که دریای آرام یا پر باد باشد آن مهارت که بدو اطمینان دهد درست نود و سه فرسنگ و ربعی از بندر خود دور است به چه درد حال او می خورد.	for of what present avail to the becalmed or windbound mariner is the skill that assures him he is exactly ninety three leagues and a quarter from his port?
در اینجا بلاس با قدری تردید و پیچیدگی زبان این موضوع را گفت	the duke hesitated as he pronounced these words
نباید به هیچ کس به گم حتی به شما سه تا.	I'm not s'pposed ter talk abou' it, no, not even ter you lot.
من دقیقاً آن کاری را که تو گفتی کردم.	I did exactly as you told me.
مثل اینکه در مورد جسد هم شکی در کار نیست.	I suppose there is no doubt then
آموزگارش او را به جائی که تا شهر یک ساعت یا هشت فرسنگ راه بود برد تا هوا بخورد.	was carried by her governess to take the air about an hour's distance, or thirty miles from town.
به حقیقت اگر چنین شود پیش از آنکه از زندان بیرون بیایم جانمان به نوک دماغمان خواهد رسید.	faith, if they do, before we come out of gaol we shall have to sweat for it.
اما ساخت اصلی اجتماع هیچ گاه تغییر نیافته است.	but the essential structure of society has never altered.
زیرا سلطنت شما هنوز طفل است و لله لازم دارد.	because your empire is a young stem, weakened by rapid growth
ولی شاید نتونن قتل اون سیاه رو گردنش بند ازن.	but maybe they won't be able to prove the killing on him, after all.
که با دوربینی به شکل و اندازه دوربینی که در دادگاه نشان دادند از چند نفر عکس گرفته است.	a number of pictures with a camera about the size and description of the one shown him
در مرکز ساحل و سی و پنج مایلی مرزهای شمالی و جنوبی.	in the center of the coast, thirty five miles from the northern and southern borders.
نزد تاجر اسلحه مجازی رفت که گهگاه معاملاتی در سطح زیر قراردادی در گذشته برایش انجام داده بود.	he had gone to a licensed arms dealer for whom he had occasionally done work in the past on a subcontractual level.
در اینجا هم ون دفترچه مهرخورده را پیش کشید	here he returnedthe identical stamped folder, on one page of which
هر شعبه تقریبا شش تا یک هزار نفر عضو دارد.	a local had anywhere from six to a thousand members
لیکن برای آرام کردن کاروانسرا دار زحمت بیشتری کشیدند.	but much more work had they to appease the landlord
صلیبی یا نوار دیگری بیش از آنچه دارند به دست آورند.	obtain an extra cross or ribbon.
شوهر خاله چند وقت پیش صد پوند به من داد.	my uncle gave me a hundred a little while ago.
من از هر دو تا انجمن استعفا می دم و میرم .	I will withdraw from both clubs and I'll
دیوان بیگی وقتی دید که کشیش داستان خود را به پایان آورده است	who, as soon as he perceived the curate had made an end of his story
اما آب و هوا ممکن است از هر دشمنی برای ما بدتر باشد.	but the weather may prove a more deadly enemy than any.
بگو که دوستش داری و از آن او خواهی شد.	tell him you love him and will be his.
طبق آن آماده پرداختن به این کار با نیرو و شدت زاییده از تشاب مصمم شدم	accordingly prepared to set about this business with a determined rushing sort of energy and vigor
. و مداخله پلیس او را گرفتار نقیصه و سرزنشی سازد.	whose interference might seriously affect him
که روی آن را تا میان آب درختهیا کر نا پوشانده بوده است.	covered with mangrove thickets that grew out into the water.
از فکر اینکه توی شهر به اون بزرگی به چه دردسرهایی ممکنه بیفتی چهارستون بدنم می لرزه	I shudder to think of the trouble you could find in a city that size.
هر چند نبرد بر خشکی عرضه شده قدیس دلاور بر اسب سوار است	though the battle is depicted on land and the saint on horseback
من پول را برای خودم احتیاج دارم و مایل نیستم که فقط برای خدمت به سرمایه زنده باشم.	I want the money for MYSELF, for in no way do I look upon my personality as necessary to, or meet to be given over to, capital.
به همین دلیل است که در میان ترکان فقط چهار نام خانوادگی وجود دارد	the reason being that there are among them only four surnames
باید از انرژی جسمانی و ذهنی فراوانی برخوردار باشید.	you have to have high levels of physical and mental energy.
که در آن زبانی که سخن گوید فراوان و سری که فکر کند بسیار کم است	where there are many mouths which talk, and very few heads which think.
من میدونم که چه دوتا و چه سه تا سیگارو با یه چوب کبریت روشن کنی فرقی نمیکنه	I know it don't make any difference if a guy lights two cigarettes on a match or three but two don't make me nervous and three does
من یک موقعی یک دختر کوچولو داشتم که چشمانش خیلی شبیه تو بود.	I had a little girl once, with eyes like these.
جاشو ان همچون خوشه انگور بر عرشه زیرین گرد امده بودند	who in one thick cluster stood on the forecastle
یک مشت پسربچه ولگرد و برهنه پشت سر کالسکه به راه افتاده بودند	gangs of ragged children were chasing the carriage
من خیال دارم پیشنهادش را بپذیرم. به عنوان مشاور صحنه با گروهش کار کنم.	I'm going to accept her offer to work on set as an advisor.
با دست دیگر سواران را بدان گونه که بالا برده بودم پائین آوردم.	I set down the troop with the other, in the same manner as I took them up.
اسم این مرد در دفتر زندان به شماره 9430 ثبت شده و نامش ژان وال ژان بوده است.	this man was committed under the number 9,430, and his name was JeanValjean.
چون معلوم گرداند که این پهلوان فرزند پادشاه دلاوری است از شاهان کشور نیست در جهان	for it so happens that this knight is proved to be the son of a valiant king of some kingdom
بگذارید صراحتاً به شما بگویم چیز قابل قبول و سودمندی برای پیشنهاد ندارم.	let me frankly tell you, I have nothing eligible or profitable to suggest.
نمی شه انتظار داشت که دو تا چوب دستی دقیقاً کار واحدی انجام بدن.	of course, you will never get such good results with another wizard's wand.
بعد از آن او را از باروت پر کرد	filled it with powder
ازکابان زندان رعب انگیز جادوگرها بود که موجوداتی به نام دیوانه ساز نگهبآنآن بودند.	the terrifying wizard jail guarded by creatures called dementors
در صورتی حاضرم تو را ببرم که هوشیار باشی!	if you do come, I have the right to insist on your being sober.
به سمت یک تار عنکبوت گنبدی شکل مه آلود در مرکز گودال.	toward a misty, domed web in the very center of the hollow
نخستین توده آن در پیشروی خود تسخیر شهر را آغاز کرده است.	the first spray of it in its advance had begun to overwhelm the city.
دو بسته دیگر را هم به روی آن نهادند.	covered it over with a couple of other bundles
همسرش نزدیک سماور نقره جلوی ظروف تازه جای نشسته بود	his wife was sitting near the new silver samovar behind the new tea service
مرد او را به اتاق نشیمن که یک زن چاق و چله موپلاتینی در آن نشسته بود و محو تماشای تلویزیون بود راهنمایی کرد و گفت	the man said as he led her into the sittingroom where a large platinum blonde woman was gazing rapturously at the TV screen.
هیولای خشنی که به سرعت از کارگاه مجاور به این مکان منتقل شده بود.	a roughly mounted thing which appeared to have hurriedly been brought there from some neighbouring smithy, or other workshop.
اگر چهار قطعه مخ مس بسازم بیست مصرع خواهد بود	if he made them of five, what they called decimas or redondillas
زندانی هم با چشمانی گناهکار به خانم لیپت نگاه کرد.	not because she could remember any strikingly black pages in her record.
از وقتی که دبیرستان شروع شده حتی یک کلاس رو هم.	I haven't missed class since I started high school.
به نظر من همه همیشه کمی دل تنگ وطن خود هستند.	I suppose everybody must be always just a little homesick.
دیوارهای آجری بی سقف در تابش آفتاب بی رمق زمستان	roofless brick walls through which the dull daylight shone
او را از میان انبوه مجروحین تا نزدیک یکی از چادرها بردند	took him, as a regimental commander, close up to one of the tents
بعد از خمی ازهایمی نشینم و از شدت کمر درد به خودمی پی چم به خوابی دن روی زمین سنگی عادت ندارم.	I yawn, sitting up, wincing from the pain in my back I'm not used to sleeping on a stone floor.
در دو سال گذشته یک سوم حقوقشان بر باد رفته بود.	their wages had gone down by a full third in the past two years
شما چه قسطاش رو بدین چه ندین به را من یکیه.	I don't give a damn if you don't make payments.
تلفنو قاپیدم و کابلشو از بدنه و از پریز جدا کردم .	I grabbed the phone and disconnected the cable from the box and the jack.
اما یادت باشد که مرتب از هردو اسب استفاده کنی.	but make sure you use both the mare and the gelding regularly
من هرگز ندیدم یه تازه متولد این کار و بک نه. یک حس رو در ابتداش سرکوب کنه.	I've never seen a newborn do thatstop an emotion in its tracks that way.
ولی یک هفته بعد و یا قبل از آن تاریخ هزاران نفر قشون هم برای او هیچ ارزشی نخواهد داشت.	would he better than thousands a week before or a week after.
من می خوام یه مدت دی گه انسان بمو نم	I want to be human a little while longer.
اگر این کار و نکنم.کارم از دستم می ره	I'll lose my job if I don't do it.
حاضرید در ازاء این کار جان خود را هم به خطر بی اندازید	will take your chance of swinging for it
هم این و هم آن را در قمار خواهید باخت.	you will lose the one as readily as you will the other.
علت این سوال من تنها برای کسب کردن اطلاع است. دانستن هر مطلبی برایم لذت دارد.	I ask for information, and I am glad to know it.
بر حسب تصادف این فکر به مغز من خطور یافت.	maybe it's stupid of me to speak of it
اما عدم ازدواجی نخواهد بود واصلا وارثی هم وجود ندارد	but there won't be any default of marriage, nor of heirs either
روا بود که من آنان را چنانکه باید معذور دارم.	for these I gave, as it was reasonable, great allowance.
من میل ندارم زندگی کنم زیرا به هیچ چیز دلبستگی ندارم.	I don't want to live, because I loathe everything!
با این همه با زبان لطیف نگاه و ایماء این قدر تفاهم داریم	but we understand each other so well in this unseen language of looks and tones
بلکه نام وطنش را نیز به آخر اسم خود افزوده بود تا وطن را بلندآوازه سازد	but added the name of his kingdom and country to make it famous
من به خاطر یک تکه پوست نارنج از یک پا شل شدم	I've been lamed with orange peel once
می دونی من او نی که می دونم می دونم.	I reck'n I knows what I knows.
گرامی باد مخترع سرای حوریان و فردوس ادالیکها !	respect for the inventor of seraglios with houris and paradises with odalisques!
در کشو را باز کردم و همه را درون آن ریختم	I open a drawer and sweep a whole load of papers inside
پس آنچه در زمان کودکی که در خاطر دارید همان بود	this pious pilgrimage in behalf of the prisoners
که قصد جان او را دارند نه خیال بردن مال	the villains sought his life, not his money
البته اگر حق داشته باشم خودم را عضو جدید بخوانم.	that is,if I may presume to call myself an addition.
وقتی بردیم خنده رو لبش ون خشک می شه.	it'll really wipe the smiles off their faces if we win.
ایستگاه تلویزیون محلی هم یک گروه خبری فرستاده بود.	the local television station had sent a news team.
به این ترتیب چهار میل در جزیره پیش رفتند.	perhaps four miles across the islands spine.
تنها آرزوی او را برای متعلق بودن به این جهان عالی بیشتر تقویت کرد.	courts only strengthened his desire to belong to that higher world.
زیرا هر چند بر وظایف و تکالیف بی شماری که لازمه حرفه پهلوانان سرگردان است واقفم	for knowing as I do the countless toils that are the accompaniments of knight errantry
تا این امر را فرای امکان لغو شدنش حل و فصل کند	to settle this affair at once beyond all possibility of revocation
به همین زودی از قبرستون بودن محروم خواهد شد.	which has no uniform, and which isgoing to retire.
بعد چون شبح انسانی را در کنار در دید	catching sight of a figure standing by the door.
باعث کمال خوشبختی خواهد بود که چنانچه الطاف جنابعالی شامل حال ایشان گردد.	I would greatly appreciate any courtesies you extend him.
بلکه معترف است که ماهیانی درشت و بد طعم دارد	only coarse and tasteless sorts
اما نمی تونن جادو رو تو وجودش ون کام لا دفن بکنن.	but they can't bury it completely.
من برای تمرین چند تا افسون ساده رو امتحان کردم	I've tried a few simple spells just for practice
منظور من از این توضیحات آنست که شخصا شما را به این خانواده توصیه کنم	I give you all this information, prince, in order to make it clear to you that I am personally recommending you to this family
دانستم که بیماری کوفت را نخستین بار چه کسی در فلان خانواده اعیان وارد کرده	who first brought the pox into a noble house
من نمی گم بریم اون پایین و کله هاشونو از تن جدا کنیم.	I'm not saying we go down there and blow their heads off.
باید بازویم را کمتر بچرخانم و از بدنم بیشتر استفاده کنم.	I will swing less with my arm and more with my whole body,
شهرت و اعتبار جناب آقای غیب گو مانند همه همکارانش در محل باقی ماند.	senor planet ruler had the credit all over the place of being a most profound astrologer, as most of these planet rulers have.
مردم عادی جز از راه مطبوعات روزانه حق ورود به درون این برج و باروها را ندارند.	they are closed to the public, save through the medium of the daily press
انواع اسلحه آتشین بیرون آمد و به سوی هنگ سرازیر شد.	a varied array of firearms came to each muster.
زیرا ترسیدیم که مبادا آلات و ادواتی خطرناک باشد.	because we apprehended they might be dangerous engines.
اگه از جات حرکت کنی من مسئول سلامتی تو نیستم.	I won't answer for you if you move.
که دو آرش ین و نیم طول و شش ورچوک ارتفاع داشت.	it was six or seven feet in length, and not more than a foot in height.
آه! چقدر میل دارم شما یا شخص دیگری این منظره را نقاشی کنید. خیلی میل درام که شما این اقدام را انجام دهید.	I do so wish you or somebody else could draw it, you, if possible.
از هر طرف جمعی از اعیان طراز اول ملازم خدمت او بودند.	attended on each side by persons of prime quality.
حتی زمانی که قوه قضاوتمان اسیر و بنده قوه قضاوت یک نفر دیگر باشد.	even when it seems like the most slavish reliance on another.
حیوانات هم آهسته آهسته از آنجا گذاشتند و رفتند.	the animals crept silently away.
مطمئنم هنوز هم جای آن هست که قدر خودتان را بیشتر بدانید.	I am sure that you might be much, much worthier of yourself.
زیرا که تپانچه اسلحه کوری است که اعتبار ندارد.	the pistol is blind.
تنها برای یک ملت نوشتن آرمان بس حقیری است .	it is a poor ideal only to write for one nation.
احتمالاً مدت اقامتش از دو هفته لااقل به یک ماه خواهد کشید.	her fortnight was likely to be a month at least.
او را بیست و چهار ساعت به خدمت خود بگمارد.	commanding their service for twenty four hours
رسیدگی به دعوی را از امروز به فردا میفکنند	adjourn the cause from time to time
هر چند که من در تمام موارد با شما موافق نیستم.	though I don't agree with you in everything,
از دوره سحرآمیز نا هوشیار کودکی به دوره ایمان عاری از فکر صبا وت و بعد دوره دو دلی بلوغمحکومیته عمومی	through infancy's unconscious spell, boyhood's thoughtless faith, adolescence' doubt the common doom
یا سالی که در پی است روغن زیتون فراوان خواهد بود	the next there will be a full oil crop
به همین سبب طبیعت مفاصل دست را آفریده است تا حوائج مرا برآورد.	therefore nature had placed those joints to answer that necessity.
پس آرنج را به میز تکیه داده دفتر را با اشکال هندسی پیش کشید.	leaning his elbows on the table he drew toward him the exercise book containing geometrical figures.
به جای آنکه آن را با هم با صلح و صفا بخورند	they will, instead of eating peaceably
چطور از فاصله صد و پنجاه قدمی توانسته است	being one hundred and seventy fivefeet distant
چراغ محل که به موجب قرارداد خود برای عمل آمده بود	a parish surgeon who did such matters by contract
با وجود این هنوز هم می گم شما آدم خوبی نیستید.	but I despise you just the same.
اسبهایش را با دمهای بافته و یراقها و شرابه ها و زنگها به نظرآورد	his own horses with their tails tied up, in their harness trimmed with rings and tassels
دیگر پوشش ضخیم خاکستری رنگ براقی بدنشان را پوشانده بود.	they had developed a kind of thick, grayish, shiny armor.
آیا عاقلانه است چنین گنج باد آوری را از دست بدهم	am I to lose what chance threw me in the way of getting safely
نوار باتلاقی و غیرقابل نفوذی که مابین ساحل و دریا قرار داشت و کوهستانی را که در پشت رودخانه کشیده شده بود مورد بررسی قرار داد.	the strip of impene trable mangrove swamp between the river and the sea, and the mountains behind the river.
برای یک نویسنده خوب شدن همه چیز داشت جز استعداد.	he had everything to make a good writer but talent.
با وجود این مزیت آسوده نشستن در عقب را هم داشتند.	yet they also have the privilege of lounging in the rear.
از صد و شصت پوند همین پنجاه پوند را دارم.	I have only got these fifty pounds towards the hundred and sixty.
حالت اسلحه سازی را داشت که مزایای سلاحش را برای مشتری برشمرده و منتظر انتخاب اوست.	as a man selling pistols, after enlarging on the advantages of each weapon, might await his customer's choice.
تاکنون که تنخواه از شما قصور و تخلف نکرده است.	I do not think you have yet known the want of money.
که پهلوانان طلسم شده را به چنین وضع ببرند.	but never yet have I read, seen, or heard of their carrying off enchanted knights errant in this fashion
هر چه را که مایه شادی و نشاط خاطر من است تغییر صورت داده	changes all those things that give me pleasure, and
ساختن خانه من و آماده کردن لوازم آن نیز محتاج همین عده است	the building and furniture of my house employ as many more
چهارنعل در طول ساحل رودخانه در مسیر دریا تاخت.	galloped hard along the river bank in the direction of the sea.
با یک حلقهٔ درشت کالباس و یک تکّهٔ بزرگ نان و یک فنجان قهوه	a thick slice of it, a hunk of bread, and a cup of coffee
اندیشه چون ماه که بر فراز امواج خروشان بالا آمده باشد	the thought spread round it, like the risen moon on turbulent waters
احتمالاً همسر شخصی خواهد شد که بیشتر از من او را سعادتمند خواهد کرد.	will marry, probably, some one who will make her far happier than I should do.
باور کنید که شما طبیعتاً عبوس نیستید همچنان که من طبیعتاً بد نیستم.	believe me, you are not naturally austere, any more than I am naturally vicious.
مگر این که بتوانند اقداماتی بکنند که نتایج مفیدی به بار آورد.	except for the fact that it was charged with serious consequences.
کارکنان مو دب و دوست داشتنی بودند و ساعت کار مناسب بود.	the staff was pleasant, and the hours reasonable.
این هم بیشتر ناشی از سن بود تا وزن زیادی.	was more a shaping due to old age than to an actual weight gain.
به آن روزهای هراس انگیز و مرد کت آبی مهاجمی که دراز به دراز در سرسرای تارا افتاده بود.	the dead man in blue sprawled in the hall.
نعش کش که با پرهایش روی اقیانوس شناور بود و امواج دریا نفرات نعش کش بودند.	a hearse and its plumes floating over the ocean with the waves for the pallbearers.
که تمام ساکنان حیطه فرمانروایی وی تنها در اثر کوشش و مساعی وی در جنبش و فعالیت هستند	that it is only by his efforts that the whole population under his rule is kept going
حتماً تا پیش از اینکه حضرتعالی این اجازه را بگیرید ارباب من در آن دنیا خواهد بود.	before you have got your permission my master will be in the other world.
گفتگویی به شرح زیر با هم آغاز کردندو تاریخ شرح کامل آن مصاحبه واقعی را با جزئیات آن آورده است.	they had a discussion which the history records with great precision and scrupulous exactness.
این زندان را برای زندانیان خشن و خطرناک ساخته بودند.	this institution being one designed for violently disposed prisoners.
ولی راه آهن از هفت هشت کیلومتری غرب اینجا رد می شه.	though o'course about five miles to the west o' here is the railroad.
در آینده چیزی بخواهد که او مایل به برآورده ساختنش نباشد.	might not she be in a position to demand more from him than he might be willing to give?
در این دنیا فقط و فقط یک هدف دارم.	I have only one aim in the world.
منظورم این بود که این جور طبابت به نظر من درست شبیه مدرسه ساختن شما برای مردم است.	that method of doctoring I merely meant as a simile for doctoring the people with schools.
زمرد زیبایی با چند قطعه الماس را به نمایش گذاشت	disclosed a fine emerald with diamonds
شاگرد کشیش شهرداری نیز کنار بخاری ایستاده مشغول تیز کردن قلم خود بود.	the parish apothecary's apprentice was standing by the fire, making a toothpick out of a quill.
شهر به شکل صلیبی ناهموار بود و بازار هم در وسط آن قرار داشت.	town was shaped roughly like a cross with the market place in the middle.
اکنون سرگرم ترتیب کار خود بودند تا از پی کالسکه به راه بیفتند.	were now concluding their arrangements to follow the coach
اما بهتر است بگویم که برای تو خیلی مشکل است به این سرعت خود را با اخلاق مردی مثل او آشنا بکنی.	after all, the whole thing has been very hurried. I don't suppose he's too easy, and you'll have to adapt yourself to his ways.
مطمئنم وقتی برگردید او را به همین صورت آرام خواهید یافت	I do not doubt that you will find him, when you come back, as quiet as you leave him.
من هم مانند سایرین قواعد ادب و نزاکت را میدانم.	I have as much delicacy as anybody else.
یعنی از عمل اتفاق و لجاجت و هوسرانی یکی از منسوبان خودمان ناشی شده.	it is ill luck, obstinacy, and folly which have caused it to be decided against me
میزبان باید در همه کاری پیش قدم دیگران باشد.	I do think the host ought to give the lead himself.
برای من اهمیتی ندارد که تو مشکل داری یا نداری.	I don't care if you're a problem or not.
آرزوی من هم این است که کاش حقیقی نبودند.	I wish they weren't real too.
تمام این چیزها در یک حصیر پیچیده شده بود که از دو طرف دو طناب داشت تا در صورت لزوم بتوان آن را مثل ننو به جایی آویزان کرد.	all of this wrapped in straw matting tied with two hemp ropes for hanging a hammock in an emergency.
قلب من با این همه مشکلاتب که برایم پیش آمده شکسته است	I have been so overwhelmed by the many storms that have broken over my head
همین چند روز پیش تو روزنومه خوندم به را میوه چیدن یه عالمه کارگر می خوان	little while ago I seen a thing in the paper says they need folks to pick fruit.
این جا یه تکه شمع پیدا کردم باید خطر کنیم و اون شمع رو روشن کنیم تا شاید بشه با قطب نمای قایق به مسیر درست رفت.	I have discovered a bit of a candle here, and we must take the risk of a small light to make a course by the boat compass.
پاسداران مواضع مقدم دشمن پس از تیراندازی کوتاهی عقب نشستند.	the enemy's outposts after a brief interchange of shots retreated.
در ظرف یک ساعت از چهل نفر افراد توپخانه هفده نفر از پا افتادند	within an hour seventeen of the forty men of the guns' crews had been disabled
اما البته قادر به حضور در مراسم عروسی نخواهد بود.	but of course they won't be able to attend the wedding.
جز در پیرامون مقعد بر همه سرینشان موئی نرسته بود	nor any hair at all on their buttocks, except about the anus
برای من مهم این است که بتوانم کار و کاسبی خود را بگردانم و طلبم را وصول کنم.	for all I care about is to get my money.
روی میز پای تخت شمعی بر نوک بطری بود.	a night table with a candle in a bottle
موعد حرکت را به هشت روز بعد محول کردند.	the departure should take place in three days from that time.
سپس اشکالی نخواهد داشت هر ساعتی شما برای آن بیایید.	then it won't matter what time you come for it.
وکلای مدافع نیز برای تنظیم لایحه دفاعی به این مهلت احتیاج دارند.	the preparation of their casewould require that much time.
آخر چگونه ممکنست یکی از ما طالب آن باشد.	how any of us happened to want them?
در واقع اصلا برای این دو واژه معادلی نداشتند.	nor, indeed, any equivalent for these two words at all.
پیشنهاد کردم که اگر مایل باشد حاضرم ملحقاتی بر مطالب او بی افزایم	offered, if he pleased, to supply him with some additions.
البته هر سه به صورت رئیس دسته درآمده بودند	all of them chiefs, of course
قریب نیم ساعت که گذشت بادی توفنده از جانب شمال برخاست و بر زورق ما تاخت.	in about half an hour the boat was overset by a sudden flurry from the north.
فکر خیلی خوبی کردین که این افسون رو به همه نشون داد ین	yes, an excellent idea to show them that
بین پرداختن و ستدن از زمین تا آسمان اختلاف هست.	there is all the difference in the world between paying and being paid.
پس از سمت راست و چپ صحنه عده بسیاری با پالتوی سیاه به صحنه آمدند.	while many people appeared from right and left wearing black cloaks
شهر کوچک به یک شهر بزرگ صنعتی مبدل گشته بود.	the little town had become a great industrial city.
لااقل اِما خیالش راحت بود که نباید برای او دیگر دلواپس باشد.	she might at least relieve her feelings from any present solicitude on her account.
وقتی بدان جا رسیدم از لای نردههای در باغ به درون نگریستم و پسرک را در آنجا یافتم.	brown eyed boy setting his ruddy countenance against the bars.
از روی تعصبات نژادی و اخلاقی و مذهبی حاضر نبودند	with a general reserve due to prejudices, racial, moral and religious
دامن پشمی آبی رنگش بیشتر در جلو جمع شده	the blue woollen skirt, with all the fullness gathered in front
از ناموس یا جان تو کدام یک در معرض خطر است	in which of these two art thou imperiled
قصه را شمرده و مرتب و بدون تکرار و مثل یک آدم فهمیده نقل کن	go straight on with it, and tell it like a reasonable man
آن هم نه به حدی که دلخواه من باشد.	more of them than I liked.
بر روی هر بامی گروه متعددی از اشخاص جمع آمده بودند.	cluster upon cluster of people clinging to every house top.
من معتقد نیستم که زن جماعت باید با مرد پشت یک میز بنشینند.	I don't think that women ought to sit down at table with men.
از آنجا پی ببرید که زور بازویی که این دست به آن متصل است تا به چه پایه است.	whence you may infer what must be the strength of the arm that has such a hand.
جز اینکه شما مرد هستید و من زن هستم.	only you are a man and I a woman
بچسباند به سر تا سر مدرسه و شماها به آن بچسبید و نیست و نابود بشوید.	I would hang them all round the school and you'd all get stuck to them and that would be the end of it.
من دوست مونثی که همیشه او را ببینم ندارم.	I don't have a regular girl friend.
تا به را کار پیدا کردن مجبور نشم راست و دروغ به هم ببافم.	so I don't have to lie to get a job.
من به این پول احیاج دارم. بدجوری احتیاج دارم.	I do need the money so badly.
من خیلی خوشحالم که با استفاده از این فرصت شما را بهتر خواهم شناخت.	am very glad to make a closer acquaintance with you.
در نتیجه مقامات فکور از روی تفقد دار الموت جدید را ساختند که از نظر آنان بسیار بهتر از دار الموت قدیم بود.	hence this newer and betterdeath house, as the thoughtful and condescending authorities sawit, was devised.
چون قدرت شناوری این نوع وال باور نکردنی است.	because of its incredible power of swimming.
در یخچال کنجکاوی کرده تا تمام مواد لازم برای مرغ سخا ری را پیدا کردم.	I poked around in the fridge until I found all the ingredients for fried chicken.
بلکه بتواند به ماهیت واقعی باد ناگهانی ملایم نیت دار پی ببرد.	to identify the nature of that determined wind
اطمینان دارم که ممکن است فقط خیلی دلشان به حالت بسوزد نه این که از تو بدشان بیاید.	many, I am sure, pity you much.
نگاه نکردم که ببینم کد وم یکی از اونها بود.	I didn't look to see which vampire it was.
مطمئنم که او از دیدن شما دو نفر خوشحال خواهد شد.	I'm sure she would be delighted to see you both as well.
او مردی بود با حدود چهل سال سن که موهای جوگندمی برس کشیده وچشمهای سرد و سیاهی داشت.	a slight man in his forties, with crinkly salt and pepper hair cut en brosse, and cold, black eyes.
سپس چهارده مرد را که سه تن از آنان از بومیان آن دیار بودند در آن نشاند	putting fourteen men on board, whereof three were of the country
کارگرهای شهرستانی خش که مقدس و تنگ فکری از آب درآمدند.	the most ordinary small town mill workers religious and narrow to a degree.
آنگاه از وی برای انجام دادن چنین کاری دشواری مهلتی مناسب خواستم	desiring a reasonable time for so difficult a work
من تا حال آهنگهائی با ین دلپسندی نشنیده بودم.	I never heard such delicious music.
من هم به این حالتش توجه کردم اما زیاد اهمیت ندادم.	I noticed that but I didn't pay it any mind then.
باید محکم توی دستم ون نگهش داریم اگه چیزی رو یادم ون رفته باشد قرمز می شه.	you hold it tight like this and if it turns red
زیرا به سبب نقل و انتقال دایمی واحدهای قشون دشمن ما از مواضع ایشان اطلاع درستی نداریم.	whereas it was perhaps not known, since the enemy was in movement.
تا هر وقت که شما میل داشته باشید منتظر خواهم ماند	I will wait as long as you like
خدا کنه همین خان مه استادم ون بمو نه!	I hope she stays, that woman!
مثل چیزی که بعدها تعمیر و یا اضافه شده است.	such as a part made up, or added later.
وقتی که این کار و کردین چهل دلار ازتون میگیرن تا کفن و دفنش کنن اگه پول نداشته باشین مثل گداها خاکش میکنن	when you do that, they either take forty dollars for the undertaker or they take him for a pauper.
لااقل جزو آن دسته از علوم نیست که موجب ننگ و فضیحت و بی آبرویی طالبان آن باشد.	it is not one of those that bring discredit upon the possessor.
یاهوهای یک محله در صددند که هر فرصتی را مغتنم شمارند و یاهوهای محله دیگر را غافلگیر کنند.	those of one district watching all opportunities to surprise the next
بلکه یک چاه عمیق واقعی که تا نهصد متری از سطح زمین ادامه داشت.	true artesian water brought from over three thousand feet below the surface.
گذشته از این چه مانعی دارد فقر که عیب نیست.	though of course poverty is no crime we must remember that!
به همین خرسندند که به طریقی مسالمت آمیز حدود و ثغور املاک متصرفی خود را حفظ کنند.	keeping peacefully within the limits of their states.
ولو به فشردگی و برق آن بسیار اضافه کند.	however much it may give it compactness and gloss.
اما شما مردم تربیت شده باید بهتر از این ما را شناخته باشید.	but you civilized people, you ought to know us better than that.
باید طوری با سه که هیچ صدایی به گوشتون نر سه.	make sure your ears are completely covered
در ساعات گرم روز هیچ کدام در معرض تابش بیشتر آفتاب واقع نشوند.	no house got more sun than another during the hot time of day.
سر یکی از میزهای خالی نشستند و سرگرم پیشگویی رویدادهای ماه آینده شدند.	found a table, and set to work on their predictions for the coming month.
باید اعتراف کنم که در بهار چنین فکری مطرح شد.	I must acknowledge that there was such an idea last spring
چون جین یک شوهرخاله داشت که وکیل روستایی بود	her having one uncle who was a country attorney,
اما اینک باید یکی را انتخاب کنم و بدون هر یک از ایشان خوشبخت نخواهم بود	but now I have to choose, and I can't be happy without either of them.
اگه بخوای می تونم از ساعت هشت به بعد منتظرت به شم.	I'll be there waiting for you after eight if you wish.
مدام باید توقف کنم تا خون را از چشمانم پاک کنم.	I have to pause frequently to wipe blood from my eyes.
یا همزمان با این عملیات جنگی به خطوط مواصلات ایشان حمله کنند.	we should attack their line of communication.
تبر را به جعبه کوفت تا راهی باز کند.	driving the hatchet into the crate for a pry.
وقتی در نخستین برخورد در میدان جنگ کشته شوی	for suppose you are killed in the first engagement or skirmish
ولی حالا بدتر شد . بیشتر بدم او مد .	I think less of them now.
من هم یک زنجیر قشنگ بهت می دم .	I'll give you a chain for it
نه کسی به من در این باب منعی نکرده است.	I have received no orders on that point.
خوشا مردمی که استادانی دارند که حاضرند حکمت قرون و اعصار گذشته را به آنان بیاموزند !	have masters ready to instruct them in the wisdom of all former ages!
توانستند درباره مسئله کشیشی بیمارستان نظر یکسانی داشته باشند.	diverse minds were enabled to form the same judgment concerning it.
در حالیکه وانت قفل شده در کوچه و بیرون در پارک شده بود.	while the locked truck stood outside the door in the alley.
متأسفانه تا وقتی مطئن نشیم که مشکلی ندا ره نمی تونی سوارش به شی.	I'm afraid that is out of the question until we are certain that it has not been tampered with.
خانم سور بری چراغ کثیف و پر دودی را به دست گرفت	taking up a dim and dirty lamp
بدانم هر ابراز توجه شدیدی بی برو برگرد موجب سلب اعتمادش خواهد شد.	understand any strong sign of interest would be the surest way to stop his confidences.
ما به خودم ون می گیم گیاه خوار یه جوک بین خودمو نه.	we call ourselves vegetarians, our little inside joke.
هر کاری هم که عشقم ون بک شه می تونیم بکنیم	they do what they want.
زیرا این نفرت ناشی از خطایی بنیادی در درون خود او نبود	because that hatred did not come from his being bad
هیچ وسیله دیگری هم برای برآورد آن در دست نیست.	there are no other means of getting at it.
ده دوازده بچه هم توی همان اتاق دور میزهای کوچک نشسته بودند.	a dozen children were propped up at little side tables in the same room
آن زنان و مردان ساکت جزیره مانند در دیوار کار گذارده شده بود.	there these silent islands of men and women sat steadfastly , masoned into the wall
این آزادی و این دوری از وحشت و اضطراب برای ما بسیار گران تمام شده است.	I might say that we have paid for freedom.
می دونی که از خو نواده خوبیه و خیلی هم محترمه.	he's from nice folks, as you know, and he's honest.
وال که کج به پشت افتاده و حال کوسه دندان زن را به خود گرفته بود آهسته و با احساس دماغه قایق را به طول کامل در دهان گرفت	the whale obliquely lying on his back, in the manner of a biting shark, slowly and feelingly taking its bows full within his mouth
جز اینکه با آنان به عنوان داد و ستد یا دوستی و هم پیمانی درآمد و شد باشیم	unless upon the score of trade, or treaty
چندان میلی به این سفر نداشتم مخصوصا تک و تنها.	I feeltoo upset and uncertain about everything
یک دست کامل بشقاب و ظرف و سایر لوازم نقره داشتم.	I had an entire set of silver dishes and plates, and other necessaries.
مردمیکه درمورد چیزهای جزئی مثلا رنگ پرچم و چیزهایی ازاین قبیل باهم اتفاق نظرنخواهند داشت	fluoridation makes you sterile people who want one sort of flag things like that
آقای گریفیث منو مأمور کرده که بگردم شاید بتونم اینجا برات وکیلی پیدا کنم.	I was instructed to find an attorney up here tohandle this case for you, if I could
ولی ابداً در فکر ازدواج نبود زیرا نیازی به توجیه بیوه ماندن خود در جامعه نداشت	should have no thought of a second marriage needs no apology to the public
زیرا برای رد این مدعا دلایل بسیار وجود دارد.	there is much evidence to the contrary.
اگر باشد با یکی از مسافران آن کار دارم.	I want a passenger, if it is.
گرد آن نیز گودالی پر از گل و لای به عمق شش تا هفت پا و با عرض ده بیست پا به موقع بالا آمدن آب فرا گرفته است	surrounded by a muddy ditch, six or eight feet deep and fifteen or twenty wide when the tide is in
تا بتواند تمام دستورهای طبیبان را درباره بیمار دقیقا اجرا نماید	in order to be ready to carry out all the doctor's injunctions with precision
از آنجا که من هم از اجزای عالمم دوستی شما بر من هم کامل گردید.	I like every one
این مطلب به هیچ کدام از اشخاصی که در اینجا هستند مربوط نیست.	that isn't anything to anybody here.
سوم آنکه در مجامع عمومی از فساد دربار بنالد	the third is, by a furious zeal, in public assemblies
چرا با حال و هوای زمان و شاعران و عصر خود همراه شد	followed the leading of the climate, of the poets, of the age itself
جز دستبندی که دو سه سال پیش داده بود و توفیقی هم به همراه نداشت.	except a bracelet two or three years ago, which had not been a success.
من باید عارض بشوم از مغازه برای این کلاه برداری.	I should sue the shop for fraud.
در این حال باید به مردان اجازه داد که خود ضامن صحت مدعای خویشتن باشند.	for which, they are allowed to be their own vouchers.
به شرطی که به ده چهارده ساعت سر نزنه.	maybe your ten or fourteen hours.
باید درس به خونم تا در برداشتن اثر انگشت اوسا به شم.	I tought to take a course to be a fingerprint expert.
قوانین و طرز کارش مثل قوانین و کار جهان مرموز بود.	the laws and ways of its working no more than the universe to be questioned or understood.
نظم و نظام استان در حال حاضر کام لا به هم ریخته.	the civil organization of the province is at an end for the present
تو فقط سعی داری که از افراد گروهت محفاظت کنی	you just trying to protect the guys on your unit
در کنار پل چادری زده بودند که در جوار دیوارهای دهکده قرار داشت.	with a guard tent pitched under the shadowy village crested wall of the opposite bank.
دریاچه که از دو طرف تا بی نهایت ادامه داشت.	the lake stretching forever in both directions.
من از مردمی که سرش ون تو کار خودش ون نباشه بدم میاد .	I hates folks who can't mind their own bizness.
همه بسته و چفت شده و قفل شده بودند.	they were all shut, bolted, and padlocked.
بدینسان هر دسته خود را از دیگری ممتاز کرده است.	by which they distinguish themselves.
از سوی دیگر کشور نیاز به کاری بیشتر از پیش بر روی زمین داشت.	the country needed more intensive working of its land.
من رویه نقشه نگاه کردم تمام راه تپه ماهوره و باید از کنار یک کوه هم بگذریم	I seen it on a map, big mountains like on a post card, an' we're goin' right through 'em.
که او را به تئاترهای نوع خاص که آخرین نمونهٔ ذوق و ظرافت بود ببرد.	take him to certain eclectic theaters, the very latest thing.
از ای نرو خواستم افرادی که آن خدمات را انجام داده بودند ببینم.	desired to see the persons by whom those services were performed.
ولی با این پولی که می دی مشکل می تونی هم چین آدمی پیدا کنی.	you won't get it for the wage you're offering.
در مسافتی بیش از یک مایل در خشکی و سه میل با قایق در دریا تا روی کشتی هیسپانیولا	a mile by land to the beach, and thence three miles by boat to the HISPANIOLA
امشب چقدر دلم برایش تنگ شده. کاش اینجا بود.	I'm so fond of her too, bless her.
تا وقتی که به نظر همه رسید که این فهرست تا صوراسرافیل ادامه دارد.	till it seemed that the list would stretch out to the crack of doom
چطور ممکنه یه پسربچه ۱۰ ساله دیوونه به شه.	I think you just want to get rid of him!
تو باید کتاب را به او پس بدهی و او را وادار کنی تا آن را یاد بگیرد.	you should just give him the book back, and make him know it.
حامی منحصر به فرد من ویلفور است او هم در مارسیل نیست	since my only protector is removed
تا قرص خورشید بر فراز افق ایستاد و سرخی آتشین خود را وانهاد و روز پا دراز کرد.	until the sun stood above the horizon and the light lost its neonatal redness, became day.
در حقیقت درباریان نیازی ندارند به اینکه عمارات خود را ترک گویند یا از آستانه قصر پا به درون گذارند.	for the courtiers, without quitting their chambers, or the threshold of the court
من که به تو گفتم حاضرم هرچه بپرسی مو به مو جواب بدهم.	I have already told thee I will answer with all possible precision.
در افتادن با ملک همچو حریف زورمندی در حکم خودکشی بود.	it would be fatal to meddle with the property of such a power as that.
من زن شیرین و زیبائی را دوست دارم و او مرا دوست دارد.	I am in love with a charming woman, and she is in love with me
پسر من یک تکه حلبی است که بدان برق و جلا داده شده است تا به صورت نقره جلوه گری کند.	the other is tin polished to ape a service of silver.
به طور مشخص تصمیم گرفتم که آن را خرج کنم.	definitely I made up my mind that I'd spend it
من آرزو داشتم آن را وقتی دخترم بیست و پنج ساله شد به او بدهم.	I wish to pass it on to my daughter when she is twenty five
در این صورت از ما مکدر و رنجیده نشوید	you must not be angry with us if we go to extremities.
دست کم نصف مطلب در آن است که چگونه از این مدرک بتوانند استفاده کنند.	at least half the business lies in how you interpret them!
اینک نیز راه حل این معما را آماده دارم.	I have a solution ready
مردم شهر شما را در چنین مواقعی خیلی دوست دارم.	I like your public, even the _cancan_ public
بر فراز تمام صفوف پراکنده دشمن دودی پدیدار گردید و صدای رگباری به گوش رسید.	smoke appeared all along their uneven ranks, and musket shots sounded.
من یک اژانس خدمات برای خودم باز کرده بودم.	I opened me a employment agency.
با همین ظاهر آراسته بود که نزد جوانان محبوب شده بود	for the appearances of ladyhood won her popularity
در اتاق بزرگ کلبه روی بخاری آجری نشسته بود.	remained on the top of the brick oven in the larger room.
دستوری صادر کرد که دراگونها به شنیدن آن خبردار ایستادند.	gave an order, and the dragoons formed up in line.
اما شروع به ساز و صحبت از فردا صبح است.	but the violins will not begin to play until to morrow morning.
بلافاصله برگی چند از اکلیل کوهی را که در آن نواحی فراوان بود چید	gathering some leaves of rosemary, of which there was a great quantity there
اما دوست ندارم معاهده رو زیر پا بذارم اگر این کار در توانم با شه.	but I don't want to break faith with you if there is any way to avoid it.
ولی فقط به این جهت به دست فراموشی سپرده شد	which had been accepted for consideration
باهم بر اساس نسیه و اعتبار داد و ستد میکننند	dealing upon credit
این کلمه را طوری ادا کردم انگار استنطاقی روزانه و کسل کننده بود.	I say,trying to sound as though this is some boring, everyday enquiry
به طور مبهم تخت خوابی را در گوشه اطاقتشخیص دادم	I dimly perceived a bed in the corner
یکی از آن دو آهسته بر دهانش نواخت و دیگری بر گوش راستش	one of them gently struck his mouth, and the other his right ear
ولی در عین حال به این جوان خیلی علاقه دارد.	he is so very great a favourite.
اینک سه کتاب دیگر که هر سه با هم بد ستم آمد.	here come three together
استروو را در نظرمجسم کردم که با پاهای فربه و کوتاه خود خواسته بود پابپای بل انش راه برود.	I imagined him with his fat little legs trying to keep up with her.
همیشه نزدیک به نصفش ون کم میمنوند غرق به شن.	half of 'em like to drowned.
اگرچه من هم یکی از وامخواهان او هستم اما مناسب من نیست که از برای ده دوازده هزار فرانک که طلب دارم از حالت تجارخانه ایشان حرفی بزنم و سخنی بگویم	but it is not for me although I am a creditor myself to the amount of ten thousand francs to give any information as to the state of his finances
ترجیح می دم با این جور مسائل قاطی نشم چون بعدا ممکنه مشکلاتی پیش به یاد.	cause I'm pretty well known around there and I wouldn't want to be mixed up in it in case anything went wrong, you see.
من او را بیش از هر کسی دوست دارم!	I love her more than anyone,
تلفن را از کیفم بیرون آوردم و روشن کردم	I hastily pull it out and press green.
در این شهر کمی پیش تر از سه هفته به سر بردم و در پایان سه هفته بود که از صد هزار فرانکم دیگر چیزی باقی نمانده بود	I spent a little over three weeks there, and, during that time, saw my hundred thousand francs come to an end.
البته با یک شرط که قبل از مرگ او نباشد.	on the one honorable condition that it not take place before his death.
آخ چه بسیار زمانی است که من بیچاره اینجا محبوسم	I have been here so long
یک همیان زر که سر آن گشاده است بردست راست و شمشیری که در نیام است بدست چپ دارد	with a bag of gold open in her right hand, and a sword sheathed in her left
تا حالا هیچ وقت ندیده بودم کسی این قدر خوب چنین موضوعی را تشریح کند.	I have never listened to a more illuminating exposition of the subject.
با این حال دیگر از این تصمیم خود دلشاد نبود.	but he was no longer happy with his decision.
به جمعیتی چشم دوخته بود که در دوردست در اطراف یک چوبه دار جمع شده بودند.	, surveying a distant crowd surrounding a gallows
برای این که به قول معروف دیر از هیچ بهتر است.	because, better late than never.
هنوز این مسأله را به دلخواهم حل نکرده بودم	nor was that problem solved to my satisfaction ere
لازم بود که شش دو رف جوان او را از جا بلند کنند.	it took six young dwarves to lift him.
این محکومیت برخلاف آن بو دکه خانواده شان به هر نحو شده برایشان معافیت از خدمت وظیفه گرفته بودند.	this despite the fact that their family had somehow managed to obtain them exemptions from the draft.
خواست بفهماند که آنجا برای کودک جای نرم و راحتی است.	told him to lie down there, and rest himself.
که کنت پیر او را در خیابان دید و به خانه خود کشید	whom the count had met in the street and dragged home with him
فکر کردم شاید دوست نداشته باشی من باهات غذا بخورم.	I thought you mightn't like me to have my meals with you.
در جائی دور افتاده به خاک کنند تا فساد نپذیرد	bury it in distant parts, to prevent infection
کشیش به اختصار از مبنا و علت جنون پهلوان یاد کرد	given him by the curate, who described to him briefly the beginning and origin of his craze
چون کسی این حق را ندارد که کنار میز قمار به عنوان یک تماشاچی ساده و بی اینکه دستش را به جیبش ببرد بایستد.	since merely to stand looking on thus occupying a gambler's place for nothing was not permitted .
تا وقتی که در حدود بیست قدم از طول تیر ناپدید شود.	until some twenty feet of the pole have gone down.
شوهرم اصرار کرد که بمانیم و ببینیم چه شده.	let's stop and see the fun.
در عین حال روشن بشود که واقعاً چه میزان مراوده و دوستی برای آینده مناسب است.	give the most decided proof of what degree of intimacy was chosen for the future.
درست مثل این بود که جاروبرقی عظیمی را در بستر رودخانه بکشند.	as though an immense vacuum cleaner were moving along a riverbed.
به طریقی که قبلاً هرگز به چیزی نگاه نکرده بودم.	in a way I'd never seen anything before.
به تنه کشتی بزرگی که تازه بر خط ساختمان نهاده شده باشد	not a little resembled the hull of a great ship new laid upon the stocks
توم گفت احتیاج نداشتی که با آن از زندان فرار کنی.	he said I didn't need it to get out of prison with
من نشستم و از تو هم تقاضا کردم بنشینی	I sat down and asked you to sit down
مرد جوان منتظر بود پدرش ماشین را به او تقدیم کند.	the young man awaited signs that his father had purchased the car.
متأسفانه آن را به مساحی ارزیابی و پیشکاری افزوده بود	he had unfortunately added to his other avocations of surveyor, valuer, and agent
فردا جنازه او را با تشریفات با شکوهی در همان جا که گفتم به خاک خواهند سپرد	to morrow they are coming to bury him with great ceremony where I said.
که صرف تماشای آن فرمانده خمیازه کش به واسطه نیروی محض تضاد مثل سحر بر جاشو ان مؤثر بود.	that the mere sight of such a yawning commander, by sheer force of contrast, acted like a charm upon the crew.
با دادن سهمی که حقش است دیگر انگیزه برای قبول آن پیشنهاد را ندارد.	the giving him his true place and his true share would set aside any motive for his accepting it.
مگی در احساسش نسبت به او خیانت کرده بود.	she had betrayed what she felt for him.
ژنرال که به کلی خود را باخته و لرزه بر اندامش افتاده بود با لکنت زبان چنین شروع به صحبت کرد.	stammered the disconcerted old man.
دیدن این که مادر و پدر و خواهر و دوستانش کشت شدند.	watching his mother, father, sister, and friends murdered.
چند خط از کتاب را تقریباً به یاد دارم.	I remember more or less how the passage went
اکنون بی صدا روی دفترچه مدالیون مانندی که به منظور ضبط طول و عرض جغرافیایی محل کشتی در هر روز در قسمت بالای پای عاج او نهاده شده به محاسبه مشغول است.	is now mutely reckoning the latitude on the smooth, medallion shaped tablet, reserved for that daily purpose on the upper part of his ivory leg.
در غیر این صورت ممکن بود مرا به لاکت برساند.	he must have the packet or he'll cut his throat afterwards.
بیهوده منتظر بودند علایم ترس و بزدلی را در قیافه یکدیگر بخوانند.	each vainly trying to detect signs of cowardice in the other.
فقط ای کاش آسیب زدن به خط ریل آهن هم به همین اندازه دشوار بود.	I only wish the railway was as difficult to touch.
اسکناس را از جیبش درآورد و آن را لمس کرد.	he took out the bill, and fumbled it for a moment
سرش را به سرعت برگرداند ولی لبخندی به لب آورد و از گوشه چشم نگاهی به او انداخت.	she turned her head quickly but smiled provocatively at him out of the corners of her eyes.
اما ناگهان در فاصله بیست متری کشتی در توفانی از آب فرو رفت و چنان از دیده ناپدید شد	but suddenly going down in a maelstrom, within three rods of the planks, he wholly disappeared from view
اون شک داشت که من احساس ضعیف سپاسگزاری نسبت بهش رو داشته باشم.	he must suspect that I would be starting to feel the first faint stirrings of gratitude about now.
بلکه وظیفه داشت تا شرایط تسلیم را نیز پیشنهاد کند.	but also to offer terms of capitulation
به این ترتیب دو رفیق صمیمی از همدیگر جدا شدند.	so the amiable couple parted.
که ممکن بود که این اعتراف مهر مادری را بالمره از دل فرزندی زایل نماید اما نتیجه خیر داد و عمل را به وجه احسن ختم نمود.	capable of destroying forever in that young man's heart every feeling of filial piety.
او مجبور است که تنها تایید کند و اطاعت نماید	she had only to submit and obey.
آن روز فهمیدم چه مصیبت بزرگی بر سرم آمده و با چه بدبختی عظیمی باید بسوزم و بسازم.	I knew then what I had done, what I had married.
ضمناً به او قول داد که در همان جا منتظر بازگشت او بماند.	promised to bide his return on the spot of their parting.
والا ممکن است حالتان بدتر از این هم بشود.	if not, it will go from bad to worse.
چون وقتی نزدیک شدیم اصلاً سر خود را بلند نکرد.	for he never lifted his head as we approached.
صرفاً یک سروان سوار نظام بود که اجازه داشت هر چه میل دارد مستقل باشد.	was simply a cavalry captain who was readily allowed to be as independent as ever he liked.
بانوان او حتی وقتی به رشد کامل برسند بیش از یک سوم جثه وال نر متوسط الجثه را واجد نیستند.	even at full growth, are not more than one third of the bulk of an average sized male.
فقط دیدم که خم شد و چیزی را در سینة او گذاشت.	I saw her stooping over her, and putting money in her bosom.
به جلوی اسواران تاخت ولی هنوز فرمان نداده بود	galloped to the front of his squadron
تازه اصرار هم کرد تا بگویم اصلاً به هیچ چیز احتیاج ندارد.	moreover, she insisted on her saying, that she was not at all in want of any thing.
در مورد تشخیص نوع کار انسان من به چنین اصطلاحاتی قائل نیستم.	I don't understand such expressions to describe human activity.
با اره کردن در صندوق سوراخی پدید آورد تا بتوانند مرا بیرون کشند.	saw a hole in the cover, large enough to pull me out.
اما تغییر فکر داد و با فریادی گوش خراش یکی از روستاییان را احضار کرد.	but on second thoughts he shouted peremptorily to the peasants instead, and beckoned to them to come up.
از بلندی شنی بپائین بدود تا بوق مه را بکار اندازد و بم وقع بازگردد تا انفجار خمپاره را ببیند.	trot down the spit a short way to actuate the foghorn, and be back in time to watch the mortar explode.
دست کم این استعداد بسیار عالی و خوشایند را از آن به ارث برده بود که از هیچ همه چیز بسازد.	she appeared to have innately derived from it that ability to make much of little means, which is one of its most useful and most agreeable characteristics.
اما حتی در وهلهء ایجاد زخم نیز هیچ طبیب حاذقی قادر نبود که جان او را از مرگ برهاند	but no skill could have saved him if it had been looked to without delay.
به زن خود در آن هنگام که من گرم صحبت بودم گفت	for he had a profound veneration for my abilities, and informed his wife in my hearing, on that very occasion,
پس از آنکه هفت بار پیشانیم را بر زمین کوفتم	then striking my forehead seven times against the ground
بقسمیکه چون دهقان بار دیگر حالش را پرسید و از دردش جویا شد	so that when the peasant again asked him how he was and what ailed him
نظریه خود را درباره عرصه کارزاری که ندیده بود به بار کل ای گزارش داد.	as unsuitable from every point of view, the battleground he had not seen.
همه سر و صدا با این مکان حالت آرامش بخشی داشتند.	the very noises all around had a heart of peace within them.
به دنبال این جمله نامه را به آرامی در آن دستش که بر روی زانوان قرار داشت نهادم.	I said, gently inserting it in one hand that rested on her knee.
من واقعا نمی تونم که این جنین چی میخواد	I can't figure out what it wants.
برای خاطر تو بود که من در گذشته آن همه دچار ناراحتی شدم.	I have borne all this for you already
از زیر پیشخوان صدای طبلی که توسط او جا به جا شد به گوش رسید.	the jar of a drum was heard as she moved it at her feet behind the counter.
این بود که آمده و در تالار مزبور منتظر او بود.	who had immediately obeyed his daughter .
بر حسب اتفاق جائی در کنار دریا توقف کردم.	I stopped, by chance, at a place by the sea.
مثل این که دی گه خطری تهدیدم ون نمی کنه.	I think we'll be okay
آدم که نباید خودشو به اون راه بز نه.	then cast at them those furtive glances I've always thought the height of indecency.
درست مثل پیچ و خم زدن در زیر آب.	as if she were moving under water.
رفتار ژان وال ژان را چندان تغییر داده بود	all this, without his being aware of it, had altered JeanValjean's walk
تا آن که فقط برای یک لحظه یک عبارت به وضوح شنیده شد	then all was quiet for a moment, and one word rang out clear
هرگز تصورش را هم نکرده بود که تجارت با رستگاری آخر وی ارطباطی داشته باشد.	he had never conceived that trade had anything to do with the scheme of salvation.
مسن تر سرسخت تر به شکلی مرموز ساکت و خاموش	older, harder, mysteriously silent
من بایستی فوراً حرکت نمایم. گرچه ممکنست الان دیگر خیلی دیر شده باشد.	I shall go at once, but it may be too late.
زیرا اگر یکی از پاهای عقب من بلغزد قطعاً بر زمین میافتم.	for if either of my hinder feet slipped, I must inevitably fail.
خودتو نو از شر این پس ره خلاص کن ین.	you've got rid of him for good and all.
داد کشید و بی آن که احتیاجی باشد راه را با انگشت نشان داد.	he cried, needlessly indicating the direction.
برای نشان دادن بلندی فکر او نیازی به این همه تمجید نبود	no other laudation would have been requisite to impress upon me the superiority of her understanding,
ولی آکنده از نوعی شگفتی بود که چگونه ممکن است چنین چیزهایی وجود داشته باشد	but just with a kind of wonder that such things could be.
که در آخر جادهٔ اسرارآمیز زندگی من نمایان شده است تا برخی نکات را به من یادآور شود	mysteriously come back to me at the end of my pilgrimage, as a reminder and an inspiration.
بلافاصله از پرستار پرسیدم که پس ره یا دخت ره.	I asked the nurse right away if it was a boy or a girl.
طولی نکشید که بدون راهنمائی چندانی از جانب کلاید یا دیگران به همه شگردهای کار مسلط شد	soon mastering without much advice of any kind all the tricks of the work
با این همه برای آقای لاری غرابتی خاص داشت.	but he observed it as a curiosity.
آن را بکا رهائی که سود همگان در آن باشد اختصاص داده بودند.	therefore had been applied to common use.
تنها امیدوار بود خداوند همراه با آن همسرش را مورد عنایت خاص خود قرار دهد.	only hoping that it might be attended with a blessing.
اما نه بوسیله آن کسانیکه در شهر باقی مانده بودند بلکه بوسیله کسانیکه شهر را ترک کردند.	, but by those who had abandoned it and not by those who remained in it.
تا دیدرس حیاط سنگفرش و پلکان مهتابی قصر پیش آمده بودند	strayed within sight of the great stone courtyard and terrace staircase
اینست که او در آن روز راه خود را یک راست در پیش گرفت و رفت تا به هنگام غروب خود و یابویش از خستگی و گرسنگی از پا درآمدند.	is that he was on the road all day, and towards nightfall his hack and he found themselves dead tired and hungry
البته این توهین به خر من شده است ولی من ترتیبی خواهم داد که این حیوان اختیار انتقام گرفتن را به اراده من واگذارد	besides, I will arrange it with my ass to leave his grievance to my good will and pleasure
که شاید در آن موقع خطر اردو کشی به روسیه مفهوم و آشکار بوده است	that the danger of the campaign was even then understood.
دخترک بای تو کیه کپه زخم بند ساخته است.	she has made heaps of lint
ولی صرفاً به خاطر این که زندگی توأم در همان خانه را ادامه دهند.	but insofar as he continued to live in the same house with her
نان را نگه داشت تابعدا بوسیله آن طعم ترشیدگی میوه را از دهانش بزداید.	saving the bread for last to take that slimy, fruity taste out of his mouth.
منظورم این بود که محال است بگویم دیگر کاری به کارت ندارم.	I only meant that I should never decline to know you.
زیرا جز بدین نیرنگ ممکن نبود حرف خود را بکرسی بنشاند.	for if he had not observed this precaution he would have been unable to bring him to reason.
فقط در این موقع بود که با تأسف زیاد از جستجو دست کشیده و به خانه برگشتند.	even then, they gave it up with reluctance.
من در آب پریدم و او را بیرون کشیدم.	I was a young boy
فراموش نشود که دو و نیم یارد پارچه آستری لازم است.	don't forget 2 1/2 yards casement cloth.
کاری که من خیال دارم به زودی انجام بدهم و خوش و خرم زندگی کنم.	as I mean to, in the very next leap year
دشمن پیوسته کوشش دارد آن را از چنگ او به در آورد.	that enemy all the time striving to wrest it out of your clutch.
اما من از او کناره گرفتم تا نشان دهم به آشنائی با او رغبت زیادی ندارم.	but I didn't go up to her, as though I disdained her acquaintance.
راه یابد و چنین قدرت و مقامی را کسب کند.	who was neither an educated man nor a courtier
با همین وضع دخترک را به وسط اطاق کشانید	dragged her into the middle of the room
به هیچ وجه صلاح نیست به خانه وی برود.	it was entirely out of the question.
همان کسی که همین چند سال پیش گوشی را برای پزشکان اختراع کرد.	the man who gave us the stethoscope, not so very many years ago.
می دون ستم که احساس قوی تر شدن احساساتم نسبت به او خیالات نیست.	I knew it wasn't my imagination that my need for her was stronger than ever.
در اینجا و در این احوال تأثیر دیگری بر او گذاشت.	still here, under these circumstances, affectedhim differently.
آمد و به ایشان اصرار کرد که به تماشای مراسم کشتن گناهکاری بروند	came and pressed them both to see an execution
من در او چیزی ندیدم جز اینکه صدای دل پذیری داشت.	I noticed nothing about her except that she had a pleasant voice.
مثل اینکه همین الان اسمشو تو این صفحه دیدم.	I think I saw his name in here a minute ago.
اما قادر است تا یک رشته افکار یا مظاهر را انتخاب نماید و تمام توجه خود را در اطراف آن افکار و مظاهر متمرکز سازد.	but has the power and will to select one sequence of thoughts or events on which to fix his whole attention.
فردی که چندان از اسرار حیات بی خبر نیست.	some one who knows something about life.
صدای بلند واضحی از طرف اتاق نشیمن در هال پیچید.	a voice came loud and clear from the dining room across the hall.
ده سال پیش همین روز بود که پدرت را از مرگ خلاصی دادم	it is ten years to day since I saved your father's life
ولی هنگام مرگ خود از اسرار آن و منافع شما برایتان مطالبی را به زبان آورده است.	leaving the secret and the gain to you at her own death.
تصور مکنم اینکه من از بی روحی او اندکی خشمگین شده بودم ابتذال خود من بود.	I suppose it was commonplace in me that I felt slightly outraged at his lack of spirit.
قلبم دو بار تپید و بعد یک بار دیگر به آرامی زد.	my heart galloped toward its last beat.
سراسر آن مکان حالتی حزن انگیز و غم افزا داشت.	the effect of the whole place was mean and melancholy.
مدتی پس از آن پنج شش تن از جاویدانان اعصار مختلف را دیدم	I afterwards saw five or six of different ages
توی بازوان مهربانی که به رویش گشوده شده بود خزید.	feeling that the hungry longing was satisfied at last.
آن انتظار را هم به حساب از دست رفتن وقت نگذاشته بود.	not count the tedious time as loss, either.
که زیرانداز حصیری که دوباره بر آن خوابیده بود و روانداز کرباسی که روی او را پوشانده بود برای همیشه از حیز انتفاع افتادند.	that the rush mat on which he had thrown himself and the canvas blanket he had covering him were fit for nothing afterwards.
رای نخستین بار دربارهٔ نیک بختی افراد صحبت کرد.	for the first time it has become possible to think of the happiness of men.
در میان راه وضعیت ملک عمویش را برای او شرح دهد	after making her fully aware of the situation concerning the management of the estate.
هوس کرد که به اتفاق شاه بانو و شاهزادگان اعم از پسر و دختر با من ناهار بخورد و خوش داشت که این کار را لذت بردن بنامد.	desired that himself and his royal consort, with the young princes of the blood of both sexes, might have the happiness, as he was pleased to call it, of dining with me.
در وضعیتی که هریت داشت این ملاقات ممکن بود خطرناک از کار در بیاید.	in her present state, would be dangerous.
صورتم را برگرداندم و صورت او را نیز کنار زدم.	I turned my face away and put his aside.
در حالی که درختان تیره سرخ دار خاموش و افسرده مصاحبش بودند	where the dark yew trees gave him a mute companionship in melancholy
تا بیچارگی خارج از حد و رور مردها را اندازه بگیرید.	you shall measure the extent of man's pitiful vanity.
با دقت تمام بر مخاطب جوان و زیبایش دوخته شده بود.	were attentively upon her young companion.
این کار چنان دشوار بود که او حاضر نشد انجام آن را به شخص دیگری بسپارد	a tricky operation she would entrust to no one else
قصد کرده بودم که با اولین فرصت آنجا را ترک کنم.	resolved to leave it with the first opportunity.
آنا به طور غریزی بلند شد تا به ربرتا کمک کند و مانع از افتادنش شود.	had risen instinctively to tryto catch her and stop her fall.
وسط لب بالا به شکل منقار طوطی درآمد.منقار کوچکی که روی لب زیرین تکیه کرده بود.	that a little parrot's beak in the middle of his upper lip stuck down over his under lip.
او سر به هوا بود و کمی پریشان حواس.	he was clumsy and a little absentminded.
اعضاء این حزب بر طبق قانون از داشتن پیشه و کار محرومند.	the whole party rendered incapable by law of holding employments.
از مشاهده این حال چنین استنباط کردم که اگر ساکنان آن سرزمین دارای عقل و هوش کافی باشند	concluded with myself, that if the inhabitants of this country were endued with a proportionable degree of reason
ولی اون قدر گرفتار عشقه که به این کارها نمیر سه.	but he's too busy messing around to get down to her.
که مثل شاگرد مدرسه درسشان را حفظ کرده بودند.	coached to the throatlike school boys.
عملیات جنگی کم اهمیتی بود که با جریان اصلی نبرد هیچ ارتباطی نداشت.	were actions distinct from the main course of the battle.
یکی دو دست کاری دیگر لازم داشت تا خیلی خوب از آب درآید.	a happy touch or two secured success.
قادر به وصف کردن تاثیری که این منظره در روحم گذاشته است نیستم.	I cannot say what an impression this made upon me
معلوم نبود چگونه این شغل را به دست آورده است.	how she ever got her present job was a mystery.
هیچ مهمانی هم نیامد که رفتن به سالنِ آب را عقب بیندازد.	no visitors appeared to delay them
پیش از اینکه حریف فرصت دفاع بیابد غلبه بر او را تأمین خواهد کرد.	win the victory before the foe has time to defend himself.
اگه خود منم بودم نمی تونستم بهتر از اون این کار رو انجام بدم.	I myself could have done no better.
که بی شک برخلاف میل خود در آنجا است	where no doubt she is kept against her will
حال که از حالت و حکایت من مطلع شدید	now I have told you of my love and my hopes
به عبارت دیگه ما امیدواریم که با انتخابات این کمیته رو برای یه ً دوره کامل حفظ کنیم	see our committee stand for election to a full term
تصویر زشتی که از دسیسه و جنایت یکی از خویشاوندان بلافصل ایشان در میان مردم تسلیم شده بود	completely overcast and charred by this awful public picture of theplot and crime that one of their immediate blood had conceived andexecuted!
بر حسب علائمی که از فوت او ذکر کردند او نیز مسموم شده.	what I heard of his symptoms agrees too well with what I have seen in the other cases
ولی از ناتوانی خودش در این مورد دلگیر نبود.	he never felt his own lack.
از وقتی برق رفته به زحمت می تونم بخوابم.	I can hardly sleep nights since the power went off.
ولی از برنامه عقب است یا دچار نوعی اشکال گردیده.	but late, or in some kind of trouble.
پس رفتار معتاد خود را در پیش گرفته و به آرامی روان شد	he resumed his ordinary pace
بلکه به لحاظ فرم باید چنان دقیق و محاسبه شده باشد که موجب جلب توجه و حیرت مخاطب و شنونده شود.	but in its form it is calculated to excite a certain amount of wonder and attention.
هری سعی کرد نیزه را از دست او دربیاورد	he tried to pull the spear away from the merman
همه متوجه شدند که او پر از خبر است	they all recognized a person crop full of news
در همان موقعی که روی چوب بست دراز کشیده و منتظر است تا وی را محکم ببندند.	while the wretched man is still standing on the scaffold, preparatory to placing his neck on the block.
اگرچه من مردی خودخواه نیستم و بعلاوه میدانم که وظیفهٔ من مبنای قضائی ندارد	but as economy is my favourite virtue, and I know this is not a case in which the law can intervene
زیرا یقینا دوستی در آنجا بود که شما را مهمان کند	however, for there was pretty sure to be a friend who would treat you
راست است که حال شوهر شما خوب نیست ولی امیدوارم که خطری در کار نباشد!	I'm afraid you must be prepared for a great shock!
که از بخت خوش بر وی فرود آمد و از پا درافتاد.	that I knocked him down
تنها شانسی که امروز آورده بودم که او اولین کسی بود که به ما رسید.	the only luck today that he was the first through to us.
او چشمان خاکستری رنگ سرد و بی اعتنایی داشت و لبخندی تصنعی بر لبانش بود.	with cold gray eyes and a wary smile.
اون نیز پس از مدتی طولانی بالاخره آفتابی شد	who after a delay that seemed interminable, at length presented himself
به کارگاه سری بزند و به سراغ مشتریانش برود .	drive to the mills, call on customers.
من تشکرات خویش را نسبت به اظهار لطف آنان ابراز داشتم و ضمناً نگرانی و هیجان خاطر خود را از فراق بیان کردم.	I expressed my sense of this commendation, and said I was very sorry we were going to lose one another.
امّا بعد از ظهرها طولانی بود و خستگی آور.	but the afternoons were long and dreary.
یا فرصتی به یارانش بدهد که علاجی برای جنون او بیندیشند.	or there might be an opportunity of discovering some ready remedy for his madness.
به درستی نمیدانست که در ملک محبوبش چه کاری شروع خواهد کرد.	hardly knew what undertakings he was going to begin upon now in the farm work that was so dear to him.
به نظر من ما فقط پنج دشمن داریم که باید باهاشون روبرو شیم.	I think we only have five enemies to deal with.
در سلولت خواهم نشست و با هم فکر خواهیم کرد. دستت را در دست خودم خواهم گرفت.	sit in his cell and plan with him holding his hands
بی حرکت روی سکو ایستاده بود و می کشیود به یاد او رد که چرا به آن جا آمده است	she stood on the platform, trying to think what she had come here for
زن هم از انتظار کشیدن برای او خسته شده	she had become tired of waiting for him
شمشیرش را به یک سرباز هوسار آلمانی تسلیم کرد و او شمشیر را گرفت و اسیر را کشت.	surrendered his sword to a huzzar of death, who took the sword and slewthe prisoner.
زن به تالاری گود افتاده که روی میزهای آن کرباس مشمع به جای سفره گسترده بودند راهنماییش کرد.	she led him to the public room where there were tables covered with waxed cloth.
هرگز نشنیدم راجع به کسانی که آثارشان شباهتی خاص با آثار خود او داشتمثلا سزان.	I never heard him speak of those whose work had a certain analogy with his own
اما ریسمانی آزاد به افسار اسب او متصل بود	but a loose line was attached to his bridle
همچنانکه واضح است که اگر در مهره بازی من یک مهره کمتر از حریف داشته باشم	as it is that if when playing draughts I have one man less and go on exchanging
که مردی چون کلاید ولو برای یک ساعت هم شد به او تعلق پیدا کند.	even for so much as an hour, assuming that he would, she would welcome and that most eagerly.
با کمی تلاش لبخندم را سر جایش نگه داشتم.	I held my smile in place with a bit of effort.
با احتیاط هوا را از بینی به داخل کشیدم.	I inhaled carefully through my nose.
ولی من یکی دی گه نمی تونم رفتار تو رو تحمل کنم!	but I will not tolerate your behavior!
پس کیسه را به جانب او انداخت و از اتاق بیرون رفت.	he threw the purse to him and ran out of the inn.
این ناراحت کننده تر ین احساسی بود که ممکن است به انسان دست دهد.	the most dismaying and unmanning kind
فی الحق یقه اندوه و درد از حد تجاوز کرده است.	although the cup of sorrow seems already full
والدین این عده به نظر من از او دسته افرادی هستن که خوب پول می دن.	the parents of that lot are what I call the good payers.
خاطرش از جمله جهان هرچه در اوست فارغ بود.	he thought he had done with this world.
زیرا اگر او را پیدا کنیم و از قضا صاحب پول خود او باشد	for, if we find him, and he happens to be the owner of the money
در حال حاضر من قدرت و قوت شنیدن هم ندارم.	I have not strength or spirits now.
هرچند هم از دشواری این کار بیمناک بود و هم از صحت اخلاقی آن اطمینان نداشت.	although not without some misgivings as to the difficulty as well as the decency of it.
به دختری که تا دیشب او را هرگز ندیده بودم.	whom I had never seen till yesterday .
از او خواستم به نام سعادت جاودانی برایم آوازی بخواند.	entreated him, for the love of heaven, to give me a song.
اما گمان دارم که تمام این مسائل تغییر کند.	yet I think this will all pass off
دانکلار از غیظ سینه خود را با ناخن خراشید	almost digging his nails into his breast
او را بر آن داشت که اینک قسمتی از قشون را به آن سوی مرزها حرکت دهد	has now decided him to despatch part of the army abroad
فیلچ به سمت قلعه برگشت و نور چراغش در تاریکی ناپدید شد.	he turned and started back toward the castle, his lamp bobbing away in the darkness.
اینک از این دقیقه همسر این مرد بیگانه و عزیز و عاقل هستم	as everybody called me, is it possible that I am now to be the wife and the equal of this strange, dear
چون دولت ناپلئون منقرض گردید آن انگلیسی را به توسط خویشان و پیوندانش از محبس بیرون آوردند	but had been released from prison during the second restoration was possessed of a diamond of immense value
شالی به خودم پیچیده و در کنار بخاری دایه خانه نشسته بودم.	sat wrapped in a shawl by the nursery hearth.
قبل از اینکه کاملاً وارد اتاق شود جیغ کشید	gushing before she was all the way through the door.
آخری آن مرد جوان روی صندلی زهره ترکش کرده بود.	for that young man on the seat had given her quite a turn.
سپس نشستیم و منتظر برنج و گوشت قیمه شدیم.	while waiting for the hot stew of meat and rice.
اما وقتی چنین کاری از من خواسته شد با میل اطاعت کردم.	but when told to do it, I was disposed to obey.
لکن شروع به قدم زدن در اطاق نمود تا خوابش نبرد.	but got up uneasily and walked across the room to shake off his drowsiness.
همچون دوران کودکی کله سخت و بی موی عروسکش را غرق بوسه سازد	has begun by showering kisses on the hard pate of her bald doll
سپس کاترین با نشاط و خوش دلی بچگانه سوار کره اسبش شد و به راه افتاد.	she sprang up as gay as a fairy, sheltered by her wide
او را تلوتلو خوران به کنار دیوار پرت کرد	caused him to stagger to the wall
من با کمال میل حاضر بودم بفرست مش امتناع کرد	I would gladly have placed him
فحش آبداری داد و گفت و لم کنید بخوابم.	he ripped out something brisk, and said let him alone.
روی جعبه ساخت تایوان ح ک شده بود جعبه را ازپرتگاه پائین انداخت و به دست باد سپرد	stamped MADE IN TAIWAN away indifferently for the wind to take
من یک حیوان وحشی بودم و نسبت به او مخالف رحم و شفقت رفتار کردم.	I was a beast and cruel to him.
به هر جهت او را بدترین وضع و ریخت دیده بود	somehow or other he saw her now at her worst
در واقع چشمی تیزبین و گوشی حساس برای تمام جریانات بود.	was said and sharp ones, too.
بر خود فرض دانست که در این باره شخصا از او تشکر کند.	made it his business to thank his personally
در همین ضمن دیدم که رنگش پرید و جای زخم کشیده شد.	when I thought her, for one moment, in a storm of rage
اما در این هنگام کنجکاوی بر او استیلا یافته بود.	but then curiosity got the better of him.
بالاخره که به بستر رفت هیچ چیز حل و فصل نشده بود.	she went to bed at last with nothing settled
دستش را باز به سوی جیب محتوی تپانچه برد البته این حرکت او بسیار پرمعنی بود.	rapped the side pocket with his fist, in a significant manner.
با آن گردن لاغر و چشمانی چون گربه گرسنه و لباس مندرس!	she with her scrawny neck and hungry cat eyes and raggedy dress!
چنانکه تا چند ساعت دیگر ممکن است او را ببینیم.	as will be seen before many hours are over.
نخست آنکه وکیل من که تقریباً از گهواره مدافع باطل بار آمده است وقتی که بنا باشد از حق و عدالت دفاع کند مانند اینست که برخلاف مقتضای طبیعتش رفتار کرده است	first, my lawyer, being practised almost from his cradle in defending falsehood, is quite out of his element when he would be an advocate for justice
این دسته صاحب نظران امور جنگی بودند و عقیده داشتند که علم جنگ وجود دارد	military theorists who believed in a science of war with immutable laws
یا آن قدر بد کار کند که پدرش را دلسرد سازد.	or as badly as possible, and would discourage his father.
حالم به هم خورد و سرم به دوران افتاد.	I felt sick at myself, sick and disgusted.
باید به تو اخطار نمایم که من مسلح هستم.	I must warn you that I'm armed.
هر پدری وظیفه دارد به پسرهایش امکان تحصیل بدهد.	it's a father's duty to give his sons a fine chance.
او به خود گفته بود هر گاه همسرش دریابد به تحریک من توجهی نکرده	he fancied now if she heard of it that if he submitted to be insulted by me
هر چند به طور موقت به نحو کامل یا قسمت بیشتر آن از هر گونه ارتباط با هر چیز که حال وحشت بدان بدهد بری باشد	though for the time either wholly or in great part stripped of all direct associations calculated to impart to it aught fearful
غش غش خندیدم و سزیع خودم رو جمع و جور کردم	I give a snort of laughter and hastily stifle it.
در دامن کاترین آویخت و از او خواهش کرد لااقل نیم ساعت دیگر هم بماند.	he begging she would remain another half hour, at least.
که دخترک کارهای دیگری از او انتظار دارد آنهم به همین زودی.	that she was expecting him to suggest a further step and soon.
قبلاً هیچ گاه چندان به این موضوع فکر نکرده بودم.	I'd never thought so much about it before.
هنوز مجرد و از تأهل دورتر از همیشه بود.	he was still not married, and was further than ever from marriage.
یادم است که وقتی فهمید پدرم چه قدر استطاعت دارد	I cannot forget that, when she first knew what my father would do for them
از من اطاعت کنی و خود را بی جهت پیش نیندازی.	to obey me and not shove yourself forward anywhere.
زیرا با واقعیت به هیچ روی وجه مشترکی نداشت.	for it was quite out of touch with the facts of the case.
به مین خاطر قطعه اول را تکرار کردو بازایستاد.	so he repeated the first verse again and quit.
برای این که فضای جادویی این جا خیلی خیلی قویه.	there's too much magic in the air.
هیچ دلیلی هم ندارید که مرا دوست نداشته باشید.	you have no reason to dislike me
از خرجین خود دو تکه قند گرد گرفته خاکستری رنگ بیرون آورد	he pulled two dirty grey pieces of sugar out of his pack
بار دیگر سرخود را در میان دو دست گرفت.	clasped his head again.
ولی بنا به دلایل قانونی و اخلاقی از ذکر منبع معذوریم.	but, for legal and ethical reasons, we can't reveal the source.
در این اثنا پیشخدمتی در آستانهٔ اطاق دفتر نمایان شد و به شاهزاده گفت	announced the footman, appearing at the door.
چون او به طور کلی در صحبت کردن با جاشو ان خود طریق خاصی داشت	because he had rather a peculiar way of talking to them in general
شایعات مربوط به رقیب ثروتمند و چنان کنجکاوی بی حسابی در میان مردم برانگیخته بود	as well as thee vidence of her rich and beautiful rival
چشمان حریصی داشت که پشت عینکی مدور با قاب فلزی روشن پنهان بودند	his eyes avid behind round spectacles in silver frames
چنانکه گویی آن رنگ پریدگی نشان واخوردگی آن جهان و وحشت مرگ در این جهان است.	as if indeed that pallor were as much like the badge of consternation in the other world, as of mortal trepidation here.
ضمناً تمام آبجو را به یک جرعه سرکشید و به خوردن پرداخت	in proof whereof, it may be here remarked, that he humourously drank all the beer at a draught
در حالتی که متفکرانه و مساوی با حالت او بود	with an expression of melancholy equal to his own
که احتمالاً مایل بودند در مراسم سوگواری شرکت کنند.	who might perhaps wish to attend the funeral.
به نظرم بهتر است بیایید و با من آشنا شوید.	I think you might come and make my acquaintance
من یه وقتی عکسایی دیدم می گفتن مال کوی ره	I seen pitchers once says a desert.
اشتباه یا بدبختی دیگری ممکن است من بی گناه را با سر به میان آفت یا مرگ ناحق بیندازد.	that another's mistake or misfortune might plunge innocent me into unmerited disaster and death.
نگاه خود را با تعجب تمام به سوی چهره او بلند کرد	looked up in her face with great surprise.
وقت نداشتم از او بپرسم که منظورش از آن حرف چه بود.	I didn't have time to ask him what he meant by that.
من تیم بسیار بزرگی دارم که صد در صد به رهنمودهای زیادی احتیاج دارن.	I have a large team, and obviously they need a lot of briefing.
. و به من بگویید نام رئیس آن مجلس چیست	tell me the name of the president of the club
اسم شوهر او در این لحظه به دست تو در کنار اسم آن سگ ملعونی به ثبت برسد که شرش را کم کرد و رفت!	her husband's name should be proscribed under your hand at this moment, by the side of that infernal dog's who has just left us?
با عجله از راهی در سمت راست بیرون آمده بود.	who had just hurried out of a path on the right hand side.
تنها آرزویم این بود که شیر یا افعی یا هر حیوان خطرناکی که ممکن بود به ما حمله کند تا او را بکشم و افتخاری برای خود کسب کنم.	only wished that a lion or a serpent, or any ill disposed monster, would make an attack upon us, that I might destroy him, and cover myself with glory.
آقای وی زلی در صندوق عقب را باز کرد	he opened the trunk
به پارچه سوسیس شده بود خاکی رنگ شلوار آنقدر فشارآورده بود که شبیه لفافه.	stretching the khaki fabric until it resembled a sausage casing.
در ضمن از او بخواهم که به جای خوابیدن در تاریکی بیاید در روی صندلی راحتی استراحت کند و تنها نماند.	I was asking her to come and lie on the sofa, instead of up stairs in the dark.
نگاهی به ساعت خود افکند و با دست جلوی صورت خود حرکتی کرد به علامت نوازش همسر و فرزندانش و چابکانه در پیادهرو به راه افتاد.	glancing at his watch, he made a motion of his hand before his face, indicating a caress to his wife and children, and walked jauntily along the pavement.
اولیای امور هم این ما جری را خاموش کردند	the authorities took no notice of it
بعد از او پا به حمام گذاشت و وقتی به کابین برگشت او را آماده دید.	, he went to the bathroom after she did, and when he returned to the stateroom he found her waiting for him naked in the bed.
وی را در حدس خویش استوارتر گردانید که این برادرش است	he felt convinced that this was his brother
مگر اینکه او را از آسمان دوستان چون باران ببارند.	unless, forsooth, the sky rains friends upon him.
من همین حالاش هم هیچ احترامی واسشون قایل نیستم.	I ain't got a hell of a lot of respect for them now
علاوه بر این بجه نم که این طور نیست.	but never mind.
در جهان حریفی نیست که ضربتی از من بخورد و قادر به حفظ تعادل خود باشد.	that there is not one in the world I will not compel to give ground.
چون گوشت تنش مثل بیسکویت برشته سخت شده بود.	his flesh being hard as twice baked biscuit.
این احساس وظیفه هم باید مثل آن تیرها در مغز تو کوفته شود.	similarly it must be knocked into you.
نمی دونم چه چیزایی تغییر کرده و چه چیزایی تغییر نکرده.	I don't know what has changed and what hasn't.
او را در وسط سالن نقش بر زمین یافتیم.	we found her lying on the hall floor.
تقریبا همچنان که مفلسان را شلغم پخته مر بریان است!	very much as the goose stuffed with chestnuts is the truffled turkey of the poor.
در طول این مدت خودم برایت کار و محل زندگی پیدا خواهم کرد.	in the interim, I shall myself look out for employment and an asylum for you.
ضم نا قصد داشتم مقداری هم از این و اون قرض کنم	you see I thought maybe I might be able to borrow some from some one too
اما وظیفه خود دانستم که شما را قبلا از آن آگاه سازم.	but I consider it my duty to let you know of it.
وعده جزی رهای به من داده است که هنوز در انتظار آنم.	promising me an island, which I am still waiting for.
حال آنکه من از فرط خشم چندین بار رنگ به رنگ شدم.	while my colour came and went several times, with indignation.
او صلیب خود را به من داد و من شمایل خود را به او.	she gave me her cross and I gave her my little ikon.
آدم دوست دارد قبل از چشم به راه ماندن دوست و آشناها را به مقصد برساند.	the pleasure of coming in upon one's friends before the look out begins
من این کار را نکردم. ضمیر ناخودآگاهم این کار را کرد.	I didn't do it, my subconscious did it.
پس تعظیم خفیفی به بانو کرد و به جانب بالاشف برگشت.	nodded slightly to the lady and turned to him.
کلمه ماهی روغن دار را با تأکید شدید بر زبان آوردم و به جای خود بازگشتم.	I uttered the word cod with great emphasis, and resumed my seat.
روزهای اول را در اتاق خود به سر برد.	for the first few days he stayed in his room
نگاهم را از او برگرفتم و با صدای بلند خندیدم.	I looked away from her and laughed out loud.
گفتگویی به میان آوردند که دست کمی از گفتگوی مندرج در فصل قبل نداشت.	where they had another conversation not inferior to the previous one.
ولی من چرا باید خودم را به زحمت بیاندازم تا درمانگاه هایی تأسیس کنم که هیچ وقت از آنها استفاده نخواهم کرد	but why should I worry myself about establishing dispensaries which I shall never make use of,
روز دراز و پرازواقعه ای را سپری کرده بود	it had been a long and eventful day
لیکن اضطراب و نگرانی او ناشی از احساس مبهم دیگری بود.	but yet that was not it, that was not it either.
ولی چیزی که درون یخچال پیدا کرد آنقدر حواسش را پرت کرد که صدای حرکت من را نشنید.	but his hunt through the fridge had covered up the sound of my approach.
این پیرمرد ملعون که با این اصرار مطابق ذوق خود	perhaps the spirit of that accursed old man
تا نیمة اتاق هم به استقبالم شتافت و روی زمین زانو زد و مرا بوسید.	coming half across the room to meet me, kneeled down upon the ground and kissed me
چرا که به عادت بد بلند حرف زدن دچار شده بود	for he had fallen into the bad habit of speaking aloud
نمی دونم اصلاً درس ته که باهات بمو نم یا نه.	I don't know if I should keep staying with you.
حقیقة تصور ادب و احترام و رضایت و خرسندی بیش از آن در قیافه او دشوار بود	really it would have been difficult for a face to express greater respect and self complacency than his did.
ارباب من اصلاً از مار خوشم نم یاد بی مار می تونم زندگی کنم.	I k'n stan' DEM, but blame' 'f I couldn' get along widout um, I tell you dat.
هر از چند گاهی از نردبون بالا میرم تا هوای تازه تنفس کنم.	I pop up the ladder every now and then for a breath of fresh air.
همچنین کیسه بزرگی پر از زر به جهت مخارج عادی به من ببخشد.	a large purse of gold for my common expenses.
آن هم زمانی که آدم متوقع است با او سازگار باشد!	when one has the most right to expect it to be as agreeable as possible
هری مثل فشنگ به سرعت اوج گرفت و بالا رفت و برای بار سوم گوی زرین را دید.	he rose fast as a bullet once more, and then saw it, for the third time 
گفتم که من نیز از دیدار مجدد او خوشوقت خواهم شد.	I said I should be delighted to see her.
اندازه قامت و حالت چهره کاملاً برایم تازه بود.	the height, the contour were new to me.
من دوباره به جایی که ضربه را مقابل مشتم حس کرده بودم نگاه انداختم	I looked back to the place where I'd felt the thump against my fist.
زیرا که هر فقره شباهت غیر کاملی به جمجمه اصلی دارد.	all bearing rudimental resemblance to the skull proper.
آنگاه فوت کرد تا حرارت و خاکستر از بیسکویت دور شود و با ادب تمام آن را به حضور بچه سیاه تقدیم کرد	then blowing off the heat and ashes a little, he made a polite offer of it to the little negro.
نمی تونم زوجی بهتر از او نارو تصور کنم.	I couldn't imagine two better people.
مانع از ین شده بود که صندوق به محض برخورد با آب درهم بشکند.	hindered it from being broken on the surface of the water.
کاترین خنده کنان از جایش بلند شد و به نزد من آمد	she cried, gaily, jumping up and running to my side.
قاب دو طرفه کوچکی را که از طلا ساخته شده بود از گردنش درآورد و به من نشان داد	she took a little picture from her neck
دریافت که چنین حالتی اصلا به عصبیت دوران بعد از زایمان شباهتی تدارد .	saw that this was not the hysteria of a woman still weak from childbirth.
طبق معمول قهوهی بدون شیر و بدون شکر خود را نوشید.	had his usual black coffee without sugar.
چه بر سه به یک کیک خشک و خالی	let alone a cake
به هیچ ترتیب نتوانستم چیز دیگری از دهانش بیرون بکشم.	I could never get past that point.
این بود که دور خانه گشتم تا جرئت این کار را پیدا کنم.	so I walked around the block to get up my courage.
دربارهٔ ایمان من هفته گذشته در ظرف چهار بار در این خصوص مباحثه داشتم.	as to faith, I had four curious conversations in two days, a week or so ago.
ویترین مغازه کام لا روشن بود و نیم تنه در معرض تماشا قرار داشت.	its display window properly illuminated and the coat in full view
همان روز ازدواج به آشیانه سعادت و خانه زیبای خود قدم نهادند.	on the same day they entered into possession of their new and happy home.
چون آشکار بود که ربرتا هم مثل خودش از دیده شدن و لو رفتن بیمناک است .	for it was plain that she was no more anxious to be observed than he was.
آن مرد کلاه خود را برداشت و گذاشت تا نسم موهایش را پریشان کند و بر پیشانیش بوسه زند.	he removed his hat, let the breeze stir his hair and kiss his brow.
آن وقت به نظر خودشان زنجیری که دور زبانشان بود قفل شد	the fetters that bound their tongues were considered to be locked
در این صورت من به آنچه روی داده است توجهی نخواهم کرد	I will regard what has passed as not having occurred
دست کودک را محکم در میان دست خود گرفته	clasped it firmly in his hand
اما اکنون شلاق سواری به دست شتابان خود را به آنجا رسانده بود	but now looked in hurriedly, whip in hand.
