او که از ترس رنگش مثل گچ شده بود	blanching with fright.
اگر مو لف داستان ما در کتاب خود اشاره به این موضوع نکرده باشد	if the author of our history has not put it in
جواب داد. ولی به عکس من معتقدم که این کار به خوبی از شما ساخته است.	I think you would do it excellently,' he said.
آفتاب در افق بسیار دور از میان مهی غلیظ سر برآورده	the sun, away at sea, just breaking through the heavy mist
تمام مطالبی را که قبلا از این و آن شنیده بود به دخترک توضیح داد.	proceeded to explain all that had been previously explained to him.
به تفنگ دکتر خورد و آن را خرد کرد	knocked the doctor's musket into bits.
به محض اینکه چشمش به من افتاد با عجله قلم و کاغذ را پنهان ساخت.	which she guiltily slipped out of sight on my entrance.
در رهگذر به دیگران تنه بزند یا از دیگران تنه بخورد و در گنداب رو بیفتد.	in the streets, of justling others, or being justled himself into the kennel.
در قسمت پایینش انباشته از تلی به شکل مثلث از مصالح ساختمانی بود	at its lower extremity,by a mass of masonry of a triangular shape
کت و پالتو خود را که هنوز خیس بودند بر تن کرد.	put on his still damp jacket and overcoat.
باید حرف بزند تا ادعای خود را با حرف به اثبات رساند.	talk, merely to convince himself that he is in the right.
در دل خود را به تلخی سرزنش و ملامت کردم که	my heart smote me sorely that
اگر مایلید که آن را کلمه به کلمه برای شما ترجمه کنم	that if I wished him to tell me its meaning word for word
هیچ جریان آبی آن را به صورت یک گودال آب کثیف و متعفن درنیاورده بود.	no gush of bilge water had turned it to fetid puddle.
این بود که تا به ساحل رسیدم خیلی طول کشید.	so I was a good long time in getting over.
از اونچه که به ما می دادن صد در صد سود می خواستن.	for one hundred per cent profit on their goods.
وگرنه تصور کاملی از ساختمان کلی که خیال داریم تماشا کنیم حاصل نخواهید داشت.	otherwise you will not gain a complete notion of the general structure we are about to view.
که از خویشتن راضی باشد و همه کس را دوست خود بپندارد.	with himself and disposed to consider everyone his friend.
جواب او را صاعقه مانند و فوری باید داد	it is immediately, and by a thunderbolt, that I must repel the flash of lightning which, for a moment, startled me
بدین ترتیب کلاید ناچار شد دنبال راه دیگری بگردد.	he was left to think of some other way.
مختصر امیدی که به بهبودی او در من باقی مانده بود بر اثر این کشف به یاس بدل شد.	it was then that I lost the little hope I had had of her.
این مسئله که این مرد پذیرفته بود برای کسانی که به کمکش نیاز داشتند چنین فداکاریای بکند انگار رنو دردهایش را تسکین داد	it relieved her sufferings to know that the man had condescended to do so much for those who really wanted his help.
برای از بین بردن آخرین اثر تردیدم فقط مانده بود آن دو نفر را باهم ببینم.	to remove the last shade of doubt, it remained but to see them together.
ولی در همان دم انتهای نخ قلاب تکان خفیفی خورد	but at that moment the end of the rod jerked feebly
که هنگام ورود اسقف به مقر روحانی به حساب او جریان یافت بی فایده نباشد.	which had been in circulation about him from the very moment when he arrived in the diocese.
چیزی هست که توضیحش سخته و من می خوام تا وقتی متوجه میشید روشنفکرانه به قضیه نگاه کنید.	I have something difficult to explain, and I'll need you to be open minded until you understand.
یعنی جنگیدن و ِپیروز شدن در مقابل پلیدی و هوای نفس.	that means fighting against and having victory over the false deity of the soul.
از انتهای خیابان صدای درق و دورق حرکت ماشین او را شنید.	until the sound of his automobile' s backfiring faded at the end of the street.
حالا شما مجبورید به تنهایی حرفتان را پیش ببرید.	you must still fight your own battle.
چنانکه گویی آنان از طبقه و محیط پایین اجتماعاند و او را با ایشان صحبتی نیست.	as persons of station and culture inferior to his own, with whom it would be useless for him to converse.
چون که بعضی کارها آسان و بعضی دیگر مشکل هستند و در آن صورت ما ملیونها پستچی روستائی داشتیم و معدنچی هیچ.	since some work is easy and some hard, and we should have millions of rural mail carriers, and no coal miners.
یک لحظه قبل از این که به داخل بروم مردد شدم.	I hesitated a moment before going in.
بهتر آنکه همه را از پنجره به داخل حیاط پرتاب کرد و بر روی هم توده نمود	better fling them out of the window into the court and make a pile of them
من نخستین کسی بودم که در این جزایر او را پسندیدم.	I was his first admirer in the islands.
مدام مراقب بود تا حرکتی انجام ندهد که غمش را فاش کند.	but she was careful about any gesture that might seem to betray her grief.
دستی بزرگ و مردانه با انگشتان زمخت که بر پشت آن موهای طلائی رسته بود.	a large, pink, very masculine hand, with thick fingers and a fleece of gold hairs upon the back.
در حقیقت قصدم این است که دیگر در آنجا نمانم.	I believe I shall not live there any more.
اما تاریخ بیش از یک دفعه آن را ملاحظه نکرده است	but which history has noted only once
من همیشه می دون ستم که ادوارد باعث مرگ بلا می شه.	I always knew he would kill her.
من در حالیکه ترس بیجایی سراپای وجودم را گرفته بود بی درنگ از اتاق خارج شدم	I hurried out in a foolish state of dread
گفتم شاید یکی از اون دو تا مرد به جای تو اون جلو باشند	because I thought it might be one of those men up ahead instead of you.
در نزدیکی چرخ چاقو تیز کنی از پیاده رو برخاست	was rising from the pavement by the side of the grindstone
بعدازظهرهایی بچگانه تا بتواند اطمینان او را به خود جلب کند.	childish late afternoons, and he won her confidence
با چابکی از روی شاخه پریدم و تا کنار او بروم. بی صدا روی پاهایم فرود آمدم.	I leaped nimbly from the branch to his side, soundlessly landing again on the balls of my feet.
اسکار لت به طرف در رفت ولی با دیوار مواجه شد .	she backed toward the door and found herself against the wall.
ناگهان این منظره به وسیله حجاب شفاف بارانی که به طور مورب باریدن گرفت از نظر پنهان گشت و دوباره به همان سرعت این پرده حریر درید	was at times veiled by a diaphanous curtain of slanting rain, then, suddenly spread out in the sunlight
بدن عظیم و قوی هیکلش به یک تخته سنگ بزرگ شباهت داشت	its great lumpy body like a boulder
من او را بار دیگر در آغوش خواهم گرفت!	I'll have her in my arms again!
لیکن امروز تبدیل به احسن شده و به صورت عبادتگاه تمام مقدسین درآمده است.	but now a days, by a better nomenclature, 'of all the saints,
بر فرض هم که بخواهند به بهای آزادی خویش فدیه بدهند معلوم نیست با چه کسی طرفند.	there is no one with whom to treat for their ransom, even though they may have the means.
مطمئنم بهتر از آن خواهد بود که از اینجا حرکت کنیم.	I am sure it will be better than our going from here.I feel certain of it.
پس مرتکب قتل پدر خود شده و باید اعدام بشود.	he will be executed as a parricide.
در آن صورت حاضرم پنجاه نیزه با شما در افکنم	then am I ready to shiver fifty lances with you there
حس میکرد که فقط به آهنگ صدای او گوش میدهند	felt that the peasants heard nothing but the sound of his voice,
با یک حرکت سریع کش را سر جلیش قرار داد.	she yanked the garter into place.
زیرا رسیدن از منتهای بدی به آخرین حد نیکی کاری ساده و آسان نیست.	for it is no very easy matter to pass from one extreme to another.
سپس دوباره به کوپه بازگشتند و در را پشت سرشان بستند.	then came back into the compartment and rolled the door shut.
زمین بی حاصل نامهربانی که حتی یک درخت شکسته یا سنگی زمخت برای تسکین دادن حالت تهی آن وجود نداشت.	an unfriendly waste without even a broken tree or a bold stone to relieve the emptiness.
به دنبال ارباب خود و مأموریت جدید روانه گشت.	followed his master on his professional mission.
که مکافات و جزا از راه خدمت به انسانیت باشد نه به سلاطین.	rewards given to the benefactors of man than to his destroyers
شما دربارهٔ من به هیچ روی مسئول نخواهید شد.	you shall not have to answer for me.
ما نیز در همین دنیا ضمن دعا و نماز برای طول عمر و سلامت حضرتت دعا خواهیم کرد	we on earth will take care in our petitions to him to pray for the life and health of your worship
اگر چنین کنی پدرم به شدت عصبانی خواهد شد.	as you are doing he'll be angry.
اگر هیچ کاری هم برای متقاعد کردنش نکردم مرا ببخشید.	but pardon me, if I cannot even endeavour to persuade him.
مثل کسی که از فرط خستگی از پا در آمده باشد باز به خواب رفت.	he fell asleep with every appearance of excessive weariness.
مگر در یکی دو مورد به خصوص که در هر حال در آنچه هم اکنون نقل خواهد شد اثری نخواهد داشت.	except in some one or two particulars, not at all affecting the matter presently to be mentioned.
که ببینیم شاید تو گرمای ساختم ون تغییر کنه	just to see if he'd change in the heat of the building.
چیزی مثل زمین لرزه زیر ما غلتید و جنبید.	omething rolled and tumbled like an earthquake beneath us.
مراسم عقد دقیقاً سر مدتی معین به اتمام رسیده و اجازه داده بود خورشید از پس درختان غروب کند.	the ceremony had lasted exactly the right amount of time, allowing the sun to set behind the trees.
هیچ وقت ندیده بودم که با کسی بیشتر از یکی دو کلمه حرف بز نه.	I've never seen him actually talk to anyone for more than a word here or there.
هر کدام از این وضع را مرحله ای گذرا و آزمونی درآور میشمرد که سپری میشد.	that it was merely a temporary painful ordeal which would pass over.
از جمله نام و آدرس یک سرباز مزدور درجه یک را به دست آورد.	including the name and address of a first class mercenary.
خودش هم عجب بد آورده که فرصت چنین دیداری را با این برادر و خواهر از دست داده.	that she was most particularly unfortunate herself in having missed such a meeting with both brother and sister.
دنده با پا عوض می شه و گاز دستیه واین خیلی وقت میبره تاآدم بهش عادت کنه.	the gearshift is footoperated, the throttle hand operated, and that takes a lot of getting used to.
درس اخلاق و تأدیب و تهذیب یکسره ادامه داشت.	the chastening process was practically continuous.
شب تا صبح از فرط ناراحتی از این دنده به آن دنده غلتید و گریست.	she spent the night turning over in bed and weeping with indignation.
احوال زنانی که آشنای مشترک ایشان بودند تحقیق کرد.	about some ladies they both knew.
اما پاکی به عنوان صفتی برای زندگی هرگز به ذهنش راه نیافته بود.	but purity, as an attribute of existence, had never entered his mind.
من از اینکه دیدم قطعی فرض کرده است که من تمام گرفتاری خصوصی او را میدانم جا خوردم.	I was taken aback by her assumption that I knew all about her domestic misfortune.
اگر تمام افراد عالم نیز حامی و پشتیبان او باشند نباید سالم از چنگ من بدر رود.	even if the whole human race favours him.
یکباره دست و پای خود را گم کرده بود.	lost her head and did not know what to do.
در جایی که معاون کشیش به احتمال زیاد کودکان کوچک و زیبایی نداشت.	while the curate had probably no pretty little children whom she could like, irrespective of principle.
ولی مگ هرگز چشمش را بالا نکرد و همچنان به خواندن ادامه داد.	but she never looked up, and the lesson was not spoiled for her.
تا اینکه به لبه ورطه رسیده و دورتا را در آن سو دیده بود.	until now that he was come to the brink of it, and saw her on the other side.
چانگ جلوی هری پیچید و او را وادار به تغییر مسیر کرد.	she kept cutting across him, forcing him to change direction.
فقط منجر میشود به این که بگویند من صرفاً سعی داشته ام به افتخار قلابی از طریق دوئل برسم.	it would amount to my simply trying to gain a certain sham reputation by such a challenge.
ملاحت خاصی در او دید که هیچ یک از دخترهای این اتاق از آن بهره نداشتند.	she appeared to him to possess a charm which no one else in this room had
ولی با چنان اشتیاقی میل به حرف زدن پیدا کرده	but his mind was so troubled with anxiety to disclose something
مثل این که تو هم خوابت رده و خواب دیدی.	I think you must have dozed off too, dear!
ولی یقین دارم که شما منظورم را درک میکنید.	but I imagine that to you this is comprehensible.
تنها همین فکر راسخ است که مرا نزد شما کشانیده است.	I felt sure of that, or I should not have come to you.
باز هم به او پول خواهم داد و من خودم هر مبلغ که او بخواهد به او کمک خواهم کرد	we would give it to him, and, indeed, I myself would give him as much as he wanted out of my own money.
به جستجوی قصر بانوی خود تمام گوشه و کنارهای آبادی را زیر پا خواهم گذاشت	I won't leave a nook or corner of the whole village that I won't search for the house, castle, or palace, of my lady
به مامان بگویید توی این باران از خانه فرار کرده رفته	tell mama she is run out into the rain
احساس تحقیر و غم و اندوهی بی پایان بر او چیره شد و نزدیک بود از پای درآید.	mingled anguish and humiliation overcame him completely.
همچنین اضافه کرد که در ایام شغل اولش در شیکاگو به مادرش نامه نوشته بود	also how while still employed at the first of these places he had written his mother .
فرصت این را نداشت که بخوابد و خواب چیزی را هم ببیند.	he had not had time to dream anything.
که با شروع زندگی مشترک و توأم با عشق آنها در اج فلاکت و تیره بختی به پایان رسیده بود شکوه عشق آکنده از امید آنها چنان بود	which had ended wretchedly just when their own lives had come together in that splendour of hopeful love,
ما هم که دی گه نمی تونسیم منتظر به مو نیم	we couldn' wait.
من فقط در جواب تقاضایی که با آن همه نزاکت ابراز شده است	I can only say in answer to what has been so courteously asked of me
به او گفتم حقیقت مطلب اینست که در زمان حاضر کاری از دست او ساخته نیست.	I told her quite truthfully that I did not think she would do any good coming over.
نامی که از قرار به طنز بر آن گذاشته بودند	so called apparently by way of sarcasm
فقط یک همسر لازم دارد تا همه چیز تکمیل شود.	all that he will need will be a wife to make it complete
یک متفکر منزوی از این همه هیاهو و جارو جنجال به فغان آمده چنین فریاد برمی آورد	replies another triumphantly, and passes on with an air of pride.
موضوع این است که من دوست ندارم راز داری کنم	but because I hate keeping things long
از مردی مثل من نباید این طور دزدی کرد.	this is not the way to rob a man of my standing.
اونوقت من می تونستم این پولو به تدریج کنار بذارم و یا ماه به ماه پرداختش کنم.	that I could save and pay it thatway, maybe.
هر کلمه زشت و کثیف که در دنیا بود و کلمات خاص ذات خودش بود به من زد.	using every filthy word in her particular vocabulary.
قاب عینکش چهارگوش بود و با خطوط دور چشم گربه سر مویی فرق نداشت.	was wearing square glasses exactly the shape of the markings the cat had had around its eyes.
تو گفتی پنداشته بود دور تا به خاطر او به آنجا آمده است.	as if he had imagined that her coming had anything to do with him.
میخو است اطمینان حاصل کند که قدش ۶ سانت کوتاه نشده و تمام دهه ۷۰ درزمان ناپدید نشده.	that he had not shrunk two feet, that the whole decade of the 1980s had not vanished back into time.
زیرا در آن صورت با من به شدت و سختی رفتار خواهد کرد.	for he is very hard.
که دیگر میلی به ازدواج با آن دختر ندارد.	that neveragain as before could he desire to marry her.
مخصوصا به مین جهت است که از دیدنتان خوشحالم.	for that reason, also, I am glad to see you.
که کنت دست او را گرفت و امر به سکوت کرد.	but the count seized his arm and prevented hiM
از طرف دیگر نه خوشی و نه رنج در روی زمین	on the other neither good nor evil on earth
مصمم بود که اگر حرکتی تهدیدآمیز از وی ببیند	determined, if he saw him make any hostile movement
شو نه هام رو بالا انداختم و به خودم اجازه داخل شدن دادم.	I shrugged and let myself in.
اگر چه این جزوه بازماندهٔ دورهٔ استعماری و پنج سال از تاریخ روز عقب است.	although in fact this is a leftover from colonial days and five years out of date.
زن جوان دیگر حتمش شده بود که خواهد مرد	feeling she should never get over it, she was on her way
معلوم بودکه حوصله لجبازی و تمرد از اوامر او را ندارد.	perhaps she had no temptation to transgress.
من باید به دنبال دانش یا اطلاعات عمومی بروم.	I must pursue general knowledge.
ولی چون چند دقیقه گذشت و لینتون نه حرفی زد و نه نگاهی به سوی وی افکند به طرف در روان شد	but as he neither looked up nor spoke, she finally made a movement to the door
روحی مشوش داشتند و در درونشان چیز غریبی بود	although they did not realize it,and there was about them something uncanny
اراده کردند تا از اسم خود بگریزند و مصمم شدند	resolved to get rid of their names
احساس کردم که دیدگان مادر و پسر به من دوخته شده است.	felt that they were very attentive.
بلافاصله با چوبدستیش زیر شکم عنکبوت را نشانه گرفت.	he aimed high at the spider's underbelly
من دی گه از نشستن توی خو نه خسته شدم و خیال ندارم به این کار ادامه بدم.	I'm tired of sitting at home and I'm not going to do it any longer.
اما از ین به بعد حتی ازم ون بیشتر فاصله می گیره.	but he'll be keeping his distance even more from now on.
بلکه برای این برد که هرگز نگاه غمگین و تا حدودی تمسخرآمیز فرد اعدامی را فراموش نکند.	but so that for the rest of his life he would never forget the sad and somewhat mocking smile of the man being shot.
کشیش روبروی او نشسته بود و ردایش روی پاها چین خورده و از دو سو پایین سریده بود.	propping her sticks against a bamboo table while the priest sat opposite her with the folds of his soutane falling about him
بعد از گفتن این کلام قوطی را بست و به جیب نهاد که تا مدتی شعشعه او در چشم کادروس باقی بود	as he closed the box and returned it to his pocket while its brilliant hues seemed still to dance before the eyes of the fascinated inn keeper
با آنکه در ذهن خود بسیار جست و کاوید تا مگر حدس بزند که چه هوسی است	though be strove to imagine what desire
زیرا که این انتقام را چون ما اخذ نماییم بسیار سخت و هولناک خواهد بود	when our turn comes our revenge will be sweeping
مشروط بر اینکه سرگرمی شرافتمندانه و آبرومندی برای من باشند و از زبان و قلم شیوای خود مرا خرسند و محظوظ کنند و از ابداع و فکر بلند خود مرا به تحسین و شگفت وادارند	so long as they are books of honest entertainment that charm by their style and attract and interest by the invention they display
مرگ به او گفت بدون احساس درد خواهد مرد.	she was told that she would die without pain, fear, or bitterness at dusk on the day that she finished it.
که از نظر عرعر کردن به هیچ وجه فرقی بین شما و خر نیست	that between you and an ass there is not an atom of difference as far as braying goes
بالاخره به فروش قسمتی از ملک خود رضا داد.	but ended by agreeing to sell part of her property.
به طوری که کام فوراً بقایای ساندویچ را به جای قبلی برگرداند	that she put it back at once
اما خواهر که مستعد چیزهای بدتری بود احتمال داشت .	her other sister, from whose disposition greater evil might be apprehended,
دست جیمز بر فرمان قایق برای کام حالتی نهادین یافته بود	his hand on the tiller had become symbolical to her
می دانستم آن جور که من او را دوست دارم او مرا دوست ندارد.	I knew she didn't love me as I loved her.
تصمیم گرفتم وقتی زندان سقوط کرد به این برج بروم سلول او را بررسی کنم.	I resolve, when the place shall fall, to examine that cell.
ولی او نا اصرار داشتن که من مرتب پلاکمو توی ده نم بگذارم تا دندونام به مرور عقب بره.	but they wanted me to carry on with my braces.
اما نمی دونم تو کد وم کوچه منزل دار ین	but I don't know in what street.
دو بار دیگر وی را به ریسمان بالا بردند	twice, he went aloft
نامه را قبل از که در پاکت را بچسبانم دوباره خواندم.	I just read this over before sealing it.
ولی در آخر سال خیال همه ناراحت شد. وبا به پایان رسیده بود.	but by the end of the year it was believed that the danger of an epidemic had been averted.
این عمل چندان تکرار شد تا هر دو پی بردند که این عرعرهای پی در پی از خود ایشان است نه از خر.	coming to meet one another again, until they arranged by way of countersign, so as to know that it was they and not the ass, to give two brays, one after the other.
من با مشقت تونستم زهر لازم رو به قلبش بر سونم تا نجاتش بدم	I was hard pressed to get enough venom into her heart to save her.
من هرگز او را در آن لحظه فراموش نخواهم کرد.	I haven't forgotten it and I never shall!
من بزودی شغلی پیدا خواهم کرد و پولی بدست خواهم آورد	I mean to get something to do directly, and earn money.
اما به فرض آنکه عشق گابریل کام لا پا کس باشد چون بیش از حد جوان است لازم است در اتخاذ تصمیم برای ازدواج با او دقت و تأمل نماید.	but he was very young, and it was a difficult question to decide.
مثل تصاویر سیاه وسفیدی که یک عکاس آماتور گرفته باشد تمام حوادثی که اخیرا اتفاق افتاده بود	getting shutterclicks of the recent past like blackand white photographs taken by an amateur
که شما را دیگر هوس شقفت و مهربانی هم نماند.	that you shall not even care to sympathize with me.
ولی حالا دیگر خیلی دیر شده بود و وی را برای آن دو تای دیگر خبر کرده بود و حق ویزیتش را هم دیگر به انسانیت و محبت وی واگذار کرده بود.	but now it was too late, and she could only ask him to help the others and trust to charity for his pay.
از اینکه به خاطر مقصود آشکار او رنگ بلا پرید خوشنود شدم.	I was gratified by the way she blanched at his obvious intent.
آن هم صرفا از طریق روشن کردن راه برای ابراز وجود عاری از خودپرستی و آکنده از همدردی.	simply by lighting the way for her unselfishness and sympathy.
اما خیال نکن که تو هم جزو قرارداد هستی!	lest you should take it into that head of yours
که به نحوی میان ابزارهای کله بری گیر کرده بود	which had somehow got foul of the great cutting tackles
چه طور ممکنه به یه زبون دی گه حرف بزنم	how can I speak a language
همان جا ایستاد و دستش را به یک لنگه در تکیه داد.	leaning against the jamb of the door.
ظاهرا به خاطر خدماتش به صنایع و در واقع برای کمک مادی محرمانه به بودجه حزب برای برگزاری انتخابات	ostensibly for services to industry, but in reality for secret contributions to party funds for the general election
پس از بررسی چمنزار به این نتیجه رسید که این اجاره بها بسیار ارزان است و اجاره ی هر سه جریب را بیستوپنج روبل تعیین کرد.	he thought on examining the grasslands that they were worth more, and he fixed the price at twenty five roubles the three acres.
به خصوص که در این موضوع خود من نیز سهم مؤثری دارم.	especially if it be anything in which I have a part.
سه فرزند داشت و پسرش به تحصیل طب مشغول بود تا بعدا جای پدر را بگیرد.	the father of three children, one of them a son already studying medicine in order to succeed to his father's practice.
سپس دستمال خویش را در جیب گذاشت و شنگول شد.	put away his pocket handkerchief, and cheered up.
در دسترس بود و توانست او را از مهلکه به در ببرد	was at hand, and managed to snatch him away
دیگری پیرمردی بود که موهای سفیدی شبیه هنرمندان داشت.	an old man with theatrical looking white hair.
به هر کس هرچه را که از آن او است باز دهد	give to every man that which is his
شک نبود که آن لباس یک لباس همشکل راهزنی بود.	without the shadow of a doubt a gaudy piratical uniform.
به بسیاری چیزهای عجیب در باب این قضیه اشاره شد.	many strange things were hinted in reference to this wild affair.
اختلافی که آن حیوانات ساکن کشور او با هم دارند ناشی از همان دردیست که ما داریم	that the dissensions of those brutes in his country were owing to the same cause with ours
وقتی بزرگ شدی مبدل به یک غاز ظاهرساز خواهی شد!	if you don't take care.
مثابه گیاه طفیلیدبق برای بلوط و زگیل برای جسم آدمی است.	what the mistletoe is to the oak, what the wart isto the human body.
مالک فقید خرفتش آن را با ساکنانی چون خود پیر کرده بود.	had been endowed by its late doting owner with a fitting residence.
که چهار تابستان را پشت سر گذاشته و بدتر از آن همواره زیرپای دو کودک ماری بودند	the once elegant furniture of which had been gradually growing shabby under the influence of four summers and two children
مخصوصاً در این موقع که هوا هنوز سرد و مرطوب است چنین کاری عاقلانه نیست.	it is not wise, at any rate this moist season.
در ضمن با دست بلندش به آن اتاق اشاره کرد.	pointing with his long hand to the room he meant.
معلوم نبود که بچه به چه کسی تعلق دارد.	nobody knew whose baby it was
هر لحظه انتظار داشتم که ببینم چشمان سیاهش با نگاهی از تنفر و تحقیر متوجه من شده.	expecting every moment to see its dark orb turn on me a glance of repugnance and contempt.
بی درنگ تصمیم گرفت که در رفتار خود احتیاط بیشتری به خرج دهد.	of course, as he now decided, he must be careful about being
در و دیوارشان را به رنگ لاجوردی آراسته و به گل زنبق مزین کرده بودند.	were besmeared with azure and decked with fleurs delys.
از خیره شدن به پایین در بهار خواب گیج شده بودم.	I was giddy from staring down at the terrace.
قصد من اینست که کوزت در مدت عمرش دیگر شما را نبیند.	my intention isthat she shall never set eyes on you again so long as she lives.
به طوری که حتی خرج دوختن و وصله کردن پوست بزها را نیز از ایشان خواهد گرفت.	even to the cost of the plugs that would have to be put to the damaged wine skins.
گرچه گفتن این موضوع در مقابل ماکزیم کمی دور از احتیاط است	though it was tactless of her to say so in front of him.
اکنون هنگام آن رسیده است که باز در آن بنگریم.	the moment has now come when we must take another look into it.
ناملایماتی که در این چند روزه به او رسیده.	of which had during the last eight days filled his mind with so many gloomy thoughts and bitter recollections
شمام به خاطر خدا اگه همین کار و میکردین کار خوبی بود.	you ought to have done thesame!
با آن چهره اندیش ناک که حالت ایستادنش را جالب توجه ساخته بود.	saw her in that brooding abstraction which made her pose remarkable.
در برابر او نه مرگ که فنا گسترده بود.	in front of him there lay not death but annihilation.
بهتره برم به درمونگاه سرم بدجوری درد می کنه.	I need to go to the hospital wing, I think
وقتی به این نتیجه رسیدم که هرگز یک خانه آرام یا مرتب نخواهم داشت	when I perceived that I should never have a quiet or settled household
اما به جای نوشتن دستهایش را روی میز و سرش را روی دستها گذاشت	but instead of writing she clasped her hands on the table, and, laying her head on them
چه غرور نابجایی که آدم بگذارد این تصورات احمقانه جلو کار خیر را بگیرند.	I call it improper pride to let fools' notions hinder you from doing a good action.
پس به عنوان یک انسان شرافتمند نمیتوان به آن بیاعتنا باشی و نخواهی در این راه کوشش کنی.	then, as an honest man, you cannot help caring about it and sympathizing with the movement, and so wishing to work for it.
ناگاه به یاد آورد که ضمن احکام مختلفی که برای دستگیری مجرمین با خود دارد	recollected that among some warrants he carried for the arrest of certain delinquents
سرش از ضربت سیلی سخت به پهلو خم شد.	a fierce blow jerked his head to one side.
زیرا که او مردی بود بلند پایه و شایسته بزرگداشت.	was on account of his quality and personal merits.
الان به این فکر افتادم که انجام دادن خواسته تو برایم تقریباً مثل خودکشی خواهد بود.	to do as you wish me would, I begin to think, be almost equivalent to committing suicide.
دیگر کار تمام شده و محکومیت ماکزیم قطعی گشت.	in a flash of fear and horror I knew that he was right.
همگی به این نتیجه رسیدند. که ماهی من خیلی هم بزرگ نبود.	they all made out afterwards that the fish I'd caught wasn't really a big one.
تو همیشه پنج شش نفر رو توی آب نمک خوابونده داری.	I can't imagine you without five or six in reserve.
زیرا از طرز صحبت کردنش معلوم است که او ایمان کامل به این نکته دارد	for, as he shows, he accepts it as a certainty
پس از آن برمی گردم و او را پس مس گیرم.	I'll return for him then.
یعنی همان موجودی که من از هر حیث به او شباهت دارم	to which I owned my resemblance in every part
این جوان را که اکنون در مقابل شما است به درخت بلوطی بسته دیدم.	I found tied to an oak this lad who now stands before you
بدون این که اصلاً از کاری که کرده بود خجالت بکشد.	but without seeming really at all ashamed of what he had done.
از ابهام موسیقی برخوردار است و از دقّت ریاضیّات.	it had the vagueness of music and the precision of mathematics.
تا این موضوع را با شوهرش در میان بگذارد خیالش آسوده نبود.	till she could find an opportunity of opening her heart to her husband.
من از آنجا او را شناختم که لباسش عیناً لباس آن روزی بود که تو او را به من نشان دادی.	I recognised her,by her wearing the same garments she wore when thou didst point her out to me.
این احساس برای شخص مبتلا به تب و لرز که ناگهان در روز آفتابی قدم به خیابان نهد کاملاً عادی است.	as a man in a fever is apt to feel when he comes out into the street on a bright sunny day.
صدای چند نفر از جلوی کلبه به گوش رسید.	they heard voices at the front of the cabin.
مرا دیگر نیازی به ماندن در این جا نیست	I have now no need to remain here any longer
حالا که لینتون نقشه شیطانی و موذیانه پدرش را با موفقیت عملی کرده بود دیگر بیمی از تنبیه وی نداشت.	that accomplished, he had no further immediate fears.
این کتاب شما هم همین طور در دست من مانده	I have this unhappy book still!
وقتی پیر شد خیلی زود اعمالی انجام گرفت که چندان عادلانه نبودند.	soon after he was of age, some steps were taken that were not quite fair
قیافه خوشحال و با نشاطی نداشت و لودگی زیادی لازم بود تا او را بخنداند	she had no vivacity of expression, and it required broad farce to excite her laughter
انگار مانند یک شیئ از بین نرفتنی در سر راهشان قرار گرفته بود.	as if it lay across his path like an insurmountable object.
پس از پنج ماه اقامت در آنجا با کوره سوادی که در ریاضیات پیدا کرده بودند بازگشتند	after five months continuance, came back with a very little smattering in mathematics
پس دست او را گرفت و به طرف اتاق روان شدند.	offering his arM
در پاییز گذشته با بار سیب در آب غرق شده بود.	it had sunk last autumn, overladen with apples.
من اگر بتوانم جبران این همه لطف و محبت را بدین طریق بکنم که انتقام شما را از مردی خودکامه که توهینی به ساحت مقدستان کرده باشد بگیرم	if I can repay them in avenging you of any arrogant foe who may have wronged you,
من به کاغذی که رو به رویم بود زل زدم	I stare at the sheet blankly
اما اکنون بیش از بیست و پنج سال داشتن ابلهانه است.	but now to be more than twenty five is absurd.
تا ببینم آیا حسن صورت شما تناسبی با ظاهر آراسته و باشکوهتان دارد یا خیر.	in order that I may see if the comeliness of your countenance corresponds with that of your equipment.
او باید اول لباسش را در آورد و پیش از من به بستر برود.	he must undress and get into bed before I did.
ولی بسیار زیبا بود و بعد هم یک بچه که فقط چند ماه داشت.	but very attractive, and an infant a few months old.
لکن از این نکات عجیب و غریب زیاد داشت.	but I heard there was something queer of the sort, very whimsically expressed.
در جیب خود به جستجوی کلید خانه برآمده بود	was already fumbling in his pocket for the door key
چون تو رو تو خطر گاز گرفته شدن قرار می ده	because it puts you in danger of getting bitten
جوان محصل تازه فهمید که محال است بتواند این زندگی را بدون داشتن عواید مستمر ادامه بدهد.	that it became clear to the law student's mind that he must have some more certain source of income if he meant to live as he had been doing.
سپس همه محو شده و زن دیوانه باز به صورت نعش درآمده بود.	had then vanished, and the madwoman had become a corpse again.
در میان یک مشت بیگانه ما مور دولت است!	an official among foreigners
در حالیکه هنوز وزوزشان در اطراف موضوع سابق قطع نشده بود	without having finished their buzzing on a previous theme
آری شما به من آهسته گفتید که آنجا باشم و به جایی نروم	you begged me not to leave
با این پارچه کلفتی که توی این گرما رو خودت انداختی.	for all your smothering yourself under that hot lap robe.
اما من حقیر در حال حاضر به دارو و مرهم بیش از پند و موعظه نیازمندم.	but I swear on the faith of a poor man I am more fit for plasters than for arguments.
چون در این کار همیشه نوعی انصاف هست و حسادت بر تمام خلقت سیطره دارد!	since there is ever a sort of fair play herein, jealousy presiding over all creations.
سرانجام بی آنکه پاسخ معینی به کلاید دهد در جواب گفت	she replied without really answering him.
سپس من برخاستم و برای خوردن صبحانه خارج شدم.	 I went out and breakfasted.
چراغ را روی میز گذاشت و تفنگش را از دیوار برداشت.	placed the lamp on the table, and took his gun down from the wall.
از مردی که به او علاقمند شده بود فن شنا و شیرجه را به خوبی آموخت.	a man who took a fancy to him and who could both swim and dive, he learned to do both exceedingly well.
بعد مطابق معمول همیشگی خود دست یکدیگر را فشردند.	afterwards shook hands, according to their invariable custom.
همیشه روزها را شمرده و همواره توانسته بود خطر را از سربگذارند.	she had counted the days and always had been able to congratulate herself that all was well.
اما چیزی که پای سماور دید سبب بدخلقی او شد.	he was gloomy, not on account of that conversation, but from what he saw at the samovar.
چه بسا در زندگی خود چنان چیزی ندیده بود.	perhaps he had not seen much in his life.
تمام ما جری را برای تو نقل خواهم کرد.	I'll tell you everything.
من دریافتم که او هم هیچ از آن خوشش نیامد	I observed it did not produce an agreeable effect
زیرا قوایش خیلی تحلیل رفته و حواسش رو به کاهش گذاشته بود.	for she was very weak.
برایت دعا خواهم کرد که زنده بمانی و موفق شوی.	I shall pray for youthat you live, and succeed.
چون این نعمت همواره در نزد فقرا موجود است	as the poor are never without that
نوری که کمی پس از ساعت نه در اتاق خواب مشرف به بالکن خاموش شد.	that moved through the house and was extinguished, a little after nine, in the bedroom with the balcony.
شرح ماجراهای ایشان بر فرض که همه در خور سوختن نباشد	their histories, if indeed they were not burned
هر چه بود بی آن که کسی جواب بدهد از بین رفت.	which faded out, with no reply.
که او را محترم دارند و حتی از او بیم داشته باشند.	how to take his stand so that they respected and even feared him.
که شب را درون یک پشته لویی خشک بگذراند.	to spend the night in an abandoned rick of dry bulrushes.
ان قدر دوستش دارم که اینجا بمو نم و تماشا کنم	I love him enough that I want that.
تا دو سه روز پس از آن هم چیزی نخورد مگر آب و نان.	for three days following, eat nothing but bread and water.
جزو اولین کسانی بودند که همراه خلبان و شش نفر میهمان عالی رتبه سوار بالن شدند.	were the first to climb into the wicker basket, followed by the pilot and six distinguished guests.
من این کار و با قصد شخصی خودم انجام میدم.	I do this of my own free will.
با تمام وجود امید بست که برادرش آمده باشد.	now he hoped with all his heart that it was his brother.
هر چند شما شخص ریزه جثه پاکیزه مقبولی هستید اما او فرشته است.	though I was a nice neat little soul enough, but he was an angel.
چون سه سال منقضی شد تقریبا این یکصد و پنجاه مجلد در حفظ من بود	till I knew them nearly by heart
ناگهان در قلب خویش احساس فشار جا نگدازی کرد	he felt a sudden pang at his heart
معلوم بود که هنوز بیم آن دارد که ممکن است به سخنانش گوش ندهند.	she added, evidently still afraid that she would somehow be prevented from giving evidence.
در حدود ساعت نه برای خوردن صبحانه پایین آمدم.	went down to breakfast at nine o'clock as usual.
بیشتر به راست بچرخانم تا از وسط مراتع رد نشود.	of turning it more to the right that it may not cut through the home meadows
دومین سرود روحانی هم خوانده شد از اطاق غذاخوری برای رفتن به کلاس درس بیرون آمدیم.	a second hymn chanted, the refectory was evacuated for the schoolroom.
وقتی هم شروع به صحبت کرد مرا متهم ساخت که مسبب پیش آمد چند روز قبل بوده ام	when he did open his mouth, it was to utter the falsehood that I had occasioned the uproar
نمی دونم چقدر دی گه میتونه ادامه داشته با شه	I don't know how much more drama I can stand.
این لقبی بود که دوستانم توی مدرسه به هم داده بودن.	that was my friends' nickname for me at school.
به زودی دچار هیجان ذهنی شدیدی شد که پس از هر مباحثه ی درخشان و پرشور به او دست میداد و برادرش این حالت را خوب میشناخت.	was soon in that eager frame of mind his brother knew so well, which always, with him, followed a brilliant and eager conversation.
اما در وضعش چیزی نبود که شباهت به ترس داشته باشد.	but there was nothing in his air which resembled fear.
در واقع شش تن در برابر نوزده تن قرار داشتند.	so that the grown men on our side were six to their nineteen.
در این حیص و بیص صدای تندر گونه و بم گام بو بدون وقفه ادامه داشت.	while the cavernous thundering of the gombo went on without a pause.
طوری به او نگاه کردم انگار بار اول بود می دیدمش.	I look at him as though for the first time 
وقتی به این فکر کردم که چقدر روی اون خون آشام تنفر انگیز حساب کرده بودم دلم خواست خودمو بزنم.	I wanted to kick myself when I realized how much I'd been counting on that loathsome vampire.
تو باید کاری رو که من می گم بکنی.	the doctor tells you.
به نظر من آمدن شما در او اثر شفابخشی خواهد داشت.	I think your arrival will have a most beneficial influence upon him.
اون وقت او نو دار نزنن این کار رو می کنه.	bout this and they didn't hang him.
ولی اگر من و تو با هم زندگی کنیم هیچ بعید نیست	but if thou livest and I live, it may well be that before six days are over
باید اذعان کرد که به واسطه روابط بازرگانی بسیار بین دو کشور و پذیرفتن پناهندگان سیاسی که بین دو طرف معمول است	it must be confessed, that from the great intercourse of trade and commerce between both realms, from the continual reception of exiles which is mutual among them
من دی گه نمی تونستم ربرتا رو بند ازم تو قایق.	I knew that I couldn't get herinto that.
یک کاسه سوپ ماسیده را به درون اتاق هل داد.	pushing a bowl of canned soup into the room.
کاری کن که او قدری روغن و شراب و نمک و اکلیل کوهی به من بدهد تا آن شربت شفابخش را بسازیم.	get him to give me a little oil, wine, salt, and rosemary to make the salutiferous balsam
فرو رفتن در رختخوابی نرم و سرد چه لذت بخش بود.	it was heaven to sink into a soft cool bed
سپس پکوئود همه چیز را به پهلوی خود آویخت و شراعها را برافراشت	then hoisting everything to her side, and stacking her canvas high up
دانسته و به عمد به ضرورت دروغگویی تن در دادن چیز دیگر.	another to enter deliberately on the necessity of falsehood.
اما ننوشته بود که دختر عموهای تو هم اونجا بودن.	but it didn't say anything about your cousins being over there.
تا مجبور به شه حقیقت ماجرا رو برامون تعریف کنه.	until he is ready to tell us the whole story.
که در ساعت دوازده جنازه حرکت داده خواهد شد اوه. خدایا	at twelve the the oh, heavens
همراه ارابه کسی جز ارابه ران و یک مرد دیگر نبود که ارابه ران بر قاطری سوار بود و مرد دیگر جلو ارابه نشسته بود.	unattended by anyone except the carter on a mule, and a man sitting in front.
این شخص که خود سزاوار تحسین و تمجید است از کارم تعریف و تمجید بسیار کرد.	of being praised by one who is himself a worthy recipient of praise.
هر فکر بد دیگری که ابتدا به ذهن اِما خطور کرده بود.	any thing mischievous which her imagination had suggested at first.
آن وقت دیگر این مخلوق کوچک و ناامید نتوانست خویشتن داری کند	courageously resumed her march, but the poor little desperatecreature could not refrain from
اتاق را طی کرد و به شدت زنگ زد.	 she cried, and crossing the room she rang the bell.
بالاخره کشیش به او گفت که بهتر است آن را پس بدهد	until the licentiate told him to let her have it
من دستم را به طور از مایشی بالا بردم و زن داخل آینه هم حرکت مرا تقلید کرد.	I raised my hand experimentally, and the woman in the mirror copied the movement, touching her face, too.
به آن جهت آمدم که به ایشان بگویم که در فکر خود باشند.	I wish to warn him, that he may be on his guard.
احتمال این که وی را تکه پاره کنند بسیار زیاد بود.	he stood a good chance of being torn to pieces.
بر حسب تصادف معلوم شد که خطری در میان نیست	it happened there was no danger
برای من پناهگاهی بیاب و بشاهزده نیز چیزی نگو!	find me some refuge, and say nothing to the prince!
فکر کردم شاید خواسته است کمی در باغ گردش کند و از هوای خوش شبانگاهی لذت ببرد.	I reflected that she might, possibly, have taken it into her head to walk about the garden, for refreshment.
که سرپوشیده شده با یک پلاسش را زیر افکنده بود	which was enveloped in a rag
دوباره آن قدر به دیک نزد شک شد تا به او چسبید.	she came close again, clinging to him.
خلاصه من قضیه رو به راش ماست مالی کردم.	I smoothed the whole thing over.
به گمانم چون قرار نبود من جواهر داشته باشم شما به آن وسیله تصمیم خودتان را برای فریفتن من به عمل درآورده و خواسته بودید چیزی را از شما بپذیرم که به اندازه جواهر ارزش دارد.	resolved, I suppose, since I would not have jewels, to cheat me into accepting something as costly.
اما با این وصف نگاهش مطابق معمول مضطرب و ظن ین بود.	but in a restless and suspicious manner habitual to him.
به سمت پنجره رفت تا منظره بیرون را تماشا کند.	she turned to the window to admire the view.
شاید در آن هنگام چنان لال شوم که تا آخر عمر و یا تا قیام قیامت نتوانم یک کلمه حرف بزنم.	then, maybe, I'll be so dumb that I'll not say a word until the end of the world, or, at least, till the day of judgment.
یک از جا برجست و سعی کرد نزدیکش شود.	she had jumped up and tried to come to him.
که با شلیک گلوله شکسته بود. مورس رف خود را کشت	which was broken by the explosion.
من مانند تیغ گیوتین بالای زندگی او قرار گرفته بودم.	I had been positioned over her life like the blade of a guillotine.
شروع کردم به قدم زدن در جهت بالا و پایین میدان بازار.	began walking up and down the market square.
هری نفس عمیقی کشید گویی پیش از آن هیچ گاه به درستی نفس نکشیده بود.	he gulped it down, feeling as though he had never breathed properly before
که پیر امر مهمی در نظر دارد که سوگند اوست.	that the old man attached great importance to an oath
وقتی حالش اندکی بهتر شد از جایش برخاست و به طرف عمارت روان گردید.	before he entered the house.
در حقیقت برای جادوگران آسان است به هر صورتی که خود بخواهند درآیند	for it is easy for enchanters to take any form they please
اما آگاه بود که صدایش خوش آیند و دستانش دلرباست.	but aware that her talk was pleasant and her hands beautiful she went on explaining.
نفسم بند آمد و نزدیک بود از ترس غش کنم بیفتم عجب جایی گیر کرده بودیم!	WELL, I catched my breath and most fainted.
به همین علت بود که من آن مار را زود افسون نکردم.	I would not, therefore, immediately charm the snake.
که این مالک از مدت مدیدی پیش نامزد دختر زیبا بوده	the young landowner had been a long while betrothed to her
من اومدم اینجا که کار درست رو انجام بدم عضو یه گروه دی گه که به شم.	I'm committed to do the right thing hereI'm not joining any other coven.
یکی از آنان کشتی بادبانی کوچک یک دکلة دراز و باریکی هم دیده بود.	one at least had seen a little lugger
یه برگ کاغذ هست که شما باید آن را امضا کنید.	I have a paper here for you to sign, the attorney announced.
اما مسلح به این سلاح جدید از همنام خود نیرومندتر و کور چشم تر بود	but, so armed, he was stronger than his namesake, and blinder
بلافاصله قاطرهای خود را شلاق زنان به جلو راند و بی آنکه منتظر سوا لات دیگری شود رفت.	without waiting for any more of his questions, he whipped on his mules.
در جمله کشور سری وجود نداشت که در برابر آن فرود نیاید.	there was not a head in the nation but must have dropped before it.
سپس خود نیز دراز کشید و باز به خواب رفت.	his son lay down too, and fell asleep again.
تا جایی که توانست بعضی از عبارت سخنرانی ایرادشده را نیز بشنود.	a few phrases of the speeches delivered in front of the house
مدتی بعد معلوم شد که مرگ کاترین چه تأثیر وحشتناکی در روحیه شوهرش بجا گذاشته است.	its after effects showed how deep the sorrow sunk.
می دونم که حتی یک پنی از مالیاتتو نمی تونی بدی.	I know you can't even pay your taxes.
خواب دیدم که در وطن نزد زن و فرزندان خود هستم	dreamt I was at home with my wife and children
که وی و افراد خانواده اش در منافع گاوداری سهیم خواهند شد	that he should with his family take a share of the profits of the cattle yard
درست بعد از جنگ بود که افتخار آشناییش رو پیدا گردم.	I made the pleasure of his acquaintance just after the war.
حاضر نبود این تنها اقبالی را که از ملکوت آسمانها به او داده شده بود از دست بدهد و	he would not give one chance of heaven, nor relinquish,
امروز صبح امکان این که با او حرف بزنم پیش نیامده.	I have not had the opportunity of speaking to him this morning.
ولی شاید فکر کرد که او باید فقط به پسرک که مایه تمام این بدبختی بوده فحش بدهد.	but reflecting perhaps, that he might only injure the boy by giving vent to it
که بر مبنای آن اعمال حق از جانب ما ممکن است باعث دردسرمان بشود.	the assertion of our station, in these days, might cause us real inconvenience.
با این حال از مشاهده تأثیر وجود خود در این سه نفر زن خرسند و مغرور شده بود.	his vanity was flattered by the spectacle of his power over these three women.
یک گرگ در سکوتی غمگین رو به رویم نشسته بود.	a wolf standing in silent grief before me.
از تکرار این خاطره که با چه اشتیاقی چهرة خویش را بالا آورد و به آنچه گفته بود عمل کرد خیلی خوشحالم.	I am glad to dwell upon the earnestness and love with which she lifted up her face to mine, and did so.
کاری به کار نیروی نامرئی که به این جوان یاد داده بود چگونه نفس خود را در سینه حبس نماید و ضربان قلبش را کنترل نماید نداشت.	had nothing to do with the invisible power that taught him how to breathe from within and control his heartbeats
که آب در همه سوی او دیوار شکی ده است.	the water cascading all around him.
جز آنکه تقریبا همه پوست دستهاشان کنده شده بود.	however, than that of scratching nearly all the skin off their hands.
ما عقیده داریم که چنین افرادی باید به سختی مجازات شوند.	we believe that that person should be properly punished.
هر سه پس از ابراز تشکر از تعارفاتی که او راجع به کاروانسرا کرده بود ترکش گفتند	thanking him in pothouse phrase for his civility they left him
یک نفر که سوار بر اسب سفید بود هنگام عبور با ملتزمین خویش از کنار جمعیت سخنی گفت.	someone rode past on a white horse followed by his suite.
یک مرتبه یک سمندر آبی رنگ دراز و لاغر همراه با آب شل پی آمد توی لیوان!	suddenly, with the water, out came the long slimy newt straight into the glass, plopl
او بعدا بدادرسان گفت که کودک خیلی زود یعنی پس از چهار ساعت زندگی را بدرود گفته بود.	when he was tried, he said that the child died soon, within four hours.
که او هم درست مثل تابلوی نئونق ف ط یک چیز را دائم تکرارمیکند.	that like a neon sign, he only made the same simple patterns over and over again.
من بیشتر و راحت تر توی کاناپه فرو رفتم.	I just slumped deeper into the chair, getting comfortable.
که نسبت به سایر همنوعان خود دارند و ممکنست که بهر کس در راهشان پیش آید ابراز کنند	that they bear to all others of the same species who come in their way
صدای افتادن چیز سنگینی از تالار پذیرایی به گوشم رسید.	I heard a loud fall in the parlour
بار سوم با یک توپ پارچه پشمی آمد تا اگر کسی پشتش درد بگیرد روی آن ببندند.	a third time with a roll of flannel for the small of some one's rheumatic back.
اما چنان عصبی شده بود که تقریبا لکنت افتاد.	but so nervous that he almost stuttered.
یک نفر باید بالاخره یک جایی باشد که بتواند به او پول قرض بدهد.	there must be someone somewhere who had money she could borrow.
این تنها طریقه شرافتمندانه پول درآوردن برای یک شاعر است.	it was the only honorable way to make a profit out of poetry
در همان حال همچون کفتار پیری به مری نگریست	while he looked at her like an aged hyena
ولی من همیشه با احساساتم بامسائل برخورد میکنمو مادرت با اصول اخلاقی این کار و انجام میده.	but it's me that ends up arguing from feeling and her from the codes of morality.
یعنی اگه کاری که کرده از ماد درز کنه	if we was to squeak
رد ناپیدای آبا و اجداد خودش را تعقیب کرد	he pursued the hidden paths of his descent
باید غذای کنسرو شده بخورند. وضعیت بدی خواهند داشت.	they're eating out of cans, they're miserable.
ترجیح می دم که داستان رو از زبون فرد اصلی تری بشنوم.	I would rather have the explanation from someone more central to the story, my friend.
کام لا دیوانه و گناهکار حقیقی نیز من بودم. اما او نکشته است!	he didn't do it, he didn't do it!
سپس به سرعت لباش بپوشد و از خانه خارج شود.	then swiftly dress and leave.
این بیچاره چهار سال هم از او بیشتر محبوس شده است	this man had been four years longer than himself in prison
نه فقط مجبور شده بود قایق چهارم را تا نیمه شب به سرنوشت خود وا گذارد	the ship had not only been necessitated to leave that boat to its fate till near midnight
اما در حال تماشای بازی به آن تکیه داده بودند	but they were leaning on them while they watched the game.
او نیز آن را از پدر خود شنیده بود	also had it from his
همسر و فرزندانشان را بدون مراقب رها کنند .	leave their women and children unprotected.
به کله فریاد سورچی و صدای خفه کالسکه را در جلو خان سرپوشیده شنید.	but the coachman's shout and the dull rumble in the covered entry.
همان پسری که اول کلمه گلابی و بعد کلمه پا پا را آموخت	that son who had first learned to say pear and then granny
این تا سی و نه معجزه در یک روز هم رسید.	as manyas thirty nine in one day.
هرگز یک دفعه هم فکر نکرد که من زن زندگی هستم که احتیاج به عشق دارم.	he has not once even thought that I'm a live woman who must have love.
من دوستانه از و گله کردم اما سودی نداد	I expostulated with him, but in vain
هنوز فکرهایم را نکرده بودم که او عصایش را برداشت	before I had made up my mind he picked up his cane
نوار تیر جدا شدن از طفل خود را انکار نکرد و تمکین به رفتن به اتاق خود نمود.	there was no difficulty in withdrawing him from his child.
در کنار پیاده رو تلألؤیی سرخ رنگ را رها کنم.	gleamed red along the edge of the pavement.
لذا با پشت دست آب چشمانش را خشک کرد	he dried them with the back of his hand
یک نگاه به پسر و وارث خانواده بیندازم و بعد مرخص بشوم.	I'll just have a look at the son and heir and then I'll take myself off.
تا ساعت هشت و شاید هم دیرتر اصلا وقت آزاد ندارم.	I shan't be free till eight o'clock or after.
چون قبل از هفده سالگی به کالج نخواهم رفت .	I won't go before seventeen, anyway.
حالا که پدر حالش خوب است عجله دارد زودتر به خانه برگردد.	as he is now pretty well, is in a hurry to get home.
بی میلی و بیحالی وی در صحبت با کاترین چنان آشکار و محسوس بود که دخترک نتوانست نارضایتی و نومیدی خود را مخفی دارد.	his equal incapacity to contribute to her entertainment, were so obvious that she could not conceal her disappointment.
من خیلی مراقب بودم که وقتی ادوارد دور و بر منه بهش فکر نکنم	I've been very careful to not think about it when he's around.
اما کسی متوجه او نشد و کسی هم با او برخوردی نکرد.	but no one noticed him and no one met him.
در چشمان درشت و عمیق او که سیاه آشتین و دلدار بود	in his large, deep eyes, fiery black and bold
زیرا او هم موجودی ضعیف و سرگردان بوده است.	as she was weak and erring.
با محاسبه مقیاس نقشه اندازه دقیق را بدست آوردم.	computing by the scale, measured it pretty exactly.
اگرچه هنوز قول او را درست باور نکرده بود	but he had some difficulty in believing
کسی نبود که اِما به خاطر دوشیزه فیرفاکس برایش نقشه بکشد.	nobody that she could wish to scheme about for her.
صبح که شد مصمم از جا برخاست و تصمیمش را گرفت.	hearted child and rose up in the morning a woman with her mind made up.
مثلا می تونیم ته و توی قضیه این شاهدو در به یاریم.	find out about this witness in the meantime.
روز بعد بار دیگر یادداشتی نوشت و با انشای کاملاً با احساسی به او اطلاع داد	the following morning she wrote again to say, in the most feeling language she could command
از احسانی که در حق ما روا داشته بودند تشکر کردیم	returning them thanks for their kindness to us
امّا ناراحتی مبهمی هم او را به رفتن برانگیخت.	but she had been urged also by a vague discomfort.
رو برگرداند و روی یک صندلی پای پنجره طوری نشست که برادر زنش نتواند صورتش را ببیند.	turning away so that his brother in law could not see him, he sat down on a chair at the window.
مشهور چنین است که این مبلغ را با کمال درستکاری از تجارتش تحصیل کرده است.	by perfectly legitimate means, acquired inhis business.
با اشتهای تمام صبحانه و ناهار و عصرانه و شام خود را یکجا نوش کردند.	they breakfasted, dined, lunched, and supped all at once, satisfying their appetites
با این همه در کنارش ایستاد و بازو در بازوی او انداخت.	yet she turned and passed her hand through his arm.
دی گه صلاح نیست بیشتر از این دم میز شما بایستم. بهتره برم.	I'm afraid I'm staying too long at your desk here, don't you think?
تا جایی که چون پسرک به در خانهء خود رسید از او نیم جانی بیش بر جای نمانده بود.	so that when the boy got to his own door he had reason for being half dead.
مگر شاید برای آنکه با پای چوبی خود سوراخ قایق را بند بیاورم.	unless maybe to stop the plug hole with my timber toe.
ولی از بی گناهی او سخنی بر زبان نیاورده است.	but not that he was notguilty.
کسی که نه جرئت جنگیدن با او را داشت نه دل اعتماد کردن به او را.	whom he has not the courage either to fight or trust.
دیروز هم خودتان توی آشپزخانه همین کار را کردید.	I saw you doing it yesterday in the kitchen.
وقتی موی دمشو کندم نزدیک بود به هم شاخ بز نه.	nearly gored me with his horn after I plucked his tail.
در دوران فراغت زناشویی خود را به نمایش خواهد گذاشت.	the broad leisure of marriage will reveal.
قول داد روز بعد تپانچه را نیز فراهم سازد.	promised to get him the pistol next day.
هیچ لباسی برای پوشیدن نداشت مگر پوست خرسی مه هنوز شکارش نکرده بود.	had he had no other clothes to wear than the skin of a bear not yet killed.
آن تصادف و یا هر چیز دیگری که سبب نقص پایتان شد.	accident or whatever it was that caused your lameness.
بلکه حریفان را همیشه برای کشتی یا پرتاب وزنه بخواهید	only to wrestle and throw the bar
تا پیش از همه با سر مهندسش که مشغول اجرای آخرین مرحله بررسی جاده بود ملاقات کند.	mainly for the purpose of meeting his engineer in chief engaged in the final survey of the road.
تأکید کرد که قبول این تقاضا موجب خواهد شد که او بیشتر به خود آید و برای اعتراف به گناهان نیرو بگیرد.	for that happiness would compose his mind and give him courage to make his confession.
او یکی از اعضای گروه خرابکاری بود که نیروگاه برق را منفجر کرده بود.	part of an ecotage group that had blown a power station.
با یک خیز به روی شانه جانی مرده پرید.	jumped for the dead man's shoulders.
به افسر نزدیک شد و از وی اجازه خواست تا با آرتور صحبت کند.	approached the officer and asked permission to speak to the prisoner.
در آن دم که سانکو حیران و متفکر ایستاده بود	as he stood there dumbfoundered and moody
خود آمده بود اطلاع دهد که عزیمت فوری شاهزاده خانم ماریا ضرورت دارد.	who had come personally to point out to the princess the necessity for her prompt departure.
زن جوانش روی چهارپایة کوتاهی در پایین پای او قرار گرفته بود.	his young wife was on a stool at his feet.
هر ضرر و زیانی از نبرد ما حاصل شود مسئولیت آن متوجه شخص شما خواهد بود.	all the harm and mischief that may come of our quarrel will be put down to your account.
این سخن برخلاف نیت من باعث شد که عقیده او درباره فهم و ادراک ما سست شود.	it gave him directly contrary to my intention a very mean opinion of our understandings.
عمویش برای این اظهار عقیده دلیل خاصی داشته است	her uncle had some special reason for delivering this opinion
این درست همان کاری است که این همه به من هشدار دادید از آن احتراز کنم.	that is the very thing which you have so often cautioned me not to do.
وقتی برای مبارزه با ان هیولا پا پیش بگذاری	when you step out to face that creature
من هیچ وقت درباره این جوان هیاهو به راه نینداختم.	I never made any fuss about the young fellow.
تا وقت یکه این اندازه نیرو و جوانی دارم باید از آزادی خود استفاده کنم.	I must use my freedom while I feel so much strength and youth in me, he said to himself.
داشتم برمی گشتم بروم که یک قدم پشت سر من برداشت و بازویم را گرفت.	I started to turn away but he took a step after me and grabbed my arm.
آنهم به مجلسی که به تصدیق من راه یافتن در آن محتاج رنج و خرج فراوانست	which I allowed to be a great trouble and expense
لکن در هرقطعه هزار فرانک سود داشت فلهذا چشم از تفتیش او پوشیده و چیزی اظهار نکرد	but the cunning purchaser asked no troublesome questions concerning a bargain by which he gained a round profit of at least eighty per cent
به محض این که در رختخواب دراز کشیدم به خواب رفتم.	a slumber fell on me as soon as I lay down in bed.
ما حیوانات باید در این مبارزه یک دل و یک زبان باشیم.	among us animals let there be perfect unity, perfect comradeship in the struggle.
موهای چند نقطه از بدنش نیز ریخته و گر شده بود.	patches of fur seemed to have fallen out too.
او نیز که وقت کمی داشت با عجله و ژستی تهدیدآمیز تپانچه را که در جیب خود داشت به او نشان داد	who, merely pausing to show him with a menacing gesture that he had that same pistol in a side pocket of his great coat
خوب تا هفته دیگر راه درازی در پیش است.	well, next week is a long way off.
او را به آغوش گرفتم و سرش را بوسیدم.	I kissed the top of his head.
او تا آن لحظه به ندرت به جنسیت خود فکر کرده بود.	up to this moment she had scarcely given her sex a thought.
بی آنکه مقصد معینی داشته باشند آن راه را به امان خدا در پیش گرفتند.	nevertheless they returned to the high road, and pursued it at a venture without any other aim.
به زحمت خودم را از آن خاطره بیرون کشیدم.	I wrenched myself back from the memory.
نمی دانشت باید پنجره را ببندد یا باز بگذارد.	wondering whether to slam it shut.
در آنجا به تنه تنومند درخت زبان گنجشک کهن سالی تکیه داده بود.	leant against an old ash tree
من اگر از گرسنگی و تشنگی هلاک شوم در اینجا چیزی نخواهم خورد!	I wouldn't eat or drink here, if I were starving.
پاهایش را روی زمین کوبید و از اتاق بیرون رفت.	slouched out of the room.
به من پیشنهاد کرد که دستمال خیس را روی گردن اسب پهن کند تا خشک شود.	proposed that my pocket handkerchief should be spread upon the horse's back to dry.
درصورتیکه شوهریان زن هر سال پنجاه لیور عایدی دارد.	though her husband has fifty thousand francs a year.
فردا هم همهٔ کارهای خود را رها ساخته و عقب او برو و بکوش که او را پیدا کنی	go again tomorrow and make haste, leave everything and make haste.
اما از این گناه چنانکه شایسته است نادم نگشتم.	but I did not sufficiently repent.
یک نگاه به او کافی بود تا موقعیت مادر بودن او را دریابد.	for the first time one could tell just by looking at her that she was a mother.
من حدس زدم که مطلب مربوط به من است.	I then conjectured might relate to me
با این حال سرآنجام توآنستند دو چادر دو نفرهای رنگ و رو رفته را برپا کنند.	they finally managed to erect a pair of shabby two man tents.
اما دختر سربریز افکنده بود و شروع به گریه کرد.	but she looked down on the ground and began to cry.
لکن از برای فهماندن مقصود همین هزار کلمه مرا بس است	but I certainly should have no difficulty in explaining my wants and wishes
پیش از اینکه بنشیند آن را سر جایش گذاشت.	passed the bottle before he sat down again.
غیر از دردسر چیزی با خودش به اینجا نیاورده است!	he has brought nothing but trouble here!
یا تکذیب صدقش محقق گشته و تصدیق خواهد شد.	or confirmed by some one who has a right to do so
بوی گرم و تند گندم تازه کوبیده همراه با گرد سپوس دهکده را فراگرفته بود.	pungent scent of newly threshed wheat and a chaffy dust enveloped the village.
آن شب همه جا غرق نور و روشنایی بود وپرازقهقهه وسروصدای میهمانان بود	when it was brightly lit and crowded with laughing guests.
اما پیش رویش مزارع سبز و زمین نرم و مردابی قرار داشت.	but in front of him was the autumn sowing where the ground was soft.
پس بهتر است که تو نیز بروی و بخوابی.	perhaps I had better go to bed.
من آهسته برگشتم و بهش خیره شدم و از تعجب ابروها مو بالا دادم.	I turned slowly to stare at him, raising my eyebrows.
هر یک از سه دکل بزرگ و بلند در آن هوای گوگردی	each of the three tall masts was silently burning in that sulphurous air
او را در آن پرورشگاه گیاهان برگزیده خواهیم گذاشت	she shall be placed in that nursery of chosen plants
ولی احساس کرد پشت گردنش از عرق خیس شده است.	but a thin shine of perspiration had broken out on the back of her neck.
پول مشروبی را که صرف کرده بودیم پرداختم و اتفاق بهرستوان ارزان و شلوغ و با نشاطی رفتیم و با لذت شام خوردیم.	I paid for what we had drunk, and we made our way to a cheap restaurant, crowded and gay, where we dined with pleasure.
او یک زن نیک را با گرد علوفه از همین مرض نجات داده بود.	who had cured an old woman of a malady similar to my own cured her merely with a little hayseed.
در حالی که هیچ کس در آن حوالی نبود.	though there was no one about.
از ای نرو کسی را دچار دردسر نخواهد کرد	so as to cause no one any inconvenience
مطمئن نبودم که باید انتظار چه چیزی رو داشته باشم.	I wasn't sure what to expect
هر دو با هم گریستیم و آن روز در تمام مدتی که آنجا بودم هر دو اشک ریختیم.	we cried, both of us, the whole time I stayed
ولی دختر با حرکتی ناشی از خصوصیت اخلاقی خود دست او را پس زد	but she stopped him with an impulse typical of her character.
که پدرم من را در آن زنده دفن کرده بود	in which my father buried me.
بعلاوه کلید همه چیز خانه در دست او است.	besides she kept all the keys.
دست دراز کرد تا او آن را بگیرد و بالا بکشد.	snuggled down beside him with her arms as far around his chest as they would reach.
گلوله کما نه کرد و بجای دیگری برخورد و دوباره زوزه کرد و ازحرکت ایستاد.	ricocheted, struck something else, and whined off again.
خیلی کم و آن هم خیلی کوتاه مدت به او ارزانی داشته بود.	only once and for the minimum time necessary
هیولا به اون بدی که ظاهرش ون نشون می ده نیستن.	monsters aren't as bad as they're made out
او را از کیفیت حال با خبر سازد و او با چشم گریان به حکایت ندیمه گوش فرا دهد و به او بگوید که بزرگترین غمی که در دل دارد این است	who listens with tears and says that one of her greatest distresses
مرا حلال کن و دیگر از این مقوله چیزی نگوییم.	forgive me, and that will do.
آنگاه برای اولین بار متوجه اطراف خود شد و تصاویر سر بخاری توجهش را جلب کرد.	then, for the first time, allowed himself a glance round the room and a look at the pictures.
هرچند در سایه زیبائی خود و ثروت بیشتر والدینش در مرتبه بالاتری از برتین قرار داشت	though of a superior station in her set, since she was so very attractive and her parents possessed of even more means
اما هوا به قدی داغ بود که تا جنگل بیشتر نتوانستم بیایم.	but it was so unbearably hot that I got no further than the forest.
من اهلام کردم که حق دارد از ما بترسد.	I have said that he had reason to fear us.
چیزی شبیه به شورت فوتبال بچگانه به پا داشت.	a pair of what looked like children's soccer shorts
دستیار دکتر سعی کرد به سرعت گیتارش را پنهان کند	the practicante endeavoured to conceal his guitar hastily
شاید دلیلش ای نه که یک زن حامله اصلاً منو متعجب نمی کنه.	in view of the fact that pregnant women do not embarrass me as they should.
ولی البته نباید کاری به کار سود معقول سهامداران داشته باشند.	though, naturally, they mustnot interfere with the reasonable profits of stockholders.
تا زمانی که قهقههی سهمناک را نشنیدم متوجه نشده بودم که او تنها نیست.	I hadn't realized that there were others with him until I'd heard the loud laughter.
گفتی انتظار داشت که تغییرات در میخانه به وقوع پیوسته باشد.	as though it were in the bar room that he expected the changes to have occurred.
تا به او خیر دهد که بساط خیمه شب بازی آماده است	to tell him the show was now ready
با مقداری آب سرد و اندکی نمک به هوشش آوردیم.	a little cold water and salts and that soon brought her back again
ضمن ادای این سخنان بار دیگر دورو ته را گرم در آغوش فشرد	with these words he once more embraced her
از جیبش یک برگ رسمی بیرون کشید و تنظیم صورت مجلس را آغاز کرد.	drew a stamped paper from his pocket, and began to prepare his report.
منقاش و چکش را از جیب بیرون آورد و تخته سر تابوت را بلند کرد.	seized hiscold chisel and his hammer, and pried up the coffin lid.
همچو به خودش فشار داد که تام دید از هرچه هرزه است گناه کارتر است.	in a crushing embrace that made him feel like the guiltiest of villains.
به در گلخانه که پدرش در آنجا خوابیده بود نزدیک شد و به صدای او گوش داد.	going to the door of the conservatory where he slept that night had listened at the door.
چنانکه گفتی در همین نقطه منتظر او بوده است.	as though she had been waiting for him there.
ناگهان تغییر حالت داد و مهر و علاقة خویش را ظاهر ساخت و مرا نیز به این کار دعوت کرد.	she was, at once, so proud of him and devoted to him, yet so compassionate and sorry
او را از زمان دختری خود به یاد دارد.	she remembered him from her unmarried days.
آن قانون این بود که برای آن که بزرگ و کوچک را نسبت به کاری یا چیزی راغب کنیم	that in order to make a man or a boy covet a thing
چون که دیگر استحکام سابق در سخنش وجود نداشت	as her temporary firmness forsook her
دو مرد در حال به داشتن تابلوهای نقاشی از دیوا رنشیمن بودند.	two men were removing paintings from the walls of the drawing room.
بر اثر فتحی که آخرین بار نصیبش شده بود خود را دلیرترین پهلوان جهان در عصر خود پنداشت.	fancying himself the most valorous knight errant of the age in the world because of his late victory.
با انتقادتان طرح ضعیف مرا یکباره نیست و نابود کردید	you annihilated my poor sketch with your criticism.
مگذار که حالا بیش از این به خاطر تو دچار ناراحتی بشوم.	don't let me suffer more for you, just now.
برای جبران ستمی که بر ویل رفته بود آزادی نداشت.	her hands had been tied from making up to him for any unfairness in his lot.
دستور مجازات شکارچی را که به خود اجازه داده روباه را از دهان سگان بیگانه برباید صادر خواهد کرد	would have the man punished who had allowed himself to seize a fox hunted by someone else's borzois.
شاید بتوانم دوستانی را پیدا کنم که او را بشناسند	I could probably find some friends who know him.
خود را نزدیک ساحل و در پنج متری دخترک یافت.	he was quite beside her, some twenty feet from the shore
ظرف چهار سال گذشته حتی یکبارهم بدی دن خواهرش نیامده بود	had not come to see her for four years
چون افتاد صدای سلاح رزمی را که در تن دارد شنیدم.	his armour rattled as he fell.
بی درنگ قاچ زین را محکم چسبیده به اسب مهمیز زد	he clutched the crupper of his saddle and, spurring his horse
پس از آن از اتاق بیرون رفت و در را باز گذاشت تا از فرصت استفاده کنم.	retired, leaving the door open, that I might avail myself of that permission.
وکیل و بورس باز ثروتمندی که زن خود را از دست داده	a prosperous lawyer and widower and speculator of this region, who
امیدوارم که بیشتر از بعضی دیگر از پیروان من دوام بیاوری.	I hope you last longer than some of my other followers.
من نباید از آنچه برای دیگران یک بدبختی است شادی کنم.	I ought not to rejoice in the misfortunes of others.
کلاه در دست در بیرون در از او پذیرایی نمود.	received the traveller at the door, hat in hand.
با وجود این چون در این موقع جیب شما کام لا خالی است اجازه دهید این بیست و پنج روبل را به شما تقدیم کنم.	you must allow me to press these twenty five roubles upon your acceptance, as something to begin with.
این خانواده از چوپانی حقیر و گمنام ریشه گرفت	which from an humble and lowly shepherd, its founder
من هم می تونم توی شهر به مو نم و مشتری پیدا کنم.	I can stay in town and see to the selling while they handle the milling and hauling.
چون تو از هر کس دیگری که تصورش را بکنی برای من عزیزتری.	for you are dearer to me than anybody can conceive.
بر روی هم فقط یک ساعت و نیم به درازا کشید.	the trials of the whole occupied an hour and a half.
آنجا اتاقکی بود با یک سقف ناهموار و پر از گرد و خاک و تارهای عنکبوت.	a long, low ceilinged room, dusty and spattered with cobwebs.
حالتی را در خود شبیه به وزش نسیمی بر بدن انسان که گویی تارهای روانش را مرتعش ساخت احساس کرد.	she felt something like a fresh breeze wafted into her soul.
با لبخندی سرشار از خلسه و شادی دستانم را باز کردم و نشستم	I spread my arms with a blissful smile and sink down onto a chair.
لینتون نیز پهلوی وی قرار گرفت و به او تکیه داد.	he reclined beside her.
بد بختی این بود که یون یس او را پیر بداند.	he wretched that she should considerhim old.
حتی به قیمت ایجاد یک رسوائی به وی اعتماد کرده بود.	even at the cost of a certain amount of impropriety.
لکن اینک ابرو درهم کشیده و سرش را آهسته به عالمت تأیید تکان داد	but now knit his brows and nodded his head slowly
آمده بودم به تو تبریک بگویم. خیلی استادانه بازی کردی!	I came to congratulate you on the inquest this afternoon.
اساتید نیز از راه رسیدند و سر جای خودش آن نشستند.	the staff entered, filing up to the top table and taking their seats.
احساس تنهایی او از آن گونه بود که از غمخواری دیگران بیزار است.	his was that worst loneliness which would shrink from sympathy.
او نیز از راه منحرف شد تا به ما راه بدهد.	while they too put the helm hard up to let us pass.
والانتین تبسمی کرده و دست برده و گیلاس را گرفته و خورد	who smiled and swallowed the rest.
چنین تصور کردم که بی درنگ به نزاع خواهند پرداخت.	 I thought, 'they'll fly at each other.
در آن وضعیت بغرنج و بحرانی به یاری اساتید بشتابد.	to support the teachers during this troubled time.
داخل آن شدند و دنباله صحبتشان در تاریکی فرورفت.	they entered, and the remainder of their confidential colloquy was lost in shadow.
امانمی توانم آنچه را میان من و آن زن گذشت	but I cannot write the words of our conversation.
چون بجز در این مورد خاص در آیین پهلوانان سرگردان نبود که خورجین به ترک اسب خویش ببندند.	because, unless for some such reason, carrying saddle bags was not very favourably regarded among knights errant.
درست مثل موقعی که با کمد گاو رهای جوان را به دام می کشانند.	as if they were cattle on the hoof.
نه برای اینکه این مزا وجه امری مناسب و اسباب خوشبختی دخترش بود	not only because the match was good
او را یک فرد یاغی ماجراجو اعلام کرده و نماینده یا سخنگوی حزب خودشان ندانستند.	branded him in adventurer who did not represent the party.
والا گیر میفتیم و بعدم جسدمونو تو صندوق عقب ماشین پیدا میکنن.	or we're gonna get caught and wind up in somebody's trunk.
بعضی پنجاه و بعضی تا شصت پا بلندی داشتند.	some fifty, some nearer seventy, feet high.
حسی خشم آلود در وجودش برخاست و در پیرامون قلبش متوقف شد.	an angry feeling rose in her and stopped around her heart
دلم میخواد پیش از اینکه از گشنگی بمیرم کسی رو که منو به گشنگی انداخت بکشم.	I don't aim to starve to death before I kill the man that's starving me.
بلکه آن را به سبک سری و تمایلات غریزی زنان تعبیر کردند.	but to wantonness and the natural disposition of women
بلکه به سبب نیروی شخصیتی که بسیار بارز بود.	also because she had remarkable strength of character.
فقط شرطش این است که مزاحم دیگران نشویم یعنی حق نداریم زیاد مهمان داشته باشیم.	the only requirement being that we do not disturb others we are not supposed to entertain on a large scale.
حتی نشان دهد تا چه حد از اندیشه نثار کردن زندگیش به پای او شادمان است	even pouring out her joy at the thought of devoting herself to him
انگار تماس دست من به او جان داده بود	as if my touch brought her to life.
با ین علت است که انسان است و ناخوشو فقیر هم هست.	it's because he's a human being, and he is ill and poor.
با صوتی زیر ولی آشکار فریاد زد هکنیاد گول .	cried out in a shrill but distinct voice, _Hekinah degul_.
کلاه قهوه ای رنگ مخصوص نوانخانه را بر سر نهاد	the littlebrown cloth parish cap on his head
من هم دویدم اما دیر شده بود و نتوانستم پا به پای آنها بروم و در نجات دادن آن غریبه که چهارپایهاش روی زمین افتاده بود کمک کنم.	I ran out, too, but was too late to follow them and help in the rescue of the stranger, whose animal had fallen.
این مناظر پراکنده نیروی تخیلم را تحریک کرده و قدرت خلاقه ای به من داده است.	the fragments stimulated his imagination and made him constructive.
در حال دویدن به سرعت شلوار کم رو پوشیدم.	I untied my shorts and yanked them on, already running for the house.
اما چیزی نگفتم که اندکی آنان را قانع کند	but I gave them very little satisfaction
که صدای دیگری از جانب استیل کی لت بازوی بالا رفته او را متوقف ساخت.	when another hiss stayed his uplifted arm.
با پا در آب رفتم تا به صد قدمی زورق رسیدم	waded till I came within a hundred yards off the boat
فقط سعی کنید از جمله ده قربانی او نباشید.	take care you don't get included among the ten victims!
شمعی درلاله و یک تنگ آب در کنار صندلی راحتی شوهرش آماده بود.	where a shaded candle and a decanter of water were already put by his armchair.
چگونه آن گذشته که مرده بود و تمام شده د	how is it that it has escaped
برای من حکایت کرد نیروی عظیمی برای مقابله با او گرد آمده!	has been telling me what forces are being collected against him!
خون به طرف بالا جوش زده مشاعر او را گرفته شعور از وی سلب گشته	he griped the flesh on his chest until his nails were stained with blood
مرا به دسته نیرومندی از محافظان سپردند تا از گستاخی و یحتمل شرارت اجامر و اوباش مانع شوند.	I was left with a strong guard, to prevent the impertinence, and probably the malice of the rabble
نباید به خوابیدن در چمن یا گندم زار میل و رغبت بنماید.	not offer to walk, or lie down, in a meadow or field of corn.
باز شروع کرد به تنگ کردن جا و فشار را به جایی رسانید که نزدیک بود قالب تهی کنم.	 bore down upon us as before, until the breath was nearly edged out of my body.
وانگهی چه فایده دارد که حرفم را تمام کنم شاید عصبانی بشود.	under the circumstances, he had no choice but to answer me.
افکار او چقدر از مباحثاتی که دوستانش در پیش داشتند فاصله دارد.	that her thoughts were occupied with matters very different and distant from those in the course of discussion by her companions.
از سرسرا گذشته و داخل دهلیز قسمت غرب بنا شدم.	I went through the hall and up the great stairs
من را ببوس من را ببوس من را ببوس.	kiss me kiss me kiss me.
به جای راحت بودن هم زیادی سر به هوا.	impudent where he might be allowed to be easy.
بنابراین باید که من از کیفیت حال با خبر شوم.	it is fitting and necessary that I should know,
لوازم آن خریده شد و درست کردن دمپایی شروع گردید.	the materials bought, and the slippers begun.
روزی بامدادان ارباب اندکی زودتر از موعد معمول مرا فرا خواند.	my master sent for me one morning a little earlier than his usual hour.
سپس بتن دی خود را تا عروسک دختران تناردیه لغزاند و بلندش کرد.	then she slipped quickly up to the doll and seizedit.
دریا را بگردند و به اصطلاح همه افق را زیر و رو کنند.	so sweeping a double horizon, as it were.
برای عبرت و تحسین قرون و اعصار آینده در دفتر شهرت و افتخار ابدی ثبت گردد.	on which I shall do deeds that shall remain written in the book of fame for all ages to come.
از سوراخ به طرف اتاق فاریا رفت و چون به آنجا رسید سوزن و نخ فاریا را برداشته و خود عریان داخل جوال شده و به همان طور که فاریا را در جوال خوابانیده بودند خوابید و جوال را از داخل دوخت	entered the tunnel again flung off his rags and getting inside the sack placed himself in the posture in which the dead body had been laid and sewed up the mouth of the sack from the inside
ولی حرف زدن در مورد این چهل هزار روبل بودجهی شورا که چطور مصرف شود	but deliberating on how to spend forty thousand roubles of district council money,
من حماقت کردم شما را با هم آشنا کردم.	I was a fool to bring you together.
آنگاه چکاچک فولاد در فضای تالار پیچید و سپس فریادی از درد.	clash of steel followed, and then a cry of pain
بعد از آن به شکار خرگوش رفته بودند و به خودشان زحمت غذا دادن به حیوانات را نداده بودند.	then had gone out rabbiting, without bothering to feed the animals.
اگر آنگاه زن این طبیب به استغائه پیش شاه رفته بود و دست به دامان ملکه زده بود	if his wife had implored the king, the queen,
ناتاشا با جامه خواب و موی ژولیده خود را در شارپ بزرگ دایه پیچیده شتابان داخل اتاق شد.	not having done up her hair or finished dressing and with her old nurse's big shawl wrapped round her.
ولی اِما وقتی از هریت خداحافظی کرد همچنان روی این تصمیمش ایستاده بود	but she left her with every previous resolution confirmed
به هر قیمت که هست او را بیابد و رها نکند	so firmly resolved to find him and not to give up doing so
فقط لطف کنید در مورد این شورش وحشتناک برایم توضیح بدهید.	but have the goodness to satisfy me as to this dreadful riot.
تا بدان حد که احساس به روی کاغذ آوردن آن در او تقویت شده بود.	to the point where he almost felt equal to writing it down.
او را نیز چون دیگران و بلکه بیش از همه کس دشمن شمرد.	she came to hate him also, and most of all.
کسی که در معیت یکی از آن ضاربان بود به فرمان شاه نزد من آمد.	a person was sent to me by the king's order, attended by a flapper.
اشلی لبخندی ضعیف بر لب آورد تا او را دلداری دهد.	he smiled up weakly, reassuringly into her face.
صندلی خود را اندکی از کنار بخاری دورتر برد.	hitched his chair a very little morsel farther from the fire.
زیرا من در آن هنگام نتوانستم در آنجا بمانم و فرجام آن حادثه را بنگرم.	for I durst not stay to see the issue of the adventure.
سپس پنجره را بستم و به سوی تختخواب رفتم و پهلویش نشستم.	I closed it, and returned to my post.
با دوربین جیبی خود نگاه کردم و چشمم به چندین جزیره در جنوب شرقی افتاد.	I discovered, by my pocket glass, several islands to the south east.
من تا بتونم برای اثبات فداکاریم نسبت به دیر خواهم کوشید.	I will do anything to prove my zeal towards the community.
به اطرافش نگاهی انداخت تا ببیند چه کسی در زده است.	looking around to see who had knocked.
که زنجیر باریک و زیبایش در بر روی جلیقه سفیدش بسیار نمایان و زیبا بود	so fine that the slender gold thread was scarcely perceptible on his white waistcoat.
آنگاه یک رشته سخنان دیگری مبنی بر فروتنی خود به زبان آورد	then he made a great many other remarks, no less illustrative of his humility
امیدوار بود در آن جمع همانند او بسیار باشند.	hoped there were many like him.
همه را به خاطر او از میان برخواهم داشت.	they should all be obliterated for her sake.
به نظر من او دختری پاک دل و شایسته ترحم است.	I think she is awfully nice and pathetic.
ولی مشخصات او را به خوبی به خاطر سپرد.	but fixing her name and address with care in his memory.
یا تصور کنیم که این مرگ دلیلی غیر از دلایل طبیعی داشته است.	or to imagine that death could be from any but natural causes.
سپس روی رختخواب دراز کشید و مرا بل کرد و به رختخواب کشید.	he flung himself back on the bed, and dragged me down with him in his arms.
آفتاب درخشان و ابرها گاهی همراه با برف و بوران به موقع و پراکنده است.	bright sunshine and clouds interspersed with a few welcome snow storms.
سایر دریانوردان فقط حق عبور از آن دریاها را دارند.	other seamen having but a right of way through it.
که یک وقتی با او نزاعی کرده و او را به مبارزت دعوت کرده بودم او مبارزت را رد کرد و قبول نکرده بود	I had quarelled with him some time previously and had even challenged him to fight me but he refused
روی این پوتینها یک جفت گالش بزرگ پوشیده بود.	with big galoshes drawn over them.
بلکه حتی انتظارش را هم داشته که چنین خبری از من بشنود.	that he was rather in expectation of hearing something of the kind.
از رفتار خشک و بدگمانی او آنقدر آزرده شدم که اشگ در چشمانم جمع شد.	I was so hurt by her coldness and scepticism, that the tears rose to my eyes.
آن را مثل یک بمب جلویش نگه داشته بود	holding it before him like a bomb
وزغش باید تبدیل به یک نوزاد قورباغه به شه	it will shrink to a tadpole.
از دید چشمان کج بین به بیت زنش هرگز نتوانسته بود تکلیفش را با سر و وضع خود یکسره کند.	to his jaundiced eye, never seeming to get on withher dressing.
قصد آن کرد که سر بر سینه فروتنی فرود آورد و راه خود گیرد.	he would have modestly withdrawn himself
او را در آنجا آهسته و آرام به شن بنشانم!	beach her quietly there.
اول پائین چراغ را بالا نگهداشت واز سه پله رفت	holding the lamp aloft and went down the first three steps
که چون شدت نخستین آن اطاق را گرم کرده است	after its first intensity has warmed the air
در جامه دان کوچکی که توانسته بود فراهم آورد جای داد.	in alittle valise which he found means of procuring.
امید داشتم که آن زن مزبور به آنجا بیاید	I was hoping that the woman with fair hair would come in
دواخونه هاتون رو فهمیدم از چه قماشی بوده ن.	I found out what your 'drug stores' were.
اما خواه شک و خواه انکار فقط چند نفری برداشت درونی دارند.	but doubts or denials, few along with them, have intuitions.
هیچگاه حالت نگاهش را مثل این دفعه واضح ندیده بودم. با تأسف متوجه شدم که لاغری ناشی از کار سخت یا اندوه بر آن چهره سنگ مانند چقدر به وضوح نقش بسته.	where it grieved me to discover the hollow trace of care or sorrow now so plainly graved.
در شگفت بودم که چه چیز زنی چنین زیبا و مردی با این تحصیلات عالی را به زندگی در چنین مکانی واداشته است.	I could not but marvel at what could have brought this highly educated man and this beautiful woman to live in such a place.
اما وضع و لباس و موقعیت او در آن وقت موجب شد که چهرة دیگری از و در خاطر راسکلنیکف نقش بندد.	but at such a moment, in such surroundings and in such a dress, that his memory retained a very different image of her.
اما قبول کن ین که خیلی سر به هواست.	but you can't pretend he's not careless.
من هیچ وقت قبلا درباره او حرفی نشنیده بودم.	I have never heard of him before.
بعد از شام برگشتم حدود ساعت ده و نیم.	I came back after dinner, about half past ten
به او گفت که زن خوب نه تنها باید از ایجاد موجبات جنگ و نزاع برای شوهر خود اجتناب کند	it was the duty of a true wife not to give her husband provocation to quarrel
اما من به تعارف برگزار کردن شما ایرادی ندارم.	but I will not quarrel with YOUR light answer.
به الطاف و عنایات مدیر نوانخانه و مسئولین کلیسا سپرده شده است	left to the tender mercies of church wardens and overseers
اقرار کرد که هرگز رقصی به آن زیبایی و شگفتی ندیده است.	he thought he had never seen any so good as this.
اما اطمینان داشت هرچه باشد بهتر از چیزی است که پشت سر گذاشته بود.	but it had to be better than what he was leaving behind.
مقداری بیشتر وال نیز بر روی آب آمد و بار دیگر هر دو قایق آزادانه به پیشرفت پرداختند.	while the whale beyond also rose to sight, and once more the boats were free to fly.
اگر روزی یقین کنم که زنده جاوید خواهم زیست خود را باید به چه کار مشغول کنم و عمر خود را چگونه باید به سر برم.	pass the time, if I were sure to live for ever.
کار عظیم تعبیر و تفسیر اساطیر به کمک قیاس	the vast field of mythical constructions became intelligible
ولی به خوبی از کلیه مقررات این ورزش مستحضر بود.	knew the rules of the hunt well
بگذار شقایق به تخم بنشیند و میخک کنار کلم بماند.	let the poppy seed itself and the carnation mate with the cabbage.
چنین کسان همیشه وجود دارند و شماره ایشان بیش از یکی دو تا است	there are always not merely one but several such
حاضرم باهاش به شهر دیگری برم و عقدش کنم.	I would goaway with her and marry her.
بالا آمده بود و سر خاکستری و موی مجعد شیر مانندش دیده شد	raised by those who were holding him under the armpits, and of his gray, curly
ولی همان کافی بود تا صدای لرزان آشپز را کام لا قطع کند.	but enough to silence the cook's faltering voice completely.
لحن او با هر کلمه غمگین تر و غمگین تر.	her tone growing more forlorn with each word.
خاموش گرد پارو بزنان چنبره زده است این خود چیزی است	as it silently serpentines about the oarsmen before being brought into actual play
با این وجود باز هم مجبور بودند به نوبت ناهار بخورند.	even then they had to eat lunch in shifts.
محال است بروی و به آن شکل زندگی کنی.	you never can go and live in that way.
یه قدم دی گه بیاین و بذارین من سر طنافو بدم دستتون	if you'll only pull ahead, and let me heave you the headline
آهسته روی ساحل پوشیده از چمن پرید و به طرف جاده به راه افتاد.	swung herself down to the grassy bank, and took a roundabout way to the road.
کفشهای مرا چپ و راست مرتب پهلوی هم گذاشت	standing my boots right and left in the first dancing position,
این بگفت و با نوک کارد یک قطعه گوشت سرد خرگوش به سوی او دراز کرد.	so saying, he handed him the loins of a cold rabbit on a fork.
همیشه اول شب می خفت تا محتاج به روشن کردن شمع نشود.	always went to bed at nightfall, so that she might notburn out her candles.
دستانم را به طور ناخودآگاه دراز کردم و بند جوراب سفید رنگی در دستانم فرود آمد.	I held my hands out automatically, and the filmy white garter landed in my palms.
سبکدلی کودکانه ای که دالی در او بسیار دوست میداشت.	of childlike light heartedness that she particularly liked in him.
که در آن نامه با تضرع و التماس تقاضای ملاقات وی را کرده بود و از اندوه مفارقت خود داستان مفصلی نوشته و آرزوی خود را مبنی بر اینکه حاضر است تمام دوره زندگی خود را در راه رفاه و سعادت او صرف کند شرح داده بود.	who implored him to see her, telling him how grieved she was about him and how she wished to devote her whole life to him.
که تنها چیز سخت و محکمی بود که برتن داشت.	which was the one thing solid in his whole accoutrement.
انگار هر یک از آنها به نوبه خود احساس میکرد یک ابر اعتقاد همچون شکورزی و ناباوری میتواند مرد را در مسیرهای فرعی کنش سیاسی تا به افقهای دوردست راهنمایی کند.	as if each had felt respectively that a masterful conviction, as well as utter scepticism, may lead a man very far on the by paths of political action.
به خصوص که او کدبانویی قابل و برای فقرا دوستی مهربان بود	moreover active, and kind to the poor
من اصلاً قبول ندارم که دولت چنین هدفی داشته باشد.	I can't agree even,' said he, that the government had that aim.
به شدت مرا تحت تأثیر قرار داد که در چند لحظه اول درست متوجه نشدم	the livid brand which streaked it, that for the first few moments I hardly noted
نتوانستم تحمل کنم که در خانه منتظرتان بمانم مخصوصاً با این باد و باران.	I could not bear to wait in the house for you, especially with this rain and wind.
در حالی که شمع اتاق خوابش را به دست داشت	his bedroom candle in his hand
من به او تشر زدم و گفتم سرش به کار خودش باشد.	I snapped at him, told him to mind his own business.
ولی هرگز این طور روبروی هم قرار نگرفته بودند.	but they had never before been face to face as they were now
در خیال دید که لذت طبیعت را از آن خود ساخته است.	imagined its raptures and made them her own.
ده ثانیه بعد گوی زرین در دست هری بود.	within ten seconds had caught it tightly in his hand.
لحظاتی گذشت تا توانست از جا برخیزد و اندکی دورتر بایستد.	moments seemed to pass before he rose and stood at a distance from her.
هنگام خداحافظی مری دست او را بسیار سرد یافت.	his hand was very cold when she shook it.
سمبل همان نوع زندگی است که من دوست دارم.	symbols of the kind of life I love.
ولی دوباره صدای تِک . تِک . تِک . را از پنجره شنیدم.	but the tack tack tack came through the window again.
روی بستری دور از دیوار پیکری پوشیده با یک لحاف افتاده بود.	on a bedstead moved away from the wall, there lay covered with a quilt, a body.
انگشتری برات میارم که حتی دوستان پولدارت هم حسودی شون به شه و به گن چقدر بی سلیقه سکه این انگشتر بزرگ رو دستش کرده.	one so big that your less fortunate friends can comfort themselves by whispering that it's really vulgar to wear such large stones.
کیسهٔ پر از ماهی صید شده را بر دوش نهاد	hoisted the sack of fish over her shoulder
پس از مقداری که رفتند به سمت چپ پیچیدند.	then turned to the left up a cross street.
آستینش هم به طور نامنظم بالا زده شده بود	his shirt sleeves irregularly rolled up at various times this same arm of his
اما پس از مرگ برادرش ملک اربابی را هم به ارث برده بود.	but the death of his brother had put him in possession of the manor also.
در اینجا فقط صد روبل پول است و نه دویست و پنجاه روبل!	there are only a hundred roubles here, not two hundred and fifty.
به دنبال مشعل داری که پیشاپیش حضرتش در حرکت بود	with his flambeau bearer going on before
یقین دارد که آن یاهوی نر به دنبال وی به همان جا خواهد رفت.	where she knew the male would follow her.
علاوه بر آن هوریج آدم حساس و زودرنجی است.	it's so easy to get nervy and irritable.
به محض این که جرئت کردم آن را برداشتم	as soon as I dared, caught it up
وقتی که برگشتند و به همان راهروی اول رسیدند	when they had regained the passage.
این پسرک نزدیک یک ماه قبل از خانه و پدر و مادرش گریخت	he ran away, near a month ago, from his parents
به عنوان اینکه باید اعترافات او را بشنود با این امر مخالفت ورزید.	but the priest who was standing by objected to its being withdrawn before he had confessed him
برای یک نفر خریدار ممکن نخواهد بود که بدون اعلام هویت خود این سهام را خریداری نماید.	it would not be possible for one purchaser to buy these shares without declaring his identity.
آن شش نفر سرباز مسلح نیز مأمور مراقبت از آن شدند.	which was watched over by the six soldiers.
من از او پوزش خواهم خواست و قضیه فیصل خواهد یافت	I shall beg his pardon, that's all.
درب سوراخت را با کمال دقت بگیر و دیگر نقب مزن و کار دیگر هم مکن	stop up your excavation carefully do not work any more
شاید که هیچ قدم هم بر این جزیره ننهاده	perhaps he never came here
من نمی خوام هیچ کدام از شماها نگران من باشد.	I don't want either of you to be worried at all.
چون ما مور اجرایی در عالم ارواح بر شانهء او کوفت	touched him on the shoulder like a ghostly bailiff.
مردی که قانع شه و سکوت وی را خریده بود.	the man he was convinced he had silenced with money.
کوشید تا دوباره خواب خود را که بر اثر ورود او قطع شده بود از سر گیرد.	resumed the slumbers which her arrival had interrupted.
من از دایره بیرون او مدم. پشتم رو به طرف سم کردمو به طرف غرب رفتم.	I left the circle, moving toward the west so that I could turn my back on him.
تا پیش از آنکه کار به این بدبختی بکشد به علاج او بکوشید	that you might put a stop to them before things had come to this pass, and
من در پنهانی رنج خواهم برد و جنایتم را باز خواهم خرید	I shall expiate everything by this secret agony.
زانویش را بالا گرفت و ورقی را از دفترچه کنده روی زانو گذاشت	raising his knee began writing in pencil on a page he tore out.
به او گفته بود تصمیم دارد در کتاب خود نشان دهد که	with something of the archangelic manner he told her how he had undertaken to show that
هنوز طنین انداز گوش او بود که با دمیدن روز هوشیار شد	when the weary passenger started to the consciousness of daylight
حتی به امر او در را نیز برویش بستند.	for he desired this, and even that the door should be locked.
ناگهان برق طلایی رنگ و پر و بال ظریف آن را دید.	a glint of gold, a flutter of tiny wings
وی دیگر آن بینی عجیب را که زشتش کرده بود به صورت نداشت.	now without the nose which had made him so hideous
حالا که از محکمه بیرون آمده حالش بهتر شده است.	she feels the better for being out of court.
تاریکی غلیظ شب و ضعف قوه دید باعث شد که نتوانم آن را تشخیص دهم.	what form, the pitch dark night and my enfeebled vision prevented me from distinguishing.
البته حالا دیگر لازم نیست برای شما بگویم که دامی گسترده شد تا او را بربایند و پیش از اینکه من موفق شوم سرگذشت او را بدانم او را ربودند .	I need not tell you he was snared away before I knew his history
برای این است که از من انتظار خدمتی دارید	you should find that there is anything else in my power
دریافته بودم که زندگی همة مردان با شرفی که در کشتی بودند	I understood that the lives of all the honest men aboard
این بود که مثل تیر پا به دو گذاشت.	so he picked up his nimble heels and flew.
تا اینکه بتوانم خود را تا آنجا که ممکنست از نسل یاهوهای ملعون ممتاز کنم	in order to distinguish myself, as much as possible, from that cursed race of _Yahoos_
ما بعد از مرحله اول مسابقه دی گه ندید مش	we haven't seen him since the first task.
در همان لحظه صدای سم اسبان اسواران خود را شنید	immediately, hearing behind him the tramp of the horses of
در همان حال به او وعده دادند کارش را بزودی پیش رویش بگذارند.	with a promise that he should have his work presently.
هدیه شما را زیر آن لباس در جعبه دیدم	under it in the box I found your present
وقتش بر سه من می گم به کجا نشانه بری.	I'll tell you where to aim it when the time's right.
حتی الا مکان با هر چه که بدست آید زندگی خواهیم کرد	get on as well as we can
تا آن کسی را که در زندگی دوست داشتیم از پاداش عادلانه و ابدی برخوردار باشد.	that she whom we loved in life shall enjoy her just and eternal reward.
رفتم زیر میز و پالون را بلند کردم و دست به کار شدم تا زیر اولوار را اره کنم و جا به قدر خودم باز کنم.	I got under the table and raised the blanket, and went to work to saw a section of the big bottom log out big enough to let me through.
این علامت این است که مطمئناً این خانواده جنی شده است.	that's a sure sign that something is wrong in this family.
بلکه از صمیم قلب کوشید تا نظر این ارباب جدید را جلب کند.	but merely did his utmost to gain his new master's favor.
بلکه بر اثر یک حادثه غیر طبیعی که ممکن بود هیچ ارتباطی با جریان کار نداشته باشد تحصیل کردم.	but thanks to a certain strange circumstance which had perhaps no connection whatever with the matter at issue.
در هر صورت نزدیک یک هفته است که حتی یک وعده غذا نیز با ما نخورده است.	but he has not eaten a meal with us for nearly a week.
شاید هم واقعه بهانه قطع رابطه را قبول کرد.	in the pretext he gave for their rupture
من حاضرم باهاش یه پیراشکی رو پنجاه پنجاه قسمت کنم!	I'm ripe to go fifty fifty on a doughnut.
سرانجام با موافقت مادرش تصمیم گرفت به لیکرگس بیابد	finally arranged with her mother to leave in order that
تا ذخیره روغن ارزان برای مصرفی داخلی تمام نشود	to keep up the supply of cheap oil for domestic employment
دیگران پیرامون سر و روی من به پرواز درآمدند	others flew about my head and face
من در ظرف چند ثانیه می تونم استخونارو ترمیم کنم	I can mend bones in a second
ما در پیدا کردن نام شما و آدرس شما زحمات زیادی متحمل شدیم.	we've driven up to see you today because we found your name
سپس آن را چندین بار با سنجاقی که از آستین خود درآورد زیرورو کرد	afterwards turned it several times with the point of a pin which he took out of his sleeve
من نیز سرانجام ناامید شدم و سفرم را به سوی خانه آغاز کردمو	I, too, despaired at last,and I began my homeward journey.
ولی خیلی واضح گفت که سوء تفاهمی در کار بوده.	but that there had been misunderstandings he decidedly said.
با ژنرالی که با وی آشنایی داشت به گفتگو پرداخت.	remained at the entrance talking to some generals of his acquaintance.
از بالای کوه به پایین دویدم تا وضع انفجار مین را بررسی کنم.	I ran down to the ruins to see what the mine had done.
شمشیر افسری شرابه داری را به کمر آویخته بود.	an officer's saber with a sword knot.
صد فرانک یعنی تمام دارائی این زن خوشبخت در آنست.	there are a hundred francs in it, all that such a fortunate woman as I can call her own.
چون دوید تا اگر لازم باشد به ارباب کمک کند	on which he hastened to join him and help him if it were needful,
نفس را در سینه حبس کرده به دقت گوش داد.	listening with breathless interest.
یک صندلی بی تکیه گاه کوتاه بود که در جلوی پیش بخاری مرمر قرار داشت.	, was a low ottoman near the marble chimney piece
زیرا هر لحظه ممکن بود بغضش بترکد و گریه کند.	looked as though he might cry.
من بی آنکه مقصودی داشته باشم چند کلمه در پاسخ او سخن گفتم.	I answered in few words, but to no purpose.
هرگز او را چنین بدخوی و عیب جوی دوستان غایب ندیده بودم.	I had never heard her more malicious about our common friends.
باید فردا هم با جدیت و فعالیت بیشتری دنبال این کار رفت!	we must get back to this tomorrow rather livelier.
اثری که در دل جرالد باقی گذاشت هیچ زنی در تمام دنیا نگذاشته بود.	she went to his heart and made him more gentle with her than he had ever been with any person in all the world.
گمان کرد که به مرض خطرناکی مبتلا شده است.	perceived that he was suffering some heavy affliction.
فکر کردم ممکن است چیز به درد بخوری در آنجا پیدا کنم.	thinking there might be something useful in there.
در هر حال دوست داشت که مشکلاتش را مدت زمانی به دست فراموشی بسپارد.	in any case he wished to forget his troubles for a time.
گویی از له وین تمنا داشت گفته پزشک را درباره اثر معجزه آسای استنشاقید تاکید کند.	demanding from him the confirmation of the doctor's words that inhaling iodine worked wonders.
عموم حضار را عقیده بر این بود که این صلح و صفا را مرهون حسن نیت و به خصوص فصاحت و بلاغت کشیش هستند.	for all which it was the universal opinion that their thanks were due to the great zeal and eloquence of the curate
اما من متحیر بودم که چرا این همه اصرار دارد زود حرکت کنیم.	I wondered why we must go so soon.
جانشین او از پیش و همه یاهوهای آن ناحیه از پیر و جوان و نر و ماده با هم از پس راه میافتند	his successor, at the head of all the _Yahoos_ in that district, young and old, male and female, come in a body
به همین دلیل دردی که من احساس کنم ترا نیز باید به درد آورد	therefore any evil that affects or shall affect me should give thee pain
مارشال یکی دیگر از نواحی که از همین گروه بود گوشم یداد.	the marshal of another district, who belonged to their party.
شاید چیزی ندانم لکن زندگی نوینی برای من آغاز شده است.	I don't know much, perhaps, but a new life has begun for me.
چون از دیدار نشاط و سلامت او سخت خوشحال شده بود	being in a state of considerable delight at seeing him so much better
شیوه ای که شما برای نقل این ماجراهای عجیب بکار بردید	the manner in which you have related this remarkable adventure
که مانند انعکاس خنده شیطان است از لبش بیرون کشیده بود.	which is like the echo of the laugh of a demon.
که تو داستانم را افشا کنی حتی اساسا به این فکر نبودم	you would betray me I never even thought of that
او را بر آن داشت تا مادر را به برآوردن وظیفهء نخستین خویش توصیه کند	who adjured his mother to perform her first duty
به همراه کاپیتان کشتی و چند تن از افسران زیردست که اطرافش را گرفته بودند نیز نزدیک او نشسته بودند.	with the captain of the ship and some minor officials from the shore around him.
این از هر رویایی که عادت داشت پیوسته در برابر واقعیت قرار دهد بهتر بود.	was better than any fancied might be such as she was in the habit of opposing to the actual.
با خودم گفتم.بهترست پنجره را باز کنم و توی ایوان بنشینم.	when I bethought myself to open the window and step out on to the balcony.
آن بانو قول شرف داد که هرچه زودتر این مبلغ را به شما باز دهد.	she promises to repay them very speedily.
که شامل معبری دور تا دور یک چمنزار بود	consisting of a walk round two sides of a meadow
سه دست لباس ذخیره و چهار جفت جوراب و شورت هم برداشت.	three changes plus four pairs of socks and shorts.
اما نتوانست جلو رفتن او را به آنجا بگیرد.	would not be hindered from immediately going to see it
به لحاظ کشیده شدن به فساد در خطر بیشتری قرار داشتند.	were in greater danger of being corrupted by the filth they handled.
من حق دارم به قضاوت شما بیش از هر کس دیگر امیدوار باشم.	I have reason to have faith in your judgment rather than in anyone's.
پرواز کنان از پنجره بیرون رفت و در تاریکی شب ناپدید شد.	took off through the window into the night.
این که به تو چه گذشته کاملاً برایم غیرقابل فهم است.	so what it must have been like for you I cant imagine.
تازه در آن موقع راجع به ملاقات با پدر محتضر خود که در انتظار او بود اندیشید	only then began to think of the interview with his dying father which awaited him.
اما امیدوار هستم که تو او را خفه نکنی	but you will not do so, I hope.
آنچنان که شادی حاصل از دیدارش هم دردمندی بود	so that the delight of her presence was almost pain
ولی در همان لحظه احساس کرد که پاهای او برهنه و سرد شده است.	but at that moment his legs grew cold and bare.
در همان حیاطی که لانة کبوتران و سگ که هر دو خالی است قرار دارد.	where the empty pigeon house and dog kennel are
فلهذا سکوت کرد و اصراری در این باب ننمود.	he did not then press his inquiries
بازوانش را بالا برد بعد یک دستش را روی قلبش گذاشت.	the arms flung above his head with the fists clenched, a hand laid flat upon the heart
که موهای خود را فرزده است با کت و شلوار چسبان خود نزدیک شد	smooth of cheek and obviously becurled as to hair, who now came over and in his closely
اما به زمین افتاد و از درد ناله کرد.	but fell back with a whimper of pain.
ابدا چنین امری از عقل دور و سزاوار نیست	,and this surely is not vanity
مرا به اطاق کوچک و تمیزی که کف آن نیز مفروش بود راهنمایی کرد.	showed me into a small, tidy, carpeted apartment
چون به عقیده من مداخله در امور طبیعت کار درستی نیست.	because I consider it wrong to interfere with nature in this way.
بی آنکه به احدی آسیب برساند قایق را سوراخ کرد.	staving her in completely, but without doing any further damage.
از اینکه شاهد آن خرابی و ویرانی نبودم سخت شاد شدم	indeed, I was glad not to have been a spectator of the havoc they made
مدتی پس از آن دانستم که این مطلب اعتقاد اعلی حضرت و همه درباریان را در حق من سست کرده بود.	as I afterwards found, gave his majesty, and the whole court, a very mean opinion of my understanding.
مهم نیست که تو یک بچه داشته باشی یا بیست تا .	I don't care whether you have one child or twenty
لا ین قطع تحت تأثیر آن قرار داشت اما اینک به یکبارگی تسلیم آن شد.	he had been continuously under its influence, but only now found full satisfaction for it.
تا آب به تنش خورد تشنگی از بین رفت	the moment the water was about him, his thirst was gone.
با این گفته نشان داد که نظراتش درباره خصوصیات زنان آن قدر گسترده هست که این نیاز را در بر بگیرد.	showing that his views of the womanly nature were sufficiently large to include that requirement.
از میان یک جفت چشم خاکستری نافذ بیرون زده بود.	jutted out between two keen, gray eyes, set closely together
من ترتیبی خواهم داد که شما را به سلول دیگری منتقل کنند.	I'll have you transferred to another cell where
بدون این که چیزی بگوییم یا بشنویم که دیروز نگفته باشیم یا نشنیده باشیم	with nothing to say or to hear that was not said and heard yesterday
به او اصرار کردم که دو هزار از سه هزار دوک ای من را بردارد	I induced him to take two of my three thousand ducats
دوباره با ترس و وحشت دریافت که میان ایشان هیچ مانع و سدی وجود ندارد.	again she felt with horror that no barrier lay between him and her.
یش از این که عطر وجودت را ببویم ناپدید خواهی شد.	you will vanish ere I inhale your fragrance.
چون تاج گل دو بار گرد سر زیبایش چنبر شده بود	two immense plaits twice round her lovely head like a coronet
که چمن دو طرف آن به علت عدم مراقبت بلند شده بود.	on both sides the grass was long and violently green.
زنی را نزدیک خود در آن کوره راه دیدم.	found a woman near me upon the path.
چه دیگر حیات او متعلق به خود وی نیست	because his life did not belong to him
که در هرچیزی نظم و ترتیب را دوست دارم	I like order in everything
باز هم برای آدم گرفتار یکه خلی ناچیزترین امور به نحوی دور از حساب حاوی پیام و معنایی است.	yet, to any monomaniac man, the veriest trifles capriciously carry meanings.
چون شب رسید باز روی رودخانه بودند. در تمام مدت روز کمتر از نیم کیلومتر راه پیموده بودند.	night found them back on the river with a quarter of a mile to the day's credit.
آنگاه دست مرا در دست بزرگ و نیرومند خود گرفت و نگاه داشت.	he took my hand in his large firm grasp.
تا دیگر مجبود نباشد به چیزی بیندیشد یا درد و رنجی را احساس کند.	didn't have to think or feel anymore.
عزیزم اگه تلفنت تمام شده من باید به وکیلم زنگ بزنم.	if you're through with the phone, honey, I'd like to call my lawyer.
من گفته بودم که آرزو دارم کلاهی یک خرده بزرگ که مد است داشته باشم.	I said I wished bigger hats were the fashion
قدر مسلم اینکه تمام مردها به او نظر داشتند.	all men assuredly must have coveted her.
ضمادی برای فراموش کردن گذر عمر و هزار نوع اختراع و کشفیات دیگر.	a poultice to lose time
شما نباید این جوری از اینجا خارج به شین.	you mun'n't go on so.
در این عبارت نخستین بار روی ضمیر شخصی تکیه کرد.	laying the same emphasis on the pronoun as before.
بهترین راه به دست آوردن سلامتی این است که مرخصی درست و حسابی برویم.	the best way to make sure I am is to have a decent holiday.
فقط باید گفت که ده هزار روبل ممکن است به موقع خود چیز بسیار خوبی باشد.	though ten thousand roubles is a capital thing to have on occasion.
اما حیف که شغل و عمل و شأن و شرف به وراثت متروک و ابطال شده.	but then, hereditary rank is abolished
بهش فکر کردم و گذاشتم برای یه دقیقه منتظر بمو نه.	I thought that over for a minute while he waited.
اما سروکار پیدا کردن با این دختر خانم برایش به کلی غیرممکن بود.	but to have anything to do with a young lady seemed to him impossible.
دست راست خود را به سوی او دراز کرده	extending his right hand
سرم را تکان دادم و به سمت راهرو چرخیدم	I shook my head and edged toward the hallway.
منظورم ای نه که تو حتی به من نگفتی در تلویزیون برنامه داری.	I mean, you didn't even tell me you were going to be on television.
اگر من هر کاری بکنم مختار باشم و زندگانی و مرگم در دست خودم باشد	you will let me take my life into my own hands
ولی در دل شب دو سه بار گوئی بر اثر یک وسواس بیدار شد.	but he was awakened twice or thrice during the night, as by some fixed idea.
آدرسی که به شما دادم برای این نبود که فرصتی بدست آورم و از دست شما بگریزم.	I did not give you my address with any intention of escaping from you.
با وجود غرابتی که کلام من در نظر شما خواهد داشت.	strange as it may appear to you.
به خوبی دریافت که در غیبت او باید اتفاقی افتاده باشد.	the count saw clearly that something had gone wrong during his absence
بسیار ممکن است تصور من مقرون به حقیقت باشد.	because it may very well be the case.
در حالی که آن مرد کولی در اثر یک نوع بیماری مزمن فرسوده شده بود.	the gypsy seemed to have been worn dowse by some tenacious illness.
من این مشکل را حل کردم. یکی از شترهای خود را در اختیارش گذاشتم.	I cut this difficulty by providing a mount for the new guide from my own beasts.
با ذکر نام ایستگاه تراموا و توصیف ساختمان مطب.	giving the car stop and a description of the house.
هنگام خروج از نزد او بینی او را با دست خود سخت بپیچاند	should, at his departure, give the said minister a tweak by the nose
توانستم هیکل جمع و جور و راه رفتن بی خیال طبیعیدان را تشخیص بدهم.	I could distinguish the dapper shape and jaunty walk of the naturalist.
هر کسی حق داره عقیده خودشو داشته با شه.	got a right to their own opinion.
ولی بگذار تا آنجا که وقت داریم بفهمیم که چقدر پول داریم.	but let us know, as nigh as possible, how much we have.
اما از بس در فکرش تکرار کرد که این شخص از کارخانه بیرونش کرده و موجب بدبختیش شده است	yet, by dint of repeating to herself that it was he who had discharged her, that he was the cause of her unhappiness
دیری نگذشت که در محل جدید خود مستقر شد.	she soon settled in her new abode
مادام دوفارژ تمام مدت سر به بافتن گرم داشته با نگاهی نامیون در او خیره مانده بود.	that terrible woman had knitted when he talked with her, and had looked ominously at him as her fingers moved.
پس از آن خودم را از ذهن او دور نگه داشتم.	I stayed clear of his head after that.
به خصوص که در گوشه راست لبش خال بزرگ و دل پذیری دارد که مانند سبیل مردان نیمی از لبش را پوشانده	which was raised to the highest pitch of perfection by a mole she had on her right lip, like a moustache
اون وقت با این مزدهای کلون شاید آدم بتونه یه تیکه زمین به خره و واسه خودش کار کنه تا عایدیش زیاد به شه	with them good wages, maybe a fella can get hisself a little piece a land an' work out for extra cash.
همان وقت بار دیگر صدای پایی از راهرو به گوش رسید	they heard footsteps outside in the corridor again
بار دیگر به شنیدن این مزاح صاحب مسافرخانه خونم به جوش امد و گفتم	now flying into a passion again at this unaccountable farrago of the landlord's.
طوری که ظاهرش را شبیه به آدم محتضر روی بستر مرگ کرد.	that gave him the look of a man on his deathbed.
بلافاصله با دندان لاک و مهر روی پاکت را خرد کرد	she tore the red sealing wax with her teeth
بعد از گذشت یک ربع صدای باز شدن در کتابخانه را شنیدند.	fifteen were counted before the library door again opened.
سرش را به سوی پنجره بلند کرد تا مطمئن شود که از بیرون چیزی از منظره اطاق نمایان نیست.	glanced up at the window, to be sure that nothing was visible from the outside.
ولی نکند بیش از حد تصورت ناراحت شده باشی.	but I am afraid it gives you more pain than you expected.
سوندرا به کلاید اجازه داد که لبش را ببوسد	she had allowed him to kiss her
مانند همه کودکان داد سخن داد و خواست مرا بازیچه کند.	after the usual oratory of infants, to get me for a plaything.
در آنجا نردبانی به دریچه اطاق زیر شیروانی تکیه داده شده بود.	there was a ladder leading through a trap door to the garret
بر کنا آن تنی چند از زنان بر پیکر بی حرکتی که در آنجا افتاده بود خم شده بودند	where some women were stooping over the motionless bundle
روزها با همه شکوه و زیبایی مانند امواج به هم شبیه بودند	the days, all magnificent, resembled each other like waves
شمشیر و شلاقش را با احترام روی تخت نهاد.	carefully laid his sword and whip on the bed.
چانه خود را در یقه پوست سگ آبی پنهان کرده بود.	the lower part of his face hidden by his beaver collar and his head slightly bent.
هر چند تکلیفی که بدان معتاد بودند اکنون روی هم به کنار نهاده شده بود.	though their wonted duty was now altogether dispensed with.
در آنجا به زودی با کسی آشنا شدم و او با مهمان نوازی بسیار از من پذیرائی کرد.	I soon fell into some acquaintance, and was very hospitably received.
از اینکه پس از چند میل گردو خاک خوردن نجات یافته خوشحال شد	a welcome relief after breathing their dust for several miles
اما مرگ در نظر من بهتر از ین بود که چنان ننگی ببار آورم و نسلی بپرورم که آنان را در قفس نگاه دارند.	but I think I should rather have died than undergone the disgrace of leaving a posterity to be kept in cages.
پسرها آزاد بودند و شوق انجام کارهای مربوط به باغ و خانه بی قرارشان کرده بود.	the boys were on the loose and eager to commence their allotted chores around the house and garden.
چون پر کردن کلیسا همواره یکی از دشوارترین کارهای یک کشیش بود	since to fill the church was always the most difficult part of a clergyman's function
تصمیم گرفته بود که نخستین کاری که باید بکند این باشد که دست دور کمرش کند	he had decided that the first thing to do was to put his arm round her waist
این نکته را نیز چون در هر چیز علم الجمالی هست	I will add since there is an aesthetics in all things
هم ون وقت که جیغ کشیدم انگار یه چیزی تو شکمم پاره شد	I felt it kinda jar when I yelled.
با آن کلاه نمدی درازش که فاصله بین لبه و بالای کلاه به صورت یک صلیب در آمده بود	with his tall billycock hat one of those hats they used to wear that were a cross between a top hat and a bowler
عطش او برای گرفتن انتقام تنها چیزی بود که در این مدت او را سراپا و زنده نگاه داشته بود	his thirst for vengeance was all that had sustained him, kept him alive.
آنگاه قلبش برای همیشه از کار افتاد و روح ازتنش پرواز کرد.	his pulse imperceptibly stopped and his soul departed.
ممکن است شمع را با این آتش روشن کنید.	you might have lit one at this fire.
طوری آن را نگه داشت انگار از جنس شیشه بود	holding it as if it were made of glass
با قلبی پرت اثر دیدم که در عقب دلیجان جای گرفتند.	saw them, with a desolate heart, take their places outside, at the back.
باری چون ساده بود و خطی نداشت او را برداشته و لوله کرده و به دم شعله بردم	I felt for it found it twisted it up together and putting it into the expiring flame set light to it
اگرچه اکنون شاهد تغییر و رشد پر غرور او بود.	though she had watched him change and grow with proprietary pride
او در آن لحظه با هر دو دستش چوب دستی را نگه داشته بود و پیوند میان دو چوب دستی همچنان برقرار بود.	with both hands, and the golden thread remained unbroken.
ضمناً برای آنکه در پی یافتن نام ناجی خویش رنج نبرید	lest you should be pining to know the name of your deliverer
طوری کنید که یقین کنند بیرون از خانه هستید.	so that you may be supposed to have gone out.
راهی که به سوی افسانه ی شخصیشان و به سوی خوشبختی میرود.	the path to their destinies, and to happiness.
یا ساعت فوران او را حساب کنیم خواهیم دید که وقتی مزاحمی نداشته باشد	you will find that when unmolested, there is an undeviating rhyme
پالتو کوتاهی بتن و کلاه بزرگ نمدی خود را بدست داشت	in his short old summer overcoat, with his head bare and his soft, old, wide brimmed hat in his hand.
ما صدای چرخیدن دستگیرة در و قرچ قرچ زبانة قفل را شین یدم.	then we could hear the handle being turned the bolt rattling
یک کتاب لغت و یک دستور زبان با مقداری کاغذ و دفترچه خرید.	she bought dictionaries, a grammar, and a supply of white paper.
کار دیگری نداشتیم انجام بدهم چون مدرسه تعطیل بود	I had nothing else to do, because it was the vacation
شیئی سیاه به پشت افتاده و چون کمانی بزرگ خمیده بود	the black thing lay on its back, and its back was arched like a great bow so that it bent upward in the middle.
کتی سیاه با شلواری ضخیم و سنگین که از مخمل نخی تهیه شده بود	a black jacket, and a pair of hard, stiff corduroy trousers
سورچی را صدا کرد تا بار دیگر بایستد و بگذارد مرا ببوسد.	called to him to stop, that she might kiss me once more.
نه فقط به این دلیل که او در معرض نفاق و رسوایی است	not only because he was a source of dissension and scandal
به یاد قبر پدرم افتادم که در کلیسا نزدیک خانة ما بود.	I thought of my father's grave in the churchyard, by our house
با هم در خاک رفتند و به همین زودی بیش و کم فراموش شده بودند.	shovelled together, already half forgotten
که بر صحت این اسشتهاد و بیشتر از آن سوگند خواهند خورد.	who will swear to everything thatis in that paper and more,
آن قدر زودگذر بود که فقط او متوجه آن شد	so brief that only he would have noticed
در آن هنگام که دو کشتی از برابر یکدیگر گذشتند	as the two ships crossed each other's wakes
در ضمن دو نوع برگ رأی میان مردان بالای بیست و یک سال سن توزیع کردند.	they distributed among males over twenty one
در ابراز آثار وقار و متانت و خشونت تقصیری نداشت.	that it was not her fault that her face happened to assume an expression of calm dignity and severity.
متأسفانه خودم شاهد قضیه بودم و در کمیسیون بازرسی شرکت جستم	but unfortunately I was an eye witness, and was also on the commission of inquiry.
عکس را از چنگش خارج ساخت و سپس آن را زیر پا انداخت و لگدمال کرد.	he wrenched it off the chain, and crushed it with his foot.
تشویقش کن به فکر ازدواج و خانه و زندگی بیفتد.	encourage her to think of marriage and a home of her own.
لیکن به همان اندازه که از جنون ارباب مات و متحیرم از ساده لوحی مهتر نیز در شگفتم.	but I do not wonder so much at the madness of the knight as at the simplicity of the squire
آن قدر از این امر مطمئن بود که گویی دختر به زبان خود به او اعتراف کرده است.	he knew it as surely as if she had told him so in words.
زیرا تازه داخل پنجاه و ششمین مرحله عمر خود شده بود	that is, about fifty five years of age,
صورت غذا را مثل معمول به روی میز تحریر شما گذاردم.	I left the menu on the desk as usual,' she said.
ارتفاعش نزدیک به صد و هشتاد و دو گز است.	about six hundred feet high.
روزی این طفل مجبور به دادن آن خواهد شد.	it will one day be required of him.
ناگهان اضطرابی ناشی از ترس وجودش را پر کرد.	he was filled with a sudden sense of trepidation.
آن گاه سکوی قطار را طی کرد و ساختمان ایستگاه را پشت سر گذاشت.	she walked along the platform.
بجز یک رختخواب و چند صندلی و لوازم آشپزخانه چیزی بر جای نماند.	except the bed, a few chairs, and the kitchen table.
قلقلک داد با شنیدن اسمم کمی از جا پریدم.	I jumped a little at the sound of my new name.
علی الحساب همان شغل ماهیگیری را داشته باش و به همین دوستی برادرانه من راضی و به همین اکتفا و قناعت کن	so remain a fisherman and contented with my friendship as I cannot give you more
من که از شدت خستگی و نگرانی نفسم بند آمده بود	I panted, quite breathless with quick walking and alarm.
قدرت چشم برداشتن از این تصویر بی مانند را نداشت .	he could not take his eyes off the marvelous portrait.
با مداد جوهری بین انگشتانش به مطالعه آن مشغول بود.	was studying it with an ink pencil between his fingers.
هنوز این سؤال را تمام نکرده بود که دریافت نباید این سؤال را کرده باشد.	but as soon as he had asked the question he noticed that it should not have been put.
هر چند بیگمان به قصد برانگیختن شک مردم شهرنشین تهیه شده باز هم به نحو شایان توجهی صحیح و از حیث کلی شبیه واقعیت خارجی است.	though no doubt calculated to excite the civil scepticism of some parlor men, is admirably correct and life like in its general effect.
نه برای تو عزیزم! مطمئن باش! من غم دیگری دارم که همواره یکسانست.	I have my own grief, always the same, always the same.
یعنی پس از اینکه او تو روتان گفت قاتل و شما جرات نکردید در طول صد قدمی که با او همگام بودید چیزی از او بپرسید!	after he had called you murderer to your face, and you did not dare to ask him a question all the way.
بم نزل من بیا تا به اتفاق منتظر فردا شویم.	come home with me do, and we'll see the day in!
از ختم جوسرخپوسته همان قدر خیالشان راحت شده بود	they had had almost as satisfactory a time at the funeral
باید یک جایی چند دقیقه با تو حرف بزنم.	I must speak to you for a few minutes somewhere
اشک در چشمانش نشست و ناچار شد از خواندن بازایستد.	tears came into his eyes, and he had to stop.
این خصیصه به هیچ وجه خود برای مرد متاهل سودمند نیست	a disposition by no means advantageous to a married man
او خواهد توانست به من کمک کند که یک مرتبه ثروت خوبی بدست بیاورم.	he might put me in the way of making a fortune by a single stroke.
به این شکوه و جلالی که نفرتشان را برانگیخته بود کمک کرده بودند.	who perceived too late that they themselves had contributed to this hated splendor
صدای آه و ناله و ضربات صلی بها به روی سینه به گوش رسید.	sighs and the sound men made as they crossed themselves were heard.
مواد لازم برای سر هم بندی یک شام سریع را روی پیشخوان چیدم و سعی کردم خودم را وادار به تمرکز روی کاری که در دست داشتم بکنم.	I lined up all of the ingredients for a makeshift dinner on the counter, forcing myself to concentrate on the task at hand.
به سرنوشت تمام هوس بازان دیگر همان طور که استحقاقش را داشتم گرفتار شدم.	I had as I deserved to have the fate of all other spoonies.
خود بیشتر به آن نژاد مقدس تعلق داشت تا به اشراف	he himself belonged to the sacred race rather than to the noble possessed him.
مهم نبود که این دو ساعت آن قدر کش آمده بود که یک سال طول کشیده بود.	the fact that the two hours had stretched into an entire year didn't matter.
انسون ولو یک کمی هم بفهمه ان قدر بدبخته..	such a severe pang one suffers when one understands something!
عبوس و زرد چهره و خاموش دست روی دست گذاشته در اتاق دفتر کار خود نشست.	sat in his study with folded hands, morose, sallow, and taciturn.
این را هم بی هیچ غرور و خودپسندی باید بگویم	I may add, without vanity
تصورش این بود که او آماده است با هر مرد دیگری هم همین رفتار را از خود بروز دهد.	she was so boy crazy he imagined she would use them on any man who gave her the opportunity.
خدا رو شکر کن که وضعت بدتر از این نیست.	it could be worse.
به عبارت دیگر ساعتی چند را برای زندگی واقعی گذارد و باقی را برای اشتغال به ابدیت.	in other words, to bestow a few hours on real life, and to cast the rest to the infinite.
ولی رنگش به چهره بازگشته و اضطراب نهانش ظاهراً آرام شده.	I saw the colour had come back into his face, the tired, lost look was gone
این کار سبب شد که عوائدی نسبتاً فراوان نصیب هر یک از وزیران شود.	whereby the secretaries of state got considerable fees.
اما در وسط این اتاق هم یک لگن بزرگ قرار داشت و روی قالی هم آب ریخته بود.	but even in this room there now stood an empty bath, and water had been spilled on the carpet.
شما را جون برادر دوست دارم و همیشه دوست خواهم داشت و بیش از این به چیزی محتاج نیستم.	I love you as a brother and always shall, and I want nothing more.
آن چنان به نظرش ساده و اسان آمد که بار دیگر لذت راستینی از تصور رنج و حرمان و پشیمانی ورانسکی به او دست داد.	it seemed to her so simple and easy, that she began musing with enjoyment on how he would suffer, and repent and love her memory when it would be too late.
به این نتیجه رسیده ام که هر کاری برای هردومان بدتر از حفظ وضع موجود اسمی است.	all other solutions will be worse for both sides than an external status quo,
هم می ایستن و تا روز بعد نگهبانی می دن و به دام می ندازنشون.	then stood guard the next day, trapping them.
چرخیدم و با تنبلی به سمت خانه راه افتادم	I wheeled and started loping in toward the house.
مطمن بودم که همه چیز خوب پیش خواهد رفت.	I'm sure everything's fine.
تنها ناخدا روی بالشی در انتهای عقبی کشتی دراز کشیده بود	only the captain lying on a mattress in the stern
خودت دیدی که یادش رفته بود برود دنبال کتابی که تو گفته بودی.	is very plain from the circumstance of his forgetting to inquire for the book you recommended.
آن اینکه اگر بخواهید از رنج و زحمت خود بکاهید و از راه میان بر به اوج غیرممکن الوصول شهرت و افتخار برسید	that if you wish to spare yourself fatigue and toil in reaching the inaccessible summit of the temple of fame
لکن بعد فهمیدم که این روزنه مشرف به حیاط داخلی است که از آنجا به خارج رفتن ممکن نیست پس از این خیال صرف نظر کردم	however I discovered that I should merely have dropped into a sort of inner court and I therefore renounced the project altogether as too full of risk and danger
بنظرمن یه کسی مثل تو حتما باید کاندیدم یشد.	I would have thought a guy like you would have been a natural.
تاج دوکی را که بر پوسنی ارغوانی قرار داشت به سفیر اعطا کرد.	handed him on a crimson cushion, the ducal coronet.
آن چنان یکه خورده بود که نزدیک بود از پشت بیفتد.	so surprised that she almost fell backwards.
زیرا نه از خاندانی بزرگ بودم و نه مرا چنانکه باید آموخته و پرورده بودند.	either by my birth or education
لذا موضوع صحبت را تغییر داد و به نقل خبری چند که تازه از پایتخت رسیده بود پرداخت.	so, from one subject to another, he came at last to talk of the news that had come from the capital
دومرتبه وانمود کردم که استخوان در گلویم گیر کرده که فکر کنم.	so I played another chicken bone and got another think.
هنوز نمی تونستم قبولش کنم. خیلی سریع داشت اتفاق میفتاد.	I hadn't wrapped my head around it yetit was happening too fast.
زیرا حجله دامادی باز یل در درون گور خواهد بود.	for the nuptial couch of this marriage must be the grave.
تا وقتی که در راه مقدس دفاع از اصول ازا دی خواهی وظیفه خود را انجام دهد و خوشبختی مردم کشور عزیز ما را تضمین کند	for the sacred defence of liberal principles has accomplished its mission of securing the happiness of our beloved country.
چون کمی پیش رفتیم کشتی را پشت سر گذاشتیم.	but after we had gone a little ahead, and the vessel was now lying to leeward
کاترین نیز چون متوجه ورود شوهرش شد لب از سخن فرو بست و ساکت ماند.	which she obeyed, abruptly, on discovering the reason of his intimation.
من نیز خواهم کوشید تا مزد این زحمت را به نحو شایسته بدهم.	I'll try to pay it back in the same coin.
اندکی خم شد و شمشیرش را که زیر شنل گیر کرده بود آزاد ساخت.	slightly bending over, disengaged his saber which had caught in his cloak.
پس از آن ظرف شامم را درون یک سینی گذاشتم و خود بیرون رفتم تا مقداری شیر دست نخورده بیاورم.	I put my basin on a tray, and went myself to fetch some more milk.
اسب دم را حرکت داده و گردن کشیده با سرعت بیشتر پیش رفت.	the horse, flourishing its tail and extending its neck, galloped on yet faster.
سر خود را به دست گرفته مشغول فکر شد.	buried his face in his hands and reflected.
او را در چند لحظه به مرکز جمعی که بر چرخ گرد آمده بودند قرار داد.	carried him in an instant to the heart of the concourse at the stone.
آن هم زیر سایه بلند دیوار پشتیبان و دنج کلیساها.	under the long flung shadow, and the snug patronising lee of churches.
زیرا در همین لندن اشخاص و جوانان پرمدعایی هستند	inasmuch as there are a great number of spirited young bloods upon town
در جایی قلم پر دار را چنان در مرکب فرو برد که مرکب روی میز ریخت	he plunged his quill so deep into the inkhorn that the ink spirted over the table
از نهر گذشت و در ساحل روبرو در جهت مخالف رفت.	managed to get the truck back across the creek and up the near bank in reverse.
چشمانش باز و به روی آقای لاری دوخته شده بود	with her eyes open and fixed upon him
چنانچه شاهزاده خانم با پدرش قبل از پانزدهم ماه از آنجا حرکت نکند	that if the princess did not take her father away before the fifteenth
دستة پنج نفری دیگری هم با آکوردئون و به همراهی زنی جوان خارج شدند.	a group consisting of about five men and a girl with a concertina had gone out at the same time.
به دیوار تکیه دادم و چند نفس عمیق کشیدم.	I lean against the wall and take a couple of deep breaths
اما در هر گفتگو و اظهارنظر و انتقاد از اوضاع سیاسی کام لا آشکار بود که گوینده هر بار در آن جا که ممکن بود	but whether telling a story or giving an opinion the speaker always stopped, or was stopped
یک لحظه طرح پیکر آن موجود ژولیده و زمخت را در زمینة آبی سربی آسمان دیدم.	I saw the ragged uncouth figure outlined for an instant against the cold blue sky.
ولی نوشتن نامه را به روز بعد موکول کرد	but he put it off until the next day.
من عجله داشتم که از خود شما مقاصدتان را دریابم.	I wished first to gain some personal knowledge of your intentions
توازنی قدسی کل هستی او را در بر گرفت.	her whole being was pervaded by a seraphic harmony.
این جواب صحیح و عادلانه نه تنها با احساسات او بلکه با تمام عوامل زندگیش مغایرت دارد.	justice clashed not only with his feelings but with the very possibility of life.
چشم از زنان برنداشت تا از برابرش گذشتند و در میان جمعیت ناپدید شدند.	did not take his eyes off the women till they had passed.
در آن هنگام با قدرت گاو دمی و رو به افزایش ناپدید شدنش	then, with the tapering force of his parting momentum
حتی به او مهلت نداد از خودش دفاع کند.	he did not grant her the grace of an excuse or the right of appeal
سپس به عادت همیشگیش شخصا سوپ را قسمت کرد.	then helped the soup himself, according to his custom.
زود باش برو و با سئوالات خود مرا ناراحت نکن.	get in, and don't annoy me.
این گنج مخفی و مستور مانده و در بطن ارض عاطل خواهد ماند	this treasure will be lost
من فرزند خردسالم را که پسر بود به دل خاک سپردم	I have buried my little son
چنان بی جنب و جوش گسترده بود که گویی چمنزاری به وقت ظهر بود.	seemed a noon meadow, so serenely it spread.
مشروط بر این که از عهده انجام دادن آن برآیم.	that I think I am likely to perform.
که هر چند هفتصد و هفتاد و هفت رقم بزرگی است	yet the slightest consideration will show that though seven hundred and seventy seven is a pretty large number, yet
به خشونت به سربازان سرودخوان نگریسته چهره درهم کشید.	looked sternly at the singers and screwed up his eyes.
بار دیگر نفوذ خود را بر همسرش باز خواهد یافت	he could win his wife back
با مرد کوتاه قامتی که جامه مستخدمین کشوری را پوشیده بود	a short man in civilian clothes with a clever face
از پشت میز برخاست و به اتاق دیگری رفت.	he got up from his desk and walked through to an inner chamber.
زیرا پایه تصورات خود را برین نهاده بود که همه جانوران در به دست آوردن محصول زمین حقی و سهمی دارند	for he went upon a supposition, that all animals had a title to their share in the productions of the earth
بلکه به عقیده من احمقی است نادان و پرحرف که بی تأمل و تعمق دست به قلم برده و داستان مرا نوشته است.	but some ignorant chatterer, who, in a haphazard and heedless way, set about writing it, let it turn out as it might
از دید لهوین مانع دیگری در راه عشق بود.	seemed to him yet another obstacle to love.
مویش دیگر وزوزی نبود و صاف و براق شده بود.	it was no longer bushy but sleek and shiny
آری من قبول دارم که ضرب شست خوبی بود.	I don't deny it was a good lay.
درش را همان گونه که او گفته بود بسته یافتند.	as he had told her, they found the doors closed.
از ین عده به حساب او پنجاه تن در پایتخت بودند	of which he computed about fifty in the metropolis
غم و اندوهش با ترحم آمیخت از شدت آن اندکی کاسته شد.	his mortification lost some of its bitterness by being mingled with compassion.
در پایان ذهنش را آماده ساخت تا به دوست خود بگوید	but in the end he made up his mind to tell him
هر چه را که از او باقی مانده است.	I lay out all that is left of him, all his little things.
اما بار دوم کنتس سالخورده را پشت پنجره دید.	but as he passed it the second time he saw the old countess at the window.
چنین خواست که جشن همچنانکه برای عروسی خود او بود ادامه پیدا کند.	desired the festival to go on just as if he were married in reality.
من که نه مه دیدم و نه جزیره و نه دردسری داشتم و نه هیچی.	I hain't seen no fog, nor no islands, nor no troubles, nor nothing.
