هیچ انتظار نداشتم که همه چیز این قدر سریع اتفاق بیفتد!	I didn't expect it all to happen so fast!
در این اطاق بود که او آخرین نفس خود را کشید	it was in this chamber he breathed his last
اما قبلا کمین کرده بود که او برگردد تا مطمئن باشد که وی را در خانه خواهد یافت.	he had watched for him to come home so as to be sure of finding him in.
به همان حال باقی بود تا مدتی بعد از آن سر بالا کرد و با چهره پژمرده و رنگی پریده دوباره کاغذ را برداشته و باز مشغول مطالعه شد	but raised his head at the expiration of a few seconds and again perused the letter
ولی این بار به خاطر این که لرزیدن زانوانش را پنهان کند.	only now he did it to hide the trembling in his knees.
که ضربه نه عمدی بوده و نه دستکم در آن لحظه چنین گمان کرده بود آنقدر شدید که آسیبی به ربرتا وارد آورد.	not withsufficient force really to injure her, he thought at the time.
به طوری که روزی بتوانند شوهران مناسبی برای خود بیابند.	so that they could one day attract desirable husbands.
یشنهاد کرده بود تا با هم یک دست شطرنج بازی کنند	she invited him to play chess
که ریشه گرایی همه ی عناصر محافظه کار را تهدید به بلعیدن میکند	that radicalism was threatening to swallow up all conservative elements,
در هر صورت در دنیای علم جنب و جوش بزرگ یبرانگیزد.	at any rate, make a great stir in the scientific world.
معجون شبیه به لجن تیره رنگ و غلیظی بود	the potion looked like thick, dark mud
بیم دارم که حتی او هم اهمیت این جمله را کاملاً درک نکرده باشد.	I fear that even he has not quite grasped the significance of this sentence.
من بزودی حکم عفو شما را بوسیله او بدست خواهم آورد.	I will procure your pardon.
من نیز در ین باره دست کمی از آن گروه نداشتم	neither indeed was I much in their debt
در آن دم که من شتابان فرمان او را انجام دادم و پایین دویدم	then as I was hurrying off
همه از جای برخاستند و برای رفع خستگی به تراس رفتند.	the committee left their seats, and stretched their legs on the terrace.
اما با تمام وجود خود ناگهان احساس کرد که او دیگر نه آزادی تفکر دارد و نه آزادی عمل و همه چیز ناگهان و به طور قطع مقرر شده است.	but he felt suddenly in his whole being that he had no more freedom of thought, no will, and that everything was suddenly and irrevocably decided.
که اونها رو تا سرحد مرگ ترسونده ورویایی که به اونها ا حساس آرامش و امنیت داده.	that frightens the bejesus out of them and one that makes them feel safe and secure.
طناب را ربود و به طرف دشمن دست و پا بسته خود پیش رفت.	he snatched the rope and advanced to his pinioned foe.
به او گفتم جای زخم روی گردنش دست کشیدم.	I stepped forward and touched the end of my fingers to the scar tissue on his neck.
ناگاه صدای افتادن کتابی را به روی زمین شنید	she heard the loud bang of a book on the floor
شاید طوفان سهمگین آن شب وی را ناگزیر ساخته بود زودتر به خانه پناه آورد.	owing, I suppose, to the sudden storm.
پس من شما را در نیم ساعت بعد از این منتظرم	I shall expect you, then, in half an hour, baron
ملتفت این نکته هم شد و آن را به یاد سپرد.	he observed that, too, and took note of it.
تاب آن نداشت که دیگری در قلب استادش جای داشته باشد.	he could not bear any one else to have a place in his master's heart.
او هرگز وجود آن را پیش خود تصدیق نکرده بود	he had never acknowledged its existence to himself.
برای چند لحظه هاج و واج به او خیره شدم	I stare at her for a few silent seconds.
با اطاعت به صورت وحشتناک آقای دیویس دوخته شد.	were obediently fixed upon his awful countenance.
تا وقتی زیر نظر شما بود خوب بود و اخلاق خیلی خوبی داشت	he was grown so steady and such an excellent correspondent while he was under your care
او در ضمن عبور از مقابل نوانخانه چشمش به اعلانی که بر در نصب کرده بودند افتاد.	in a species of arithmetical desperation, he was alternately cudgelling his brains and his donkey, when passing the workhouse, his eyes encountered the bill on the gate.
هرکس به نحوی شادی عظیم خود را از بازگشت او اعلام کرد.	testifying in every way to their great joy at her return.
بعد شنیدم که کلید بار دیگر در قفل چرخید	then I heard the key turn once more
آمدند و به رقصندگان روی بهار خواب ملحق شدند.	came to join the dancers on the terrace.
بعد هم خیلی زود اِما را به داخل هدایت کرد.	then ushered her in too soon.
آن وقت به اندازه لباس عوض کردن هم معطل نشدم.	I have not taken the time to dress myself
اما از تظاهر به دروغ شرم کرد و با نگاهی سرد مستقیماً به چهره ورانسکی خیره شد.	but ashamed of making a pretense, she looked straight in his face with cold eyes.
که این یکی از متمولین بسیار با ثروت عالم است که	that he was in the society of some nabob
چون این جمله را با لحنی ادا کرد که انگار زیپ شلوارش باز بود.	because he suspected that she would have informed him that his fly was open in that same tone.
که امورات متوقفی بر وفق نظم و ترتیب صورت یافته	the affairs of the deceased are in perfect order
همیشه چلیکی پر از سیب روی عرشه قرار داشت	always a barrel of apples standing broached in the waist
رویم را برگرداندم و تظاهر به مرتب کردن کشوی بالایی کردم	I turn away and pretend to be reorganizing my top drawer.
که با آن فضای عامیانه و پرهیاهو کمترین تناسبی نداشت.	which was all out of proportion to the fragile, gimcrack scene.
قهوه به اتاق نشیمن منتهی شد تا آن را در آنجا بنوشد	as coffee led to a drawing room in which to drink it
اما من و شما داریم نهایت سعیمان را میکنیم حتی الامکان شام خوردنمان طولانی بشود.	while here are we trying to drag out our meal as long as possible,
بلکه با وجود برتری مقام خود چون گروهبانی مطیع اوامر او هستم.	but obey him like a corporal, though I am his senior.
تو مرا متهم به دروغ گویی و نادرستی کردی.	on that you told me I was lying, that I was not an honorable man.
نان شیرینی که مثل ابزار ماشین مهر خورده بود.	a piece of pie branded like an engine part.
که چه کسی را بپرستند و وجدان خود را به چه کسی تسلیم کنند	that is, some one to worship, some one to keep his conscience
چون هیچ معمول این گونه لویاتانهای سالخورده نیست که اجتماعی باشند.	for it is not customary for such venerable leviathans to be at all social.
کسی که نه مانند همسرش بلکه یک دانشمند و همکار باشد و مسئله را درک کند.	someone who, unlike his wife, was a fellow scientist and would under stand the problem.
من زیاد به ایرادهای او اهمیتی ندادم اما خوشحال شدم که و لم کردند.	I didn't care nothing for the compliment, but I was glad to be let off, anyway.
هرگز با هیچ زن دیگری رابطه برقرار نکرده بود	he had never known a woman.
فاصلهٔ وی بیش از آن بودکه بتواند خوب متوجهٔ آن گردد	he was too far away to tell
امروز می خوام یک خواهش بزرگی از شما بکنم. و در این حال یادگارهایش را از روی رضایت دوباره در جیب نهاد. از ین لحاظ بود که فکر کردم لازمه اطلاعاتی از زندگی من داشته باشید.	I'm going to make a big request of you today, he said, pocketing his souvenirs with satisfaction, so I thought you ought to know something about me.
موتور رو خاموش کردم. در سکوت گوش فرا دادم.	I cut the engine and listened to the quiet.
که تا وقت باقی است به دنبال محبوبش بدود.	urged her to run after him before it was too late, and he was gone.
شاید اگر در ین جا شرحی از کارهای خانگی و طرز زندگانیم در مدت نه ماه و سیزده روز اقامت خود در آن کشور بیان کنم خواننده را سرگرم کند.	here it may, perhaps, divert the curious reader, to give some account of my domestics, and my manner of living in this country, during a residence of nine months, and thirteen days.
اما از میان تمام اجناس چیز درد بخور تقریباً نبود.	but there was almost nothing in it of the slightest value.
قسم خوردند که برای آن کار یا هر دیوانگی دیگر یا خلاصه هر کار دیگری به جز تسلیم حاضرند.	they swore they were ready for that, or for any other mad thing, for anything in short but a surrender.
چه بهتر از آنکه شخص عمر خود را پایان برد	I ought to meet death on the same spot
باز هم به شنیدن این حرف به خودشان لرزیدند	quaked again under the inspiration of this remark
روز دیگر که محبس خلوت بود زبیده چندین بار با عصا و با دستمال برای ما تا حدود دو هزار اشرفی طلا پول انداخت.	thus the next day that the bano chanced to be empty she at different times gave us by means of the reed and cloth two thousand gold crowns and a paper
من هم وظیفه خودم دانستم که این امید را در دلش زنده نگه دارم.	I have made it my business to keep this very hope up.
شاید یک وقت دوباره به تو احتیاج پیدا کردم.	in case I want you again.
من آمده بودم این خبر را به تو بدهم.	I was coming to tell you so.
حیوان دمی عمیق زد و چشمان درشتش را چنان چرخاند که سفیدی آن بدل به کاسه ی خون شد	she drew in a deep breath, and, turning back her prominent eye till the white looked bloodshot,
بلکه این کینه ناشی از آرزوهای برنیامده او بود.	for her hatred was not in proportion to her love, but to her disappointed expectations.
مامانش یکی دو ماه بود که او را در خانه نگه داشته بود	his mama had taken him home for a month or two
ببینند همه چیز برای فردا آماده است یا خیر.	to check their things for the next day.
زیرا این صفاتی بود که با طبع آن جانوران ناسازگار بود.	which were qualities altogether opposite to those animals.
من فکرمی کردم که تو او ن کسی هستی که قرا ره جواب این سوال ها رو بدی.	I thought you were the one meant to provide answers.
ولی این دفعه دی گه تقصیر من نیست .	it won't be my fault!
پنجاه و سه سال و هفت ماه و یازده روز و شب بود که آماده داشت.	for fifty three years, seven months, and eleven days and nights.
این سعادت نصیبش شد صد وبیست سال پیش دیده بر جهان فرو بندد	had the happiness to be dead a hundred and twenty years ago
برای همین شوهر خواهر داشتن از شوهر داشتن بهتر است.	that is the good of having a brother instead of a husband.
تا سیاستمداران مزخرفی را قادر سازد که آن را به هدر بدهند.	to enable futile politicians and state managers to fritter it away on electorally useful white elephants.
ممکن بود کلاه را از او بگیرد و به دختر دیگری بدهد.	he might jerk the bonnet right off her head and give it to some other girl.
زن کوچک اندام به سرعت به سوی چادر رفت	the little woman walked quickly to her tent.
صدایی بیرون دادند که به غار غاری سوگوارانه شباهت داشت.	emitted a funereal shriek.
خواهید دید هم امروز هر گونه ارتباطی را قطع خواهم کرد.	 and I will do so this very day.
دی گه با خود ته که کی بخوای راه بیفتی.	I guess it's up to you when you want to leave.
برخی نیز به هواداری باز یل شمشیر کشیدند و به مقابله پرداختند.	in whose protection as many more swords were in an instant unsheathed
که در آن لحظه همچون سقفی بالای سرش قرار داشت.	which had now become the ceiling.
من یه اعلان دارم که می گه اونجا یه عالمه کارگر می خوان	I got a han'bill says they need men.
که به سال و به نیرو از او برتر است	, stronger and older stallion
که اگر هم این سعادت به شما روی آورد و چنین شمشیری بد ستتان بیفتد	that even if that happened and your worship found some such sword
نمی خوام با بحث برای منصرف کردنتان وقت را تلف کنم.	I'm not going to waste time trying to talk you out of it.
این مرا خیلی پکر کرد و علتش را هم نفهمیدم	which made me feel sorry and disappointed, I didn't know why.
چون دیگر این دو فرق چندانی برای من ندارند فایده بزرگ این کار آن است که مادرم هرگز راز مرا نخواهد دانست.	it doesn't make so much difference now she will never know
الغرض در هر چه که بتوان نام نیکی به آن داد او مقام اول را داشت	generous without limit, grave without arrogance, gay without vulgarity, and, in short, first in all that constitutes goodness
ضرورت داشت که درباره امر بسیار مهمی با وی مذاکره کنم.	I had to talk over a very important matter with him.
به هر حال اگر توضیحاتی بیش از این از من بخواهند	if anyone wants to know anything more about me
او هم صندلی خود را آورد و در کنارم نشست.	until he came out with another chair and joined me.
مادر با یک حرکت غریزی در برابر فرزند خویش بر زمین زانو زد و او را به سینه خود فشرد.	that her mother instinctively kneeled on the ground beside her, and held her to her breast.
مسلم بود که در مورد اخیر دلیل نامعلومی بوده که کام لا باعث آن زخم و برآمدگی که گفتیم شده است.	there must needs have been some other unknown reason in the present case fully to account for the ulceration alluded to.
همچنان که در رختخواب سفری خود دراز کشیده بودم یادآوری خاطرات گذشته را رها کردم تا بعداً به آن بپردازم.	laid down on my traveller's bed, I left reminiscence for anticipation.
این که اصرار کردی تا منتظر روز تولدم بمانی.	insisting on waiting for my birthday.
که بازوان جستجوگر در سرتاسر ساحل باریک پیچیدند و دیواره صخره و درها را لمس کردند.	when the groping tentacles writhed across the narrow shore and fingered the cliff wall and the doors.
در گذشته هرگز برایم اتفاق نیفتاده بود که چنین احساسی را تجربه کرده باشم.	I had never experienced the sensation.
پس از آن دیگر کسی با این گونه سؤالات مایه زحمت من نشد.	after which I was no more troubled with such questions.
اِما این را با چنان شور و حالی گفت	it was spoken with a sort of sighing animation
گفتم شاید یه جورهایی با خانواده خواهرت ربط داشته با شن.	maybe'it was something to do with'you know'her crowd.
مانند کسی که در آب غوطه خورده است هوش خود را از دست داد.	like a man plunged into water he lost consciousness.
سعی کردند دستش را در دست به فشارند و یا سپاسگزارانه شانه و بازویش را لمس کنند.	sought to seize him by the hand or place a gratefulpat upon his arm or shoulder.
تا ببیند واکنش او نسبت به این روش جدید پذیرایی چیست.	to see how she felt about this new and more complicated method of dining
رنگ باخته و لرزان در جای خود به پا خاسته بود.	pale and trembling, standing where he had been seated.
کاش اون سه نفر و تو جنگل ندیده بودم!	had not met those three menin the woods!
چیزهایی را گفتم که هرگز به کسی نگفته بودم.	I'm saying things I've never said to anyone.
سپس برای آنکه خاطر از هر تشویش و اندوهی آسوده سازد	to relieve himself of constant doubts and suspicions
به آشپزخانه رسیدم و فکر کردم شاید غذایی برای آرامش چیزی بود که به آن نیاز داشتم.	I ended up in the kitchen and decided that maybe comfort food was what I needed.
در همین موقع ناگهان زن جوانی به کنار او رسیده و با صدای بلندی جیغ کشید	when he was startled by a young woman screaming out very loud.
موفق شد با پسر خود در اتاقی سوای دار الموت قدیم دیدار کند.	she was permitted to see her son in a room entirely apart from theold death house.
اما از خوشبختی جوی کوچکی در آن نزدیکی جاری بود	but by good fortune there was a small brook hard by
آن کلاه خود را که در نظر من این مرد لگن سلمانی است به اینجا بیاور	fetch hither the helmet which this good fellow calls a basin.
او فرمان داد که دو تن از پاسدارانش که از همه بلند بالاتر بودند آن را بر تیری قرار دهند و بر شانه خود بگذارند و ببرند.	commanded two of his tallest yeomen of the guards to bear it on a pole upon their shoulders.
مقرر بود که مراسم عقد در آنجا به عمل آید	where they were to plight their troth
آن احساسی نیست که در این لحظه در تمام صورت تو نمایان است	it is not the feeling of which your whole face is full at this moment
در موقع بیماری و ناخوشی نیازهایت رت برطرف سازد و کمک کند زودتر خوب شوی.	to take care of your needs when you were ailing.
فقط بکشی دن علامت صلیب اکتفا خواهم کرد این طور!	I'll just make the sign of the cross over you, for now.
راز پدران ما در گورهای آن مادران نفهته است و ناگزیر بایست همان جا برویم تا راز را بیاموزیم.	the secret of our paternity lies in their grave, and we must there to learn it.
در آنجا به زمین خفتم و تا دو هفته هر شب کار من این بود.	where I lay on the ground, and continued to do so about a fortnight.
اگر واقعا جنون باشد یک جور ظاهر عقل دارد.	if it be really foolish, then has it a sort of wiseish look to it.
آن برتری اندیشه که در دلبستگی سوزان به کارهای علمی در او وجود داشت	that distinction of mind which belonged to his intellectual ardor
مثل این که دوباره باید از شنل قدیمی پدرم استفاده کنیم.	it's time to get my dad's old cloak out again.
ولی هنوز دل آن نداشت که از این رؤیا چشم بپوشد.	but she had not had the courage to renounce her dream altogether.
همراه با اشتباهات آشکاری است که غیر قابل چشم پوشی است	but with obvious errors that from every point of view are inexcusable?
مسئله بهتر کردن نیروهای نظامی فیصل خیلی مهم بود.	whose improvement was now our main effort.
گفت که سمت راست بدن شاهزاده فلج شده است.	said that the prince had had a seizure paralyzing his right side.
آن هم با دل و جرأت زیاد و خیال راحت.	had courage and leisure for saying it.
اگه دوست داشتی ساعت سه بیا پیش من که با هم عصرونه بخوریم.	so would you like to come and have a cup of tea with me around three?
خلاصه آن روز به اندازه مندرجات یک کتاب داستان کامل راجع به زندگی عشقی خود برایم حرف زد.	in short, a volume of a novel of fashionable life was that day improvised by her for my benefit.
به او اطمینان داد که چنانچه از شوهرش طلاق بگیرد با او ازدواج خواهد کرد.	he gave her to understand that in the event of her obtaining a divorce from her husband he would marry her.
چه کنم آن وقت از غیظ و دلتنگی دیوانه شده بودم	but I was mad
اگر سر و وضعم مناسب نباشد چه لذتی دارد با دوست و آشناها دیدار کنم.	I have no pleasure in seeing my friends, unless I can believe myself fit to be seen.
مشغول بافتن چیزی شبیه به چادر سیرک زرد رنگ بود.	sat knitting what looked like a canary yellow circus tent.
از تالار طویل به سوی اتاق خواب خود رفت.	she paced down the long gallery to her bedroom.
هنگامی که در این افکار مستغرق بودم و حیران و سرگردان مانده بودم	as I was thus deep in thought and perplexity
در نتیجه من تمام مدت بر نیمکتی لمیده بودم.	I lay on a sofa, almost from shore to shore.
سپس خم شد و تعداد از شیرها را باز کرد.	then knelt down and turned on a few of the taps.
که انگار همان لحظه یک راست و به تاخت از مرغزاری سبز از آن سوی دنیا آمده بود.	as though he had come this moment , straight out of some green meadow at the other side of the world.
با تقلای فراوانی کوشید به سمت او پرتابش کند اما توفیق نیافت.	threw it with a hard effort which was but impotence.
که پدرش تا به این درجه توضیح خواهد نمود	that his father would carry candor, or rather rudeness
باز هم با آن بسازم چون چیزی بهتر از این نیست که انسان با تمام ساکنان هر کجا که در آن اقامت کرده دوستی کند	would they let me since it is but well to be on friendly terms with all the inmates of the place one lodges in.
ولی البته به خرج ما و با غذایی که از سفره ما خواهد خورد.	on our victuals and our drink.
لوسی نه به کارهای معمول خود پرداخت و نه برای پدر چیزی خواند.	she had neither engaged herself in her usual work, nor had she read to him.
اما در ته دل از کیتی و از خود ناخشنود بود.	but he set off at the bottom of his heart dissatisfied both with her and with himself.
باید حکم اعدام را در عرض بیست و چهار ساعت آینده اجرا شود.	the execution was to be carried out within twenty four hours.
دیدم امید از نو زنده شد و حس کردم تولد تازه امکان پذیر ست.	I saw hope revive and felt regeneration possible.
حاضر به تحمل هرگونه سختی و هرگونه خواری است	that he was ready for any trial
از او دعوت کرد که به اتفاق به خانه ی ییلاقی وی و سپس به تماشای مسابقه بروند.	he invited him to drive with him to his country villa and to the races.
من مایل بودم به طبقه بالا بروم و لباسم را بپوشم.	I had a longing to go upstairs and put on my dress
من تا حالا ندیده بودم این جور ورجه ورجه کنه.	I never see him get around so since
محصور بود و دیگر به متحد ین خود اعتماد نداشت	losing confidence in its allies, suffering from shortness of supplies
مطمئنم که در سلامتی کامل به سر می بره.	I'm sure he is in excellent health.
از جیب کتش دستمالی بیرون کشید و سر و صورت نمناک خود را با آن خشک کرد.	he took from his pocket a handkerchief andbegan to wipe his moist, cold face and hands.
چه جفای عظیمی کردی که مرا از آستان خود راندی	a grievous wrong hast thou done me to drive me forth with scorn
گمان ندارم هیچ گونه حساسیتی در آن نهفته باشد.	I do not think that any sensation lurks in it.
بلکه کسانی را که از هر جهت شایسته و قابل قبولند به ایشان پیشنهاد کنند	but that they should place before them what is good
البته مرد باید راه تحریک کردن را بلد باشد.	as long as he knows how to move her to passion each time.
از هفت هزار تا رسانده به هشتهزار و پانصد تا	raised it from seventhousand to eighty five hundred
باید خون جوجه رو با کنیاک قاطی کنیم و هر نیم ساعت یه بار یه سطل بهش بدیم.	feed it on a bucket o' brandy mixed with chicken blood every half hour.
دنیایی که در آن موجوداتی برتر از خدایان وجود داشته باشند.	speckled with beings greater than gods.
همین باعث شد که فوراً با من بر سر لطف بیاید.	this put her at once into good humour.
ولی او پشت به آفتاب نشسته و پشتی بزرگ صندلی نیز در جلو آفتاب حایل شده	but she sat with her own back and the back of the large chair towards it
تا حدی با کار دریانوردی آشنایی داشتند اجیر کند.	who had been somewhat used to the sea.
چون برخی خصایص آخوندی به او بسته بودند که زاده دوران زندگی دریایی سابق او بود.	because there were certain engrafted clerical peculiarities about him, imputable to that adventurous maritime life he had led.
زیرا در این حالت دو قطب آن چون از زمین به یک فاصله است تأثیر قوایشان یکسانست.	for in that case the extremities of it, being at equal distance from the earth, act with equal force
من همکاری دارم که میخ وام هرچه زودتر بیارمش اینجا.	I have a partner that I'mgoing to bring around here presently.
به هیچ وجه متأثر نشد گفتی قلبش به راستی از سنگ یا فلز ساخته شده.	they produced no more effect on him than if his heart had been really a matter of stone or metal.
این بود که با عجله یک بحث روشنفکرانه را پیش کشیدم تا پوستینم را فراموش کنید.	but I made haste to plunge into intellectual conversation to smooth over the defects of my attire.
که باز هم حاضرند آن جور دست انداخته شوند	they would almost be willing to be made ridiculous again
در هر قدم هزار گونه ناشیگری و حماقت و ندانم کاری از او سر خواهد زد	at every turn she will fall into a thousand blunders
تو هم اعتراف کردی این دوربین پیش از افتادن در آب تو دست خودت بود.	you yourself swear that it waslast in your hands before it reached the water.
میل داشت برای ابراز عشق و اشتیاق خود به امپراطور با این فریاد خویشتن را رنجور نماید.	with all his might, feeling that he would like to injure himself by that shout, if only to express his rapture fully.
که او از اخبار بسیاری که دیگران از آن آگاه نیستند اطلاع دارد	that much that was concealed from others was usually known to him
من برای خودم راهی به طرف میز قمار وسط باز کردم و نزدیک میز پا جای گرفتم.	I pressed forward towards the middle of the room until I had secured a seat at a croupier's elbow.
که طفل روستایی را هم ردیف خود کرده بود	with a little boy before hiM
خواه پول خود و خواه سپردهٔ مشتریان را نیز در این کار گذاشت.	not only his own money, but that of his clients as well.
یا به عبارت دیگر هر مردی که دارای قضاوتی درست باشد موظف است با ین احساسات وفادار بماند حتی در موردی که قانون راجع به آن صامت باشد.	that is, every man of sane judgment because it is not to be found in miserable legal codes.
اما شاهزاده خانم به محض شنیدن لحن او سکوت کرد	but as soon as the princess heard his tone she subsided at once,
مواظب باشید که روی هر گنجی ماری خوابیده است!	look out for squalls
ولی من که نفهمیدم علت این تظاهر و هورا چه بود.	I did not quite know what for
برای خودداری از ریختن اشگ خیلی به خودم فشار آورده بودم	I had taken great pains to repress them
فعلا دی گه حرفی نزن تا خودم دوباره خبرت کنم.	not until you hear further from me.
من به نحو احسن از آن مراقبت خواهم کرد.	I'd take real good care of you.
به زحمت جلو خودش را گرفت و چیزی نگفت.	he could hardly hold himself
من عاشق انگشترش شدم و با تمام وجود آرزو کردم که کاش به جای او بودم.	I wanted it dreadfully, and wished I was her with all my might.
آری او را به دیوار میخ زده و مصلوب کرده بود.	hammered nails into him and crucified him, and afterwards
آن را به نحوی که در نظر مجسم کرده بود به خاطر سپرد.	but only as she had imagined it before she had been there.
زیباترین زنی یافت که تا به حال دیده بود.	found her one of the most beautiful people she had ever known.
برای مثال از بی پیراهنی و بی کفشی ایشان و از پارگی و نازکی لباسشان صحبت کنم	as for example want of shirts, and no superabundance of shoes, thin and threadbare garments
من در این روزها کمی عقل از سرم پریده است.	I don't know what I am thinking about these last few days.
با اینکه گواهی پزشک به تغییر شکل نسبتاً شدید چهره اشاره دارد	though the doctor's evidence pointed to an almost incredible facial distortion
همیشه به خودش سختی داده جان کنده تا بدهکاریش را بدهد.	he has fared hard, and worked hard to make good everybody's loss.
به طوری که معلوم نبود باید اول به کدام یک پاسخ گفت.	so that there was no knowing to which to reply.
ولی اول باید دقیقا بدانم که این گنج کجاست	but I must know exactly where this treasure is,
به شرطی که کرکره پشت پنجره را باز کنید.	if you will open the shutters for me.
مطمئنم همه تلاشی که هر کس می تونست بک نه رو کرده.	I'm sure he did all that anyone could.
جیل که ظاهرا از پیش گوش به زنگ ورود کلاید ایستاده بود.	who apparently was on the look out for him a smooth
سیگاری کشید و سپس با انگشتان خود که با آب دهان تر کرده بود آن را خاموش ساخت و ته سیگار گنده را روی کف اطاق له کرد.	lit a cigarette, smoked it, and crushed the end on the floor.
اینان هرچه دقت کنند و هر قدر مهارت بکار ببرند	for, with all the pains they take and all the cleverness they show
من اگر بخواهم چهار رباعی بسازم که شانزده مصرع باشد	so, if he made four ballad stanzas of four lines each
اما باید بگویم که آنچه احساس کردم استریکلند نیست همان مبتذل بود.	but commonplace is precisely what I felt he was not.
با خودم فکر کردم و آخرین چیزی که داشتم از دست دادم.	I thought, giving up the very last thing I had to give.
اما از فحوای کلی بیانات نامفهوم میس پراس این نکته را دریافت که رقیب او را به هیچ وجه تحویل نگرفته است.	but, she so far understood them as to perceive that she was set at naught.
خیلی هم ناراحت بودم تا ببینم بعد از آن چه خواهد کرد.	feeling but ill at ease meantime to see what was next to follow.
به ریشم قسم که خرک هم خر بدی نیست.	by my beard but the grey is a good one.
دو نامه بود که تاریخ همان شب بیماریش را داشت	were two, dated on the night his illness first came on
این یک دستور غیرمنتظره بود که ای میرا قبل از این که از پشت میزش بیرون بیاورد غافلگیر کرد.	was the unexpected command which arrested her before she got out of her seat.
در کنار خرمن زردرنگ چاوار که در خرمنگه به منظور بذرپاشی گذاشته بودند ایستاد و مشغول گفتگو شد.	fell into talk with him , stopping beside a neat yellow sheaf of rye laid on the thrashing floor for seed.
منطقه فعالیتش وسیع بود و جمعیت در نقاط دور از هم پراکنده بودند.	his parish was large, the population scattered
در میان دستان لرزانم نمایشگر و گیرنده حرارتی موتور درون کاپوت لرزشی کرد.	but between my jittery hands and the redlining heat sensor, the engine just shuddered under the hood without turning over.
مطمئن نیستم. به او التماس کردم که درباره مشکلش با شما صحبت کند.	I'm not sure. I pleaded with her to talk to you about it.
دعایی که مادرش به وی آموخته بود به خاطرش آمد	he recollected the prayers his mother had taught him
هری به زحمت توانست آن را از دستش جدا کند	he had a hard job shaking it off
من مشکلی در رابطه با مرتب کردن کارها با شرکت نداشتم.	I hadn't had any difficulty in fixing things with the firm.
راهش را با جنگیدن بگشاید وبا وی فرار کند.	fight his way out, and elope with her.
تا عاقبت وال تا حدی از سرعت گریز خود کاست.	till at length the whale somewhat slackened his flight.
اما این مانع از آن نبود که حال درجه بگیرد	but it did not prevent it getting sprinkled with grey upon his shoulders.
من باید یکی دو روزی شهر را ترک کنم.	I have to go out of town for a day or two.
ما تمام مواضع خود را در جناح چپ از دست دادیم	without a position for our left flank
وقتی که به خانه رسید زنش هنوز بیدار بود	HIS wife was up when he came in.
که شما فعلا دو هفته دی گه هم صبر کن ین تا صدردصد مطمئن به شین.	you'll not do anything now but just go home and wait until you're really sure.
گویی در حال تمرینی ساده برای تند و کند رفتن و آمادگی برای مسابقه بود	as it were, by simple exercise of will, increasing and slackening speed and turning his course.
با سرعت تمام به دنبال همسر گرامی خود روان شد.	followed his helpmate downstairs.
اما البته در زندان اوا بازرسی کرده و کلید را از وی گرفته بودند.	but he must have been searched, and his latch key must have been taken from him.
جامه خود را در آوردم و بروی خود افکندم	covering myself with my own clothes
در نتیجه آن دو دختر وقت زیادی داشتند تا با هم از زندگی لذت ببرند.	so there was plenty of time for them to enjoy life.
که هرگز به آرامش و تسکین بعد از اعتراف دست نخواهد یافت .	knew with a sinking heart that the peace and calm following confession could never be hers.
کاهوها را شست و سر شیشه روغن زیتون را باز کرد.	he washed the lettuce, heopened the olive bottle.
نباید کاری کنم که به من اهانت کند .	I mustn't do anything to risk his contempt.
او را روی تغار نگه داشتند و فنجان پشت فنجان نفت روی سرش ریختند.	held over the tub while they poured cup after cup of kerosene over her head.
گویی متوجه این نکته شد که در پیشانی دختر نیز همین تمرکز به وجود آمده است.	he seemed to become conscious that it was in hers too.
مانند دیروز که به زور وارد شد تا دریابد	as he did yesterday through impatience to search the rooms, to see
ضمناً برای سلامتی جسم و روح ما نیز سودمند است	is good for health and spirits
از هر حیث عوض شد و مرد دیگری گشت.	looked in every way another man.
با مردمان معاصر خود و تمام تصورات و پیشداوری های منفی آنان به مقابله برخاسته بودند.	confronting the people of their times with their preconceived notions.
اما پس از چهارده سالگی وقتی مادرش را از دست داد دیگر پیانو نزد چون دیگر کسی نبود تا او را تشویق کند	she had never since the age of fourteen never since the loss of her dear mother known the happiness of being listened to or encouraged by any just appreciation or real taste
من دی گه پشت دستمو داغ کردم که تا وثیقه نگیرم پول به کسی ندم.	I ain' gwyne to len' no mo' money 'dout I see de security.
مخصوصاً برای من که یک عائله چند نفری را باید نان بدهم.	especially when one has a family to provide for, sir.
از وقتی که طریقه جدید تغذیه را هیئت مدیره باب کرده	since the new system of feeding has come in
دختر خانم خودت به یاورش و به گذارش همین جا.	ou bring it, missy, and lay it down here
اما خودمو مثل برق از لای کت در آوردم و فرار کردم.	but I slid out of the jacket quick as lightning, and saved myself.
روی دو صندلی روبروی یکدیگر و بسیار نزدیک به هم نشستند.	they sat down on two small chairs opposite each other, with their knees touching.
روی تخت نشان دش و مشغول لخت کردنش شد.	sat her on the bed, and began undressing her.
مخصوصاً آشپز و کلفت خانه که در این جع حضور داشتند.	but especially the cook and housemaid, who were of the party
اما لطفاً مراعات قانون و اصول را بنمایید و با من بازی نکنید!	but kindly act in due form and don't play with me!
از دور به پسرکی شبیه بود که روی اسبی بزرگ نشسته باشد.	appearing in the distance like a boy on a too large horse.
در حقیقت رمه باید گفت زیرا سه اسب و یک خر بودند که در حین برخورد ابتدا یکدیگر را بو کشیده و سپس همه با هم به چرا پرداخته بودند.	for by this time the three horses and the ass had smelt one another out, and were all together.
با مویی به سپیدی برف و چشمی سیاه و درخشنده به وی معرفی شد.	with snow white hair and brilliant black eyes, was presented to her
من از مدیر مدرسه خواهش کردم به اساتید به گه که کاری به کار اون نداشته با شن تا شاگرد ای کلاس بتونن باهاش تمرین کنن.	I asked the headmaster if the staff would leave it to give my third years some practice.
زیرا همین که صاحبش بر زمین نشست او نیز به آرامی در کنارش دراز کشید	for as her master seated himself, she stretched herself quietly beside him
اما پیامدهای این دیدار به هر صورت بدانی ونگرانی همسرش را برانگیخت.	but he could not altogether hinder the circumstances of the visit from compromising himself and alarming his wife.
با دست کوچک و جواهر نشانش بر درگاه سعی داشت تعادلش را حفظ کند.	was steadying herself with a little bejewelled hand against the side of the door.
یه بار یه لولو خو خوره توی ساعت دیواری یک پدربزرگ جا خوش کرده بود	the cupboards under sinks ' I've even met one that had lodged itself in a grandfather clock.
با قیافه مصمم و خشنود دهانش را از پهلو گشود و آماده فریاد کشیدن شد.	with a happy and resolute countenance, opening his mouth awry, prepared to shout.
یک زخم بند از یک تکه روی میخکوب شده بر آن نصب کرده بودند.	to which a band of zinc had beennailed by way of dressing.
وفی الواقع جای پرافتخار بالای چپ صفحه اول را به آن اختصاص داده بودند.	in fact, the place of honour at the top left hand corner of the front page.
مردک از جذبه مقاومت ناپذیری برخوردار بود و ظرف یک هفته حتی با چند بار تلاش موفق شد استا را چنان مفتون خود کند که دخترک تمامی وجودش را دربست در اختیار او گذاشت.	but of compelling magnetism, who was able within the space of one brief week and a few meetings to completely befuddle and enmesh her so that she was really his to do with as he wished.
به خاطرم آمد که چندی پیش وقتی مریض شده بود دکتر اکیداً سفارش کرده بود هیجگاه نباید موجب عصبانیت و برانگیختن خشم وی بشویم.	brought to my recollection her former illness, and the doctor's injunction that she should not be crossed.
هم ون کت و شلواری رو پوشیده بودم که وقتی اومدم اینجا تنم بود.	I was wearing the blue suit I had on when I came down here.
تا جایی که آخرش تمامشان اختیارشان را از دست دادند	till at last the whole company broke down
چندان هم در عرصه عشق نامراد و بداختر نیست.	that he was either unsuccessful or ill fated where girls were concerned was false.
اما به سرعت و در یک آن خود را آماده ساخت	but was quickly, instantly, on his guard.
خیلی بهتر است تا در دست عده ی زیادی از اشخاص دیگری باشد که من میشناسم.	will be better than in the hands of a good many people I know,
به زحمت میتوانست عقیده ی دیگری را هضم کند و بر عقاید خود تعصب داشت	was slow in taking in any other person's idea, and particularly partial to his own.
من پس از آنکه او را یافتم به خانه آوردم و حبسش کردم هیچ کس تا آخرین لحظه از این جریان آگاهی نیافت.	I found him, I took him home and hid him at once. I kept him locked up at home and did not show him to any one till to day.
بر خر خود سوار شود و بی آنکه خود را به آن راه بزنی به دنبالشان برو	mount thy ass and follow them quietly
که پس از گرفتن روغن پیه بر ساحل افتاده بودند.	which had been left ashore after trying out the blubber.
مخرجی دیگر نداشت جز همان که تحت نظر بود	had but one outlet to the gallery in the sight of everybody.
از گنجینه سرشار از مهر و عطوفت خود در آن شئی بی جان روحی شادمان بیافریند.	creating a happy soul within that woodenness from the wealth of her own love.
اما یک نفر دی گه پیدا کن که دقیقاً بتواند در جای تو قرار بگیرد.	but find me another precisely placed as you are.
به قم سی که اگر آن سه چهار قطره را به تو نخورانی ده بودم	without the three drops I gave you
هر چند که هیچ ردی از آن در صدایش نبود	though there was no trace of that in her voice.
مخصوصاً وقتی اون آخری رو با چای صاف کن به دام انداخت ین	the way you trapped that last one with the tea strainer
در خاطرات فردای شما من جای ناجوری خواهم داشت.	I shall make but a poor figure in your journal tomorrow.
الغرض در سر تا سر آن کاروانسرا بجز گریه و زاری چیزی نبود	so that the whole inn was nothing but cries, shouts,
در این میان جنگ و جدال زمین بازی در برابر جنگ و جدالی که در میدآن مسآبقه برفرازسرشآن جری آن داشت هیچ بود.	meanwhile, the pitched battle below was nothing to the one taking place above.
شاید از سر گرفتن چنین ازدواجی زیاد هم ناخوشایند نباشد.	it might not be so very bad if the marriage did take place.
اکنون نیز مرا فروخت و بهای مرا دریافت کرد.	the price he had now sold me for.
که این پنجه مخملی دندانی بی رحم به زیر خود پنهان کرده است.	that this velvet paw but conceals a remorseless fang.
در مقایسه با آن مرأی که پیش چشم درون داشت هیچ تابلویی قابل نبود.	it seemed to him of no consequence compared with the vision that obsessed his mind.
شاید هم این مردک به دلیل دیگری فکر کرده بود که اوضاع رو به راه نیست	or the fellow may have had some other reason for thinking that all was not well
از جیب دیگرش یک لوله کاغذ پوستی یک قلم پر و یک جغد زنده را بیرون آورد.	from yet another pocket inside his overcoat he pulled an owl ' a real, live, rather ruffled looking owl ' a long quill, and a roll of parchment.
به حال همه مردانی که حرفه او را نداشتند دل سوزاند.	something like pity for those less lucky men who were not of his profession.
حد اقل تا هنگام ماه عسل کوتاهش آن همه لذت نبرده بود و تفریح نکرده بود .	except for her brief honeymoon interlude, she had not had fun in so long.
اما حتی آمرزش روح خویش را پول سیاهی خیرات میخانه نکرده بودند.	who could not have laid a piece of money on the counter to save their souls.
اگرچه تنها زمان کوتاهی نزد مسام حی کارآموزی کرده	though he had only been a short time under a surveyor
امروز بجز من شاه زده میش کین دیگری وجود ندارد.	there are none, except myself.
رفقای جوان به محض اینکه فهمیدند تفریح و شادی زیادی کردند.	much to the amusement of his young friends.
به سویی که هم سفرش به انتظار او ایستاده ذو از دورمتر صد بود	spurred after his companion, who was standing at a distance looking on
پس از مطمئن شدن از عشق او احساس رضایت کرده بود	how and why, having oncesecured her love he felt and thought himself content
اما آنان به سبب نداشتن مواد مورد حاجت نتوانستند قسمت اعظم مهارت خود را نشان دهند.	but they could not show us much of their skill, for want of materials.
اگر پوست نارنج موجب مرگ من نشد حاضرم کله خودم را بخورم!	I'll be content to eat my own head, sir!
اما اکنون حوالی ظهر بود و خبری از او نشده بود.	but much time had passed and it was nearly midday
شماره تلفن را نوشتم و بعد با ریتم روی صفحه کلید ضربه زدم.	I noted the phone number and then stroked the keyboard in rhythm.
بلکه در مورد اون با آدم بحث می کنه.	she tells you about it.
در حالی که روح و حواسم از رنجی سینه سوز در تلاطم بودند	soul and senses quivering with keen throes
چنین کسی را باید لعنت کرده و اسمش را تا ابد نیاورد.	but have a curse put on it and be forgot forever.
به نسبت اینکه این ادویه باید تا جلسه دیگر در مزاج آنان مؤثر افتد و تکرار عملی را موجب گردد یا وقفه آن را سبب شود.	according as these medicines should operate, repeat, alter, or omit them, at the next meeting.
زیرا مگر یک تصنیف چه قدر تواناست که بتواند ما را از جریان زشت عبور از مرگ به زندگی سالم به دربرد	for how handy a rhyme is to pass us safe over the awkward transition from death to life
اما نکته او نجاست که باید بر این طبیعت مسلط باشین.	but to gobern dat wicked natur, dat is de pint.
ولی باید بگویم که این کینه را لزومی نداشت او به من ارث بدهد	though she need not have left me that
بعد خودش و دوک داخل آلونک شدند و لای پتوها خودشان را پیچیدند که بخوابند.	then him and the duke crawled into the wigwam and turned in for the night.
یادش آمد پیرزنی که پرستارش بوده هنوز زنده است	on recollecting that an old woman who had nursed him was still living
با وجدانی آرام و سعادتمند به بستر خواب رفتم.	I am going to bed with a happy and tranquil mind.
دندانش هایش را روی هم شار داد و آماده جنگ شد.	girding herself for combat.
اما فشاری که از همین کار به مغزش آمد خیلی زیاد بود	but the strain upon his mental faculties was too great
ولی در اینکه سرتاپای من خرد و خمیر است شکی نیست	but bruised and battered no doubt
با این کار کف صاف و چوبی اتاق عریان ساخت.	revealing a smooth, hardwood floor.
خاموش بود و شاهزاده پیر متوجه وضع غیرطبیعی او شده عبوسانه سکوت اختیار کرد	the old prince noticing this also became morosely dumb
خود نیز بدون اینکه چیزی بگوید به تماشا پرداخت.	looked on without speaking.
در همان لحظه صدای سرد و بی روح اسنیپ را از پشت سرشان شنیدند و هرمیون حرفش را نیمه تمام گذاشت.	said an icy voice right behind them, and all three of them jumped
شجاعانه بلند بلند به اثبات لزوم اعزام نیروی کمکی به میدان نبرد پرداخت	in a loud voice began boldly demonstrating the necessity of sending reinforcements.
بدیهی است من از او شکایتی نکردم بلکه بر عکس بدی گران توصیه کردم که در این خصوص سکوت کنند تا آموزگاران از ما جری آگاهی نیابند.	I did not sneak on him, of course, and I made them all keep quiet, so it shouldn't come to the ears of the masters.
دیروز هم شما خود را همچنان که اشک در چشمانتان حلقه زده بود به او شناسانیدید.	that when you met yesterday you made yourself known to him with tears of joy.
یه بزرگ الان به من گفت که من بیش از نه سال و ده ماه دی گه اینجا نخواهم ماند.	one of the big girls has justtold me that I have only nine years and ten months longer to remainhere.
تا آن لحظه غذایی به آن خوشمزگی نخورده بود.	but he still couldn't take his eyes off the giant.
چنانکه گویی در شگفت مانده بودند که چرا خودشان به شنیدن سؤالاتی چنین بیهوده آنقدر به هیجان آمده بودند.	as if marvelling how it was that they themselves became so excited at such seemingly purposeless questions.
لکن اکنون حالش بهتر شده و خطری ندارد با این همه سخت خسته و عصبانی است.	that now she was better and out of serious danger, but still in a nervous, hysterical state.
چنانکه در حدود صد و سی سگ شکاری و بیست شکارچی سوار در دشت دیده می شدن.	so that, with the borzois on the leash belonging to members of the family, there were about a hundred and thirty dogs and twenty horsemen.
ملکه با هردو دست دل خود را گرفته بود که تپیدن دلش معلوم نگردد.	during which the queen pressed her hand to her side, evidently to still the beatings of her heart.
امیدوارم شما یک کسب و کار آبا و اجدادی داشته باشید	I hope you have a family business
آنهم ظاهرا بی آنکه نیاز روحی و اجتماعی ربرتا کمترین تغییری در رفتارش پدید آورد.	without a thought, seemingly,that her great moral and social need should modify his conduct inany way.
این الزام که شخصا خودش هم به مهمل گویی بیفتد به هیچ وجه بخشی از معامله نبوده است.	the obligation of uttering balderdash personally was by no means included in the bargain.
او در کشتی بهترین یار و همراه من خواهد بود.	here was one of the best of possible shipmates.
برآمدگی ای را که دیروز روی شکم ام وجود نداشت لمس کردم.	I touched the bump on my stomach that had not been there yesterday.
زیرا این یکی از مواردی است که حقیقتی در آن وجود ندارد.	for this is one of the cases where the truth does not exist.
سرش پائین بود و دستش را بین پاهایش حلقه کرده بود.	its head lowered, its tail coiled down and over its privates.
بنابراین امیدوارم که این نامه به موقع به دست تو برسد.	so I hope this reaches you in time.
زیرا تبسم اخیر او پر از محبت و حلاوت و در آن نوعی سادگی و معصومیت نهفته بود.	for it was full of amiability and sweetness, and there was a simplicity in it,
بدون توجه به ژنرال دست کوچکش را بالای سر سایبان کرده به پیش رو نگریست	not noticing the general, looked out shading his eyes with his small hand.
برای تثبیت عزتن فس ملی که بدون وجود آن با نیرو و انرژی تمام اعلام کرد که	for the establishment of national self respect without which he declared with energy
داره با بقیه مشورت می کنه که برای تم وم کردن دعوای ما پا پیش بذاره	he's debating whether or not to come break up our fight.
قادر نبودم جای دقیق آن را به خاطر بیاورم.	I couldn't even say exactly where it used to stand.
در حدود سه چهار پوند نقد در بانک دارم.	between three and four thousand of ready money in the bank.
ناگهان به گوشه اتاق نشیمن به خصوص اتاق خودش در کنار سالن بزرگ برود.	to withdraw quietly into a little drawing room, especially her own, next to the great sala.
امیدوارم کاری به کار این گونه مشاجرات نداشته باشم.	I hope I shall have nothing to do with clerical disputes
شبیه به محبت نعشی است که بخواهد باز آید و زندگان را در آغوش گیرد.	the tenderness of corpses whichshould return to embrace the living.
که از قضا به پیچی رسیدیم و همین که سر پیچ من به عقب نگاه کردم	when chancing to turn a corner, and looking back as I did so
بعد به اتاق صبحانه رفتند که در آن میز صبحانه را چیده بودند.	went down to the breakfast parlour, where breakfast was prepared.
خود را به دقت هرچه بیشتر در آن برانداز کرد.	surveyed himself minutely in it.
دکتر با مهابتی تمام و با وقر و تمکین گفت	with an imposing calmness, but I think it is now
در این اقدام به قدری توفیق پیدا کرده بود	he was so far successful
بالاخره پهلوان دخترک را در خیال خود به لطف و زیبایی شاهزاده خانمی مجسم کرد	in short, he drew her portrait in his imagination with the same features and in the same style as that
تمام این مدت منتظر بود صدای زنگ در بلند شود.	he was listening all the time for a ring at the bell.
پیرمردی هم از من نشو نی دار التبلیغو پرسید.	one old gentleman asked me wherethe mission was and when we held services.
او را به ابلهی معتاد به الکل تبدیل کرده بود.	had driven him into an alcoholic stupor.
اما در جایی که سرنوشتی جز کاروانسرا داری نداشت ناچار بود که به چریدن مشغول باشد.	but an inn keeper must browse wherefate has hitched him.
ولی در همین دم مرد جوانی که در گوشه دیگر کالسکه نشسته بود او را پس کشید	when he was suddenly pulled back by a young gentleman who occupied the other corner of the chaise
من دیگر تحمل دیدن شوهرت را ندارم چون او را خواهم کشت.	I might meet your husband, and I should kill him on the spot.
پس از دقت و مطالعه کافی به این نتیجه رسید.	he deduced for himself the following of the state of affairs.
در حالی که به بافتن مشغول بود جای خود را ترک کرد و از حیاط گذشت.	went, knitting, out of the lamplight, through the courtyard.
اطاق بسیار تنگ و کوچک بود که یک تختخواب و یک صندلی و یک جالباسی داشت و چند دست لباس پشت در آویزان بود.	which was a tiny place about eight by six, with a cot and a chair and a dressing stand and some dresses hanging behind the door.
نشست و بشقابی پر از گوشت خوک و دو نان درشت برداشت	sat down, loaded his plate with pork and two big biscuits
همچنین با توجه به این امر که او بعدا در صدد نجات ربرتا بر نیامده بود	that afterwards he had not gone to her rescue
احتمالاً فکر کرده که من هیچ احساسی به جز یک دوستی ساده ندارم.	he probably thinks I don't care a thing about him except as a friend.
کاری که به پلیس باید گفت نه به ما	an affair for the police!
دوباره استخوان را همچنانکه در ابتدا قرار داشت راست و مستقیم در ظرف استخوان نهاد.	placed the bone again in the dish erect, as it stood before.
او بازپرس بود و از مدت قلیلی پیش مستقیما از دانشکده حقوق به دادگستری آمده بود.	he was the investigating lawyer, from the school of jurisprudence, who had only lately come to the town.
چون ممکن است چنین فهرستی به کار محقق بعدی بیاید	for possibly such a list may be valuable to future investigators
استاد بی درنگ آمده بود تا دیدگاهش را برای او تشریح کند.	the professor had promptly appeared to argue the matter out.
بسیار دشوار بود که حدس بزنم آن روشنایی از چیست.	I could not think what it might be.
شاید خود را چنین آموزش داده بود که احساساتش را به جانب دیگری معطوف کند.	whether he had taught himself to sublimate his passions almost perfectly
آن دهکده کوچک آن طرف تپه و کلیسای او آن کلیسایی است که نزدیک دروازه است.	that little village yonder on the hill and that church near the gates was his.
ناگهان چیز انبرمانند دراز و پرمویی را احساس کرد	suddenly he felt something long and hairy
چنان طوفانی از مشت و لگد بر سر پهلوان بدبخت بارید	rained down upon him such a shower of fisticuffs
به دنبال آن فریادهای هورا و ژی وی و طنین انداخت.	then shouts of hurrah! ' and jivio!
با شنیدن این حرف از دهانش احساسم کردم صورتم گر گرفت	I can feel my face growing hotter and hotter.
به این نتیجه رسید که او واقعاً گم شده است.	he gave him up for lost
اما این نگاه دوستانه و نوازش دهنده حاکی از برتری و تفوق صاحب نگاه بود.	yet his glance friendly and affectionate as it was expressed a sense of his own superiority.
نقش یک یتی را بازی کرده بود که روی سرش یخ داشت	a yeti with a head cold
چون او را کاملاً از درون غار بیرون کشیدند دیدند که چشمانش مانند چشمان کسی که به خواب رفته باشد بسته است.	drawing him out entirely they perceived he had his eyes shut and every appearance of being fast asleep.
مگر این که مورد خیلی خاصی پیش اومده با شه.	except in very special circumstances
آن دو نفس را در سینه حبس کردند تا پلیس رد شد.	they held their breath till he was gone.
بعلاوه کنت 6000 روبل جهت تهیه لباس رسمی افسری با لوازم گوناگون برای پسرش فرستاد.	finally there were six thousand rubles for his outfit and various other things the old count sent to his son.
آنهم با غلامی که من او را بسیار دوست داشتم	with a page, whom I was very fond of
مزاجش چنان به شدت اجابت کرد که برای من و همراهانم بسیار زننده بود.	made so violent a discharge as was very offensive to me and my companion.
سرجیمز ناگزیر شد بر احساس ناراحتی و خشم خود سرپوش بگذارد.	that he was obliged to behave as if nothing had annoyed him.
قیافه هیچ کدام از این دو نفر تفی نداشت دمغ بودند.	there was gloom on the face of each.
ولی من نمی تونم فراموش کنم خانم اسکار لت.	but I can't.
در عمرش هرگز با مردی آن طور محترم آشنا نشده بود.	whom he considered the most honorable man he had ever known
اگرچه با خود عطرها و چیزهای خوشبو زیاد دارند	even if they do carry odours about with them
اما الیور موفق شد با یک شیرجه آن را مهار کند.	dived on top of it and managed to pin it to the ground.
تا کنون این نوع از نظر علمی ناشناخته بوده.	genus hitherto unknown to science.
قول دادم اجازه دهم پدرم مرا معاینه کند و او رهایم کرد.	I promised I would let my father examine me, and he let it go.
کی بود که او را از رفتن به مهمانی قدغن کرده بود	who used to fake seizures at frat parties when she got bored
صدایش در اثر آن همه داد کشیدن گرفته و خشن شده بود.	hoarse from so much roaring
قول داد که برای کسب اطلاع از وضع ساکنان آن کمال سعی را بجا آورد.	resolved to ascertain with particular care who lived in it.
به شرط آنکه به آیین پهلوانی که فرمان آن را یافته است سوگند یاد کند	as he has sworn to me by the order of knighthood which he has received
در جستجوی سوراخی بود تا خود را در آن پنهان سازد	he was seeking a hole inwhich he might hide until
آرزو کردم که کاش خودم به تعمیرگاه رفته بودم.	I wished I'd just gone to the dealership myself.
ولی شاید این ماجرا درسی به تو داده باشد.	but maybe it's taught you a lesson.
باید طبق معمول دزدانه نگاه کنند و لبان لرزانمان هستند که کم و بیش با نگرانی صدایمان را میزان کنند.	peeping as usual and our timorous lips more or less under anxious control.
فکر کردم مجبور شوم خودم بدان جا بیایم و پسرم را بیاورم.	I feared I should have to come down and fetch my property myself.
من فقط میخ وام آن چیزی را که صلاح است انجام بدم.	I only want to do what's right.
مطمئن باش که تلگراف حتما به دستش میر سه.	I know he'll get it all right.
بعد رهایش کرد و باز به آن خیره شد.	let it fall, with a shudder.
در این جای تردید نبود که میان او و متهم شباهت چندان بود	they were sufficiently like each other to surprise,
هفته پیش به یه زنی گفته بودم به یاد اینجا یه نگاهی به پاهام بک نه.	I had a woman up here last week to look at my feet
این چیزیه که واقعا نمی تونی بهش عادت کنی.	it wasn't something you ever really got used to.
بقیه را دقیقاً به همان صورت که نوشته شده نقل خواهم کرد	otherwise they are exactly as written
به محض دمیدن سپیده صبح از رختخواب بیرون آمدم.	I rose as soon as day dawned.
بزودی بازی را رها ساختند و کنار سماور آمدند	soon left their game and came over to the samovar
به سرعت پیچ و تاب غریبی به آن داد.	attempted a complicated sort of wiggling action
هنرمند بازنشسته در سایه روی یک بشکه نشسته بود	the retired artist sat on a barrel in the shade close by
اما همین که پا به داخل گذاشت دیگر ندیدش.	but when she entered his figure was gone.
اجازه داد که روی سه چهار پایه که نزدیک نخستین پله او رنگ عالی جناب بود بنشینیم.	we were permitted to sit on three stools, near the lowest step of his highness's throne.
سرانجام من دل و جرأتی به خرج دادم و دست خود را به قصد نوازش بر گردنش رساندم	at last I took the boldness to reach my hand towards his neck with a design to stroke it
بار سوم به قدری ناراحت شده بودم که چیزی نمانده بود روی برگردانده و فریادی بر سر او بکشم.	I felt a senseless stupid irritation come over me, and I did not know how to prevent myself from turning round and screaming to him to stop.
ولی متوجه شد که وجودش برای مقدمه این گفتگو ضروری بوده	but understanding that he was wanted as a peg on which to hang the prince's favorite topic
عشق و حسادت او را از حسادت و عشق آگاه کرده بود.	from about the same period, one sentiment having probably enlightened him as to the other.
فوراً او را شناخت که یکی از نوکرهای پدرش است.	but presently recognised him as one of his father's servants
که برای مرگ کسی در چنین شهر بزرگی نیاز است	upon a death in a large city
که مطلب را به مردم واضح کرده و نهایتی از برای این امر بگذارد	, which will bring this dreadful tragedy to a close
قریب به یک ساعت این ظرف غذا را در دست نگهداری کرده	he held the plate in his hand for an hour at a time
زودتر از حد معمول به کارگاه برگشت تا بلکه دخترک را تنها گیر بیاورد	returning a little early in the hope of finding her sufficiently detached to permit him
ولی در هر صورت قیافه غمگینی به خود گرفته بود و پس از چند لحظه به سوی پدرش رفت.	but his cousin put on as sad a countenance as himself, and returned to her father.
فقط دانست که این نامه را او فرستاده یعنی آن مردی که او دوستش دارد.	only that it was a letter from him from the man she loved.
زیرا که در درجه اول آن را ایجاد و مسلح نموده است.	because it created and armed them in the first place.
هر فصلی رشد سریعی برای او به همراه داشت.	every season would bring rapid progress.
اطمینان دارم که نخستین باری است که شما کسی را دوست دارید.	I know now that you have never loved before.
اگه بخوام شغلمو از دست ندم غیر از این راهی ندا ره.	if he chose to ignore them, as he must to keep his position here.
در آنجا در حالی که کشتی تحت فشار رو به آن خمیده بود	there with the strained craft steeply leaning over to it
یک ما مور متفرعن قطار در واگن را محکم بست و چفت آن را انداخت.	an impudent conductor slammed the door and the latch.
روی را برمی گرداند تا شرمش را پنهان کند.	looking away to hide her shame.
منظره غریبی بود که به بالا آمدن بازویی از میان علف روی قبر شباهت داشت.	a sight strange to see, as an arm thrust forth from the grass over a grave.
در عالم خیال تصمیم گرفت که تمام مؤسسات را به منتهی درجه از بخشش و سخاوت خود برخوردار سازد.	he mentally decided that he would shower favors on them all.
برای تشکر از شهامتی که آن شب جیل به خرج داد	in consideration of his gallant behaviour on the occasion of that attempted robbery
این کلمات را رازومیخین ناگهان و به طوری که خودش هم انتظار آن را نداشت ادا کرد.	he blurted out suddenly to his own surprise
مگر آنکه بکوبیم خدمتکارهایی که درها را باز کردند شاهد دیدارشان بودند.	unless the servants chiefly intent upon opening the proper doors could be called such.
گلوله از بالای سر افراد قشون روس که پای تپه بودند پرواز کرد و نرسیده به دشمن به زمین خورد.	a whistling grenade flew above the heads of our troops below the hill and fell far short of the enemy
به من دستور داده شده که این پاکت را فقط بدست خود مادام لاکونتس بدهم.	I have orders to give this into her hands myself.
حال به اوجی از حرمت رسیده بود که از قدرت و هم او نیز به دور بود.	was now so exalted that he could not take it in in his imagination.
حتما فکر کرده گذاشتن اون روی میز از یادداشت خودکشی به راش راحت تر بوده.	I guess he thought leaving them there was all the suicide note anybody would need.
هر کدام به طرف یکی از میزها رفتند و روی صندلی خود نشستند.	each walked to a table and took her seat.
لابد به نظر پدر و مادرهایتان شماها نظیر ندارید.	I suppose your mothers and fathers tell you you're wonderful.
برای نوشتن اون خط آخر حتما مجبورشده از سقف آویزان به شه.	his ass must have been out to the wind when he put that last line on
از آن لحظه به بعد او آرامش خود را از دست داد و احساس کرد که فقط به خاطر مائوریسیو بابیلونیا زنده است.	it was then that she lost her calm and lived only for him
تا به حال برایش پیش نیامده بود که تأثیرات سیانور طلا را روی جسد بررسی کند.	he had never had the opportunity to study the effects of gold cyanide on a cadaver.
زیرا نیمی از آن را که چانه بند است فاقد است.	for half of it is wanting, that is to say the beaver.
به ویژه که خیار بسیار گران بود و فصل آن نبود.	especially since this had been a very dear season for cucumbers.
تعلیم نادرست درباره این موضوع به اندازه تعلیم ندادن مضر است.	on such subjects wrong teaching is as fatal as no teaching.
که دفعتاً احساس کرد او باید احساس شرم کند و خود نیز به همان سبب خجل شد.	when she suddenly felt that HE ought to feel ashamed, and that she was ashamed of the same thing.
آنهم درست موقعی که قرار بود او به خانه والدینش برود	when she was about to leave for home
اما همین که زن عرب نام خود را شنید	but the instant she heard him
من چیزی نگفتم تا وی کمی گریه کند و بغض گلویش وا شود	it appeared, at present, her favourite diversion.
من فقط مایل هستم بگویم که به عنوان قدرشناسی از این افتخار	I merely wish to say, that as a slight token of my gratitude for the honor done me
بلکه در عوض در آینده جانب احتیاط را رعایت کنید	rather to be circumspect in the future
من عاشق این هستم که اینجا بشینم و از مغزتان استفاده کنم	I'd love to sit down with you and just pick your brain
دیری نکشید که تردید من در این باره از میان رفت.	I could no longer be in doubt about that.
چرا باید همه افراد خانواده او رااز صحنه روزگار محو کنند	why would anyone want to wipe out his entire family?
با سه نفری که در برابر پیشخوان به نوشیدن شراب خود سرگرم بودند به گفت و گو پرداخت.	fell into discourse with the triumvirate of customers who were drinking at the counter.
تا ما به سرعت به جایی برسیم و بتوانیم چیزی برای خوردن شیرها پیدا کنیم.	for we must make haste to the place where we are to feed them.
شاهزاده نیز لبخندی زد ولی هنوز زبانش قادر بحر کت نبود.	he smiled, but his tongue could not form a word as yet.
شصت و دو توپ به آتشبارهای دشمن حمله کنند.	in all 62 guns.
بقایای ابدی از خودش در یک اتاق باقی بگذارد.	leave an eternalized fragment in a room.
سینی بزرگی را با هر دو دست گرفته بود به اتاق وارد شد.	with a double chin and full red lips, entered carrying a large loaded tray.
من از قفس بدم میاید. هرگز خوشم نمی امد.	I don't like cages, I never did.
دهان رون از حیرت و شگفتی باز مانده بود.	whose mouth was hanging open.
بدون اینکه منافع مرا هم به همین چشم بنگرید.	without taking care of me, number one.
من اونو دعوت کردم هروقت دلش خواست برای شام به یاد پیش ما	I invited him to supper whenever he wanted to come
خودش در سن و سالی هست که بفهمد چه کند.	she is old enough to know what she is about
راستش را بخواهید خیالم از اینکه شما را تنها بگذارم راحت نیست.	I am doubtful about leaving of you,you see.
محلی که به قصد انجام مصاحبه برای منشیگری کسی به آن جا رفته بود.	where she had gone for a job interview as someone's secretary.
تا دو طبقه بالاتر هیچ حرفی به هم نزدند.	didn't speak at all until they had climbed two floors up.
که سرانجام قادر به تحمل این وضع شده است	he was beginning to feel slightly sustained at least
را که به دولتی سرنگون شده وابسته بودند نجات دهد.	belonging to an overturned government.
اما کسی حاضر نشد برای دفاع مهمانخانه همراه ما بیاید.	not one would help us to defend the inn.
در حالی که آسمان را به کنت نشان داد	pointing to heaven with solemnity.
دلم خنک شد که زی لا به چیزی که حقش بود گرفتار شد.	I'm gladZilla got what was coming to her.
من خیال ندارم هیچ چیزی را از او پنهان کنم.	I'm not going to keep secrets from him.
منظورش گیر آوردن والدین و به چهار میخ کشیدنشان برای شهریه بود.	that is to say, canvassing likely parents.
چون اون یک قهرمان بود هر کس غیر از این گفت بزن تو دهنش .	for he was a hero and don't let anyone tell you differently.
آن تابلو بر روی دیوار باریک یک پلکان مارپیچی قرار داشت.	picture hung on the wall of a narrow spiral staircase.
موهای خیس و نگاه خیره و بی فروغی که حاکی از یک خستگی جسمی و تشتت اعصاب بود شد.	the hair dripping with water, the dim gaze that told of physical prostration and disordered nerves.
همه برای تماشای خوشی و شادمانی ارباب آمده بودند.	who with beaming faces had come to see their master making merry.
که به نظارت جداگانه یک دستیار زن یا مرد نیاز دارد.	department which required the separate supervision of either an assistant forelady or man.
سراپای بند من محتاج حفاظتی است که مرا از گرما و سرما مصون دارد	my whole body wanted a fence against heat and cold
دوست عزیز من بسیار میل دارم با تو صحبت کنم ولی فرصت آن را ندارم.	I should like to have a chat with you, my dear boy, but I haven't the time.
سپس نگاهش را با تأنی در اطراف سال ون گرداند.	cast her eyes slowly round the room.
دیدم چشمانم سرخ شده و دست در صورتم به حال اسفناکی درآ ده است.	to see how red my eyes were, and how sorrowful my face.
آنگاه ما بی درنگ اینجا را ترک خواهیم کرد و موضوع همین جا خاتمه خواهد یافت	we will go away at once, and there will be an end of the matter.
اورسولا از فرط حیرت و ناراحتی فقط توانست گریه کند.	rsula wept in consternation.
به خصوص به من گفتند که حضرتعالی شاعری بزرگید.	above all, that you are a great poet.
سرانجام من و مادرم بدین فکر افتادیم که با هم به دهکدة مجاور برویم و کمک بخواهیم.	at last to go forth together and seek help in the neighbouring hamlet.
زره تن این پهلوان از پوست مار و سپرش لنگه در بزرگ معبدی است	who for armour wears that serpent skin, and has for shield a gate which
به ساعتم نگاه کردم. ساعت نه و ربع بود.	I glance at my watch and see with a dart of shock that it's 9. 15.
ولی یک سانتور دیگر با مو و بدن مشکی جلو آمد	but it was only a second centaur, black haired and bodied
باد و وحشت او را از تنفس بازمی داشتند.	terror impeded her breathing.
در بعضی جاها متمایل به زرد و در نقاط دیگر بدنم روی هم رفته در حال ناپدید شدن بودند	yellowing in some places and disappearing altogether in others
برهان این مطلب این است که فامیل من به بستگی و اخلاص خود به شاهزادگان مطرود باقی ماندند و پدر تو شتاب کرد تا خود را به سلطنت جدیده بست	in proof of which I may remark that while my family remained among the stanchest adherents of the exiled princes your father lost no time in joining the new government
هر چهره که برایش آن همه عذاب و لذت بار آورده بود	every face that had given him such torments and such raptures
به دست شویی می رو مو بعد به پایین نردبان برمی گردم.	go to the toilet, then return to the base of the ladder, pick up the log and climb again.
برعکس او نان را با دست چپ خود برید و سوپ را با دست راستش خورد.	broke his bread with his left hand and drank his soup with his right.
ناپلئون ظاهرا اعتقاد راسخ داشت که این تذکر باید برای مخاطب او مطبوع باشد.	he said, evidently not doubting that this remark would be agreeable to his hearer since it went to prove his
دوست دارم در دریاهای خطرناک سفر کنم و به سواحل وحشی پیاده شوم.	I love to sail forbidden seas, and land on barbarous coasts.
اگر هم پولی کنار گذاشته مال این بود که به خودش گرسنگی داد.	if he didn't save it wi' clemmin' his own inside.
هیچ فلزی نیس که تاب این همه تک ون رو بیاره.	the metal ain't made that'll hold it for long.
چون هر قدر هم که در این مورد یک وال تصادفی خاص و ممتاز باشد	for however peculiar in that respect any chance whale may be
در نتیجه احساس کرد که انتقامش را از آن زن گرفته است.	she had the delicious pleasure of vengeance fulfilled.
اما من قضیه را به بعد موکول کرده بودم.	which I had postponed taking.
شمشیرش را در هوا حرکت داد و آزمایش کرد و آن را در غلاف گذاشت.	then he flourished the saber, tested it, and sheathed it.
بالاتر از همه به سردرگمی عظیم و عجیبی دچار شده بود.	a ghastly, all pervasive embarrassment.
ما با هم همسایه هستیم و تو نباید فکر کنی که مزاحم ما خواهی بود.	we are neighbors, and you needn't think you'd be a bother.
که دشمنانش برای رسوا کردن و حمله به مقام بلند اجتماعی او از آن به عنوان موهبتی آسمانی استفاده خواهند کرد.	which would be a perfect godsend to his enemies for calumny and attacks on his high position in society.
من می دونم که اینجا به طرز تهوع آوری ساک ته.	I know that it's awful quiet.
تا از همه بیشتر به موجودات زنده نزدیک باشد	to be as near living people as he could
یعنی توطئه ای در زندان که جان لوسی را به خطر انداخت و یحتمل جان دختر او و حتی پدرش را.	a prison plot, and that it will involve her life'and perhaps her child's'and perhaps her father's
هر کاری هم کنی من وقتی که کنار ادوارد باشم ساده به نظر می آم	I'm going to look plain next to him no matter what.
بهتر است اول همشیرهء شما را تا سر خیابان خودشان همراهی کنیم.	I propose that we first conduct your sister safely to the corner of her own street.
یکجورایی امیدوار بودم که حالا حالا هم به آن پی نبرد .	I kind of hoped it wouldn't soon.
تا حالا به کسی نگفته بودم که از پرواز وحشت دارم.	I've never told anyone I'm scared of flying.
به پادگان نظامی شهر نیز دستور داده شد تا آخرین نفس مقاومت نمایند.	the garrison received orders to resist to the end.
بیان حقیقت برای او با همان دشواری طبیعی همراه بود که ادای سخن برای شخص الکن	but it was as difficult for him to tell the truth as for a stutterer to pronounce words.
حال دیگر برای من و شما جز خوردن شراب شیرین کار دیگری باقی نمانده است.	there's nothing left for you and me but to sip sweet wine, my dear, n
روی پل مردی اسب سوار را که پاکت بزرگ و سفید رنگی در دست داشت متوقف کرده بودند.	on which they had stopped a horseman holding a large white envelope in his hand.
بچه شیرهای جنگجو اما اطاعت پیشه او گردش جمع بودند.	surrounded by his warlike but still deferential cubs.
این خطر در پیش است که قفس چنانکه درخور نزاکت و نجابت پهلوانی چون او است پاک و تمیز نماند.	the prison might not be as clean as the propriety of such a gentleman as his master required.
این شهر را کف و جوش تجارت محاصره کرده است.	commerce surrounds it with her surf.
زیرا در چنین نبردی ما به جای اینکه به هم صدمه بزنیم گرد لباس یکدیگر را پاک خواهیم کرد.	for that sort of battle will serve to knock the dust out of us instead of hurting us.
بعلاوه فقط برای مدت کوتاهی قصد اقامت در آنجا را داشتند	as they had come only for a short time
چون هم سرعتش خیلی زیاده هم پیدا کردنش سخته.	because it's so fast and difficult to see.
دلیلش این بود که ربرتا را به تخطی از اصلی فراخوانده بود	for here he was encroaching upon something t
در آن روزها وحشت از تاریکی کودکانه کمی از بین رفته بود	in those times the childhood fears of the night had faded a little
باید آن را روی سنگ حکاکی کرد تا هیچ بادی نتواند آن را پاک کند	we must engrave it in stone where no wind can ever erase it.
لذا او جین خود را در سکوت کامل نوشید	so he drank his gin and water in silence
که اگر اتفاقاً من بتوانم به نحوی به دردت بخورم	that if you should need me
در پی هم تمام دسته سگان شکاری خارج شده از همان محلی که گرگ دویده بود عبور کردند.	sprang helter skelter from the wood opposite and the whole pack rushed across the field toward the very spot where the wolf had disappeared.
او را از دو تمنای آشکار آگاه کرده بود.	made him aware of the too obvious appeal
از گناهکاری خود به وحشت افتاد و این بیم و وحشت از این جهت بود	she felt horrified at her own vileness, horrified
همه با هم برابر باشند و هر حیوانی به قدر وسع کار کند	all equal, each working according to his capacity
بلکه بیشتر به یک قطعه گوهر درخشان و نابود نشدنی شباهت دارد.	but rather the radiant resemblance of one, cut in an indestructible gem.
او را در نظر آوردم که وارد اطاق شده کارت مرا میان شست	I saw him come into the room
حدس زدم که او هم مثل من آماده است تا سریعا دست به کار شود.	I guessed that he was ready, like me, to act at a second's notice.
با این همه ذهن من به دیدن چیزهائی خو گرفته بود که از هر سوی در پیرامون من قرار داشت	yet my ideas were wholly taken up with what I saw on every side of me
هر یک آماده جنگ بودند و چیزی نمانده بود که با هم در آویزند.	just ready to engage.
او که به شما گفت از میس ایزابلا متنفر است و حالا این طور علناً با وی عشقبازی میکند.	when he told you he hated her?
قبل از این فقط یک بار دیده بودمش و آن هم فقط یکی دو دقیقه	I have only seen her once before, for a couple of minutes
اکنون خواهند دید آیا من مردی هستم که از شیر بترسم یا نه.	shall see if I am a man to be frightened by lions.
دیگر برایشان محال بود بگویند کدامین خوک و کدامین آدم است.	already it was impossible to say which was which.
اما پیش از آنکه قدم به درون خانه بگذارد محتاطانه به دوروبر نگریست.	but before doing so she looked inquiringly about her.
ولی لری متوجه شد که باهم دوست شده ان د.	but they seemed to be on good terms now.
بنابراین حتم دارم که شخض دیگری صدای ما را نشنیده.	thus I am certain that we could not have been overheard.
سخن من نه تنها یاوه و بی سر و ته نیست بلکه برعکس بسیار شایسته و منطقی است.	will not be impertinent, but, on the contrary, pertinent.
او به من نگاه کرد و انگشتانش از حرکت ایستاد.	he looked up and his fingers stilled.
که در مناسبات خود با همقطاران و افسران مافوق نشان میداد و ترس و احترام بر میانگیخت	which he showed in his relations with his comrades and superior officers, commanding both fear and respect, and also at cards,
چون دستکم چند تن از آن دخترهای خوش برو بالا بودند.	since at least a few of them were attractive.
چنان با دقت زمین را پاک کرده بودند که گرد و غبار مرا نیازارد.	care was taken to have it made so clean, that the dust was not offensive.
آری باید این مسأله را درک کرد و جنگ را بازی نپنداشت.	we ought to understand that and not play at war.
که از خویشتن اطمینان دارد و به کار خود وارد است	who knows his job does when turning up his sleeves
اما تصمیم گرفته بود که هرگز چیزی نپذیرد از مردی که با پدرش بدرفتاری کرده بود.	but he had set his mind on not receiving anything more from the man who had been unkind to his father.
مقداری نزده به منظور مسلح ساختن عوامل خرابکارتر جمع از جا کنده شد	some area railings had been torn up, to arm the more belligerent spirits
گذشته از این چیزهای کهنه و مهجور بسیاری نیز به ذهنش راه یافتند.	withal it introduced into his mind much that was archaic and obsolete.
بعد دست خود را روی کاردی که روی میز قرار داشت برد	laying his hand on a bread knife which was on the table
آمده بودکه مطمئن شود پولی را که این قدر نگرانش بود به دست آورده است.	but to make sure she had gotten the money for which she had been so desperate.
در همان جهت شروع به حرکت کردم و حدود ده متری به جلو رفتم و بعد تصمیمم را عوض کردم.	I actually started wandering along the bank in that direction, and then when I'd gone about ten yards I turned back.
آن مرحله بینایی و گذاری که عامل رشد احساس شادی و ناشادی است.	that delicate poise and transition which determine the growth of happy or unhappy consciousness.
دخترک به نوبه خود به او خیره شده بود	she in turn stood staring down at him
سایه گذشت. و رد بسیار کوچکی در خاطره باقی گذاشت	the shadow passed leaving hardly a shred of memory.
که سومین منصب والایی است که در امپراطوری وجود دارد.	which is the third place of trust in the realm.
ما را با قدرت زیاد ناشی از اشتیاقش مثل دو ماه موازی در آغوش گرفته بود.	holding us two moons in parallel orbit by the sheer force of her will.
امیدوارم آن قدر زنده بمانم که شما دو تا را دست به دست بدهم.	I hope I shall live to join your hands.
اگه لطف کنی و بیای به دفترم من تمام جزئیات ماجرا رو برات توضیح می دم.	I will explain it all to you if you will step up to my office.
از ای نرو فرزندانشان معیاری برای صرفه جویی نداشتند	so that the children had no standard of economy
اما اگه پا برهنه باشی نمیگذارن وارد کلیسا به شی.	but then, you will not be allowed to enter churches
در این موقع پیرمرد بر اثر تنه و فشار جمعیت به وسط دایره رسید	when the old gentleman was officiously dragged and pushed into the circle by the foremost of the pursuers.
برای دوشیزه فیرفاکس غصه خورد و دنبال راه گشت تا برایش کاری کند.	grieved for her more and more, and looked around eager to discover some way of being useful.
در اینجا ناچار باید از آبروی بانوئی محترم دفاع کنم.	I am here obliged to vindicate the reputation of an excellent lady, who was an innocent sufferer upon my account.
اگر کس دیگری غیر از تو آن دوروبرها پیدایش بشود.	don't you go for to bring any of them other young whelps
به اتاق او رفتم که در طبقة قبل از آخر یا یکی مانده به طبقة زیر شیروانی بود رفتم.	we went up to his room top story but one , and cried very much.
برای من مهم نیست که آن جا کی هست یا چه هست.	I don't know and don't care to know who's there and what.
احتیاج به یک دامن پشمی دارد و دست کم لازم است که مادرش ده فرانک برای این بفرستد.	that she needed a woollen skirt, and that her mother must send at least ten francs for this.
لیکن برای تفکر در این باره وقت بسیار است	but there will be time enough to think of that
به عکس دیگر نگاه کردم و ناگهان سراپا ذوق و شوق شدم	I turn to another sheet and feel a pang of excitement.
در میان آب او را تعمدا به دست مرگ نسپرده بوده است.	that he had not willingly left her to die in the water.
او کرم شب تاب پر وش داد تا به مرادش برسد.	he bred glow worms to serve his purpose.
از احکام و تصورات جدا افتاده خود انباشته و تا حدی نسبت به کلیه بیگانگان بد گمان است	was full of his insular prejudices, and rather distrustful of all aliens
مطالب دیگری نیز به گفته افزودم که آن نویسنده را قدری شرمنده کرد و در بنیان عقایدش اندک ترلزلی راه یافت	some further remarks I added to these, with which, I think, I left him rather dumbfoundered
اگر او دین خود را به تو نپرداخت باز گردم و او را ولو در کام نهنگ پنهان شده باشد پیدا کنم.	if he did not pay thee I would go and seek him, and find him though he were to hide himself in the whale's belly.
زیرا که الآن چیزی که ابدا در فکر نیستم تو هستی.	for indeed I did not think of you in the least at the moment
تکانی از روی ناراحتی خوردم و به صندلی خود تکیه کردم.	I leant back in my chair
کارهنین در پیاده شدن از کالسکه به آنا کمک کرد	he helped her to get out of the carriage,
سنگ بزرگی را که در جلو پایش افتاده بود برداشت	snatched up a stone that he found near him
سردردی که بدون شک به خاطر نیم استکان کنیا کی بود که در پایان جشن به سلامتی نوشیده بود.	that he attributed to the half glass of brandy at the final toast.
پیش از سر رسیدن مدعوین سراسر خانه و زندگی را نشانش داد.	conducted her around the premises before the guests arrived.
به او اجازه دادم از چیزی که در سرنوشتش بود منحرف بشود	I allowed her to divert from her destined path
ولی تنها چیزی که شنیده بودند تمجید از نواختن پیانو در زیر پنجره او بود و بس.	but they had heard only benign comments concerning the serenade by solo piano.
سگی بود بدخو و خویش آزما و با غرشی دائمی و نگاهی بدخواه.	sour and introspective, with a perpetual snarl and a malignant eye.
حاضرم حلقومت را بچسبم و در برابر دو پول سیاه خفه است کنم.	I'd catch hold of your throat and choke you for half a guinea.
در تمام کشو رهائی که یاهوها در آن تفوق دارند رایج است	in all countries where they preside
سماور کوچک و جامه دان خواربار و نیم بطری روم را روی آن قرار دادند	a small samovar was produced and a cellaret and half a bottle of rum
تا دو هزار دلار لازم را برای فرجام خواهی فراهم کند.	two thousand dollars or more with whichthis appeal could be conducted.
به طرف صدایی که اسمم را گفته بود برگشتم.	I turned to the sound of my name being called
گویی بیش از معمول نیاز به آماده شدن داشت.	as if she needed more than her usual amount of preparation.
دیدم که بدن او وقتی دید آن پسر منتظر اوست سخت شد	I watched her body stiffen when she caught sight of the boy waiting for her.
امیدوارم که حالا حالاها سایه تون رو سر ما با شه.	I hope we shall have you with us for a long time yet.
من خودم موقعی که این سانحه رخ داد در حال انجام وظیفه بودم که این طور.	I myself was personally on duty when the accident occurred, 'I see.
از بس شتاب زده بودم از شوربختی آن را در خانه نهاده بودم	I unfortunately left behind me for haste
او در شورای سلطنتی تصمیم گرفته بود که باید مرا بدان گونه که گفتم فرو بندد	determined in council, that I should be tied in the manner I have related
اما همین قدر شنیدم که از برای خلاصی شاه اتفاقی کرده بودند.	I only know that there was a conspiracy to rescue the king.
از پنجره یک عاقله زن و یک دختر بچه را دید که روی دو صندلی نزدیک به هم نشسته بودند	he saw through the window an older woman and a young girl sitting very close together on two chairs
با این حال تلاش زیادی کرد تا بتواند به احترام ولی نعمت خود از جای برخیزد	made an ineffectual attempt to stand up, out of respect to his benefactor
ایشان همه با هم نزدیک شدند و از او پرسیدند که علت این همه داد و فریاد چه بوده است.	who approaching asked him what was the matter with him that he shouted so.
اما این کار را به طور کامل انجام نداده است.	but not done it properly.
لباس زیر بسیار کوچک و ابری شیمی به تن داشت.	wearing a thin silk slip
در حقیقت آنچه که تو با بیانات و عبارات روستایی خود درباره مرگ میگویی	for in truth what thou hast said about death in thy rustic phrase
آن شب من یک لحظه دیده بر هم ننهادم.	I did not close my eyes that night
پشیمان شد و چنین نمود که آمده است تا قلمش را بتراشد.	changed his mind, and pretended to want a pen mended.
تنها و ساکت نشسته بیش از پیش به فکر فرو رفتم.	I sat there in my corner
بهتر آنکه این یک روز را مانند اوراق امتحانی مدارس با خط قرمز نشان کنید	had better mark it with ruddle, like the inscriptions on the walls of class rooms
با این وصف نزدیک به نیم ساعت صبر کردند	they waited about half an hour
سبحان صبحانه را آورد و نان را روی میز گذاشت	the jailer entered and placed the bread on the table
اما وقتی نگهبان از روی پاگرد سرک کشید تا ورود یک زندانی را اعلام کند او بلافاصله سر حال آمد.	but when the sentry on the landing thrust his head in to announce the arrival of a prisoner, he revived at once.
بینی پهنش مثل بینی مارها به جای سوراخ دو شکاف داشت.	a nose that was flat as a snakes with slits for nostrils
در عمرم هیچ وقت این جوری حرف نزده بودم	I've never spoken like that in my life, I say.
نخست کسانی را که در پائین بودند خبر کردند تا به کناری روند	first warning the people below to stand out of the way
اربابم که بیدار شده بود به من دستور داد بروم ببینم چه اتفاقی افتاده است	the master called to me to see what was the matter
در این موقع دو هم قطارش از جا برخاستند.	his two colleagues were already on their feet.
تا زحمت حساب کردن و دچار اشتباه شدن را نکشیم	then we'd have no blessed miscalculations
از دیدن قیافه نحس زشت و پیر سر کار آن قدر خوشحال شدم که آمدم یک چاق سلامتی یک نم.	I wasso glad to see your ugly old phiz that I just dropped in to say howdy.
که از ته و توی کارش سر درآورند و فهمیدند چه فضایل و کراماتی دارد.	before she was, by some means or other, discovered to have every recommendation of person and mind.
به نظرش آمد که در آن اتاق جنگی اتفاق افتاده.	with the expression of one who expects battle and welcomes it.
پس بهتر است هر سه نفر سواره برویم و این پل را بگیریم.	so let us three go and take it!
قبلاً برای جلوگیری از اشتباه یا عوضی بودن بطری قدری از مشروب را خودش چشید	previously taking a taste, himself, to prevent mistakes.
باید بر من رحم کنید و نگذارید بیش از این بدبخت شوم.	you can't help being sorry and pitying me.
دیدم که آن جسم عظیم چندان فرود آمد که با من هم طراز شد	saw this vast body descending almost to a parallel with me
از آن پس نیز دیرزمانی سخنان او را به خاطر داشت.	she remembered it long afterwards.
ناگهان به خود آمد و متوجه شد بدون آموزش دریافته است که چه باید بکند.	he realized he'd found something he could do without being taught
در اطاقی که بیرون از کاخ بود بر روی زمین و در کنار دیوار قرار دهند.	was placed on the floor, along the wall, in an outer room of the palace.
این دوستی دیرین اندک اندک به احساسی بدل شده که من حالا اصلا قادر به بیان آن نیستم.	past the friendship I have had in my heart for you has ripened into a deeper feeling, a
من امیدوار بودم که بشود ترتیب این طور کارها را داد.	I hoped that sort of thing could be arranged.
که به خوبی به یاد دارم که سه هزار دوکا به صورت نقد بود	which as well as I remember was three thousand ducatsa piece in cash
لازم است که یک دوربین هم روی چشممان ببندیم.	have a telescope at each eye
که برای ما خاطر ما از آزادی خود چشم بپوشند و در مقابل ما تسلیم شوند.	when they renounce their freedom to us and submit to us.
چیزی نخواهد گذشت که صدها تن به دنبالشان از راه برسند!	now we shall have hundreds of people pretty soon!
تا بفهمد آن تجلیل از طرف چه کسی است.	to know who was the sponsor of that uncommon tribute.
که کرارا فرزندان خویش را به جرک پیشنهادی مبنی بر بهبود بخشیدن قوانین و معادریفی که در آن عمری جای اعتراض بود	which did very often disinherit its sons for suggesting improvements in laws and customs that had long been highly objectionable
هر مرد با همه توان و نیروی خود به نشیمن خود چسبیده بود	each man with might and main clinging to his seat
یادتان باشد این پسر تنها خویشاوندی است که شما در این دنیای پهناور دارید و باید قدرش را بدانید.	he's all you have akin in the wide world, that you will ever know remember.
این مرد بر صندلی کذائی دم دکان خود نشسته و مشغول پیپ کشیدن بود.	was smoking a pipe at his warehouse door.
خودم رو روی ایوان پرت کردم و اجازه دادم گرما توی سرم به پیچه.	I hurled my body off the porch, letting the fire rip me apart midair.
من نمی تونم خودم را کنار بکشم و شاهد رنج بردن تو باشم.	I'm not going to stand by and see you suffer.
او دیگر آن را درک خواهد کرد و تحمل خواهد نمود.	he would understand it, and bear it.
هری مقاومت کرد و دست و پا زد و مرد او را زد.	he struggled, and the man hit him
اما از هر دستی که رسیده دست خدایی روی او است.	but that enemy is only the agent of providence
خود پسرک خواب را تکان داد تا بیدار شود.	shook the sleeper to rouse him.
یا گواهی جعلی و قلابی را به دولتی ارائه داده با نام و تضمین خود از آن پشتیبانی نماید.	or put the phony certificate to a government, with his name and guarantee backing it up.
فقط آرامش و یک قهوه در دستان من ولی نبود.	just the quiet and the coffee in my hands'but it wasn't.
او هنوز بشقاب پر از جوجه را در دستش نگه داشته بود.	she was still holding a plate heaped with chicken in aspic.
از اینکه جای عرق قبلی زود خشک نخواهد شد ناامید شود.	knowing the old one wouldnt dry out anyway.
باید این عبارت را چندین بار برای خود تکرار کنید.	repeated over and over.
در مورد اخیر است که لیاقت و شم قضایی	here capacity and sound judgment come in
صدای خفیفی کاملاً مغایر با آن صداها که موجب وحشتش شده بودند از وی بیرون جست.	a little noise, very different from that which was causing him so much fear.
تا آنکه نگاه سرگردانش به مجموعه تابلوهای کوچک رسید	till her wandering gaze came to the group of miniatures
دارای علف دان و آخوری بود که در امتداد یک ضلع اطاق قرار داشت.	a rack and manger, extending the whole length on one side.
ناگهان از اتاق لیزی صدای تالاپ و تولوپ بلند شد	I hear a thumping sound from her room
موجب کمال و افتخار و مباهات من خواهد بود.	I should esteem it the happiest good fortune.
با جواب دادن به سوا لش او را خجالت رهایی دادم .	I spared him from his mortification by answering his question.
ربرتا حس کرد که او نه تنها فقط اندکی از دیدنش شادمان شده است	she could feel that apart from being moderately glad to see her again
امروز صبح بنا به دلایلی باید حال بهتری داشته باشم.	this morning there were reasons why I ought to have been in a better mood.
چیزی وجود نداشت که من بتوانم بی گناهی خودم را نشان بدهم.	there was nothing I could say to clear myself.
تا بتواند به میل خود او را در اطراف سرگردان سازد.	enable it to ramble at its pleasure.
با این همه جرئت نکرد از او سئوال کند.	but he did not dare ask him a question.
مثل اینکه بیش از قاطر خود به رفتن شتاب داری.	you seem to be making more haste than suits that mule.
او باز آن کت و شلوار پرموی قهوه ای زشتش را به تن داشت و به میز بالای سرسرا چشم دوخته بود.	he was back in his horrible hairy brown suit and gazing up at the top table.
تا آمدن لاری آن را به دقت توی کشو میزش گذاشت تا نشانش بدهد.	whom she wanted as a second witness.
اما او هم دریافت که دیگر برای فرار خیلی دیر شده است.	but he could see that it was too late to try to escape.
وقتی یکی دیگرش آمد و خواست با تو عروسی کند	when the next comes and wants to marry you
باید دریافت که درحال اجرای نمایش یا جلب توجه یکدیگر هستند.	it is a powerful signal that they are making a play for one another.
من مکرر بت و گفته بودم که ممکن است این برای تو پیش آید.	I told you that this is what would happen to you.
این کارت و این مکتوب سر به مهر را به ایشان بدهید.	that card and this sealed paper
هر یک از طرفین در حال رزم و پافشاری خون خود را از دست دهد.	wounded men, each of whom, still fighting and still resisting, is expending all his blood.
اما وقتی آن را به دقت روی طومار بزرگی نوشت که خواندنش آسان بود.	but when he had copied it carefully, in a large scrawl that was easy to read
من دیروز یکی از ملازمین را به ملازمت خود آوردم	I yesterday engaged a servant
دفاتر حسابداری تم اما خط خوردگی داشت و نامرتب بود	even the parish registers were in a muddle and so on and so on, ad infinitum.
خود را بر زمین افکند و در برابر پیکر والانتین زانو زد	fell heavily on his knees before the bed.
با چنان درخششی شروع به نورافشانی کرد که چشمان او را خیره کرد.	with such strength that the light creaked like a fishing boat.
ولی الآن ساعت یک بعدازظهر است و هنوز برنگشته شاید اصلاً برنگردد	but he has never come back and now it is almost one
لیکن شاه و ملکه وی را به حضور بپذیرند و بدرود گویند	as he takes his leave of the pair
او در پاشنهٔ کشتی به نرده تکیه داده بود	was leaning against the after rail
از او بپرس آیا ممکن است من به دیدارش بیایم یا نه.	ask her if I may come.
امروز به شما ظاهر ساختم که من دلی دارم.	I showed you this morning that I had a heart, did I not, count?
مگر اینکه چندان کوتاه باشد که در دو کلمه ادا شود.	unless indeed it is short enough to be said in two words.
لکن بر اثر طپش قلب شدیدی خواب بچشم انش نرفته بود.	but could not, owing to the painful beating of his heart.
هوای عطر آمیز هم در دالان کوچک آن پر شده	the sweet smelling air stealing in at the low porch
درست مانند همان که او محتوایش را دور ریخت	just as it was when she threw the contents into the ashes.
آنگاه زنگ را به صدا درآورد و جام تازه خواست.	then, rang the bell, and ordered in another.
بنابراین بهتر است از جایتان تکان نخورید و آرام باشید.	so you may as well sit down.
کیفیت دو موردی که به من ارجاع شده بود	stating the nature of the two cases to which I had been summoned
ولو اینکه در مقابل خود دو غول دیو پیکر ببیند که سرشان نه تنها به ابر بسا ید بلکه از آن نیز بگذرد و به جای پا دو برج بلند	though he may see ten giants, that not only touch the clouds with their heads but pierce them, and that go, each of them, on two tall towers by way of legs
یکی از گل کاری ها را دور زد و با سه خیز روی یک گل فرود آمد.	circled one of the nearby flowerbeds, and made a three point landing on a peony.
تنخواهی را که کنت در زیر درختی مدفون کرده	the sum of money which he, through a sense of delicacy
اما همچنان بر جای ماند و نامه به دست اندیش ناک چشم به زمین دوخت	still sat holding his letters in his hand and looking on the ground meditatively
پهلوان با این تصمیم پیش تاخت که جان خود را به بهای زدن یک ضربت کاری به حریف به خطر اندازد.	determined as he was to venture all upon a single blow.
تو هم به خاطر او این تکه چسب را گرفتی و نگه داشتی!	so you actually put this piece of court plaister by for his sake!
در نتیجه مخفیگاه امنی برای این حیوان پیدا کرده بود.	so had found a safe hiding place for the creature.
اگه پول خوبی بهش بدم اون وقت آدم درستی هم می شه.	but he'd be honest if it paid him to be honest.
من فقط وضع موجود را برای شما شرح دادم.	I am only telling you what it is.
سر پیش برد تا پاسخ این سؤال را بشنود.	stretched his neck to hear who they were.
اگه آدم چیزی رو فراموش کرده با شه این یادآور به آدم تذکر می ده.	this tells you if there's something you've forgotten to do.
وقتی افرادی مثل تو رئیس به شن میدونم چه اتفاقی میفته.	I saw what happens when guys like you are in charge, you see.
یا دست کم یک شاهزاده خانم بود تا بتواندیک همچو چیزی را داشته باشد.	or at least aprincess, to have a thing like that.
معلوم بود که تمام شب بیدار بوده و نخوابیده است	it was evident that he had not slept.
خلاصه وقتی به خشکی اومدم ته جزیره رسیده بودم.	I 'uz mos' to de foot er de islan' b'fo' I found' a good place.
که هنوز کسی در آن ریش نتراشیده بود و یک اشرفی شیرین برای من تمام شده بود.	never yet handselled, that would fetch a crown any day.
من هم تقریبا همین قدرها در تیراندازی دست دارم.	there we are about equal
گمان کنم سفرم در حدود بیست دلار خرج برداشت.	I spent about twenty dollars on the trip, I think.
بلکه بدین سبب که امپراطور میل داشت عقایدشان را درباره اشکالات موجود بداند گرد هم نشسته بودند.	but certain persons whose opinions he wished to know in view of the impending difficulties.
من این را در نخستین برخوردی که با تو کردم فهمیدم	I see that when I set my eyes on you
او را از خانه و زمین خود برکنده بودند.	, they had taken him away from the land!
حالا آرامش بیش از معمول به آن دست داده بود.	although it was ordinarily quiet enough, in all conscience.
هر چند پرده گوشت او تقریبا شفاف شده بود.	though the screen of the flesh seemed almost transparent
از در رد شدم و آن را پشت سرم بستم.	I darted through the door, pulling it shut behind me.
اون وخ میبینین که چه طور حقتونو کف دستتون میذارم.	I'll take it an' I'll ram it up your ass
اما خاطرهء من بر سراسر آن سایه انداخته بود.	but my poor history pervaded it all.
پشت آن گارد شاهی در یک نقطه سراشیب جلگه جمع شده بود.	behind which theguard was massed on a slope of the plain.
او هرچه مورد نیاز من باشد برایم تهیه خواهد کرد.	he would furnish me with all things necessary.
چیزی جز خودستایی نیست من نیز با این مردک که شاید اصلا وجود نداشته است همفکرم.	 I agree with that good man, who never existed, perhaps.
من هیچ وقت نتوانستم یقین کنم که آنچه دیدم واقعیت بود یا رؤیا	I never could entirely settle. whether it was a reality or a dream
او را تا داخل یک کتاب فروشی دنبال کرد	followed her into a bookshop
همهء آن کسانی که دوستشان داشته بود دیگر برایش وجود نداشتند.	all those who had loved him dropped out of his existence.
اینکار خطرناک است و اگر خوب فکر کنی بسیار احمقانه است.	it is a dangerous business, and if you think about it a stupid business.
از برای فرزندی که داستان قتل پدر خود را	in hearing the son read aloud in trembling pallor these details of his father's death
که همان سال برای رفتن به انتخابات به کارش برده بود.	which he had made use that same year when he went to the elections.
این حرکات را بی وقفه و به همان ترتیب پشت سر هم ادامه داد.	so on in regular changes, without a moment's intermission.
در فکر بود که این زن را با خود ببرد یا نه.	she was considering whether she would take her with her or not.
پس از آنکه چشمم به دیدن آن موجودات کوه پیکر خو گرفته بود طاقت نداشتم که در آئینه بنگرم	I could never endure to look in a glass, after mine eyes had been accustomed to such prodigious objects
سرانجام چنین نتیجه گرفتم که چنین فکری خیال باطل بیش نیست.	I felt that last idea to be a mere chimera.
با همه معایبی که داری خدا ترا حفظ کند.	though it be with her pip, live
خرسند از آن که گمنام همراه با سنگ تراش و صیاد به یکسانت در خاک شوند.	they were content to go down into obscurity with the molecatcher and the stone mason.
پس از آن زبانش باز شد و سیلی از ناسزا فروریخت.	then words came back to him, and he broke out into a flood of abuse.
من هیچ وقت خودمو نمی دم دست شما عمل کن ین!	I wouldn't let you operate on me!
دست خودش در اثر خراش گلوله جراحت مختصری برداشت.	his own arm slightly grazed by a bullet.
پس من به هرچه او درباره تو نوشته باشد یا بنویسد اعتقاد نمایم و قول او را در حق تو معتبر بدانم	I can then rely on the notes he has left concerning you
صورت و گونه دخترک چنان به چهره کلاید نزدیک شد	her face and cheek came very close to him
تا این که بالاخره بر روی زمین سرد و مرطوب فرود آمد.	then landed on cold, damp earth.
اون موقع باهاش حرف یعنی اون روز چیزی نگفتم.	then I couldn't just tell her then notthat day, anyhow.
تنها مطالعه کردن در آن دوران بی هدفی و رکورد نبود.	it wasn't so much the books I read as the rotten meaninglessness of the life I was leading.
دکتر جوانی که تخصص اصلی او در جراحی است	the young physician, originally an expert surgeon
اما مرد خل و چل نسبتاً شوخی آمد و خیلی عجیب مزاحمم شد.	but was strangely harassed by a queer, half witted man
مانند کودکی نفس زنان به هشتی خانه دوید. طوفان هیجان و مسرت لحظه اول ملاقات فرونشست.	on arriving he ran breathlessly, like a boy, up the steps of his home.
لیکن تو خود با او صحبت بدار و علم و دانش او را بیازما و چون تو جوان باهوشی هستی	do thou talk to him and feel the pulse of his wits, and as thou art shrewd
وقتی دیگر خبری نشد او را در خم بازویش خواباند.	when nothing further happened settled her in the crook of his arm comfortably.
من منتظر لحظه مناسب بودم تا دست به کار بشوم.	I was waiting for the right moment to act.
با ضایعه وحشتناکی که گریبان گیر او شده بود این افسردگی سراسر وجود او را گرفته بود.	that to the quick, with the terrible casualty which had overtaken him.
که شاید تو بتونی این جای خالی رو پرکنی.	whether you might be able to fill.
من نمی تونم هیچ چیزی رو در مورد اون ببینم.	I can't see anything about it.
اتومبیل سرپوشیده بزرگ و سنگینی درست در برابر آن توقف کرد.	a closed car of great size and solidity stopped directly in front of it.
که هیچ تناسبی با صرف شام به اتفاق یک دوست و دیر آمدن به خانه نداشت.	quite out of proportion with the cause a late supper with bachelor friends.
چون معلوم بود که همان لحظه از راه رسیده بود.	for it was plain that he was that moment arrived that
خروجی که منفعت و شهرت بیشتری نصیب ما خواهد کرد.	which may turn out more profitable and creditable to us.
بار دیگر به نزد او بازخواهدگشت و از آنچه بین او و بانو دول سینه گذشته است باخبرش خواهد کرد.	to return and render him an account of what took place between him and her.
بی تردید یک یا دو بار برای قدردانی از دقت نظر و سخاوت او برایش نامه نوشتم.	I certainly wrote to him once or twice to acknowledge his delicacy and his generosity.
البته زمستونا که روزها خیلی کوتاهند ما نمی تونیم از فضای محوطه استفاده کنیم.	though in vinter, ve have very little daylight, so ve are not enjoying them.
ورانسکی پیغام را گرتفه و بیش از آن توجه نکرده و به اتاق خود رفته بود.	he believed what was told him, did not care to find out more, and went to his own room.
با دقت بسیار چشمان کوچک درخشانش را پیرامونش گرداند و در چند قد میش یک سر پاسبان دید که پشت به آنان کرده بود.	darted his little sparkling eyes about him with profound attention, and perceived a police sergeant standing with his back to them a few paces off.
به من گفت که از این خواسته ناشایست من حیرت زده شده.	he expressed himself shocked at my want of decency.
دختر ما با این جوان که هم شأن و همسر اوست خواهد ساخت	with him, one of our own sort
آقای شاهزاده من از آمدن شما به اینجا بسیار مشعوفم.	I am so glad you chanced to come here, prince.
برای وقوف بر استعداد عجیب او در حفظ سکوت همین بس که در سرتاسر آن داستان عظیم و واقعی بیش از یک بار به نام او اشاره نشده است.	that in order to indicate to us the greatness of his marvellous taciturnity his name is only once mentioned in the whole of that history, as long as it is truthful?
دوست دارم یک نفر شهر را به من نشان بدهد	I'm willing to be shown.
تصمیم گرفت شخصاً به این مهم بپردازد و باز به سراغ رشته افکار پیشین خود رفت	she decided, and going back to her former thoughts,
ملانی ناظر بود که چقدر لاغر شده و چشمانش گود افتاده و سیمایش چه ویران شده است .	when she could see him getting thin before her eyes, see the torment in his face?
سپس دخترش را از دفتر کار بیرون کرد و گفت رفتن یا نرفتن تو برای من یکسان است	he drove her from his study telling her that if she did not go away it was all the same to him.
بعد با لحنی آمیخته به اشتیاق و شوخ طبعی گفته بود	he had added in a tone between jest and earnest.
بلکه دوش خود را از سنگینی بار او آزرده یافته	but because it was an unbearable burden
یکی از آن تیرها از گوشه چشم چپ من گذشت.	whereof one very narrowly missed my left eye.
اما به مجرد آنکه عملی را انجام داد دیگر آن عمل که در لحظه معینی از زمان انجام پذیرفته است	but as soon as he has done it, that action performed at a certain moment in time
من به او نگاه کردم در حای که همزمان دچار خشم و در عین حال شادی شدم.	I stare back at him, feeling a breathless mixture of anger and exhilaration.
وقتی که به بدن جان برخورد کرد صدای تاک محکمی داد.	it made a solid thuk as it hit his body.
ناخودآگاه در جواب شور و شوق او لبخند زدم.	I had to smile at her enthusiasm.
تلاشش همه بر آن بود که آرامش آخرین روزهای زندگی خود را به هم نزند.	all her efforts were directed towards preserving the peace of her last months.
رون ملافه را جلوی هرمیون گرفت و تکان داد.	he yelled, shaking the sheets in her face.
زندگی پهلوانان سرگردان در معرض هزاران خطر و نامرادی است	the life of knights errant is subject to a thousand dangers and reverses
میل دارد بدون زحمت دادن به پدرش خود آن را بپردازد	his wish to meet it without troubling his father
شاید از آن رو که به اوهامی جدید دست یابم.	perhaps to acquire others
صورت اخمویش را برگرداند و نگاهی به آن دو انداخت.	cast a surly look over at the pair of them
تا ببینی که وجود ایشان چیزی بجز باد و هوا نیست	thou wilt find they have only bodies of air
درخواست نامه متواضعانه مردی که خشونت و وحشیگری کور و ابلهانه اش او را از روستایی ای صادق به یک سارق و راهزن تبدیل کرده بود.	containing the fierce and yet humble appeal of the man against the blind and stupid barbarity turning an honest ranchero into a bandit.
ترز این بگفت و زار زار به گریستن پرداخت	with this she began to weep in earnest
دور تا دستی به زیر چانه خواهرش زد و با نگاهی پر مهر به او نگریست.	touching her sister's chin, and looking at her with indulgent affection.
همان طور که میدانید این کار خیلی لازم است.	I have to, you know
من دریافتم که مقصودش خیلی بیشتر از آن بود.	I understood that he meant a great deal more than that.
که متوجه سکوتی شوند که در اتاق حاکم شده بود.	to notice the hush that had stolen upon the school
از وقتی که باکره نبود خیلی به ندرت به تنهایی در آن بستر خفته بود.	because she had rarely slept alone in that bed since the loss of her virginity.
به خاطر آنکه اجازه دادید نظرتان را جویا شوم	for allowing me to sound you
نباید خیال کنه که با اعتبار لیاقت خودش ترقی کرده.	not for any reasons of merit in connection with himself.
اگر چه درک معانی سخنان من به سهولت میسر بود	yet my meaning was easily known
برای آنکه در زورق بآنها علوفه دهم یک بار بزرگ علف خشک و یک کیسه غله همراه بردم.	to feed them on board, I had a good bundle of hay, and a bag of corn.
پشت سر این موجودات دوان دوان وارد محوطه نرده دار شد.	came jogging into the paddock behind the creatures.
تصاویر پهلوانان ریش دار به دیوارهای آن آویخته بود.	pictures of knights with short beards hung on the walls.
عاقبت بلند شدم و لباس پوشیدم و جوراب پا کردم و بدون کفش از پلکان پایین رفتم و دنبال نامداریم گشتم	at last I got up, dressed, and softly going down in my stockinged feet, sought out my stepmother
این چیزی است که به نظرم میل داری فراموش کنی.	which I think you tend to forget.
هرمیزانی که برای داوری به کار گیرید با همان میزان درباره شما داوری خواهند کرد.	with what soever measure ye mete, it will bemeasured unto ye again.
با اشاره به کودک به ارباب خود هرچه بهتر فهماندم که خواهش دارم از خطای پسرش درگذرد.	pointing to the boy, made my master to understand, as well as I could, that I desired his son might be pardoned.
قطعاتی بسیار دلنشین و طنزآمیز به نظم و نثر نوشت.	she wrote some very pleasant, witty verses and characters in prose.
فضایی باز به عرض بیست متر با دیوارک جا نپناه کوتاه.	an open space, about twenty yards across, with a low parapet.
اگر به همین طریق ادامه دهی با تو قادر به گفت و گو نخواهم بود.	I can't talk business with you if you're going on that way.
مشتاقانه خم شد و به درون آن نگاهی انداخت.	he leaned forward eagerly
آن وقت در همان جا بازی را قطع کرده بود و خود را شکست خورده اعلام کرده بود.	surrendered without honor.
ولی گفت که اگر باد بر روی جسد بوزد صورتش دگرگون خواهد شد	but he said it would change if the air blew on it
تا اصل و ماهیت پیکاری را که در پیش بود دریابد	straining each faculty to understand the essential points of the impending battle
ولی علو طبع من با این امر مخالف بود و زن را به شوهرش پس دادم	but, prompted by magnanimity, the captain restored the wife to the husband
از کارمند دهبانی دعوت و در حضور او علوفه را تقسیم کردند و یازده خرمن سهم مالک شده است.	they had invited the counting house clerk over, had divided the crop in his presence, and had raked together eleven stacks as the owner's share.
تا آن موقع نه بازی کرده بود نه بازی دیگران را دیده بود.	she had never played the game nor seen it played in her life
نقطه به نقطه در جهان بگردد و هرچه دلش بخواهد به عنوان موعظه و خطابه بگوید.	go into the market places to his heart's content.
زیرا روشن است که در این ساعت مقیمان قلعه در خوابند	for it is plain enough that they who are within are either asleep
چنان همه فکر و حواس مرا به خود مشغول کرد	kept me so busy
آن گاه به سرو گردن سرخ له وین نگریست و احساس مالکیت غریبی کرد.	looking at his head and red neck with a feeling of possession strange to herself.
لری پی برد که جورابی درکارنیست و لباس زیرهم بتن ندارد	showing him her bare legs making him curiously certain that everything else was bare as well
خیلی مطمئن نبودم که راجع به این چه احساسی دارم.	I wasn't sure how I felt about that.
که هرگاه کسی به ما حمله کرد از آن استفاده کنم	lest we were attacked
توی این فکر هستم که آیا نقاش درجّه دوم بودن ارزش دارد.	I wonder if it's worth while being a second rate painter.
در ین هنگام کم کم خستگی بر من چیره شد	I now began to be weary
او لا نباید هرچه در درون قلب خود دارید این طور واضح نشان بدهید.	in the first place you must not be so demonstrative.
به او مراجعه کرده بود تا تحقیقات لازم را به عمل بیاورد	he had introduced himself to him in order to make particular inquiries
امر جسیم و کارگران شده و گریزی هم نمانده.	the affair is serious and unavoidable.
تنها برای نیل به صلح مسلح بدان اقدام شد	only for the purpose of securing an armed peace
شاید که به اشتباه بوده یا سهو و ندانستگی	which by some mistake
به نبوغ ناپلئون دستورها و فرامین او را مورد مطالعه و قضاوت قرار دهیم باید بگوییم	oneself to regard the arrangements without religious awe of his genius
مارکیز از این اسم مادر که به او گفت	she felt touched at the name of mother
در قسمت عقب عمارت و در طبقه اول قرار داشت.	was on the ground floor, at the back of the house.
آنچه طی آن همه سال در وجودش رسوب کرده بود	the sediment that had accumulated at the bottom of her life over the course of so many years
مشاهده کرد که پرچین چوبی کام لا شکسته شده	he saw that the carved garden fence was broken
من باید اعتراف کنم که در ابتدای امر نسبت به این سخنان تردید داشتم	I confess to you that I had doubts, at first
که باید درست به موقع از ادامه آن جلوگیری کرد.	that had to be ended before it was too late.
درست مثل این بود که او را در روغن داغ فرو کرده باشند.	as the skin all over his body bubbled like hot wax
حتی دیشب که برقا قطع شده بود جک تغییر حالت نداد.	even when the power went down last night.
بعد نیم تنه زیری را در آوردم و مدتی با زیر پیراهنی به فکر ایستادم.	I then took off my coat, and thought a little more in my shirt sleeves.
اظهار اطمینان کردکه به زودی پولی دریافت خواهد کرد	the certainty that the money would be forthcoming
حالا بیا بگو که در این کاغذ مجهول کدام فقره صحیح است	what truth is there in the accusation contained in this anonymous letter
که اندیشه خوشبختی او و خویشاوندانش و سبب بیماری	that, fortunately for her and for her parents, the consideration of all that had caused the illness
آن هم بدون رعایت جوانب بهداشتی و بسیار با عجله و بدون تابوت.	without delay and without coffins
این عمل چندان محسوس و دگرگونی حالت در چهره زندانی جندان آشکار بود که چش ماهایی که به او دوخته شده بودند از او به آنم دو تن متوجه شدند.	so immediately, and so much to the changing of his aspect, that all the eyes that were tamed upon him, turned to them.
اگر بدانم موضوعی در کار بوده که من از آن اطلاعی نداشتم	I cannot bear to think that there might be something which I did not know
سپس از آن یک پیرینت گرفتم و بدون اینکه کسی متوجه شود ان را لا به لای پوشه گذاشتم	I send it over to print, stroll over to the printer and whisk it out before anyone else can see what it is.
در این خصوص همه چیز گفته شده و همه چیز به پایان رسیده است.	it's all exhausted, it has all been said over and over again
داستانی را که در بدو ورودم برایتان خواندم به من سپرد.	he confided to my keeping that narrative which I read to you when first I came.
من قلب پر از عشق و وفای خود را تقدیمش کردم	I gave him my heart
شما را نجاتتان داده و سپس با خود بدین جا آورده است.	he'd lodged you here!
منتظر ماندم به من دستور دهد به اطاقم برگردم بلکه همان طور که بدون جلب توجه دیگران بیرون آمده بودم به آنجا برگشتم.	I did not wait to be ordered back to mine, but retreated unnoticed, as unnoticed I had left it.
اما چنان غافلگیر شده بود که پایش لغزید و به زمین افتاد.	but in his haste, he tripped.
من هیچ نمیدونسم که زن دونی شدن این قدر دردسر داره.	I never knowed b'fo' 't was so much bother and trouble to be a prisoner.
تنها علم استوار و تردیدناپذیر و روشنی که من و همه ما داریم همین است	I and all men have only one firm, incontestable, clear knowledge
شک داشتم که آن شغل موقعیت اجتماعی مرا بالا برده باشد.	I doubted I had taken a step which sank instead of raising me in the scale of social existence.
من در آن هنگام روی زمین نزدیک در خانه نشسته بودم	as I sat on the ground by the door of my house
تا وقتی که خود را مس تخلص سازند و دختران را شوهر بدهند.	until the deed is done
به من دستور داد که از این ماجرا با کسی صحبت نکنم.	forbade me to tell the truth.
کلیدی در قفل حرکت کرد و در باز شد و دو مشعل از بیرون به اتاق روشنایی انداخت	a key turned in the lock the bolts creaked the massy oaken door flew open and a flood of light from two torches pervaded the apartment
که او هیچ فرصتی برای حرف زدن با ربرتا پیدا نکرد.	he had no opportunity to communicate with her.
بنابراین وقتی مرد محترم بعدی او را از نو به زوبین زد خاتون ملک مسلم مرد محترم بعدی شد	therefore when a subsequent gentleman re harpooned her, the lady then became that subsequent gentleman's property
که احتمال ورود ناگهانی پدرش را نیز به ذهن راه نداده	that he had not thought of his father
با توجه به این که سرعتش ده مایل در ساعت است	considering its inevitable pace was ten miles an hour
که ما در خیال سرنگون ساختن آن سلطنت هستیم.	we wish to overturn
بعد تقی افتاد روی زمین و از وسط نصف شد.	then suddenly it dropped to the floor with a tinkle and broke in two.
من خواستم او را جلو بیندازم و به نزد شما بازش گردانم	I tried to drive him before me and bring him to you
اما مطمئن بود که تصمیمش درست و صحیح بوده است.	but she never doubted that her decision had been correct.
از شباهت آن به جمجمه انسان در صورتی که در همان وضع قرار گرفته و از همان نظرگاه دیده شود خیره خواهیم ماند.	you will be struck by its resemblance to the human skull, beheld in the same situation, and from the same point of view.
یک او رک او را از پشت سنگ هدف قرار داد.	an orc shot him from behind a stone.
سرهایشان را از روی کارشان بلند کردند تا مرا ببینند و بعد باز مشغول شدند.	raised their heads to look at me, and then went on with their work.
فقط سرمای شدید مانع از خونریزی آن شده است.	only the cold prevented from bleeding profusely
با حالتی نظیر حیرت به خاطر آورند که وجب به وجب آن از آن خودشان است.	every inch of it their own property appeared to the animals so desirable a place.
منظره در تصاویر متغیر تهی از زندگی یخ زده بود.	the landscape frozen into a colorless diorama devoid of life.
اما شاید یک گلوله هم در آن نزدیکی به زمین نیفتاد و همه از بالای سرشان گذشت.	but not one fell close by, they all flew over.
در حالی که به آتش خیره شده بود یک سطر از مطلب خوانده شده را تکرار کرد.	repeated, while she gazed at the fire, a line of what had been read.
از نوکرهای وی شنید که لوتر شبانه با هرچه نقدینه داشته رفته است	the servants reported that he had been absent from his house all night and had taken with him all the money he had
نه قاتل نفرت انگی زی که به اشتباه باور داشتم که هستم.	not the loathsome killer that I mistakenly believed I was.
من از اولین بار که چشمم به تو افتاد	when first I set my eyes on you
چون من شوهری را چون تو زنی در کار سزاوار است.	worthy wife of such as I am!
اما لازم بود با دقت بسیار در حفظ جان خود نیز بکوشیم.	saving our own lives, with the extremest care.
آن را روی سطح مایلی از پهلو به دو گوه تقسیم کینم	on an inclined plane, sideways divide it into two quoins
سپس نیم چرخی زد و به سرعت در تاریکی دور شد	then he turned and walked quickly away into the darkness.
چگونه نقرس از پای چپ او به پای راست رفته بود	how the gout had left his left leg and gone to his right
چون به وضوح تنها جنبهء ادب داشت به هیچ عنوان مایهء دلگرمی نبود.	was so clearly a slight form of good breeding that it was not reassuring.
از اتاق بیرونش کرد و در را پشت سرش بست.	he rid the room of him and closed the door.
زیرا او جوان بود و مجبور نبود که برایش زیاد نقش بازی کند.	who was young and for whom he would have to put on only a small show.
از یکی دو نفر بومیان پرسیدم که آیا چیزی درباره او میدانند	 I asked one or two natives if they knew anything about him
چشم سحرآمیزش چرخید از پنجره بیرون را نگاه کرد.	his magical eye swiveled onto the window.
ولی همین کافی بود تا بفهمد که همین دیدار کافی است	but just enough to feel that the first meeting was over to give her the impression of
این فخر نصیب من شده که با حاکم ناهار بخورم.	I had the honour to dine with the governor
قطار در چند قدمی جایی که دین ایستاده بود ایستاد.	for the train had halted only a few feet beyond where he stood
از این که شب توی تئاتر یکدیگر را خواهند دید	that they should see each other across the theatre at night
تا با اشخاصی که در قلب وی جای دارند به گفتگو بپردازد .	converse once more with those dear to his heart.
اما از نظر روحی آن قدر قوی بود تا گرفتار توهم و جنون نشود.	but she had the strength not to succumb to delirium.
ولی بعداً با خود شرط کرد که رازش را به طور جدی مکتوم دارد	but she had stipulated that her secret should be rigidly kept
الآن که خودم هستم حتی یادم نم یاد چطور این کار و بکنم	I can't even remember how to do it now.
اونوقت دی گه اصلا کسی از قضیه بو نمی بره که ازم ایراد به گیره.	perhaps she would meet him in some clandestine way and thus obviate all possibility of criticism.
با این همه مردک چنان عرصه را بر آنان تنگ کرد تا به مقصود رسید و توانست مرا به بدترین کیفرها که از نظر انسانیت از مرگ هم بدتر بود برساند.	however, prevailed so far, as to have a punishment inflicted on me, worse, in all human appearance, than death itself.
آن هم با هزاران هزار پا فاصله از زمین	thousands and thousands of feet above the ground 
زیرا آن طور که او شروع کرده است کار شکوه و شکایتش یک ماه تمام ادامه خواهد داشت.	for he seems in a mood to bewail himself for a month at a stretch.
منتظر حرف اسکار لت بود. اما اسکار لت چیزی نگفت.	when she did not he picked up the reins.
فرمان خواهم داد و خودم را از حادثه کنار هم نگه خواهم گذاشت.	I shall bid you do it, or else renounce me.
به راستی رفتنش از آن ناحیه بم نزله رفتن جان از بدن شد.	lacking him, there actually was a soullacking.
فکر کردم دیگر وقتش شده و اگر حالا نکنم دیگر نخواهم توانست	I thought it was high time, now or never
ولی توی گلویم گیر کرد و به سرفه افتادم.	but it goes down the wrong way and I start coughing.
چرا که جاستین در آن صورت ضربه را تلافی کرده بود.	for she had lashed back then.
قزاق کوتاه قدی با چهره پر کک و مک بود	a thick set, freckled cossack.
کمی بعد از شروع این قصه باز وارد اطاق شده بود	had returned to the room shortly after the commencement of the story.
چون همه ما عیبی در کله داریم که سخت محتاج معالج است.	for we are all somehow dreadfully cracked about the head, and sadly need mending.
اما از برای اینکه زنده بمانی لازم است به من اعتماد داشته باشی.	but to insure this you must rely on me.
که به سراغش خواهد رفت و او را با خود خواهد برد.	that he would come and take her away.
زیرا کام لا از چگونگی موضوع و اینکه چرا به اینجا انجامید باخبر هستم.	I know exactly all that went on, in every detail, and why things have turned out as they have.
ولی شاگرد او که مرد تیزهوشی است فوراً دوائی در یک بطری سیاه رنگ برایش فرستاد.	but his prentice which is a very clever lad sent 'em some medicine in a blacking bottle, offhand.
اگر صدایت را دربیاوری وقتی که همراه من بیایی	if you speak a word when you're out o'doors with me
شوخی و تمسخر از آن به خوبی آشکار بود.	cynical amusement in them
حتی رنگ و تکیدگی رخسار نیز چون آن زمان به او بازگشته بود.	even the old haggard, faded surface of face had come back to him.
مگی لبخند زنان مهار اسب را کشید و منتظر شد تا او برسد.	smiling, she reined in the chestnut mare and waited for him to catch up.
با زمزمة این کلمات خود را در راهرو افکند.	he muttered and he rushed into the entry.
شاید چهار یا پنج سال با برانا بوس بودم.	maybe four or five years.
اما این بار به دلیل خستگی و پرخوری بود.	but only because he was so tired and full of food.
سپس یک لحظه گاز را رها کرد و از نو گوش داد	then he speeded up for a moment and listened.
نمی تونم باور کنم که تو منو صدا کردی تا فقط بگی که سگمو خوردی	I can't believe you called me out here to tell me you ate my dog.
من فقط دارم بهت می گم که اون امشب سعی نکرد خودش رو بک شه.	I'm just telling you he didn't try and shoot himself tonight.
اگر تازه حکم آزادی محبوسین به اطراف صادر شده باشد	the letters have not yet been forwarded
انگشتان پاهای مرد حدودا شش اینچ از سطح کف اتاق فاصله داشت.	at the feet hanging down nervelessly, with their bare toes some six inches above the floor
همان پیراهنی که در نخستین روزهای عروس به تن داشت	she had worn during the first days of their married life
میگویند که در میان بزرگان قوم همسر مرد باید پیوسته در حکم یاری خردمند و موافق باشد	a wife should be always a reasonable and agreeable companion
با حالتی که سرشار از شکر و سپای بود	with an expression of infinite gratitude.
چون پای خود را روی تخته گذاشتم تخته خم شد و از زیر پایم در رفت.	I stepped on it, but it bent and gave way
اما خاطرم نیست شما را به چه متهم کرده بودند.	I forget what you were accused of?
که اگر بدان دست یابد ممکن است پشیمان شود.	when found, may, for all I know, fly in his own face.
من از تو خواستم که برای کمک اینجا بیایی.	I asked you here to help.
از این به بعد هم یادتان باشد که ما با یک افعی نیم وجبی طرف هستیم که گلوله کثافت زیر میز من	don't forget, madam, that we are dealing here with a little viper who put a stinkbomb under my desk
راستش را بخواهی من باید اعتراف کنم که من برای سر و سامان دادن به این کار سخت تحت فشار هستم.	I don't mind telling you, I'm getting a hell of a lot of pressure to do something about her.
هنوز این سخن را تمام نکرده بود که صولت مرض به سختی رسید	sudden and violent was the fit that the unfortunate prisoner was unable to complete the sentence
با نهایت احترام سرانگشت او را بر لب نهادم.	put the tip of it with the utmost respect to my lip.
کلاید که از دریافت آن نامه به افسردگی عمیقی دچار شده بود	because of the deep depression into which he had sunk onaccount of it
هر وقت به وجود اون نیز داشته باشی در وجودت متجلی می شه.	shows himself most plainly when you have need of him.
اما خیلی زود از کار کردن در استودیوها خسته شده در اطاق خودکار کرده بود.	but, soon tiring of the studios, entirely by himself.
فقط ستاره فکور به نحو شفافی صافی و نرم بود و ظاهر زنان را داشت و دریای قوی	only, the pensive air was transparently pure and soft, with a woman's look, and the robust
من هم بلند شدم و از اتاق بیرون آمدم.	so I got up and left him.
چون ممکن بود آنان به چنین کاری دست بزنند.	that they might do it.
بیدرنگ تصمیم گرفت که زود شام بخورد و برای دیدن همسرش به خانه ی ییلاقی و از آنجا به محل مسابقه برود.	he made up his mind to go to their country house to see his wife immediately after dinner, and from there to the races,
از شوق این پیروزی دلش از جا کنده شد.	her heart leaped with exultation at such a victory
بازوانم را دور بدنش گذاشتم و او را فشار دادم.	I put my arms round him and held him.
که مال یکی از آقاهای شهریه که به من سپرده و خودش روز بیست و ششم هر ماه لازمش داره.	which belongs to a bourgeois of the town, who gave it to me, and who only uses it on the thirty sixth of the month never, that is to say.
دی گه زجر نمی کشیدن و خانوده شون افتخار می کردن که فرزند ما در راه وطنش کشته شد.	there'd be no problems to face, problems that have no solutions.
من بیش از آنچه حقتان بود در حق شما دوستی کردم.	I was a kinder friend than you deserved.
به شصت روبل فروخت و زن خدمتکار آزادتری را به جای او گماشت.	for sixty paper roubles, and hiring a free servant to take her place.
که مبادا سبب خشم و غضب او شوند و از این راه به وی زیانی برسانند.	usage by him but for fear of causing him to sin.
این هم یک امتیاز دیگری است که ما در خانه کوچکمان در این خل نگزار از آن برخورداریم	it is another privilege we exercise in our little moorland home
امروز اثری جز یک عروسک از آن نمانده است.	to day, thereremains only a doll.
تا در این نمایش مضحک نقش خود را تا به آخر ایفا کنم	to play my part in the farce to the end
پس از اینکه کارشان به پایان رسید خواهش کردند که ایشان را به رزمین بگذارم تا سیاهه را به امپراطور تقدیم کنند.	when they had done, desired I would set them down, that they might deliver it to the emperor.
نه جاسوسی که مراقب گفتار و رفتار من باشد	no informer to watch my words and actions
او امری به آجودانش داد و به اتاق کار خود رفت.	went into the study, giving instructions to his adjutant as he went.
در شمار مردم عاقل و فرزانه به شمار آورد	treating you as if you were in your senses
به لحن ناله مانندی که صدایش گرفته بود خندیدم.	I laughed at the whining tone she put on.
گنج هم در انبار کشتی بار شده بود و در اختیار ما بود.	the treasure in the hold of her, by thunder!
به دست نایب داد و به او گفت که آن را راست نگاه دارد و نگذارد به عرشه بخورد.	with fascinated eyes they awaited whatever magic might follow.
من ظرف هشت سال حتی یک دعوا هم به دادگاه نبردم	I've never had a single thing to do with them during eight years.
به هیچ رو رنگ و روی پریده شوهرش را نداشت.	had none of her husband's low toned pallor.
آنگاه چون به جستجوی نامی برای او برآمد که با نام خود وی قرین باشد و	after some search for a name which should not be out of harmony with her own
تا کاری بکند که به نظر در حال درست کردن قهوه بود.	to do something that sounded like making coffee.
چند خطی نوشت و کاغذ را در پاکتی گذاشت.	scribbled a few lines, and put the note in an envelope.
جای ذخایری را که برای آنان گذاشته بودیم نشانشان داد.	told them of the stores we had left
تا بالاخره پس از آن که نیمی از ناخن انگشت خود را جوید	after having half gnawed off the end of a finger
هیچ خیال نمی ردم تا این اندازه از او متنفر باشی	I never dreamed that you of all people had such contempt for her!
ارزشش را دارد که هر طور شده مدرکی فراهم کنیم.	it is worth our while to run any risk in order to establish one.
فی الحقیقه اطلاع شما از عمر و زندگانی من بهتر از خودم است	for in good truth you see more clearly into my life than I do myself
این دختر شیطان به دروغ و فریبکاری عادت کرده بود.	, a naughty child addicted to falsehood and deceit.
از درد چهره درهم کشید و از شرم در مقابل چیزی تبسم کرد.	on his face and a shamefaced smile.
در پای همین کوه است که آن مرحوم وصیت کرده است جسدش را به خاک بسپارند!	the foot of that mountain is the place where he ordered them to bury him.
اما چون این نکته با آبروی یک بانوی بزرگوار بستگی دارد ناگزیر به تفصیل شدم.	if it had not been a point wherein the reputation of a great lady is so nearly concerned.
پس یک کلمه هم بر زبان نیاورد و بیرون رفت.	uttered not a word in reply, and leftthe room.
پول را در دست مهماندار گذاشتم و خواهش کردم	I requested of the hostess, handing her the money.
به بینی کشید و مثل آن که بخواهد علامتی بدهد پایش را دو مرتبه روی زمین کوفت.	sniffed at it, and stamped his foot twice on the floor as a signal.
هر جانداری را که در آن هست در یک لحظه و با هم کر کند.	deafen every creature in it, all at one and the same moment.
به آرامی به دری که قبلا از آن وارد شده بودم نزدیک شدم .	I approached the door I had broken into earlier that week
چون به محض دراز کشیدن به خواب عمیقی فرو رفت که نُه ساعت طول کشید.	for when there she immediately fell into a sound sleep which lasted nine hours
بلافاصله کلاه نیروی دریایی که درون ترقه بود ترکید	while from the inside exploded a rear admiral's hat
کاسه صبرش لبریز شد و از آن دو پرسید که نکند سایر شارحان مانند ایشان آن همه کودن باشند.	he asked them, whether the rest of the tribe were as great dunces as themselves?
که مرتکب هیچ بدی در حق من نشده بود آماده کرده بودم	who had done me no wrong
فقط یک مشت کلمه بود که بدون ذوق و سلیقه و خیلی سرسری کنار هم ردیف شده بودند.	it was a jumble without taste or truth.
سپس بهترین لباسش را پوشید و به آن هتل رفت.	made hisway to this hotel in his very best clothes.
بلکه کمی صورتش قرمز شد و این نشان داد که جا داشته ناراحت بشود.	though a slight blush shewed that it could pain her.
اما رنگ رویی تر و تازه و زیبا داشت	but he had a beautiful fresh colour
حتی ممکنه بفهمه که چرا مجبور شدم و لش کنم.	she might even come to know how and why he had lost her.
دوستی هم نداشت که به آموزش او کمک کند.	she had no friends of her own age to contribute to her education.
امّا او تبر را گرفت و به مدار پرنده انداخت	but he seized the axe and added it to the flying circle.
حال آنکه من او را به زشتی و فرومایگی زنک روستایی خشن و ناهنجاری یافتم	while I saw her in the repulsive and mean form of a coarse country wench
به جستجوی صندلی گرد خویش نگریست شتابان صندلی را زیر پای او گذاشتند	glanced round at a chair which seemed to place itself under him
دنبال کاری یا برای دیدار کسی بیرون رفته بود	while she went somewhere upon business, or a visit.
فقط حس کردم که به من اخم کرده و در فکر است.	I just felt her frowning at me, thinking.
زیرا برای شرکت در این گونه نبردها شرط حتمی و ضروری نیست که انسان حتماً به مقام پهلوانی رسیده باشد.	for to engage in battles of this sort it is not requisite to be a dubbed knight.
ولی باید هشدار بدهم که ممکن است باعث اتلاف وقتتان بشوم.	but I ought to warn you that I may be wasting your time and attention.
حاضران همه از جا برخاستند و بر اثر صدا دویدند.	at the noise they all ran out.
هر خدمتکار صدیقی موظف به گفتن آن به ارباب خویش است	what a good servant should tell his master.
هر دوی ما با شنیدن صدا از جا پریدیم.	both of us jerked at the sound.
او هنوز کفایت یک پرستار را پیدا نکرده بود.	she was not the most adequate of nurses.
در اثنای این زمان پدر فرصت کرده و به شما تفصیل را خواهد گفت.	while the father talks to you
وقتی او را کنجکاو دید سرش را پس زد.	pushing it away when it got too inquisitive.
به نظر ما تو مهارت و کاردانی سابقتو نداری.	we feel you're losing your touch.
گویی دستی نا پیدا عکس او را از آلبوم درآورده جلوی او نگه داشته بود.	as though somebody had pasted the picture from the album over his eyes.
اما فقط نخواستم شما را خجل و سرافکنده کنم.	only I didn't wish to mortify you.
که من دیگر هرگز به کسی اجازه نخواهم داد که در حضور من از هرزگی و عیاری و ولگردی زندگی تحصیلی چیزی بگوید.	I shall never allow people to talk before me about wastefulness and profligacy, and so forth, in connexion with that life, any more.
خیس آب می شو دی و دائم باید سعی کنی با گرد و خاک و مگس و به وی گند کنار بیایی.	try to cope with the dust and the flies and the stink.
زیرا بیش از حد ناتوان و منحط و بدبخت و عاصی هستند.	for they are weak, vicious, worthless and rebellious.
چون وقتی بار اول این وسیله زر کوب کردن پشت جلد باب شد منظور همین بوده است.	because it was so intended when the device was first introduced.
