درست نیست که اسب چنین پهلوان نامدار که ذاتاً حیوانی اصیل است نام مشهوری نداشته باشد.	it was not right that a horse belonging to a knight so famous, and one with such merits of his own, should be without some distinctive name
بعلاوه او همیشه در مقابل نظر مقامات عالی بود.	very agreeable and well en evidence.
که پس ره جوانی خوش قد و بالا آمد	graceful, and half naked young man appeared
اگر من دختر بدون جهیزی را را دوست داشته باشم باز شما میل دارید	he asked his mother, not realizing the cruelty of his question
ولی بعد که جوابش را نوشته بود گذاشته بود کنار.	but having answered the letter, had put it away.
زیرا لازم است یک تن برای همه فداکاری کند.	because some one must go for all.
به تدریج در میان دوستان و خویشاوندان پاولیچف این فکر را بو جود آورد که شما اساسا پسر او هستید	his relations and servants grew to believe that you were his son
حالا تابلو مثل کلاه بوقی رنگ و رو رفته ای به پهلو آنجا افتاده بود.	where it lay on its side like a pallid duncecap.
اطلاعاتی در مورد این که چه حیواناتی در چه موقعی به چه محلی رفته بودند.	telling me which animals had traveled where and how long ago.
مدتی است که او را ندیده و اشتیاق تمام به ملاقاتش دارم.	, and pine if I do not often see her
ولی هرچه فکر کرد چنین پهلوانی را به یاد نیاورد.	but no instance occurred to his memory.
یک راست پیش فرمانده هنگ رفتید و در حضور افسران دیگر هم نتوانستید زبان خود را نگه دارید.	but no, you go and blurt it all straight out before the officers.
اینجاست که برای این کودکان بم نزله همه کره زمین است.	this constitutes all the earth to those children.
ترفندهایی مشابه سنت دیرین دفع عقاب به پاشیدن نمک بر دم آن.	for accomplishing many similar objects akin in their nature to the abolition of eagles by sprinkling salt on the tails of the race.
آن قدر عصبانی است که چیزی نمانده منفجر شود.	so unbearably angry that something was bound to explode inside her very soon.
زمانی که اگر یک پر در ترازو بیافتند تعادل را برهم خواهد زد.	when if a feather alight in the scale it will be weighed down.
زنی درست و حسابی که مایل بود خودش پا پیش بگذارد و منتظر نماند تا او آغاز کند.	who liked to take the initiative.
خیلی چیزها هست که باید قبلش یاد بگیرم تا آماده شوم. پس برای من یکی زمان کوتاهی بیش نخواهد بود .	I've got so much to learn before I shall be ready, it seems a short time to me,
خود پشت پردة سبزی نشت که ذکرش رفت و دیگر نتوانستم صورت او را ببینم.	then, sitting herself down behind the green fan or screen I have already mentioned, so that I could not see her face, ejaculated at intervals
این زندان را خالی نخواهند گذاشت یک بدبخت دیگر اینجا خواهد آمد	some other unfortunate being will soon take my place
برای آن بود که تصمیم داشت در اندک مدتی وضع زندگی خویش را تغییر دهد.	it was only on the plain understanding with his inner self that he would very soon change it all, and have things as he chose again.
چه برسد به اینکه بخواهد به آنها پاسخ گوید.	or to know what to say.
در نظر دال داده راستین کارش نفرت آور است .	it would be distasteful to the lover.
اما در این مملکت لعنتی آنقدر الماس وجود ندارد که حتی بتوان مخارج را تامی نکرد.	but there ain't enough diamonds in this fuckin' country to pay expenses.
آنجا خود را به بستر انداخت و تا صبح فردا به خواب رفت.	where he flung himself down upon the bed and slept till the next morning.
از ای نرو تناسب دقیقی بین آنان و سایر حیوانات و همچنین گیاهان و درختان برقرار است.	so there is an exact proportion in all other animals, as well as plants and trees.
متوجه شد که بیان افکاری که او را به خود مشغول داشته ضرورت دارد.	felt a need to express the thoughts that filled his mind.
به ناچار کلاهم را بر سر گذاشتم و به همراه او راه افتادم و به هیچ وجه به خاطرم خطور نکرد که کاتی چه قصدی دارد.	I put on my bonnet and sallied out, thinking nothing more of the matter.
سعی کردم همة آنچه را که اتفاق افتاده بود مجسم کنم.	tried to picture all that had occurred.
تا اسناد مربوطه عصر همان روز تنظیم و امضاء شود.	for signature and approval, that very afternoon.
با زور و قدرت خود موجبات سعادت و نیکبختی آنان را فراهم سازد.	by the employment of power confer benefactions.
شما درباره هنر به طور کلی عقاید عجیبی دارید.	I fear you are a heretic about art generally.
عصا و کلاهش را به طور خیلی رسمی روی میز گذاشت.	officiously deposited his cocked hat and cane on the table before him.
برای خیل عظیم مردمی که چون سیل به کلیسا جاری میشدند و وحشت زده و مبهوت به حفره کنار تابوت آجری زشت در مقابل محراب بزرگ خیره میشدند.	to the barefooted multitude that streamed in, awestruck, to gaze at the hole in the side of the ugly box of bricks before the great altar.
بلکه به کلی حقیر و غیرعادی و غیرضروری تلقی شد بسیار متعجب بود.	but quite irrelevant and unimportant matters.
با همه گوشتخوارگی خود کاری به انسان نداشتند و جز در این صورت باور کردنی نبود.	the otherwise miscellaneously carnivorous shark will seldom touch a man.
چیزی نماند که راز دل دردمند خود را بر ملا سازد.	he is hardly able to keep from showing his pain.
این چیزی است که لااقل نصف روز باید فکر کنم تا از آن سردربیاورم.	this is a circumstance which I must think of at least half a day, before I can at all comprehend it.
که گویی به حکم تصادف در آنجا پیدا شده بود و از این رو صرف نظر از بود و نبود	in that vessel I must immediately ship myself
از ای نرو من با چنان غم و اندوهی از جای برخاستم که مانند آن را در عمر خود به یاد نداشتم.	whereupon I rose up, with as melancholy a disposition as ever I had in my life.
چنانچه اینک اشکالاتی پیش آمده باشد تنها معلول این خطاکاری است	that if there were now any difficulties the whole fault lay in the fact
چون که من واقعاً از این که کتابش را سوزاندم متأسف هستم.	because I am sorry I burned up her story.
زیرا حق دارم که مطابق میل خودم رفتار کنم.	such being my prerogative.
من این افتخار را پیدا کردم که در پاریس با او آشنا بشوم.	I had the honour of knowing him there.
اظهار امیدواری کرد بتواند برای دو دوست خوبی باشد.	hoped he should have the honour of his intimate acquaintance.
البته بلافاصله بعد از اینکه مطمئن شدن به اونارأی داد ین حتی فراموش میکنن صورت شما چه ریختیه!	then they've forgot your very face the day afterwards.
زیرکی و هوشمندی این کودک بیش از مقتضای سن او بود.	was a child of towardly parts for her age
اگر دریا آرام باشد در هر جا که توانستیم به خشکی پیاده شویم.	land where we could if the sea were calm enough to permit us.
پیشانیش شکفته و روشن و چشمانش ظفر آلود بود.	his brow expanded, his eyes triumphant.
اما درست نیست که دائم روی این نکته پافشاری کند	but it would be more becoming in her not to be always insisting on it
یا خدمتکارانی هستیم که ما را به کار اربابان کاری نیست.	or we are merely lackeys who care nothing for their master's business.
ناشناس سکوت را با صدایی جدی و شدید در هم شکست	the stranger, in a harsh, deep voice, broke silence.
دقایقی بعد آرکادیود را در آنجا به حال خود رها کردند.	they left him tied up
شاید من بتونم به گم که تخم پدرم هستم.	I am the daughter of my father, perhaps.
بعد و باید آن را جوشاند تا بتوان به قهوهی داخل فنجان افزود و به صورت قهوهی شیری درآورد.	the milk must be boiled in order to be mixed with coffee to make coffee and milk.
دوباره نزد او آمد و دستی به گیسوان شاهزاده خانم کشید .	he paced up and down, lightly touched his daughter's hair and sat down again.
که هر چند که آن مرد محترم در اصل آن خاتون را با زوبین زده بوده و زمانی او را محکم به خود بسته بوده	that though the gentleman had originally harpooned the lady, and had once had her fast
نه اینکه همیشه دلت بخواهد زود تمام شود تا بتوانی دنبال تفریحت بروی.	not be always looking over the edge of it, wanting your play to begin.
همان اشلی قبل از کباب خوران دوازده بلوط .	before any word of love had been spoken between them.
پس بهتر است خودت را به زحمت نیندازی و هرچه زودتر بگویی موضوع از چه قرار است.	so it will save you trouble to tell it sooner rather than later.
آن روز هم همین حال و وضع را داشت.	as he was then, so he is now.
امواج به نرمی تنه پهن وال را به گونه جوشش نرم آب بر ساحل می ساییدند.	far out upon the midnight waves, which gently chafed the whale's broad flank, like soft surf upon a beach.
شخصا دیده نشده است که از دیواری بالا رود یا شاخه درخت سیبی را بشکند.	had not been seen scaling that wall nor breaking that branch by any one.
لیکن بخت ناسازگار که هرگز از آزار احرار دست بردار نیست چنین مقدر کرده است که	but fortune, which is never weary of persecuting the good, has chosen to place me upon this bed
در تمام مدت نقاشی نیز مشغول سوت زدن بود.	whistling, meantime, with peculiar shrillness.
امیدوارم که غنایم بسیار و پول کلان به دست بیاوریم!	hold your luff, plenty of prizes and plenty of duff.
شاید چون از عزیمت دختر ارباب جلوگیری شده رنجیده باشند.	might take it amiss that the mistress was being detained.
همه درزهای آن را با پیه یاهو گرفتم تا اینکه شایسته اطمینان شد	stopping all the chinks with _Yahoos'_ tallow
زیرا این یک رقابت نامشروع با کلاه ای هنرمندان کنونی بود.	which, they declared, was unfair competition with the work of living artists.
دوباره متوجه دختر عموی خود شدم که با صدای بم و هیجان انگیزش مرا به سؤال گرفت.	I looked back at my cousin who began to ask me questions in her low, thrilling voice.
چطور به یکباره آن وقت توانسته بود ببیند که شکی باقی نمانده است.	WHY SHE had seen at once that there was no doubt.
دو فنجان چای از غرفه ای واگذار شده خریدم و برگشتم	I bought two cups of coffee from the concession stand and returned
بالاخره حتم کرد که یک جادوگر در کارش خرابی کرده.	finally decided that some witch had interfered and broken the charm.
اما با اندوه و تأثر دریافت که استعدادش برای درک این مسأله کافی نیست	but was mortified to feel that his mental capacity was inadequate for the task.
ناگهان جای خود را به زنی کام لا مسلط بر نفس خود و حتی راضی پرداخت	he saw a woman completely self possessed and even exceedingly pleased
از جمله اینکه او بیشتر از یک سال نیست که با زن جوانی ازدواج کرده است که در اتاق مطالعة او دیدم.	as, how he had not yet been married twelve months to the beautiful young lady I had seen in the study
من با همین وضع هشت سال پیش دشمن او بودم.	I assure you I was his enemy eight years ago.
مطمئنم انتظار دارد درخواست خیلی مهمی را مطرح کنم.	I can tell he's expecting an overbearing request.
اگرچه لایدگیت به راستی به او بدگمان شده بود.	though in reality it was not due to any suspicious conjecture.
تا اینکه سرانجام سر به پشت برد و با صدای بلند خندید.	till at last he threw back his head and laughed aloud.
چون تمایلشان در همه عمر علیه حقیقت و انصاف بوده است	having been biassed all their lives against truth and equity
لطف جریان آن بند نیاید یا به هم نخورد.	not to break the charm of its flow.
یک مرتبه کنت پیر هر دو دست پسرش را گرفت	exclaimed the count, and gaily seizing his son by both hands
به احتمال زیاد همه را در عالم خیال دیده بود.	very likely he had imagined everything.
همه به زانو افتادند و به آواز مشغول خواندن دعایی شدند.	everyone knelt down and sang a prayer.
چون من آدم اهل معاملهء کند ذهنی بیش نیستم	because I am a mere dull man of business
می ذارم هر وقت که آماده بودی خودت به بقیه بگی برخاست	I'll let you tell the others when you're ready.
کار کمدی این جهان نیز بر همین منوال است	the same thing happens in the comedy and life of this world
فوراً برگشت تا به فضای باریک میان نرده و دیوار نگاهی بیندازد.	turned around quickly to stare at the alleyway between the garage and fence.
اما لعنت برمن اگر بگذارم دوان دوان به استقبال مرگ برویم.	but I'll be damned if we're going to run to our deaths.
آنگاه پیرمرد مطالبی را در میان کشید که مورد علاقه شنوندگان بود.	led the conversation to the topics most calculated to interest his hearers.
با ناخدا گفتگو کند در میان جاشو ان هیچ هیجان کاهش ناپذیری پدید نخاهد آورد.	it would not create any unsubduable excitement in the forecastle.
او و خواهرش ایستادند و منتظر کلفت خواهرش شدند	he and his sister stood still, looking for her maid.
هنوز برای تأیید وابستگی ژرفش به رای نر زود بود.	she was far from ready yet to admit the extent of her commitment to him.
اما همین که این فکر به ذهنش خطور کرد گویی نگه داشتن آن پیوند دشوارتر شد.	but no sooner had he thought it, than the thing became much harder to do.
هر ساعت منتظر هستم که بیاید و از اعتراف خود سر باز زند.	I am waiting from hour to hour for him to come and abjure his evidence.
با خیز دیگری کلانتر او را بزمین انداخت و دور او جسته شروع کرد به لگد زدن به سر و سینه و پهلوهایش.	with the second blow the police commissioner felled him to the ground, and, jumping around with a growl, he began to kick him on his breast, his side, and his head.
اگر کانبرون پس از آن گلوله باران مهیب زنده ماند تقصیر خودش نیست.	it was not this man's fault ifhe survived after he was shot.
ولی چون ماده است در نظرم چندان قربی ندارد.	for as she is a female I have a contempt for her
چهره مطبوع و لبانش هنوز همان حالت صداقت معصومانه را داشت.	of her eyes, of her lips was still her own characteristic expression of guileless truthfulness.
ببینم تا اون موقع چی دستگیرم ون می شه.	see andwe'll see what we know by then.
خواهش کرد تا او را در بسترش بخوابانند و تنهایش بگذارند.	on account of which he bade them cover him up and leave him alone.
بلایی سرت بیاورم که مرغان هوا به حالت گریه کنند	I'm going to make you sorry you ever laid eyes on me.
با فریاد ازش خواستم که خودشو برسونه به قایق داشت	I called to her to try to get to the boat
سپس نشست و منتظر ماند که بلکه سگ بازگردد.	sat down and waited in the expectation that he would return.
همین پسری که حالا دیدن او برای شما مردم بانزاکت غر قابل تحمل است.	which is a disagreeable remembrance and makes the sight of him odious now.
فقط گرسنگی و تشنگی اورامجبور کرد که بیرون بیاید	coming out only when hunger and thirst drove him out
تعادل لو پین به هم خورد و نقش زمین شد.	he overbalanced and fell to the floor
لذا شنیدم صدای گیلاسی که در روی میز است حرکت کرد	I heard my glass removed
پس اگر قدری به طرف چپ متمایلا به طرف روشنایی شنا کند به جزیره تیبولان خواهد رسید	by turning to the left therefore he would find it
با توجه به ناتوانی تنش تندخوتر و زود خشم تر شده بود.	allowing for his bodily weakness, more violent than ever.
سپس به سوی زیبایی قلم خورده و تراشیده شده بود	then chiseled away in the direction of prettiness
در دوران حیاتش سراسر منطقه از اقبال بلند او منتفع شود	the whole countryside should, within his own lifetime, profit by his good fortune
زیرا از وقتی که به این قصر آمده بودیم	for since his sojourn at the kiosk
به علاوه هیچ وقت این قدر تنها نمانده بود.	more alone than he had ever felt before.
تصمیم گرفت که این توضیح را ولو کت با صبح روز بعد در کارخانه به او بدهد.	he decided to explain the following morning at the factory by note, if necessary.
از همین رو چقدر برای اشراف دشوار است که نویسنده باشند.	incidentally how difficult it is for a nobleman to be a writer
دستش را دراز کرده بود که آن را نوازش کند.	raising his hand to pat it
ولی وقتی سیگارش را خواست روشن کند دستش لرزید.	but her hand as she tried to light a cigarette was trembling.
با یک چرخش تند تعادلش را از دست داد	a particularly wild swing made him overbalance
باید به طور مسلم به همان نقطه عرض و طول جغرافیایی بروید که بار اول نظر افکندید	you must be sure and take the exact intersecting latitude and longitude of your first stand point
اما از لا بلای دکل آماج گرفتن چیز دیگری است	but to shoot down upon them is a very different thing.
هر چه باشد ما خرسند و شادمان خواهیم شد.	no matter what it may turn out, we shall be satisfied with that.
بار قاطر را پایین آورد و به حیوان آب و غذا داد.	unloaded and watered and fed the mule
مطمئن نبود که آنگاه خواهرش به دنیا آمده باشد.	he was not certain whether his sister had been born then.
حالا معلوم نیست این جریان تاکی ادامه ادامه داشته باشد و ما باید تا چه مدت اینجا بایستیم.	I don't suppose anything will happen for hours.
آن دهلیزی که نقبی به زیر او برده بودند احتمال خرابی پیدا کرده بود و بازسازی شد	the gallery on the sea side which had long been in ruins was rebuilt
زیرا که وی همیشه با پرده بلندی به طول هفت پا از نظرشان پنهان است.	who is always hidden from themby a serge curtain nine feet in height.
باورم نمی شه که بالاخره تونستم شما رو ملاقات کنم.	can't believe I'm meeting you at last.
که دست سرنوشت چنین دوستی را سر راهش قرار داده است.	for the chance which had procured her such a friend.
آنگاه به سرسرای پایین رفت و از در پشتی خارج شد.	he stumped down the hall to the back door.
بی درنگ کتاب را از دست حریر فروش بیرون کشیدم	snatching it from the silk mercer
البته اگه ازش ون چیزی مو نده با شه.	for what's left of them
کام لا دوستانه خسته از سیاستی که آن همه در موردش بحث کرده بودند	very friendly, having exhausted politics
آشکار بود که میل دارد او را به بحث و جدل بکشاند.	distinctly challenging him to a discussion.
این گرایش به ویژه نسبت به مردم فاضلی بود	especially for that of lettered people
این برای من معما شده بود. آنجا از قرار معلوم وحشتناک است.	which was an awful speculation.
زیرا این تصادمات و زد و خو ردها با تئوری مطابقت ندارد	they did not accord with the theory
یک زورق با بادبان درخشان و تابنده در نزدیک ما بود.	a shining sail close to us made
بعد همه تون غیر از من و کشیش راه میفت ین	then all you folks but me an' the preacher get in an' move on.
ناشناس دستش را حرکت داد و باز گردنش را در یقة آهاری فرو برد.	the stranger waved his hand, and settled his chin in his shirt collar.
من کورمال کورکال در خروجی اطاق زیر شیروانی را پیدا کردم و پیش رفتم تا از پلکان باریک جلوی آن اطاق پایین بروم.	I, by drift of groping, found the outlet from the attic, and proceeded to descend the narrow garret staircase.
که باز هم حاضر است برای گردش به غار برود یا نه.	if he wouldn't like to go to the cave again.
امیدوار بودند که تا حدی آنان را از باد شمال و سقوط سنگ حفاظت کند.	so that they hoped it would give them some protection from the northerly wind and from the falling stones.
که روز قبل به خاطر باد موفق نشده بود راه بیفتد.	that did not arrive the day before because of contrary winds
نشست و آن قدر سر فرانک را نوازش کرد تا اندوه برادر سرریز شد.	she sat rocking his head back and forth, back and forth, until his grief expended itself in emptiness.
از اخبار خسته شده و برگشتم تا او را ببوسم.	I got bored with the news and twisted around to kiss him.
آسمان در امتداد خط افق به هیچ وجه تیره و تاریک نبود.	the sky on the horizon was not dark at all.
از نو صندلی را به کنار دیوار کشید و بر گلویش دست مالید	he tipped his chair back against the wall again and fingered his throat.
به طوری که حتی چند ساعت پس از عبورش نیز کماکان قابل احساس است.	a tormenting breeze that was still perceptible several hours after she had passed by.
نکند وقتی تو از اینجا بروی وی از آن پشت خارج شود و به طرف من بیاید.	I hope it will not come out when you are gone!
گرچه او هرگز آن شهر را قبلاً ندیده بود و از مردم هم چیزی درباره آن نشنیده بود	no one had ever described them to him
همه افراد حاضر باید توجه داشته باشند که هنگام تاب خوردن آن به موقع سر خود را بدزدند	every one present must take good heed to dodge it when it swings
آنگاه دوست تو جناب منشی عاجزانه خواهش کرد که دوباره به سخنانش گوش فرا دهند.	your friend the secretary, humbly desiring to be heard again.
از اینکه این توانایی رو هم ازت بگیرم متنفرم	I hate taking that away from you, too.
که از حرکات وحشت زده او بیشتر باید ترسید تا از حملات بی باک و بدخواه او!	that his very panics are more to be dreaded than his most fearless and malicious assaults!
یکی از ایشان از ما پرسید که نکند چوپان برای ما بوده که فریاد مردم مسلح شوید! برداشته است.	one of them asked if it could be we who were the cause of the shepherd having raised the call to arms.
از چوب سدر بود و روی آن خیلی عجیب و غریب با چوب تیره تری کار شده بود.	it was of cedar, curiously inlaid with some darker wood
پس برای دانتس دریانوردی جسور که مکرر از قعر دریا شاخه مرجان بیرون آورده هم ممکن است	should a hardy sailer an experienced diver like himself shrink from a similar task
چون غیر از میز چیز دیگری به چشمش نخورد	seeing no board but the table
بازوهایش را به پشتش با طناب گره زدند و در وسط سال ون همکف میخانه به تیر مشهوری که در روزگار گذشته اسم خود را به میخانه داده بود بستندش.	bound his arms behind his back, and fastened him to that celebrated post in the middle of the room which had formerly given the wine shop its name.
اون وقت دلم می خواد یکی از شماها جلو مو به گیره .	I just dare anyone to stop me!
به همان حال به طرف دکل بزرگ رفت و با دست دیگر سکه طلا را نشان داد	he advanced towards the main mast with the hammer uplifted in o ne hand, exhibiting the gold with the other
او نیز دهانه مشک را در دهان خود گرفت	who raising it aloft pointed to his mouth
خود را ناگهان به باد سرزنش گرفت و از کاری که کرده بود سخت پشیمان بود.	he was overwhelmed with a sudden rush of self reproach, and bitterly, bitterly, he regretted what he had done.
از شوق رفتن به آنجا خیلی شور و هیجان دارم.	I am terribly excited at the prospect.
دیدند که انگشت خود را به سوی چمنزار پشت خانه گرفته	pointing in the direction of the meadows behind the house
از پشت دریچه به کنار رفت و به اصطبل فرود آمد	she got down from the hole and went into the stable
باید شوهری داشته باشد که او را در کارها کمک کند.	she had to have a husband to help her run it.
باز هم همه ملاحان از هر گونه که باشند کم و بیش هوس باز و غیرقابل اعتمادند	yet all sailors of all sorts are more or less capricious and unreliable
هرگاه یکی از طرفین ضربه قاطع را فرود آورد برد با او خواهد بود.	that a blow struck for the mastership on one side or other, must necessarily be final and conclusive
او نم برای من همین کار و می کنه.	he might do it for me
از میانشان گذشت و به انبار مرغ دانی رفت.	stepped through them into the shed.
سپس خود را میان ما جا داد و با قامتی که رو به جلو خمیده بود	then insinuating himself between us, stood stooping forward a little
در حالی که از هوش و ذکاوت خود در حیرت بود با سرعت از کنار او گذشت.	amazed at his own brilliance, he dashed forward.
اما ما جای پا و نیروهای مسلح خودمان را در آنجا حفظ کردیم.	though we kept a foothold there and strength of arms.
باور خود را متوجه مردانی بزرگ کرده بود اما با وجه تمایزی کوچک.	she bestowed her credulity upon great men yet with a distinction.
ولی مایل هم نیستم به قطعات و اشعاری که مورد علاقه من است دست بیندازد و	he has no right to appropriate what is mine
حاضر نیستم که به مقام پیشکار خرفت فردی تازه به دوران رسیده تنزل کنم.	I will not step down to be the dotard chamberlain of an upstart.
دیگر نیازی نیست که به این وسیله برانگیزیم تا قبل از موعد مقرر بمیریم و میوه عمر ما نارسیده از درخت هستی بیفتد.	without our going to look for fillips so that they may be finished off before their proper time comes and they drop from ripeness.
تقریبا یک کیلو گرام و نیم وزن داشت برداشتم	weighing about three pounds?
چنان به شتاب خودم را از زیر آن خلاص بخشیدم که ضربتی هم ره گردنم خورد.	I tore myself out of it in such a hurry that I gave myself a kink in the neck.
زیرا که این خانه بسیار کهنه و اندوهناک بود.	for it was very old, and dull too
پرسیدم که چه قسم انتحاب بکنم که پسند او باشد.	I besought him to tell me the death he wished to see me die.
ری چل گفت با عجله ظرف تاس کباب را روی گاز گذاشتم تا خودش بدون احتیاج به من بجوشد و آماده شود.	I hurried to get the pot of stew simmering on the stove so it could occupy itself without me.
من مطمئنم که قبل از رفتن آن را بستم	I closed it before I left the room.
تو اکنون درس همان طوری که در بچگی بودی.	now you are just as when you were little.
اومدیم اون بام بی که خورد کشته باش دش!	maybe that whack done for HIM!
ناگهان با نگرانی از خوابی که قصد آن را نداشتند بیدار شدند.	they woke suddenly and uncomfortably from a sleep they had never meant to take.
بلکه خود را به کلی رها کرد تا کلاید باز هم او را ببوسد.	she let him remained just as she was in order that he might kiss her more.
چون به اتاق رسیدیم بیماری را بر بستر افتاده یافتم که به تب مغزی مبتلا بود.	I found a patient in a high fever of the brain, lying on a bed.
اینک خوانندگان شرح آن ماجراها را در دنباله داستان خواهند دید.	as will be seen farther on.
در هر صورت او با ترس و لرز دست خود را بط رف گل دراز کرد.	she moved restlessly, stretching out her hands for the flower.
اگه نتونم هفتاد و پنج دلار آبش ون کنم تخم با بام نی سم.	if I can't get seventy five for that team, I ain't a business man.
خوشحال اما ترسان از این که در اشتباه باشند.	happy, though fearful of being mistaken.
حالا این زن باعث شد یه چیزی اتفاق بیفته ومنهم نمی تونم سردرب یارم چی شده.	now that woman has come and something has happened and I'm losing what it was.
سپس فریاد آمادگی کشید و خود را محکم گرفت	then giving the word, held himself fast
متأسفم که اینو بهت می گم اما از هم ون اولین باری که وارد این کلاس شدی	I am sorry to say that from the moment you have arrived in this class my dear
با حالتی حاکی از بیم و هراس بسیار به آنجا خیره شده است.	stare past me with an expression of the most dreadful horror.
در اینجا مقامی یک درجه پایین تر از مقام کشیشی دارم	I'm a deacon here.
مادر و خواهرش را پیش چشمش با گلوله زدند.	shot his mother and sister before his eyes.
انگار موضوع پرسش نوع جدید و خاصی از حشرات باشد.	as if the object of her inquiry were a new and particularly obnoxious species of insect.
بر استی پدران مردم و افراد طبقه روحانیت بشمارند.	were indeed the spiritual fathers of the clergy and the people.
علتش این بود که به شدت از دستش عصبانی بودم.	merely because I would be as angry with her as possible.
با چه شاخ و برگی خواهد توانست این داستان را برای دیگران نقل کند.	assuming that any time in the future he should choose to retail it.
هرچه زودتر راه خودت را بگیر و بگذار من هم راه خودم را بروم.	go your ways as soon as possible, and let me go mine.
فقط موفق شد برای جلوگیری از پریشانی خود نگاهش را پایین بیندازد و وانمود کند	nothing occurred to him but to lower his eyes again in order to hide his embarrassment
فقط می خو ای به وسیله من گرگ رو از در خو نه ت دور کنی.	but you will to keep the wolf away from the door.
من به خودم میگویم هر گاه نتوانم این نکته را درک کنم	I have come to the conclusion that, since I can't understand even that
بعد زنش را طلبید و هزار و پانصد فرانک را به وی نشان داد.	then he took her aside and showed her the fifteen hundredfrancs.
در خواب یک مرد بیگانه و برهنه را دیده	she had dreamed about a naked stranger
اما با یک اندک تهییج ممکن بود به منتهای عظمت رسد.	one more turn of the key, and he might be sublime.
حتی تصور چنین امری توهین بزرگی نسبت به شماست.	I should offend you again by even suggesting such a thing.
به یاد آورد که چگونه سرش را راست نگه داشته بود.	remembered the stubborn lift of her head.
بدن رو گول می زنه که فکر کنی گرمه.	tricking the body into thinking it was warm.
بر سپر خود تصویری را که در نظر داشت نقش کند.	have his shield or buckler painted as he had devised.
بعد ابروان را درهم کشید و به فکر فرورفت.	knitting her brows, and sinking into thought.
دوباره آه کشیدم ولی برای بیرون آمدن تلاشی نکردم.	I sighed again, but didn't move to unearth myself.
اما گمان ندارم سلامتی خود را به مخاطرات افکنده و خود را گرفتار غضب نمایی.	but still you do not like to risk your soul.
پس عرق دوزخیان از سر تا پایت فرو خواهد چکید.	you shall have the sweat of the damned.
همان نوری که پدر بی چاره هیچ امیدی به دیدنش نداشت.	which poor father despaired of ever seeing?
راه چندانی نرفته در برابر تک عمارتی از حرکت بازایستاد.	presently stopped at a solitary house
پیش از آن که دیگران ناکامی خود را دریابند	before the others had had time to realize the disappointment.
وی به این نتیجه رسیده بود که باید سرمشق مدرسه باشد	he had quite an idea of being a good influence in the school
ولی یک نیم تنه ضخیم چرمی و یک کمربند و یک دشنه داریم.	but here is also a stout jerkin of leather, a belt, and a knife.
ومرا مجبور کرد با ساکی محتوی شش لباس مختلف بیرون در بایستم تا او به محض خبردارشدن از شیوه لباس پوشیدن دیگران لباسش را عوض کند	she made me come and stand outside the door with about six different outfits in carrier bags, so she could quickly change.
دهه شصت خوب بود و دهه ۸۰ مزخرف بود.	give me the sixties and cram the eighties up your ass.
اما نشان دهد که به ناشایستگی این سکوت معترف است	betrays a consciousness of the impropriety of such silence
مطمئن باشید که در اسرع وقت این دعوت را غنیمت خواهم شمرد.	you may be very certain that I shall avail myself of it as soon as possible.
چون قرا ره با یه نفر دی گه به جشن برم	because I'm already going with someone.
اما میدانست وقتی گاری به راه بیفتد او هم سوار آن است.	but he knew he was going to be on it when it pulled out.
قبل از این که جوانک نگاهش را بالا بیاورد	before he raised his eyes
زیرا آن مردان شریف چنان او و اربابش را لخت و غارت کرده بودند که چیز قابل توجهی برای ایشان نگذاشته بودند.	seeing how they pillaged and ransacked.
پشت در زن زیبا و چاق و گلگونی را با جامه گلی و روسری ابریشمی ارغوانی دید	he noticed behind that door a plump, rosy, handsome woman in a pink dress with a lilac silk kerchief on her head
یک توسن بلند قامت که شخصی بر آن سوار بود.	a tall steed, and on its back a rider.
پدر آهی کشیده ظاهرا پریشان گشت و بزودی سخن خود را بریده نزد کنتس رفت.	his father, sighing and evidently disconcerted, very soon became silent and went in to the countess.
با وجود آنکه سفارشی بود از طرف دوستان ناشناس	, notwithstanding the advice of his anonymous friend
مبارزی که در سر وقت در میعادگاه نبرد حاضر شده است تاج افتخار پیروزی را خواهد ربود.	he who waits for him carries off the crown of victory.
اگه شوهرهاشونو دار می زدن باز هم به رام مهم نبود.	I wouldn't of minded if all their husbands got hung.
ضمناً از شروع با نامه فدایت شوم قصد و نیت خود را نیز به صاحب خانه اطلاع دهند.	to make an appointment, by post, a day or two previous.
پایش به چنگک تیز عنکبوت خورد و از سوزش و درد شدید پایش نفسش بند آمد.	his leg connected with the pincers and next moment he was in excruciating pain.
زیر خورشید صلات ظهر جاده سفید رنگ پیش رویش امتداد یافته بود	straight out before him in the noonday sun on the white road
قهراً نباید برای گناه خود بیمی از کیفر داشته باشد.	he had no reason to fear any punishment for his offence.
زمانی در اینجا ده اتاقک وجود داشت و برای همه فضای کافی بود.	ten huts contained within the circular wall, plenty of space for everyone.
اما علتی ندیدم که برای این کار به سراغش بروم.	but I saw no object in seeking him out for the purpose.
این توجه ژنرال به سلامتی کاترین عملاً سرکوفتی بود به کاترین که چرا چنین تصوری از ژنرال داشته.	which seemed to reproach her for her opinion of him, was most urgent for returning with his daughter to the house.
که روزهای خجستهٔ عشق را به دنبال داشته بود.	days which had been followed by the blessed days of love.
همان چیزی که ساعتی پیش مغرورانه از تو تقاضا کردم.	that I in my pride begged for not an hour ago.
تا روز نوزدهم نرسیده بود باد تند شدید از جانب شمال غربی نوزید.	it was not till the nineteenth that a brisk gale from the northwest sprang up.
به خاطر اقدام علیه خواهرش به این وضع گرفتار شده است.	withered and somewhat crumpled for having been raised against his sister.
در همان حین چشمم به سوییچ پدرم که بر روی کابینت بود افتاد.	as I did, I noticed my dad's car keys on the counter
در آن دستور کارش را از رئیسه گرفته بود رفتند.	on thepreceding day, had received his orders from the prioress.
مشکلی که برای حل آن خواستار کمک من هستید دقیقاً چیست.	what the exact nature of the problem is in which you demand my assistance.
این باعث شد که بتواند صورت واقعی اشیاء پیرامونش را تشخیص دهد.	this restored her to a true perception ofthe things about her.
با صدایی ملایم از او پرسید چه اتفاقی افتاد که او را چنین ناراحت کرد.	tenderly inquired what had happened to distress her.
امیدوارم امروز تقدیر شما را برای فردایی پررونق و انباشته از سعادت نجات داده باشد.	I hope you have been this day preserved for a prosperous and happy life.
تا زمانی که به یاد آوردم که او خود گرگم است.	until I remembered that he was my wolf.
حتی در این لحظات خوشی و سعادت خوشنودیش از کارهای سر جیمز به آن اندازه بود که به حساب آید.	her pleasure in it was great enough to count for something even in her present happiness.
خود طناب تا ارتفاع معین بوسیله یک غلاف فلزی محفوظ بود.	the ropeitself was protected by a metal case.
همه عیوب را داشت و در خط همه جنایات بود.	he had all vices and aspired to all crimes.
دی گه تا محکمه رأی نده نمی تونم برگردم	I don' wanna do it over an' over.
نمی دونم اخرش چه بلایی به سرش ون میاد.	I don't know what's going to happen to them, I really don't.
ولی در اعماق قلبم بسیار ناراضی و ناراحت بود.	though I felt miserable.
به همین نحو از داخل اطاق نشیمن هم گذشته	went on to the other living room
خود را تا آن مقدار حقیر و پست کرد که یک عدد چاقو برایش خرید	he abased himself, so far as to buy him a knife
از ترس اینکه نیفتم روی دستمال سراپا دراز کشیدم.	for fear of falling, laid myself at full length upon the handkerchief.
در آغوش گرفتن بدنهای کوچک برهنه ی آنان و فرو بردنشان در آب	to take in her arms and dip those little naked bodies,
مرد درخت را گرفت و آن را به هوا میخکوب کرد که بالای تپه قرار بگیرد.	the man was nailed to the tree and raised in the air to die at the top of a hill.
تکه سربی را که روی زمین افتاده بود برداشت و به آن بست	tying it to a leaden weight, which had formed a part of some pulley, and was lying on the floor
زیرا من و اربابم از مصالح حوادث و ماجراهای گوناگون پهلوانی چندان گچ و آهک بر سر ماله او بگذاریم	I and my master will give him as much grouting ready to his hand, in the way of adventures and accidents of all sorts
گفتش خیال دارن تا پونزده روز دی گه برن.	he says they're aimin' to go in about two weeks.
مثل این است که آن روزها هنوز جریان دارد	as if they were still going on
آن گل رز را برای تقدیم جلو روی گرفت.	offered her the solitary rose.
قاشق و چنگالش را برداشت اما به آن لب نزد.	picked up his fork but didn't start.
هنوز دست اندر کار نشده بودم که از حرکات من پی به مقصود بردند	who, conjecturing by my motion what I was going to do
که در آنجا هتل بزرگی مشرف به خلیج قرار داشت.	where a large hotel stood looking out over the bay.
به حدی که چنان مستغرق سعادت و نیکبختی باشی که مرا فراموش نمایی.	that there may be no place for me even in your memory
برای ایشان وسایل آسایشی فراهم آورد که خود از آن بی بهره بود.	giving them what comfort he could, and much more than he had himself.
به یک ضربت کاری او را از پشت قاطر به خاک انداخت.	brought him badly wounded to the ground
مثلاً برای آن همه سر و صدا کردنش بعد از بیدار شدن.	the noises he made on arising.
به این فکر افتاد که در عین بیچارگی و درماندگی حس ترحم او را تحریک کرده و به کار اندازد.	for an instant, thought of appealing to her compassion for his helpless state.
آنگاه از ناخدا پرسیدم که به حساب او ما چه مسافت از خشکی دوریم.	I then asked the captain, how far he reckoned we might be from land.
به دریا نگاهی انداخته و دیده بود چنان صاف است که به یک صفحه فلزی شباهت دارد.	when the sea seemed paved with aluminum
اما هیچ تصویری نیست که بتواند با دقت کامل او را نمایان سازد.	but none can hit it with any very considerable degree of exactness.
این بحث نشاط انگیز چون کپهای هیزم زبانه کشید و گل انداخت.	the conversation crackled merrily, like a burning faggot stack.
باز در آنجا یک سوم دیگر از افراد خود را از دست داد.	the regiment here lost another third of its men.
چنانکه به قرار اظهار خود بانو گامیج مثل این بود که او را جادو کرده باشند.	that she said next day she thought she must have been bewitched.
آنگاه کاترین روی فرش اتاق دراز کشید و به من گفت ساکت باشم. زیرا حالش خوب نیست.	afterwards she lay down on the rug, and told me not to talk, for she was weary.
مقابل گنجهٔ دیواری در میان یک تل خرت و پرت نشسته بود	she would be sitting in front of a cupboard in the midst of a heap of things
برای اولین بار پس از چهار ماه هر هفته رفتن.	for the first time in four months.
در حالی که کنارش نشسته و از آن کابوس جدایی بیدار شده	sitting by him, roused from the nightmare of parting
یکی دو بار در طول راه. از ماکس خواهش کردم که کنار مهمان سرایی توقف کند تا فنجانی چای بخوریم.	I wanted to draw up at some wayside inn and stay there, in a coffee room, by an impersonal fire.
طبیعت چگونه بلد است تسکین بدهد هر دردی را که بالاتر از آن نباشد	nature knows how to alleviate the deepest sorrow.
کشمکش ادامه داشت تا اینکه بالاخره رت او را بلند کرد	his eyes hard and anxious as he lifted her completely off her feet
من بر آنم که به دست خود مانع و رادعی را که در سر راه سعادت او وجود دارد از میان بردارم	I will, with my own hands, do away with the obstacle that may interfere with it
در حالی که دستش را برای گرفتن کارت پرواز دراز کرده بود	holding out a hand for my boarding pass.
چنانکه دیگر قدرت بازگشت به آن اندیشه را نداشت.	he had not the strength to turn it back again.
بعد از آن برای گوسفننتدان مقتول مراسم تشییع جنازه به جا آوردند و بوته خاری بر روی قبرش کاشتند.	then the sheep who had been killed was given a solemn funeral, a hawthorn bush being planted on her grave.
از پشت شش بازیکن قوی هیکلی که در مقابلشان بودند هفتمین بازیکن بیرون آمد.	from behind the six large figures before them came a seventh
سر خود را برگرداند و یک لحظه جاده را نگاه کرد.	he looked back down the road for a moment.
این احساس را داشتم که آن روز حتماً به کلاس خواهد آمد.	I had the impression that he was sure to visit it that day.
به او نگاه کردم و دیدم که باز از چیزی ناراحت بود.	I looked at her, and saw that she was sad about something again.
آنگاه با حرکتی عصبی با دست چپ استخوانی خود شروع به بیرون ریختن محتویات صندوقچه رویی کرد.	then with an agitated jerk he began to work with his bony left hand at emptying the tin box before him.
مجبور است با خیلی چیزهای رنج آور زندگی زناشویی بسازد	has got to put up with the life her husband makes for her.
او مدعی است که تنبیه از راه بدجنسی و به منظور نپرداختن مزدی است که به وی مدیونم.	he says I do it out of niggardliness, to escape paying him the wages I owe him
به سرعت به طرف دیگر بر که برگشتم و وسایلم را برداشتم.	I hurried back to the other pool and got my fishing things together.
برده بودش تا بازتاب واپسین آن روحانیت پرتوان را در او ببیند.	carried her off to watch her aftermath reaction to that overpowering ecclesiasticism
سپس با چشمانی که بر اثر فرو ریختن شدید خون از دهان زخمی بزرگ کور شده بود به زمین افتاد	fell nearly blinded with the blood that rained down from a deep gash in her forehead
مارتین چند تا پیراهن و چند تا زیر پیراهنی و چند تا کتاب پشت سر هم از صندوقچه در آورد.	a few shirts and several changes of underclothes come out of the box, followed by books, and more books.
تا کف زمین پوشیده از موی بلند مگی شد	untill all the long curls were huddled in glistening heaps on the floor
که آیا باز هم این چنین از نزدیک و بی تکلیف او را خواهد دید.	if he would ever see her again so closely and intimately as here.
همان طوری که خواستی اصلاً مطلب را فراموش کنیم.	we'll dismiss the matter, as you advise.
لذا از آنجا بیرون آمدم و آهسته آهسته به راه افتادم.	so I turned away and made my exit, rambling leisurely along
آقای راچستر مرا مأمور کرد یک معلم سر خانه برای او پیدا کنم.	he commissioned me to find a governess for her.
فکر کن که همین امشب من از چه چیزهایی به خاطر تو صرف نظر کردم!	think of all I have given up, only this one night, for you.
زیرا که وجود و عدمم نفع و ضرری به کسی ندارد	I was a very insignificant person
نگفتم که من یک وقت پولدار بودم و بازم پولدار میشم!	I TOLE you I ben rich wunst, en gwineter to be rich AGIN
متوجه نشده بودم که آن پسر با من خصومت دارد.	I hadn't realized the boy harbored any ill will towards me.
آرزو داشتم در میان مردمی به سر برم که بتوانم با آنان در اوضاع و احوالی همانند به سر برم و گفتگو کنم	I wanted to be among people, with whom I could converse upon even terms
اما بعد از ازدواجش به فاصله کوتاهی مادرشان از دنیا رفت.	but, as her own marriage had been soon followed by the death of their common parent,
ولی تا چند ماه بعد دیگر به آن فکر نکرد.	but he did not think of it again until a few months later
خواستی که با کاتب اسرار وزارت داخله به میدان سیاست قدم بگذاری.	with the minister's secretary
من هم نی باریکی را که در دست داشتم به دندان گزیدم و به طرف دریا نگاه کردم.	I began eating a piece of grass and looked away.
همین عامل به وی اجازه داد تا پی ببرد که چرا مردها از مردن وحشت دارند.	had permitted him to understand why man are afraid of death.
که از دست سما را و به جانم پیوست نبود	imparted by her genial touch, as other unobtrusive beauties
گویی کسی آن را از جلوی راهش برداشته و در آن اتاق گذاشته بود.	something that looked as if someone had just put it there to keep it out of the way.
طولی نخواهد کشید که پدرش را روی انگشتانش بازی خواهد داد	she will soon twist her father round her fingers
ناگهان از شدت آن به اطراف پرتاب شویم و در مسیری دیگر قرار بگیریم.	suddenly it would shoot you up some backwater where
شغل خود به عنوان سرکارگر شرکت موز را کنار گذاشت	he gave up his position as foreman in the banana company and
که تنها دو ساعت پیش به وی چه گفته است	with the words he had heard only two hours before
پس از چندی فرمان داد که بگویم مقصود من از ذکر این عنوان کدام نوع مخصوص از یاهوهاست.	he commanded me, some time after, to inform him, what species of _Yahoo_ I particularly meant by that appellation.
قبل از اینکه بتوانم جلوی خودم را بگیرم کلمات از دهانم بیرون پرید	I've never done anything to make my parents proud of me.
حیران بود که آیا انداختن خرج تلگراف به گردن روزنامه کار درستی است	wondering whether it would be well to permit a newspaperto pay for this
تیرهای پراکنده تلگراف در بیرون شهر با سیمی تک	the sparse row of telegraph poles strode obliquely clear of the town, bearing a single
او را به دیده یک بچه ننگریست بلکه مثل یک زن بزرگ با وی رفتار کرد.	she treated her no longer as a child, but as a grown woman.
هرکس جز این فکر کند یا اصرار ورزد که دیگران غیر از این فکر کنند دزد و دغلی بیش نیست.	he would be a blockhead who would hold or believe anything else
اما نتوانسته بود بر افکار ضد و نقیض خود فایق آید.	but she had not been able to overcome them
از این جهت دیگر اغلب اوقات پیرمرد سرحال نبود و خشمگین و عصبی به نظر می سید.	who apart from that was usually in a bad temper lost control of himself.
ولی برای بقیه که نباید دست روی دست بگذارم.	but I must, indeed, for other people.
که صورت او نیز کمتر از صورت بزچران آغشته به خون نشد.	that the poor knight's face streamed with blood as freely as his own.
مادرش اورسولا هم سعی کرد یک پتوی دیگر روی دوش او بیندازد	rsula tried to throw a new wrap over his shoulders.
چنانچه به فرانسه برگردند محکوم به اعدام خواهند شد.	condemning all to death who return.
با خود عهد کردم که دی گه رأی ندم.	I says I'll never vote agin.
اون دو تا هم می خواستن یه ذره سنشونو بالا به برن.	both of whom decided to age themselves up a little too.
در حالی که قبض کنت را از بو ویل گرفته و به روی میز نهاد.	carelessly throwing down the receipt on his desk.
لای در کوچه را باز کرد و یواشکی بیرون خزید و بعد آن را بست.	he opened the door into the street a very little, and crept out, and shut it
لکن مایلم یک شب دیگر با او تفریح کنم.	but till then I am going to have another night of it with him.
که هنوز از این گمان که در حق او کردم	those suspicions which, even when there is no crime
کتابی که تمام عالم در آن ایام مشغول خواندنش بود.	that everyone was reading in those days
به طور مداوم در چنبرهای ریسمان زوبین که گرد دنب وال بسته شده بود گیر افتاده بود.	had permanently caught in the coils of the harpoon line round his tail, the cutting spade itself had worked loose from his flesh.
گوشه دهانش که بازمانده بود حرفه سیاهی در پایین صورتش درست کرده بود.	the corner of her mouth, which was open, seemed like a black hole at the lower part of her face
که بوسیله حملات به دشمن و یا قربانی فرزندان در راه نجات وطن و اعمال غیرطبیعی امثال آنا بیان شدنی نیست	which expresses itself not by phrases or by giving one's children to save the fatherland and similar unnatural exploits
قبل از اینکه بتواند جواب دهد. دیدم که در باز شد و کسی داخل گشت.	I heard the door open before he could answer
تا جان خود و جان کسان خود را حفظ کند.	humiliation in order to save his own life and those of his dear ones.
ریش خود را از ته تراشیده و به خود ادوکلن زده بود.	carefully shaven and fragrant with lotions from his dressing table.
کلاه بالا کل اوایش را روی موهای سیاه و نامرتبش بالا کشیده بود	his balaclava perched on top of his shaggy black head
در حال گذر از خیابان اصلی و خاک الاود کلیپ دریفت بود	drawn by two beautiful matched bays.
مردی سوار بر اسبی خاکستری که کلاهش تا روی چشمانش پایین کشیده شده بود	a man on a grey horse with his hat down on his eyes
با نهایت مسرت خاطر حاضرم از ته دل آن را به وی ببخشم و مالکیتش را تصدیق کنم.	he is heartily welcome to keep it.
بلافاصله صدای ترقه مآنند بلندی به گوش رسید و هر دو ریش سفید و بلندی درآوردند.	there was a loud popping noise, and both of them sprouted identical long white beards.
قسمتی از من خوشحال بود که این دیوانگی توجیه شده است.	a tiny part of me was relieved to have the madness explained.
فعلاً کاری به کارش نداشته باش تا مرده را دفن کنیم.	let her be till after the funeral
تقدیر که هر چند در حرکت خود میان خطوط مستقیم و چوب محدودیت دارد	chance, though restrained in its play within the right lines of necessity
نسبت به تنه او عمود است معلق در آب مانده و در نظر همه کس شبیه دهانه کشتی میان دو عرشه آن است.	hanging straight down at right angles with his body, for all the world like a ship's jib boom.
از ترس اینکه مبادا باز بیاید و تعقیبم کند	this for fear she should come and hunt me up.
مرد روحانی به سر طاسش که فقط چند دسته موی خاکستری شانه شده داشت دستی کشید	the priest, passing his hand over the thin grizzled strands of hair combed back across his bald head.
البته اگر چنین باشد من ایشان را اولاد خود نخواهم دانست	I do disown them and in this way
چون در چنان مواردی برایش آسان نبود تشخیص بدهد که آن حس شفقت است یا عشق.	because in such cases it was not easy to distinguish between compassion and love.
زیرا در ظاهر همسایگانش یک چیز مخصوص وجود داشت	for there was something rather peculiar in the appearance of his neighbors.
او را بار اولی که صدای من را شنیده بود رنجانده بودم و این مسئله از آنجا شروع شده بود.	I'd offended her the very first time she'd heard me speak, and it was downhill from there
ناگهان مثل اینکه ضربت شدیدی بر او خورده باشد از جا پرید	suddenly he jarred as though under a heavy blow.
زیرا با چنان شدت و استحکامی به شما علاقمند بودم که دیگر عقل و هوش خود را از دست داده بودم.	never know how devotedly I loved you, as almost bore down sense and reason in its course.
پدری دارم که اکنون باید هفتاد سال داشته باشد اگر زنده باشد	I have a father who is seventy if he yet lives
نفس توی دلم حبس کردم و گوش دادم و صبر کردم.	I held my breath and listened and waited
که نه از جا جنب خورد نه یک کلمه حرف زد نه به من نگاه کرد	he would not move a peg, nor say a single word, nor even look at me
باید قرارداد ما را تنظیم کنی و ما را مثل یک جفت رند و کلاش چنان محکم به هم ببندی تا فرار نکنیم.	so you'll soon have to arrange our contracts, and to bind us firmly to them, like a couple of knaves.
از آن سوی میز با اشاره به او فهماند .	so he signalled to her across the table
هم آواز خواندنش و هم پیانو زدنش واقعاً بهتر از اِما بود و اِما هم توی دلش این را قبول داشت.	performance, both vocal and instrumental, she never could attempt to conceal from herself, was infinitely superior to her own.
زیرا کیف لوازم بهداشتی من روی آن قرار داشت و یک عالمه چیز صورتی آنجا بود.	because my familiar bag of toiletries was right on top, and there was a lot of pink in there
موجی از دلسوزی به شکل رنگ و صوت نه تنها خود می سون بلکه یکایک تماشاچیان را در تالار بلند سقف و باریک دادگاه متأثر کرده بود.	the wave of passing pity that was moving as sound and color not only throughhim but through every spectator in the high, narrow courtroom.
سعی کردم صدامو عوض کنم تا نفهمه دلم می خواد بکوبم تو صورتش	I tried to make my voice sound like I wasn't about to punch him.
باید یادآوری کنم موضوعی که برای صحبت دربارهی آن پیش شما آمدهام باید اکیداً محرمانه بماند.	I ought to observe that the business about which I have to speak to you is to be strictly private.
اصلاً به فکرم نرسیده بود که توی این کتابو نگاه کنم.	I never thought to look in here!
همان جا که خارج از تصور ارباب بود تنها حیواناتی هستند	which my master said was altogether past his conception
او نیز پاهایش را روی هم انداخت و دست به سینه نشست.	crossed her arms and legs too
به زودی خانه کسی که مرا به او سفارش کرده بودند یافتم	I soon found out the person's house to whom I was recommended
از ایشان دعوت کردم تا نشانشان بدهم که واقعا شوهر دارم.	I asked him to show him that I really had a husband.
دیدم که فایده ندارد حرف بزنم باید دستم را باز کنم.	I see it warn't a bit of use to try to go ahead I'd got to throw up my hand.
در حدود نیم ساعت دیگر در مجلس رقص توقف کرد.	remained there about another half hour.
مقابل تلویزیونی که روشنبود نشسته بود و یک لیوان مشروب اسکاچ در دست داشت.	with the television set on and a scotch in his hand.
از ای نرو من پاسخ او را به ایتالیائی دادم	therefore I returned an answer in that language
در حالی که هر دو دست خود را بر کفل خر نهاد به چستی و سبکی باز شکاری بر پشت پالان پرید	putting both hands on the croup of the ass she dropped into the saddle more lightly than a falcon
که دو برابر کله هر یک از ما بود.	was about twice the bigness of our heads.
به ما ترحم کن و ما را نجات بده!	have mercy on us and save us
امیدوارم که وقتی او با من ازدواج کرد این دختر فرانسوی را نیز همراه خود بیاورد.	I hope she will bring her along with her when we're married, la petite est gentille.
اول یک نرده و بعد خانه را مشاهده کردم.	presently I beheld a railing, then the house
به همراه گروهی دیگر از مردان جوان و شاخص.	with some other young men of position.
با این بهانه که بر ایمنی جان او بیفزایند	with the pretext of protecting him
فقط میل دارم که مرا مثل یک دوست و مصاحب خود بدانی.	I'll be your friend and your companion, a sort of boy.
خیلی زود فهمیدیم که برای رسیدن به او شانسی نداریم.	we soon found that we had no chance of overtaking him.
هر چه شهرت نویسنده آن بیشتر باشد مردم با تأمل و تعمق بیشتری آثار او را خواهند خواند.	the greater the fame of the writer, the more closely are they scrutinised.
قول داد که مانند بار اول جواب مساعد بیاورد.	to bring back an answer as good as the one he brought back before.
بر آن شدم که خود را به نخستین بومی وحشی که دیدم تسلیم کنم	resolving to deliver myself to the first savages I should meet
در وال سرزای کام لا رشد کرده اندکی از دو هزار قدم مربع کمتر است	in a full grown sperm whale something less than 2000 square feet
که من اول همین نصیحت را به او کردم	that I gave him the same advice
ناشناس را از سر تا پا ورانداز نموده و سخت سراسیمه شده بود	surveying the stranger, from head to foot, in evident perplexity
من در نظر اول آن دو قهرمان را به جا آوردم	I knew, and could distinguish those two heroes, at first sight
ولی چون هوا گرم بود به گوسفندان گفته بود که همان جا بمانند.	but, as it was warm weather, told the sheep to stay where they were.
ولی زندگی به او نشان داد که سخت در اشتباه بوده است.	but life convinced her of her error.
از راه دادن این حالت هذیانی به ذهن خود هراسان شد.	she was afraid of giving way to this delirium.
هر جای خالی آن از انواع بی شمار خزه پوشیده شده بود.	unnumbered varieties of moss filled its hollows
که هیچ کس پاروب نزند و کسی جز به نجوا سخن نگوید.	that not an oar should be used, and no man must speak but in whispers.
درست بعد از آنکه اجاره نامه امضا شد فهمیدم دروغ است.	I found that out just after we signed up.
رون به زور کاغذ را از دست او درآورد	wrenching it from her grasp
تازه اگر هم داشته باشد چه ربطی به شما دارد.	I don't know what it's got to do with you if he is.
من از نگاهی که میان ایشان رد و بدل شد دریافتم که سخنان جوان واقعیت دارد.	I saw in the two faces that all he said was true.
سرانجام فهمیدم که چیزی شیطانی و مرگبار در کار است	I knew at last that something dark and deadly was at work.
سه روز به من مهلت دهید تا بروم بچه این زن بدبخت را بیاورم.	three days in which to go and fetch the child of this unhappy woman.
اما اینک از فکر اینکه مبادا کلاید ناگهان لیکرگس را ترک کند	that he might suddenly go at any moment
به نظر من خیلی بهتر از یکه تکه فلز است.	I think it's a lot better than a lump of metal
از قرار معلوم شش ساعت تمام راه رفته بود.	so that he must have been walking about six hours.
با ین فکر افتادم این منظره را برای نقاشی به شما پیشنهاد نمایم.	I confess I had serious thoughts of giving you one.
که در اطاق عقب کشتی که بالای آب مرده دنباله کشتی ساخته شده به فکر فرو رفته است	where he broods within his sternward cabin, builded over the dead water of the wake
انگاردرآن لحظه دوباره از عالم جنون به عقلانیت بازگشته بود.	the sudden sanity in her eyes, and understood.
ساکت و آرام بود و آن سبد سنگین را تمام راه از شهر آورده بود.	quite thought she wanted it, carrying that heavy basket all the way up from town.
پول و آشنایان هم زیاد دارد و سابقاً هم دوست شوهر اول وی بود	with a large property and vast connections, who had been a friend of her first husband's
به سؤالات اعلی حضرت که بیش از یک ساعت ادامه داشت جواب دادم.	by whose intervention I answered as many questions as his majesty could put in above an hour.
وقت را تا آن زمان در آرام کردن خویش مصروف دارد تا از آن پس به تسلای دیگران بپردازد.	so to strengthen himself in the interval that he might be able, after that time, to strengthen others.
تصور مییرفت که این شکل مشئوم طنابی به گردن دارد.	that this sinister form had a rope roundits neck.
چون دانش مرا در فن دریانوردی آزموده است من دست کم با او هم طراز خواهم شد	that having experienced my knowledge in sea affairs to be at least equal to his
برای او چندان نادر بود که هیجان یک شهوت را داشت.	for her that itcontained all the violence of voluptuousness.
پس از قوس طولانی که در سقوط خود طی کرده در فاصله چهل متری به دریا افتاده است.	making a long arc in his descent, fell into the sea at the distance of about fifty yards.
به شک افتاد که آیا واقعا پای کارگری در میان است	was inclined to wonder whether there was a working man
ماندن این همه مدت در خانه ناراحتش ساخته است.	that being shut up here so long has made her restless
بسیار بد خواهد شد که راز او از زبان من یا از زبان کسی به جای من فاش گردد.	it is not right that I or anyone for me should disclose them.
برای آن که غضب پدر شوهرش را متوجه خود نسازد	to avoid drawing down her mother in law's wrath upon her.
وکیل پادشاهی یا نایب وکیل پادشاهی یا رئیس وزارت دادگستری	the king's attorney his deputy or a magistrate
این را از طرز نگاه کردنش فهمیدم این جن بو داده مرا برداشت برد طبقه بالا تو یک سولدونی	I found out afterwards they called it a room, but first I thought there'd been some mistake
در ازاء مبلغی که تعهد کرده بود برای پدر زنش بفرستد	for a payment which he agreed to send to his father
نزد او رفتم تا اوامر دیگرشان را اصغا کنم	came near to him to expect his farther commands
من هم چاره دیگری ندارم غیر از اینکه به سرعت دنبال او بروم.	I've no option other than to run after him.
آن قدر ناراحتش کرده که به فکر چنین چیزهایی افتاده!	to suffer her even to think of such a measure!
سپس در کلبه را باز کرد و در آن هوای طوفانی جغد را با شتاب به هوا پرتاب کرد.	went to the door, and threw the owl out into the storm.
مطمئناً دوست و آشناهای خانم التن هم مثل او هستند.	I dare say her acquaintance are just what they ought to be.
او را حق است که هیچ نبیند و نفهمد.	he has the right to notice nothing.
زیرا هر روز باید برای آوردن وسائل آشپزی به آناج بروم.	I have to go into the cellar every day, too.
شروع کردم دوباره از پنجره بیرون را نگاه کردن و چند بار چوب را لمس کردم.	I continued staring out the window and brushed the wood a few times.
تکالیفم را جمع کردم و همه را به اتاقم بردم.	swept up my homework, and carried it all to my room.
زمانی که او چند دقیقه پس از یاعت چهار در حال صحبت کردن بود	that just as he was taking his post a few minutes past four
مثل این که در دنیای دیگر اتفاق افتاده باشد.	somewhat as if they had happened in another world
به خانه تلفن زدم و به من گفتند که تو اینجایی.	I called the house and they told me you'd be here.
من یگانه کسی بودم که وقتی پدرت در اوج قدرت و شهرت بود حقیقت را به او گفتم.	I used to be the only one to tell your father the truth when he was in favor
بنزین در خطی مستقیم از سرسرا تا محراب ریخته شد. آ نرا همه جا پخش کرد.	the gas spraying out, all the way from the vestibule to the altar he had run
من تو این جور کارها خیلی بی دست و پام.	I'm not so clever that way.
بنابراین قاعدتاً اطلاع داشته که اربابش و بانوی خانه در واقع زن و شوهرند.	so that he must have been aware that his master and mistress were really husband and wife.
اما کسی برای برداشتن سنگ از وسط خیابان کاری نکرد.	but none did anything about getting the big stone out of the way.
بدون هیچ اعتراضی و بی آن که غرولندی کند راه افتاد.	without one objection, one murmur, he departed.
با این حال استماع این جمله از زبان دوبوسه برایش مطبوع بود	he was pleased to hear it from him.
فرمان داد که چندین نردبان به پهلوهای من تکیه دهند.	commanded that several ladders should be applied to my sides,.
خوب خودت که یادت هست و خیال کرده بهترین راه جبران اون سانحه ای نه که منو به رقص به بره.	well you remember it, she inserted dryly, and he thinks prom is somehow the correct way to do this.
آنگاه پاهایش را از تختخواب به پایین آویخت و کف پا بر زمین نهاد.	then he hung his legs over the edge of the bed, and placed his feet on the floor
تا مجازات مناسبی برای این کار پدر شر برانگیز تدارک ببیند.	yet another suitable punishment for the poisonous parent.
هیچ چیز نبود که بتواند در ان چنگ بیندازد	there was no stay to clutch at
با حرکتی حاکی از بی صبری شمع را خاموش کرد.	with an impatient gesture he put out the light.
تا طبق قولی که داده بود در کنار همسرش بمیرد.	to fulfill the promise of dying beside his wife.
راستش من تک تک کارها رو .انجام نمی دم..	I don't exactly manage every single
چنان هیجان زده و مضطرب بود که دیگر به خواب نرفت.	was too excited and nervous to go back to sleep.
دختر با عجله بازوان خود را روی سینه صلیب کرد.	before she hurried to cover them with crossed arms.
در اول از برای آزادی خود پانزده روز انتظار قرار گذاشته بودند	he at first expected to be freed in a fortnight
پس آرام آرام به هوش آمد و به اتاق دفتر بزرگ داخل شد.	then he gradually recovered and went with me into my study
خود او هرگز از حدود این اراده خارج نشده بود.	he never went beyond that limit.
درس ته کتابه قدیمیه ولی همه چی توش داره.	it's a bit outta date, o' course, but it's all in here.
تا اعماق درونی قاره پیش رفت و مدتی قزیب به دو سال در آن حدود به سفر مشغول بود	penetrated far into the interior, where he travelled for a period of nearly two years
چه دیگر مقتدائی نخواهم داشت که مرا در طریق فضیلت رهنمون شود و مانع از گمراهی من گردد.	for want of examples to lead and keep me within the paths of virtue
به جای آنکه شخص محتضر را دل دایر بدهید	, instead of consoling theM
که مورد لطف و اعتماد است با مهر و محبت خاصی او را پذیرفت	received him with distinction and special marks of favor
خم شدم و مطمئن شدم که حفاظ آسیب ندیده با شه.	I flexed, making sure the shield was undamaged.
تکه کیک چسبناک را با دست گرفت و با آهستگی تمام مشغول خوردن شد.	took the sticky thing in his fingers and started very slowly to eat it.
شایعات خاص شهر و تحولات مداوم و لاینقطع سیاسی فرایند مداوم حفظ میهن	the peculiar gossip of the town, and the continuous political changes, the constant saving of the country,
هم این بود شیوهء رفتار این مرد در امور مربوط به کسب و کار و مسائل روزمرهء زندگی خانوادگی خود در سراسر عمر.	in which condition, indeed, as to the business and his domestic affairs, he walked up and down through life.
باید جایی رو بگین که جستجوی اون چند روز طول بک شه.	I am clever enough for that, he said, quietly, almost with indifference.
وی پس از آنکه دو حالت از حالات رقص خود را نشان داد سر بالا گرفت	after executing two figures, raised his eyes
چون وقتی شام تمام شد صحبت آواز خواندن پیش کشیده شد	for, when supper was over, singing was talked of,
لیکن گوسفندان در پس گردو خاک چنان از نظر پنهان بودند که تا کاملاً نزدیک نیامدند تشخیص داده نشدند.	which, because of the dust, did not become visible until they drew near
به واسطه رشک و حسادت غیرارادی به زیبایی و جوانی و سعادت او و به واسطه غبطه به عشق برادرش با این دختر نظر خوب و مساعد نداشته است.	she was prejudiced against her by involuntary envy of her beauty, youth, and happiness, as well as by jealousy of her brother's love for her.
من هم مجبور شدم صبر کنم تا تو کتاب را تمام کنی.	I was obliged to stay till you had finished it.
منظورم ای نه که اگر بتونم اون طوری آ روم و مؤدبانه حرف بزنم و بقیه ماجرا.	I mean if I could talk easy that way, an' polite, an' all the rest.
آن قدر به تو خواهم چسبید تا یکی از ما از هوش برود یا بمیرد!	I hold you till one or other of us faints or dies!
او هم که حتماً انتظار چنین نگاهی را داشت قبلاً سر خود را بلند کرده بود	who raised his eyes for an instant, as if in expectation of it
من هرگز ندیده بودم که خون آشامی به طور تصادفی چیزی را بیندازد.	I had never seen a vampire drop anything by accident.
در عمرم هیج وقت تا این حد گیج و هیجان زده نشده بودم	I have never been more excited and thrilled and petrified.
در این صورت مدتی است که سرگرد با خانمش منتظر شماست.	it must be getting on for half past twelve.
در نتیجه همه چیز دوباره به نظرمان دلچسب و مطبوع است.	so it is all cheerful once more.
بر اثر گردبادی که به واسطه افراشتن ناگهانی یک جفت دنباله فراخ در نزدیکی او پدید آمده بود کلاهش یکباره از سرش برداشته شد.	had his hat taken clean from his head by the air eddy made by the sudden tossing of a pair of broad flukes close by.
من وانمود کردم که باور ندارم اون به زودی میمیره.	I pretended I did not believe she was going to die.
بعد چماق بزرگی را برداشت بر سر و مغز او فرو کوفت.	seized a heavy club and struck her down.
گفت که جهنم را باید با جهنم پاسخ داد.	said that hell must be repulsed by hell,
اوست که در سی و دو جنگ پیروز خواهد شد.	he'll win thirty two wars.
به خاطر همین هم چیزهایی که دستگیرش شد ارزش و معنای بیشتری پیدا کرد.	which made the information she received more valuable.
نه اینکه اصل داستان بم عنای واقعی کلمه دردناک است	not because this story is dramatic in the restricted sense of the word
اما همین که چشم تو به خرس بیفتد ترس و بیمت خواهد ریخت	but when you see one your fear's all gone
اما از نیمکت همیشگیش که وسط خیابان بود آن سوتر نرفت.	but he did not proceed further than his bench midway of the alley.
دویلفور گفت مادام لامارکیز چه فرمودند من ملتفت نبودم	I beg your pardon I was not attending to the conversation
امیدوارم بتوانیم به طور دائم در اینجا از وجودش استفاده کنیم.	I wish we may be able to benefit her permanently.
با نیم دوجین از همراهان خود به طرف چهره من پیش آمد.	advanced forwards up to my face, with about a dozen of his retinue.
ما کارهای عادی و مطالعات منظم خود را از سر گرفتیم	we resumed our usual habits and regular studies
ولی من جلویشان را گرفتم و گفتم که خودم ارباب را با خبر خواهم ساخت.	but I bespoke the announcement of it myself.
دشمنانش را مشوش کند و بدین ترتیب سخت به سود دولت باشد.	to discomfit his enemies, and thereby to be of the greatest benefit to the government.
از رئیسشان و حتی از کارکنان تحت نظر خود سوال کنید .	ask your boss, and even your staff members,
اما در دلش فقط به یک مطلب می اندیشید و هیچ توجه نداشت که میزبانان سخت خسته شدهاند و مدت زیادی از وقت استراحتشان گرفته شده است.	but the one thing that filled his heart, and did not observe that he was boring them dreadfully, and that it was long past their bedtime.
همین که در حدود دو فرسخ از ساحل فاصله گرفتیم	having gained about two leagues the word was given to row by batches
به قول خودش پرستش چوب و زلم زی مبو.	the worship, he called it, of wood and tinsel.
حدس زدم که مقصودش ماشین کردن چمن من است.	I suspected that he meant my grass.
که لااقل تلویحا مخل به مبانی اجتماع و اخلاق و مذهب است!	which by implication at leastpicked at the very foundations of society religious and moral!
رئیس شرکت بی اختیار مسحور محیط اطرافش شده بود.	he could not help being impressed by his surroundings
ولی مسلماً اگر هم تاب حال دستگیر نشده باشد	but he will be, or is, by this time.
تراکتور برگشت و یک بار دیگر از آن گذشت.	the tractor cut through again.
سرهنگ محافظان فرمان داد که شش تن از سردستگان اوباش را بگیرند	the colonel ordered six of the ringleaders to be seized
او بی آنکه سخن دیگری بگوید از پیش ما گریخت	without another word he left us
که شما نباید آن را از او دریغ بدارید.	you must render it to him.
من معتقدم که زن و شوهر. پس از آنکه حادثه دردناکی برایشان پیش آمد همدیگر را بیشتر دوست خواهند داشت.	I believe there is a theory that men and women emerge finer and stronger after suffering
من فقره آخر را با دست خود به آن اضافه کردم	to which I have added with my own hand
زیرا جز در چند جای معدود یک خوشه گندم یا یک پر علف نیافتم.	for, except in some very few places, I could not discover one ear of corn or blade of grass.
مدتی پیش دیدم که کشیش از او جدا شد	I saw him parting from her a good while ago
با یه بادکنک گوسفند که از سلاخ خو نه آورده بودم.	a bladder that I got at the slaughter house.
توضیح داد که پیش از ترک منزل فقط چند لحظه نزد ایشان خواهد ماند.	explained that he would stop in for only a moment before leaving.
من انتظار دارم که او برای کمک کردن به من خودش را به خطر بیندازد.	I am asking him to risk his life to help me.
پیوسته این آرزو بر جانم چیره بود که باید روزی آزادی خود را بازیابم	I had always a strong impulse that I should some time recover my liberty
هیچ وقت ما قادر نخواهیم بود او را تسلی دهیم.	we could not comfort him in the least.
ولی وی خوشحال بود که کمکش پذیرفته شده است.	still, he felt gratified that she had accepted his assistance
یعنی دستور داد هنگام لباس پوشیدن قبل از ناهار پسرش به اتاق او بیاید.	he gave orders to admit him to his apartments while he dressed for dinner.
با صداقت و خلوص بر رویکرد قاطعانه و انعطاف ناپذیرش نسبت به سرمایه و نفوذش تأکید کرده بود.	he had emphasized his uncompromising attitude with a freedom of sincerity permitted to his wealth and influence.
دوره گردان و گدایان همگی در آن سهیم بودند.	vagabonds and beggars all shared it.
این بدخواهی آن چنان فراتر از عشق پر احساس و مشروع او به پسرش و آن چنان درهم شکننده بود	this malice was so revolting beside her passionate, legitimate tenderness for her son
هیچ وقت با کسانی که استحقاقش را دارند مخالف نیستم.	I never was against the deserving.
پس به تعجیل کاغذ را با دست خاموش نمودم و خود شمع را به شعله گرفته و روشن ساختم	I grasped it in my hand put out the flame as quickly as I could lighted my taper in the fire itself
که معلوم بود این بار اول نیست که این شخص را ملاقات کرده است	which seemed to indicate that it was not the first time he had been in his presence
تنها انتظار من آن است که در تقدیر شما و در خانه و زندگی شما سهیم باشم	I look only to sharing your fortunes, sharing your life and home
این جوانی که من آن روز طرز حرف زدنش را دیدم بعید است به این خوبی بتواند احساساتش را بیان کند.	I can hardly imagine the young man whom I saw talking with you the other day could express himself so well
لیکن به زودی دریافتیم که او از دیدار و برخورد چنین کسانی گریزان است.	but at last we began to see he was desirous to avoid them.
آن وقت او را بدون اینکه در کارش دخالتی کنیم تسلیم سرنوشت خودش خواهیم نمود.	he shall be left to his fate, without any farther interference on my part, at all events.
این راه را حتی اگر شده با چهار دست و پا بروم خواهم رفت.	I will cover it if I have to do it on my hands and knees.
سؤال وی را نفهمید و در پشت دیگران پنهان شد.	did not understand what was being said to him and slipped behind the others.
شعور و هشیاریش را همچنان سلامت حفظ کرده بود.	his mind as intelligent and alert as it had always been.
بلکه خود را وادارد که همه علاقه شدید و معروف خود را در دنبال کردن کلی حرفه خود به ظهور برساند.	but force himself to evince all his well known passionate interest in the general pursuit of his profession.
سطلی نیم پول به مرد کی می پرداختند که کارش آوردن آب برای مردم بود	paid half a farthing a bucketful to a man who made a business ofit
دستش را رها کردم و یک قدم عقب رفتم.	I sat down on the window seat, and let go of his hands.
از صب تا حالا من تو فک ریه دعا هستم!	I been looking forward all the morning to a little prayer.
در بازگشت به خانه همه را برایش حکایت کردم.	I told her everything when I got home.
من همه شوخ وندم وحالا یه سردرد وحشتناک دارم.	I read it all, and now I've got a damn headache.
اگر هزاران بار مانند مردم فرزانه و دانا صحبت کند	that though he often spoke like a highly intelligent person
اما با جزئیات اصیل این سانحه هرگز به طور تصادف برخورد نکردم	but the authentic particulars of this catastrophe I have never chanced to encounter
بعد از آن رفت به وسط جزیره و به ژاکوپو و عملجاتی که همراه داشت گفت در زورق بمانند تا او مراجعت نماید	but leaping lightly ashore he signified his desire to be quite alone
طبعاً بنا بر تقاضای خود او همراه با سگش.	with his dog beside him, as he had requested.
اما پدر من ماهیگیر و مادرم نیز دختری ماهیگیری بیش نبود.	my father was a fisherman and my mother was a fisherman's daughter
به دخترک بینوا که با همه غریبه است چیزی از وجود خود بدهد.	give the poor little female outsider something from himself for her very own.
حمام دستی و منقحی و شام خوب حاضری در آنجا یافت.	where a bath and supper were prepared
به نظرش رسید که در یک قسمت کوچه که از آن گذشته	he thought he perceived in theportion of the street which
این نکته را در شرافت ابدی حرفه ما باید گفت که نخستین والی که طرف حمله اخوت ما قرار گرفت با هیچ نیت سویی کشته نشد.	to the eternal honour of our calling be it said, that the first whale attacked by our brotherhood was not killed with any sordid intent.
من خودم سر شب او را به آنجا آوردم.	I saw her to the house some time ago.
نباید کاری کنم که باعث سوءظن مردم به من بشود.	I must refuse to do anything that might lay me open to suspicion.
اگر قرار است حقوق بدهند باید به او بدهند.	if pay is to be given, it should be given to him.
ما نمی تونیم این اتومبیل رو از جا تک ون بدیم	we can't move this here car.
موهای او از جنس و رنگ یال اسب بود	her hair, which in some measure resembled a horse's mane
ولی جدا میل دارم به زندگی شما سر و صورتی بدهم	but I should like to be of some assistance to you, some small assistance, of a kind that would give you satisfaction.
از من خواست یکی دو هفته او نو واست نیگه دارم و اگه دیدمت بهت بدمش.	but he asked me to keep it in my cash drawer for a week or so, or give it to you if I saw you.
یک دفعه دیگر بیشتر به سمت سرازیری مسیر درخت زار پیچیدم.	I turned once more to the steep path through the woods
تا هر دو با هم بتوانند در یک کشتزار خدمت کنند.	so the two could live on the same plantation.
به عنوان کرم و بخشش گفت هر یک از بازی کنان که در دست خود یک صورت داشته باشد به او یک شیلینگ خواهد داد	offered to cut any gentleman in company, for the first picture card, at a shilling at a time.
ولی روی هم رفته به قدر کافی حواسش بود که گلو درد چه خطری دارد.	but altogether sufficiently awake to the terror of a bad sore throat
اما تا ساعت پنج بعد از ظهر هنوز به آنجا نرسیده بودیم.	but had not reached it by five in the afternoon.
چون ایشان گفتند مایلند با تو خصوصی حرف بزند.	as he says he wants to see you privately.
از این بازی هیجان بخش رق در لذت و سرور شده بودیم.	we enjoyed ourselves.
با این کار ده جفت دیگر را هم خراب خواهی کرد.	you can spoil ten more pairs.
به آن اندیشیدم. به نگاهش که روی دخترم قفل شده بود خیره شدم.	I puzzled over it, watching him stare at my daughter.
مخارجش برایم اهمیت ندارد ولی من طاقت این هم آدم امل را ندارم.	 I don't mind theexpense but I can't stand all the old fogies.
دیگر احتیاجی به این فداکاری نیست که از حقی که عادلانه به تو تعلق گرفته صرف نظر کنی.	without stipulating for this sacrifice of your just rights.
تا اینکه به شخص مورد بازپرسی به اصطلاح جرات دهند یا بهتر بگوییم او را منصرف کنند	so as to encourage, or rather, to divert the man they are cross examining, to disarm his caution
امکان نداشت تصور کنم که نقل کردن آن وضع ممکن است روزی به یک افتضاح منجر شود.	what consequences would come of the introduction into those alms houses of my insignificant person.
یا باید اینجا گرفتار شد و یا باید با تابوت بیرون رفت.	I must either becaught here, or accept this escape through the hearse.
بدون اینکه منتظر دعوت دیگری بشود مصممانه وارد شد.	walked boldly in, without any other invitation.
هیچ نمایشی مرا به قدر بازی بندبازی بندبازها سرگرم نکرد.	I was diverted with none so much as that of the rope dancers
آن گاه به سمت پنجره رفت و پرده را کنار زد تا نگاهی به خیابان بیندازد.	crossed to the window, and drew back the curtains to survey the street below.
الان فهمیدم که باور نداشتم اون بلا رو زنده بر گردونه.	I saw that I'd never believed that he would bring her back alive.
تأخیرش در این کار باعث شد که ده هزار دلار بیشتر از جیب مبارک بدهد	his delay was going to cost him tenthousand extra dollars
بعد چشمش به فنجانی که در دست داشت خیره شد	bringing them down again to the brim of the cup
وقتی آن را انجام دادم از این جا خواهم رفت.	but when that was done, she would leave.
در این چهار سال فقط چار دفعه.هر دفعه یه تیکه کباب خوک خوردم.	I had jus' four slices of roastin' pork in four years
در هوای آزاد زندگی کن قوی و سرحال شو و برای کار و تلاش سال بعد حسابی استراحت کن.	live out of doors, and get strong and well and rested for a year of hard work.
من یقین دارم که خلاف این نکته در این دادگاه به اثبات نخواهد رسید.	no evidence to that effect, I am positive, will beintroduced in this trial.
زیرا دود و مه برفراز این فضای پهناور آهسته در حرکت بود.	as the smoke and mist spread out over the whole space.
باز همان بانگ خفه سکوت پرهیبت را برهم زد.	then the same muffled boom troubled the solemn hush.
ای کاش مردم این قدر پست سر من بد نمی گفتن!	I wish people would stop talking behind my back!
قرار هم شد که زودتر راه بیفتند تا بم وقع به خانه برگردند.	they were to set off very early, in order to be at home in good time.
پیش دویده بودند تا جوابی بدهند که نیرنگشان آشکار نشود.	came forward, in order to answer in such a way as to save their stratagem from being discovered.
به راهنمائی من در ده روز زورقی مخصوص تفرج با همه لوازم آن ساخت.	by my instructions, in ten days, finished a pleasure boat with all its tackling.
دود سبز رنگی در دخمه پیچید و صدای فیس فیس به گوش رسید.	clouds of acid green smoke and a loud hissing filled the dungeon.
سعی کردم قوطی را به داخل جیب خود بیندازم.	I tried to cram the box furtively into my pocket
من هم در پانزده ساعت طی مسافت کرده و به اینجا رسیدم.	I have come in fifteen hours
شروع کردم به قدم زدن به بالا و پایین.	I began to walk up and down.
از سوراخ قفل به ماجرایی که بین آن دو گذشت نگریست و دید	posted himself to watch and listen through the keyhole to what passed between them
من این نکته را از این جهت تذکر دادم تا شما بدانید که در آن مدت که اربابان ما با شمشیر به جان هم میافتند	I say so to remind you that while our masters are fighting
در نتیجه کار به جایی رسیدکه آن زن را به داخل اطاق خود کشاند.	she ended taking him to her room.
به هر نقطه و هر جا حیران و نگران بود.	everywhere she could direct her gaze
در حالی که مهیای یاری به خاطر هایده نماید تا شاید به خاطر بیاورد	quite ready to aid the memory of the narrator
گذاشت بازوی نرم دور تا در وضعی ناراحت به بازوی سختش بچسبد.	allowed her pliant arm to cling with difficulty against his rigid arm.
انتظار چنین جنونی از ما داشتن مثل این است که از نارون گلابی بخواهید.	to ask this of us is like asking pears of the elm tree.
با وجدان و در عین حال انعطاف ناپذیر چه تنبیه سنگینی برای مقابله با کسی که او را رنجانده در نظر گرفته است.	a conscientious yet implacable man can inflict on one who has offended him.
هم تأیید کرده بود که به بهترین وجهی دستور مرا انجام خواهد داد.	saying the work would be put in hand right away
با من چندان خصومت شدید دارد که این دیوان را به صورت آسیاهای بادی درآورده است	has turned these giants into mills in order to rob me of the glory of vanquishing them
وقتی بالاخره بالا آمد صورتش سرخ و برافزوخته بود.	emerged with her face glowing like the setting sun.
مراسم خدمت گزاری را به جای آورد و به تزار کمک کرد تا پیاده از نهر بگذرد.	offered his services, and assisted him to cross the ditch on foot.
با وجود این خود در اثر مرور ایام رنگ و رو رفته بود.	but still discolored by age.
ولی من جوانمردی نموده و از و شفاعت کرده بودم.	if I had not been so generous as to intercede.
هنوز بی حرکت روی تخت آخری دراز کشیده بود.	was still lying motionless in the end bed.
با چنان حدتی به پارو زدن پرداختیم که به هنگام غروب نسبتاً به ساحل نزدیک شده بودیم	set ourselves to row with such energy that by sunset we were so near that we might easily
با نشان افتخار گرد و غبار و گل رطوبت ماشین بخار یا خاک خوشبوی جنگل و مزرعه سر و رویش را نیاراید.	as to get often honorably decorated with marks of dust and mortar, the damp of the engine, or the sweet soil of the woods and fields.
با چهار یا پنج میل فاصله از یکدیگر به طور موازی حرکت کنند	by sailing over the sea some four or five miles apart, on parallel lines
مثل بقیه برای بدست آوردن کار شروع به مبارزه کردم	i like everyone else I was fighting for a job
دست کوچک و مرطوبی را که به طرفش دراز شده بود فشرد.	shook the damp little hand which was offered him
من مایل نیستم علیه تمام این اشخاص دست بکاری بزنم	I'll not turn upon them
دختر قد بلندی و متینی از زیبائی درخشانی برخوردار نبود	girl of dark and by no means ravishing features talking to a broad
به سفری دور و دراز بی آن که چیزی بگوید.	on journey long without a word.
دوست ندارم منو در هم چین وضعی قرار بدی.	I don't want you to put me in that position.
هیچ وقت احساسات یک مادر به فرزندش را نداشته بود.	never having known for herself the passion of a mother for her child.
صبح روز بعد وقتی کاترین را از جریان با خبر کردم خیلی ناراحت و اندوهگین شد.	so I informed her in the morning, to her great disappointment.
اما از بابت خودم کام لا رضایت خاطر دارم.	but I am satisfied on my own account.
دهانم را به عقب بردم و تفی بر زمین انداختم و گفتم که کارد خیلی بدطعم است و به هیچ قیمتی حاضر نخواهم شد آن را ببلعم.	I spat out, and affirmed it tasted detestably I would not take it on any account.
اما فرناندا آن را در ساعت خواب بعدازظهری بست	were closed during siesta time
حس کنجکاوی و آشتیاق وادارم کرد بدان جا نگاه کنم و گوش فرادارم.	being moved there to by a mingled sense of curiosity and envy, that grew as I lingered.
که اعماق مواج با مکیدن او وی را ده هزار ذرع پایین کشیدند	where the eddying depths sucked him ten thousand fathoms down
زبونم گیر کرد و نمی تونستم چیزی به گم.	I faltered to a stop, unable to speak.
بیش از چند روز و شاید هم چند ساعت از عمرش باقی مانده است.	that not only his days, but his hours were numbered.
دست کم تیرهای زهرآگینی بر دست و روی من افکنند تا هر چه زودتر از شر من خلاص شوند.	at least to shoot me in the face and hands with poisoned arrows, which would soon despatch me.
به همسر کوچک اندامش در پیاده شدن کمک کرد و در پی او به راه افتاد.	helped his little wife to alight, and let her pass into the house before him.
آنگاه به خواب سنگینی که بیشتر به بیهوشی شباهت داشت فرو رفت	he fell at last into a heavy, swoon like sleep
بر اثر یکی از تصادفاتی که حتماً دست شیطان در آن دخالت داشته شما	by one of those chances which the devil throws in the way of his friends sometimes
ولی ما حتی برای شش هزار نفر هم تخت روان و تختخواب و پرستار و طبیب نداریم.	we haven't stretchers, or bunks, or dressers, or doctors enough for six thousand.
این جادو مشهور همچنین موفق به کشف دوازده کاربرد جدید خون اژدها شده و	for the discovery of the twelve uses of dragon's blood
جمعیتی که جلوی در کتاب فروشی ازدحام کرده بودند	a large crowd jostling outside the doors
چشمانش مثل کودکی بود که ترسیده و درد جانکاهی به دل دارد.	the eyes of a child in pain, a child in fear.
زیرا تا آن لحظه با هیچ مردی برخورد نکرده بود که تا این حد رسوخ ناپذیر باشد.	for she had never before met anyone who was so completely impregnable.
در آن لحظه هر کدام با افکار خود مشغول بودیم	for the moment each occupied with his own thoughts
ولی چون همین چند دقیقه پیش دستم بود مطمئن بودم روی میز است.	but I had it in my hand so very lately that I was almost sure it must be on the table.
که چنین کامل وضع یک فقیر را داشت به نظرش دشوار بود.	who had so completely the air of a poorwretch seemed difficult to her.
من نصف سهام کارگاه رو به اون پیشنهاد کردم و اون	I offered him a halfinterest and he
او به تنهائی هم رهبر و هم ارکستر بود.	he would be both conductor and orchestra
من که به تو گفتم برایت یک پیشنهاد تازه دارم	I told you I have a proposition for you.
پسر احساس کرد که زیر آن نعشی قرار دارد.	the boy felt that it was a corpse.
یک کلمه هم نگفت که میل دارد باز مرا ببیند.	said not a word of wishing to see me again,
اما نه یک روز زودتر و نه یک روز دیرتر!	but neither sooner nor later.
بی آن که بتواند حتی یک قدم او را رهبری کند.	without being able to lead him a step out of his path
به قسمی که چهار هزار دوکا وجه نقد نیز برای او باقی ماند.	so that there was left for my father four thousand ducats in money
اگر تمامی زیبایی زنان را بپوشانند مبادا ملوانی از بادبان به زیر افتد.	when all a woman's beauty has to be kept covered lest a sailor may fall from a mast head.
یقین پیدا کرد غیر از او در آن حوالی کسی نیست	that he was again alone
در آن موقع باید جای دیگری برای کارم پیدا کنم.	but I must seek another situation somewhere.
از آن گونه صداها که از عالم خاک نیستند	voices whichare not of the earth
مطمئن باشید هرچه از دستم برآید انجام خواهد داد مطمئن باشید.	I shall indeed.
شاید تصادفی بود که دو روز پشت سرهم نزدیک او نشسته بود.	perhaps it was coincidence that she had sat so close to him two days running.
هرچند ذهنش هنوز از ترس و تشویش متلاطم بود.	though still inwardlytroubled by his great dread.
دستم را دراز کردم تا آن را بردارم. دیدم کتابی آنجا هست.یک نگاه به جلد آن به من فهماند که دیوان شعر است.	I found them, and my fingers closed upon a book as well, whose slim covers told of poetry.
این بود که در خیال روی عرشه ایستاده بود	so he had to imagine himself standing on his own hurricane deck
موهای مشکی بلندی که دور صورت قرمز کوچکش را فرا گرفته بود.	black hair curling around her little red face.
من اونجایه قفس کوچک برای حضور درقداس و مراسم مذهبی دارم.	I have a little cage there, where I hear the mass and the offices.
فریادهای استمداد او بلند شد و در خانه متروک پیچید.	uttering shrieks for help, which made the bare old house echo to the roof.
وقتی چشم او به خمیر سفیدی افتاد که در ته کلاه خود له شده بود	seeing all that white mash inside his helmet
این رو هم ازش پرسیدم که من باید انتظار چه چیزی رو داشته باشم.	I also asked him what I should expect.
جیکوب ادامه داد ما فقط باید اینجا بمو نیم.	we've got to stay here, he went on.
از قدرت خود علیه شوهر بی گناه من استفاده نکنید.	not to exercise any power that you possess, against my innocent husband, but to use it in his behalf.
پس از راه رفتن در گل و لای مرداب اطراف اردوگاه خود	after wading in the marshes round their camp.
گرچه در عکس سیاه و سفید سرخی موهایشان قابل تشخیص نبود.	though the black and white picture didn't show it
وقتی در کنار او نم با سرپا نگه داشتن خودم مشکل که دارم.	I do have some trouble with incoherency when I'm around him.
صندلی خود را کاملاً به نزدیکی صندلی ایشان برساند	brought his chair, in time, close to that in which the matron was seated.
در نتیجه عاری از کینه و عداوتی بودند که او در پشت سرش از خود باقی گذاشته بود.	they were almost freed from the rancor that he had left behind.
بلکه از بچه خرگوش شیرخواره هم کمتر و حقیرترند.	it's a sucking leveret.
با سرعت تمام شروع به دور زدن و چرخش کرد.	he skated about describing inner and outer circles.
به کاوش پرداخت و پس از یک ساعت جستجو اتاق خوبی پیدا کرد.	after little more than an hour's search found one place which pleased her.
من اکنون از دیدن این جوان از ته دل خوشحالم	which in my heart I rejoice at
4 و نیز همسرش در حالی که هیزم کش دوزخ است	4 and his wife, the carrier of the firewood
ما را که زن و دختر ولی نعمت خودش بودیم به هزار کیسه تقریبا چهار صد هزار فرانک فروخته.	, whom he sold for the sum of four hundred thousand francs
اما این پیروزی آسان و چشمگیر بر رقبا واقعا در خور تفاخر بود.	but it was something to triumph thus easily and handsomely over these others.
بروید اعلیحضرتا نه از آن جهت که جان شما در معرض خطر است زیرا که خضم شما به قدری قدرت و قوت دارد که محتاج به تلف کردن شما نیست	go sire not that you incur any risk for your adversary is powerful enough to show you mercy
پس از معاینه ناتاشا نسخه همان گردهایی را که دو هفته پیش برای او تجویز کرده بود تجدید نمود	that day ordered her to continue the powders he had prescribed a fortnight previously.
باید زرنگی کند و بجنبد تا این کار ناهنجار را از دست ندهد.	he would have to stir himself even to keep the wretched post he had.
چه اگر به کسی اجازه دهند که خود درباره خود سخن گوید این کار خلاف تمام مقررات قانونست.	it being against all rules of law that any man should be allowed to speak for himself.
زمانی که او را برای خداحافظی در آغوش کشیدم قول دادم	I promised as I hugged her goodbye.
آنچه بر سرم آمد حکم دوری و محرومیت از آنچه دوست داشتم و بدان دل بسته بودم داشت.	an exile, and outcast, thenceforth, from what had been my world.
ابرهای پر باران کبود گویی به زمین نزدیک شده بودند	the heavy, slate coloured clouds hung low over the landscape
نباید می ذاشتم از همه چی سر در بیاره.	I shouldn't have let him get to me like that.
اینک او مجبور بود به داروخانه برود و شربت بخرد	now she was obliged to go to the drugstore and buy extracts
چون این آخرین یخ زمستانی است که ما داریم.	for this is the last ice we shall have.
اگر شکست بخورم مهم نیست . چون خودم کردم .	or went down through my own fault.
نیم ساعت تمام از یافتن موضوعی برای صحبت درم یمانند.	it takes them half an hour before they can find a subject for conversation
من هرگز واقعاً قصد نداشتم از دستش خلاص شم.	I was never going to get rid of her.
باز هم به علت فقر مفرطش محال است بتواند در دنیای آنان جائی برای خود باز کند.	also, that because of his poverty it would be impossible to fit him into
حالم خیلی خوب بود تا همین امروز صبح کاملاً سرحال و بانشاط بودم	I was very well yesterday nothing at all the matter with me till this morning
بر حسب اتفاق پایم بپو ست نان گرفت و با چهره به زمین نقش بستم اما آسیبی نیافتم.	I happened to stumble against a crust, and fell flat on my face, but received no hurt.
شکل و ظاهر ساختمان برایش آشنا و خودمانی بود.	the shape and aspect of the building seemed familiar to him.
چون دیگر برای روبرو شدن با آن آمادگی ندارم.	because I wont have anything put aside to meet it.
با آن شانه های گرد سر همیشه فرو افتاده دهانی که انگار همه چیز و همه کس را به ریشخند میگرفت و آن نگاه های زیر چشمی و تلخ و بسیار مرموز و غیرعادی	who, with his twisted shoulders, drooping head, sardonic mouth, and side long bitter glance, was mysterious and uncanny.
زیرا او بیش از پیش احتیاج بیک پرستار دائمی داشت.	who needed to be watched more and more every day.
ولی چون با همه جوانب کار آشنا نیستی بهتر است چنین قضاوتی درباره من نکنی.	but you don't know all, so don't judge.
یک مجسمه عظیم از یک انسان دریایی بود که آن را از سنگ تراشیده بودند	a gigantic merperson hewn from a boulder.
اگه در رویای من باشی منهم در رویای تو خواهم بود.	I'll be in your dream if you'll be in mine?
پس از آنکه هرچه دلشان خواسته بود برداشته بودند	when they had got all they had a mind for
متأسفانه باید بگویم که شما در حال حاضر باید درمحل استراحتتان باقی بمانید.	I am afraid for the time being you will have to remain confined to your quarters.
حروف آنقدر بزرگ بود که از آن سر اتاق خوانا بود.	in letters almost big enough to be legible across the room.
چون من و او مسلما تنها دو نفری هستیم که در قلمرو خود بیش از دیگران کار داریم.	for he and I are certainly the busiest people in the parish.
من چیز زیادی نمی تونم به شما یاد بدم.	there is very little I will be able to teach you
اصلاً این کار ربطی به قد و هیکل آدم ندارد.	that it didnt depend on a mans size.
کار خود را از سر گرفتم و موفق شدم آن را به پایان برسانم.	I resumed my task, and succeeded in completing it.
آه! چه تصوراتی! با این همه شما مرا راهنمائی خواهید کرد.	I wonder why I always thought so but at all events you'll help me, won't you?
می تونستم به خاطر اون از اون گنج لعنتی دل بکنم.	I could have torn myself away from that accursed treasure for her.
همیشه عادت دارم این طرف و آن طرف بروم و همه جا را ببینم.	it was my way to go about everywhere and take in everything.
آنگاه به عزم گردش به گلخانه گرم قصر رتفند.	they went to walk in the hot houses
مادر روت یک روز به او هشدار داد مایلم به دختر کوچولویم توصیه کنم مواظب خودش باشد	I should recommend my little girl to be careful, her mother warned her one day.
حتی مردد ماند که برگردد یا به راه خود ادامه دهد	he half resolved to turn back.
دختری با موهای بلند فرفری از ورودی بیرون آمد.	a girl with long, curly hair emerged from the entrance.
گره درشتی را که در یک گوشه آن بود باز کرد	untying a large knot in one corner
در عین حال احساس زشت خوشایندی هم به او دست داد.	but also a mean sort of pleasure.
من به عقلم نرسید تا به شما به گم که وردارینش.	I did not think to tell you to pick it up.
تصمیم گرفته بود بهترین اتومبیل آقای کی مبارک را بردارد و با آن به گردش برود.	had decided to take the very finest of them and ride in it.
اکنون در حال انجام تحقیقاتی هستند تا بتوان او را از ثروت هنگفتش مطلع نمود.	inquiries are being instituted with a view to informing him of his good fortune.
چند جای آن را با مته سوراخ کرده بودند تا هوا به من برسد.	a few gimlet holes to let in air.
جای پای تنها فکر بی خواب و همواره در راه او.	the foot prints of his one unsleeping, ever pacing thought.
با رعایت بهترین روشی که ممکنست منافع خصوصی آنان را تأمین کند بر اعتبار افکار عمومی بیفزایند یا از آن بکاهند.	raise, or sink the opinion of public credit, as either shall best answer their private advantage.
ولی زن خود را جلو انداخت و گفت که در جریان تمام وقایع بوده است.	but his wife anticipated the reply, by intimating that she was perfectly acquainted with it.
هرمیون قوطی کبریت را از او گرفت و طرز استفاده از آن را نشان داد.	taking the box from him, and showing him how to do it properly.
آن هم در حالی که نیمی دیگر از این معدنچی ها در صفهای طولانی در مسیرهای پیچ در پیچ منتهی به انتهای تنگه رو به عمق زمین در حرکت بودند	while the other half would move off in long files down the zigzag paths leading to the bottom of the gorge.
تا آن لحظ نتوانسته بودم در این خصوص تصمیم بگیرم	I hadn't been able till that moment to bring myself to it.
مرا نسبت به او از نوعی ابهام نامشخص احساس درد انباشته بود.	filled me with a certain wild vagueness of painfulness concerning him.
اما هیچ راهی برای خاموش کردن کامل آن وجود نداشت.	but there was no way of shutting it off completely.
با هر نوع زندگی که در مسیری تداوم داشت تا به هدفی درست بینجامد بیگانه بودند.	or with lives passed in travelling by any straight road to any true earthly end, were no less abundant.
سپس چند کلمه بر سبیل عذرخواهی به گفته افزود	then he added a few apologies.
از سوی دیگر با نوشیدن شراب پرت و شربت گنه گنه فراوان هم هیچ نظر خوشی نداشت.	on the other hand, of incessant port wine and bark.
تلفظ این مرد تو دماغی بود و با صدای زننده و خشکی که ماریوس منتظر بود بشنود کام لا فرق داشت.	the pronunciation was nasal and absolutely unlike the dry, shrill tone which he had expected.
او غرش اضطراب آمیزی کرد و با دست مغشول وارسی من شد.	giving a sudden grunt of astonishment he began feeling me.
در کوچه و صحرا راه بروم و نترسم از ین که مانند قورباغه و توله سگ مرا لگد کنند.	walk about the streets and fields without being afraid of being trod to death like a frog or a young puppy.
پس از دفن جنازه ساختگی در قبرستان نزد او آورد.	after the counterfeit interment in the cemetery.
که حالا جو فرصتی طلایی برای صدمه زدن به او در اختیار داشت.	that if the boy still didn't like him, this was the best chance he could have to show it.
ولی از نظر اسلحه مابین ایشان تساوی برقرار نبود	but he found himself ill matched as to arms
خسته و خواب آلود بودند و دلهاشان همچون روز رو به زوال گرفته بود.	they were tired and sleepy, and their hearts were as gloomy as the dying day.
کام لا سفی و تازه بود و با تاریکی غبارآلود و کهنه اصطبل کاملا تناقض داشت.	startlingly white and fresh and in direct contrast to all the rest of the barn's old dusty darkness.
ولی موفق نشده بود مقامات مربوطه را برای به رسمیت شناختن سبکش قانع کند.	but she could not obtain official approval for them.
چون باید مناطقی از زمین به عنوان شکارگاه تخیلات شاعرانه حفظ شود.	that there should be some unknown regions preserved as hunting grounds for the poetic imagination.
دویست نفر مرد از بالا و رودخانه رو به غار راه افتاده بودند.	two hundred men were pouring down highroad and river toward the cave.
با هم فرمان را به او ابلاغ کردند و دستور دادند که چگونه باید برود و به کجا باید عزیمت کند.	orders as to how to proceed, reprimanding and reproaching him.
تو برای محافظت با او نرفتی و او غرق شد.	you didnt go with him to protect him and he drowned.
برای آنکه وجود تو برای من از هر حیث ضرورت دارد.	because I need you
در اتاق قدم زدم و قوطی به دست ژست گرفتم.	I start to stride around the room, gesturing with the can.
که دیدن آن برای موجودات ضعیف اندکی هم قابل تحمل نبود.	which it was hardly sufferable for feeble souls to see.
برمبنای سوگند رؤسای دهات در مورد تعداد جمعیت دهاتشان قرار داشت.	was based on affidavits from each village chief as to the population of his village.
دلیل اینکه خواستم با من بیای این بود که هم صحبتم باشی	I really only asked you along for the company.
پس از این که از پشت شیشه به اطاقی که در عقب مغازه قرار داشت نگاه کرد اندکی متعجب شد.	beholding a light shining through the glass window of the little parlour at the back of the shop
آب آن را خالی کردند و از شامپاین پر کردند.	drained the pool, and filled it with champagne.
ولی حاضر نشده بود درباره این نکته صحبت کند که در دادگاه استیناف چه کس وکالتش را بر عهده خواهد گرفت.	although by whomsuch an appeal was to be conducted he was not now prepared todiscuss.
به نظرم برای اولین مرتبه حس کردم که چقدر احساسم نسبت به تو قویه	I think I realized for the first time quite how deeply I feel about you.
حتی یک نفر در این دنیا غیر از من از آنجا خبر نداشت.	not a soul in the world knew about them except me.
به شما گفتم که توی انبار زیر شیروانی بود.	I tell you he was in the loft.
ولی اگر بیست لیره و یک پنی خرج کند بدبخت است.	but that if he spent twenty pounds one he would be miserable.
باید تا موقع یکه به سن قانونی نرسیده این جریان را عقب بیندازد.	he should insist on its being put off till she is of age.
زمانی که یکی از این قطرات بروی گلی که بر آن خم شده بود افتاد	when one fell upon the flower over which she bent
روی آسفالت چسبناک افتاد و چیزی نماند که له شود.	slipped and fell on the slippery asphalt, and was all but run over.
ولی براستی گذشته را باید از آن گذشتگان دانست.	but as it is, let the dead bury their dead.
آقا من به هیچ روی قصد توهین به شما را ندارم.	with no intention to take offence
یکی وقتی که نفرت درونی ولد مورت ناگهان شدید به شه.	when he is feeling a particularly strong surge of hatred.
چون اگر اشتباه نکنم او فعلاً در چنان وضع روحی مساعدی نیست که بگذارد توقیفش کنند.	nor will he, it is my opinion, let himself be taken away.
کاری که در حقیقت شایسته حمالان است نه پهلوانان.	an enterprise that might more fitly be entrusted to porters than to knights.
لیکن پیش از رسیدن به شهر سارا گوس چندان حوادث گوناگون و ماجراهای تازه و ناگهانی بر سرشان آمد	but before they got there things happened to them, so many, so important, and so strange
چگونه شما توانستید در دلش افزود با این حماقتتان	how was it that you idiot that you are , he added to himself
در این لحظه حرکتی کرد انگار بخواهد تمام کاغذهای پیش رو را پاره کند	here he made as if he were tearing a whole budget of papers across
ناگزیر بود بپذیرد چهره مرد روستایی خشن و کندذهنی را دارد.	must submit to have the facial angle of a bumpkin.
هنوز هم دخترهای بسیاری مثل اودردنیاوجود داشت بعد از آن بیماری هولناک تصورچنین چیزی کمی مشکل بود.	thinking there were a lot of chicks like her in the world even now, after the superflu, he was willing to bet there were a lot around.
معلوم است که راهی نداشت جز آن که بگوید متوجه چیزی نشده.	I tell you, she was fit to be tied that she hadnt noticed anything.
یک سکه بیست کپکی. من نه سال داشتم و پس از سه روز پول را پس دادم.	I stole twenty copecks from my mother when I was nine years old, and gave it back three days after.
سعی کردند طوطی را به هر قیمتی شده بخرند.	would have bought him at any price.
بت صور من رسید که آن را با صمغ لاک و تربانتین بسازم.	I invented a way of making it with gum shellac and turpentine.
من مایل نیستم بیشتر از آنچه مطلقاً ضرورت دارد برآوردن این خواسته او را به تعویق بیندازم.	I would not defer attending to her desire longer than is absolutely necessary.
اما هنوز از پایین یعنی از کنار پل دشمن مرئی نبود.	but was not yet visible from the bridge
چقدر دوست دارم شما را همیشه به همین حال کودکی و شجاعت و خوبی بیابم!	I am so pleased that you are such a child, such a dear good child.
من کاملاً به خلاف میل باطنی خود شما را از چنگال مرگ و تختة تابوت نجات دادم	I have just, very much against my own will, dragged you headforemost out of the grave.
چون هم از پدر و مادرش خیلی میترسه هم از حرف مردم.	so fearful was she of her parents and people.
ای کاش این تشک را از بوته و گیاه انباشته بودند.	would it were stuffed with brushwood!
که در آن پلکانی میان دو دیوار فشرده شده بود	on which opened a staircase shut inbetween two walls
بنابراین در را باز کردم و داخل اطاق مجاور شدم.	I did so, and entered the next room.
به طرف پنجره رفت و آن را کشود و اجازه داد نور شعیف غروب به درون آید.	going to the window, she raised the sash, unlatched the shutters and let the last light of the wintry sunset into the room.
همچنین ممکنست که جوانان کج خلق را مهار کند	curb the petulancy of the young
لذا مجبور شدند با عجله وی را دفن کنند.	they had to bury him hastily.
اولیور خود را در میان اطاق کوچک و پر از کتابی دید	he found himself in a little back room, quite full of books
در فاصله یک سنگ انداختن تا آن پشته و کلیسا.	within a stone's throw of the said knoll and church.
زیرا که در همه جایش اسکناس دوخته شده بود.	being all wadded with bank bills.
در حالی که او به میل خود آن راز را به ما گفته است.	when he, of his own free will, had told us the secret.
که از طرف دیگر فرستاده جدیدی از میدان پیکار به تاخت رسید.	a messenger from another part of the battlefield galloped up.
بعد از آن یکی دو دقیقه کنار پنجره ایستاد و در ظلمت شب به طرف دریا نگاه کرد.	went and stood by the window.
در شکوه و زیبایی و جادوی همدیگر گم شده بودند.	lost in the wondrous glory and magic of each other.
پس هیچ دلیلی ندارد که به من کمتر از دیگران توجه بشود.	I don't see why I shouldn't get as much attention as anybody else.
با این حال در هیچ نقطه لگدمال نشده بود و این وضع فقط در نقاطی وجود داشت که خودشان گذشته بودند.	but it was trodden down nowhere, save where their own feet had crushed it.
او بیش از پیش خندید و داخل خانه شد.	laughing more than ever, into the house.
صندلیش را از سطح شیب دار کوچکی که به راش ساخته بودم بالا و به اتاق نشیمن بردم.	I rolled his chair up the little ramp I'd made for him and into the living room.
آن روز مرا به دوازده دسته از مردم نشان دادند.	I was that day shown to twelve sets of company.
اما برای من اهمیت بسیار عمیقی دارد من مرد خوشبختی هستم.	but to me it has the most intense significance.
چنانچه این پیک بتواند فرمانده کل را ملاقات کند این عمل بسیار دشوار بود	found the commander in chief which would be very difficult
خاله من قصد دارد شما را نیز همراه بیاورد	my aunt intends that you shall accompany us.
چون تقریباً دو ثلث از مقدار شب گذشته بود همه مصمم شدند که بروند و اندک مدتی را که تا رسیدن روز باقی بود استراحت کنند.	as now almost two thirds of the night were past, they resolved to retire to rest for the remainder of it.
که پس از شروع حمله تدریجا دستورهایی متناسب با عملیات دشمن صادر خواهد شد	that, after the fight has commenced in this manner, orders will be given in accordance with the enemy's movements
اما کاترین اشتها نداشت و نتوانست بیش از چند لقمه بخورد.	but she had no appetite, and could not swallow many mouthfuls.
که اسبها را برای مسابقه ی پرش از روی مانع به آنجا میآوردند.	where the horses were being led for the great steeplechase.
هر کاری که برای آدمی در موقعیت مادرم لازم بود انجام شد.	or which her situation in life could command.
مخصوصا بعد از این رابطه قشنگی که با هم داشتیم	especially after all that had been between them
استدعا کرد برای خاطر دختر جوان هم شده آرام بگیرد	to beg, earnestly, that, for the sake of the dear young lady herself, she would be more calm
دیدم هر دو هنوز خواب خوابند و آب از آب تکان نخورده.	I looked through the crack, and everything was all right.
اما آنان که زنده ماندند و از آب بیرون آمدند مردان قوی و نیرومندی بودند.	but the survivors emerged from the waters stronger and more virile.
که من تاکنون نظیرش را در حرفه خودم ندیده بودم	it has ever been my professional mis fortune to encounter
با مناظری روبرو شد که یکسره سایر اشتغالات ذهنی او را نابود کرد.	there was enough to occupy his mind, and to drive all considerations of self completely from his memory.
به اضافه یک کلاه پشمی که مناسب مناطق سردسیر روسیه بود	a hat worthy of the steppes
در سال 1812 من ده یا دوازده سال داشتم	I was ten or eleven in the year 1812.
او به خوابی فرو رفت که مال مردم خسته و با وجدان آسوده است.	he slept the sleep of the conscience free and the weary.
این کار به دست نرم و لطیف احتیاج دارد.	it wants soft hands.
تمام پول هاسم را برای این سفر جمع کرده بودم.	I saved up all my money for this trip.
اما آن زنی که دستمال مرا در مقابل نان نپذیرفت البته در صورتی که	as to the woman who would not take my handkerchief in exchange for her bread, why,
استارباک هر قدر هم که شجاع بود شجاعت او بیشتر از آن گونه بود	brave as he might be, it was that sort of bravery chiefly
زیرا او و مدیر کارخانه تازه دو سه سال بود که به آنجا آمده بودند.	for both the forelady and the superintendent were new people, having only been there two or three years themselves.
چرا او به چنین کار پستی تن در داد!	what made him risk such a contemptible action.
دیگر در مورد اینکه آن را کشته باشم چندان خوش بین نیستم.	no longer positive that I killed it.
به مهمانان نگریست و با لبخند مهرآمیزی مؤدبانه به ایشان تعظیم کرد.	she looked at the visitors and, with a pleasant smile, bowed respectfully.
که تو چه حقیقتی رو ازش پنهان کردی و چی شد که وقتی زندگی سخت شد فرار کردی و او را پشت سرت تنها گذاشتی و مثل یک هدیه به من سپردی.	how you kept the truth from him and ran away when the going got tough, leaving him behind for me as an offering.
که در وسط آن دریچه بزرگ مربع شکلی بود که به تنها انبار کالای کشتی میرسیدکه در وسط آن قرار داشت.	in the center of which was the large square hatch to the only cargo hold set amidships.
با شتاب به آن سمت دویدم و مدخل پله تنگ و بسیار کثیف و تاریکی را تشخیص دادم	I crossed to that corner and found a dirty dark staircase.
مرد قد کوتاه جلو رفت آن گاه شروع به برگرداندن مبل کرد.	the small man walked forward and began to turn the chair.
بعد یک مرتبه صدای دور شدن اتومبیلی به گوشم رسید.	I heard the sound of a car starting up in the drive.
تا اینکه پس از گردشی طولانی در هوای آزاد و تسکین دهنده شامگاهی و در میان اشک باری فراوانی آرام شد	until, after a long ramble in the quiet evening air, a burst of tears came to his relief
چاه زنخدانش را نشان دهد تا حواسش را پرت کند.	show her dimple to divert him.
مطمئنم از اون موقع تا حالا صنعت این کار خیلی پیشرفت کرده	I'm sure there've been amazing technological advances in the industry
کمتر کسی اگو رو واسه این قبیل کارا مورد استفاده قرار می ده.	ery few people make use of the sewers for their affairs, while the river belongs to everybody.
لیکن چون مهتری نیکو و مهربان و خدمت گاری صدیق و با وفا بود	but in the end, like a good squire and good servant
نقطه اتکای هر آنچه در استان برای ادامه حیاتش نیازمند نظم و ثبات بود.	a rallying point for everything in the province that needed order and stability to live.
با خشم و غضب شروع کرد به کوبیدن سرش به پنجره	started banging his head furiously on the window
آنقدر آهسته شد که نتوانستم سخنان آخرین او را بشنوم.	so low that it was like a whisper.
این کلمه را هرگز پیش از آن به وی نگفته بود	a word he had never used to her before.
که او اشتباه کرد و تأدیب سختی خواهید دید.	if he thinks so, he deceives himself
لازم نیست نگران شوید که وقت تلفن کردن به مردم دیر شده است.	no need to worry, it s too late to start phoning people.
قصدم از ین کار آن بود که تا شب همچنان بدان حال بمانم.	my design was to continue so till night.
غرشی ار از داخل ان جا شنید و به درون رفت.	he heard a roar from inside and entered.
دفترهای یادداشت پر ورقش را پر کرده بود و	he had assembled his voluminous notes
اما در فضای کوچک پشت آن تیغه سه افسر	but found it completely filled by three officers
در همان نقطه که در آب فرو رفته بود بار دیگر آهسته بالا آمد.	in the same spot where it sank, once more it slowly rose.
او را میبینم و فوراً قصدم را درباره ی خواهرش به او میگویم و توضیح میدهم که چرا نمیتوانم در خانه اش شام بخورم.	I will inform him at once of my position in regard to his sister, and explain why it is I can't dine with him.
ولی سم خودش را به در رساند تا از کامل بسته شدن آن جلو گیری کند .	but he reached far across the seat to keep the door from shutting all the way.
کلید و شمعدان را برداشت و شمع را با شمع دیگری که روشن بود افروخت.	seized the key and the candlestick, and lighted the taper at the candle which was burning there.
شاید کمی سکوت و تأمل کافی باشد تا آقای وودهاس برگردد سراغ همان جو و شیر سالم خودش.	that a silent rumination might suffice to restore him to the relish of his own smooth gruel.
تا زمانی که همه چیز از بین رود و تنها باد آه کشان آنان را به یاد بیاورد.	until it all was gone and only the air remembered, sighing.
ولی بلافاصله پس از آن حاضر بود تن به هر پستی بدهد تا آن پول را باز به دست آورد زیرا در خانه حساب چندین ماه را به قصاب بدهکار بودند.	then immediately he would have done anything to get it back, for at home there was a month's old account with the butcher to pay.
یا هرگز او را به این شدت عصبانی ندیده بود.	he had never seen her this angry before.
اما در مورد بقیه داستان تا حد امکان عین واقعه را نقل کردم.	but for the rest I was as accurate as I could be.
چندین سال بود که مرا تنها گذاشته و به یک کشور دور دست رفته بودید.	you were departing for many years and for a distant country.
بگذار او بداند که من هم این عمل را انجام خواهم داد.	let him know that I will do so!
تا همان وقت راجع به یکی از آن دو مرد بیش از حد اطلاع دارد	he already knew too much about one of those men
تا روزی که بالاخره کسی را پیدا کرده بودم که زیباییش مرا گرفته بود در حالی که رز الی این احساس را در من به وجود نیاورده بود.	until the day that I finally found someone whose beauty touched me the way hers had not.
شاید این هم درست باشد که در کنار او باید زنی قرار گیرد.	I think you are right that he needs a woman's care,
بیچاره آن قدر زنده نبود که برادرشو به بینه.	he couldn't a lived to see his brothers, poor soul.
اگر باید راستش را گفت هیچ کس نامه را برای من رونویس نکرد چون من اصلاً آن را با خود نبرده بودم.	if the truth is to be told, nobody copied out the letter for me, for I carried no letter at all.
او که آتش خشمش زبانه کشیده بود نیزه را فرود آورد و بی آنکه بیشتر درنگ کند بر سر یکی از سواران سیاه پوش تاخت	who now moved to anger, without any more ado, laying his lance in rest charged one of the men in mourning
شرح داد که چگونه از سن دوازده تا پانزده سالگی	where from his twelfth to his fifteenth year
تقاضا کرد به او مهلتی داده شود تا فکر کند.	she asked for some time to think it over.
صفت صداقت خالصی که برایش قائل بودم از بین رفته بود.	the attribute of stainless truth was gone from his idea
طرح اول او این بود که به جای بذر کاه در زمین بیفشانند	the first, to sow land with chaff
برای سرزمینی در دوردستهای دور برای آینده ای پر از ماجرا و نبرد تصور ظریف جبران کردن و ظفرمندی و همه و همه چنان وجود او را آکنده بود	for great distances, for a future in which there was an air of adventure, of combat a subtle thought of redress and conquest, had filled her with an intense excitement,
هر چیزی غیر از این گفته شود مغالطه و دروغ خواهد بود.	to say otherwise is sophistical is false.
با تندی و خش نونت همکارهای کارگردانش بسیار متفاوت بود.	was different from the rough and ready good fellowship of directors
من درست بعد از اتمام دبیرستان مأمور قانون شدم	I became an officer of the law right after high school,
به خانه رفت ولی با اهل خانه قهر بود .	went home, haughtily refusing any overtures of peace from her household.
که زنجیرهای مخصوص و سایر ابزارهای لازم از پیش برای بستن وال آماده شده بود.	where fluke chains and other necessaries were already prepared for securing him.
یکی از شروط قرارداد ما این بود که شما به من اجازه بدهید هر چه بخواهم حرف بزنم	one of them was that I was to be let say all I liked
یک حلقه و یک رشته طناب و یک سکه یک روبلی آوردند و بازی مشترکی را آغاز کردند.	a ring, a string, and a silver ruble were fetched and they all played games together.
سرم را به سختی بالای آب نگه داشته بودم و قادر به حرکت نبودم.	I passed a lifetime with my head held barely above water, unable to move
برای آنکه تو را شکنجه دهد همان کافی است که تو خود از آن آگاه باشی.	it will suffice to torture and crush thee that thou knowest it thyself.
البته باید هم باشد چون چهارده سال یا حضرت عباس از من بزرگ تر است.	he ought to be, you know, for he has fourteen years' start of me.
می دونی باید زندگی کنم و کتاب و لباس بخرم.	I must live and buy books and clothes, you know.
ولی زیبایی او از نوع کاملاً به خصوصی بود.	but of another school of beauty
در این مورد کافی نیست که تو رد نکنی	it's not a question of your rejecting her
ولی چیزی که برای او ضرورت کامل داشت پول بود و من نیز در آنجا متأسفانه یک کپک هم در جیب نداشتم.	I longed to give her some money, but I never had a farthing while I was there.
نشان بدهد که با وجود این احوال با شروع مذاکرات موافق است	showing that he was nevertheless willing to negotiate.
آیا دست تاراجگر زمان و قضای آسمان به عمر و ثروت پدر و مکنت برادران من چندان ایفا کرده است	or whether time and death may not have made such changes in the fortunes and lives of my father and brothers
شاید خیالش این بود که این پارچه ممکن است بعدها برای شناختن قاتل و مقتول به کارش آید.	probably thinking that this morsel of stuff might serve, later on, to identify the assassinated man and the assassin.
این بود که در هر نوع ترتیب تازه نباید آنان را مجبور به اجرای هیچ روش جدید و یا استفاده از هیچ گونه ماشینآلات نوین کشاورزی کرد.	whatever that they should not be forced to any new methods of tillage of any kind, nor to use new implements.
من از لطف و زیبایی و هوش و دانایی لوسیند با چنان اشتیاقی با دن فر نان سخن گفتم	I extolled her beauty, her gaiety, her wit, so warmly
طرف خطاب من مردی بود که پشت تختة فروش ایستاده بود	I addressed myself to a man behind the counter
که کم و بیش به عنوان ماده کمکی با چوب سر و کار دارند.	which more or less have to do with wood as an auxiliary material.
از مهمانخانه بیرون آمدم و خودم را به شما رساندم.	I came straight to you from my hotel.
توضیح داد که در لحظه اولی که پائین رفتند	explained, that when he first went downstairs
می خوام بدونی که من او نارو آماده کردم.	I need you to know I recruited them.
بجای آنکه در را بکوبد کوبه را به ملایمت برجای نهاد و راهش را با شتابی بی سابقه پیش گرفت.	instead of allowing the knocker to fall abruptly, he placed it gently, and resumed his way with a sort of haste which had not been apparent previously.
شنل بلندش که یقه آن بسته بود از روی بازوانش به کنار رفته	her long cloak, fastened at the neck, was thrown backward from her arms
من به بیرون از باغ منحرف شدم و به میان درختان رفتم.	I slipped out into the garden and through the woods.
در میان شما حتی یک مرد هم نیست که بتواند کشتی را هدایت بکند.	there's not a man among you fit to sail the ship.
حتی اگر رس ما از من دعوت کنند در اینجا نخواهم ماند.	I don't think I should stay even if they were to invite me.
هر دو دانستند که ان لحظه سپری شده است	both he and she felt that it was over
ولی هی چک دام لوس نبودند. یعنی اونقدری لوس نبودند که قابل اصلاح نباشند.	but none of them at that age are irrevocably spoiled.
من اسکناس را به او دادم و بعد او بقیه پول را نداد.	I gave him the bill and then he wouldn't give me the change.
اضافه بر آن وقتی انسان بدان طرز عجیب ارتقاء یافت برای برتری خود هیچ پایه مناسبی ندارد.	besides, when a man is elevated in that odd fashion, he has no proper foundation for his superior altitude.
هرچند که حالا هم هم چین صاف و مرتب نیست!	not that it needs it
ما تنها ماندیم باز مرا گرفت و دوباره به همان بلوط بست	we were alone, he tied me up again to the same oak
اگر باز هم اتفاق عجیب و غیرعادی پیش او مد فورا به رام بنویس.	I still want to hear about anything unusual.
آنهم بر نژادی از موجودات فانی که از مشاهده تناسب و توافق کامل میان من و یاهوهای خود مستعد قبول بدترین عقاید درباره نوع بشر شده بود.	among a race of mortals who are already too apt to conceive the vilest opinion of humankind, from that entire congruity between me and their _Yahoos_.
آن وقت رکاب کشیدم و خود را در میان صف دشمن دیدم.	I spurred on and found myself in the enemy's ranks.
به قصد پیدا کردن تام و گفتن همین چیزها آن راه را آمده است.	had come to hunt him up for that purpose.
ما باید یاد بگیریم که چگونه دشمنانمان را عفو کنیم.	we should learn to forgive.
خود نیز پهلوانی بوده است مهربان و مو دب و با تربیت.	but very polite and well bred.
من فردا برای ناهار مراجعت خواهم کرد و آن وقت ما به عمل خواهیم پرداخت	I will come back to dinner, and we'll set to work.
نه تنها در این ساعت و در این روز عقل و وجدان این مرد	not for that day and hour alone were the mind and conscience darkened of this man on
در ظرف دیگری یک تکه پنیر پوشیده از کپک سبز و نرم	a slab of cheese covered in furry green mold
واقعاً برایم عجیب است که سرگذشت شما چه نقاط مشترک زیادی با سرنوشت آن بچه دارد	really it strikes me there are parallel points in her history and yours
چون معلوم شده است که او با آنکه دو چشم راست و سالم بجای طبیعی خود دارد	for it is averred that, though his eyes are properly placed and straight,
او این رو گفت تا توجه من رو به خودش جلب کنه	she said to distract me.
نتوانسته است به این نتیجه برسد که گناه مرگ ربرتا به گردن او نیست.	he could notfeel that either primarily or secondarily could he be absolved fromguilt for her death.
اما تا به حال اون رو این جوری پریش ون ندیده بودم.	but I've never seen him so agitated.
ولی چون چشمی وجود داشت بی شک باید نگاهی هم وجود داشته باشد.	but that as long as one has eyes they must look somewhere
خیلی متأسفم که اوضاع خراب شد تو به اینجا آمدی	I wish, that you had picked out some other crib when the two old ones got too warm, my fine feller.
به عقیده او تفکر نبایستی احساس را خفه کند.	in him the thinker did not stifle the man of sentiment
جعبه سیگار را روی میز نامأنوسی پیدا کردم دو سیگار خشک کهنه توی آن بود.	I found the humidor on an unfamiliar table with two stale dry cigarettes inside.
به طرف نرده محراب حرکت کرد و به افسران دیگر اشاره نمود تا از پی او بروند.	he and moved up to the chancel rail, beckoning to the other officers to accompany him.
با کمال خوشوقتی ایشان را با این چیزها آشناتر خواهم کرد.	I shall be most happy to make her better acquainted with them.
ممکن است پنجاه بار او را دیده باشم بدون این که بشناسم.	I may have seen him fifty times, but without having any idea of his name.
ملاحی را دیده بودم که از آن جزیره دیدن کرده بود و برای من گفته بود که رسم آن جزیره همین است	I had seen a sailor who had visited that very island, and he told me that it was the custom
وقتی به آن دست زدم روی لولایش چرخید و باز شد.	it moved on its hinges as I touched it.
من خود این تصور را در دیدگان او خواندم	I noticed that!
لکن اکنون و شاید تنها در این لحظه میل دارمی کسانی که باید درباره اقدام من قضاوت نمایند	but just now and perhaps only at this moment I desire that all those who are to judge of my action
چون کالسکه بیش از نیم ساعت طول داد تا به مقصد برسد.	but he must have done so, because it took the carriage almost half an hour to reach its destination.
اما با این حال تصمیم گرفت با وی گفتگو کند.	but made up his mind to address him nevertheless.
بنام امپراطوری که سرورشان بود مرا به کشور خود خواندند.	invited me to that kingdom in the emperor their master's name.
کتابی را که چند لحظه پیش به کناری انداخته بودم برداشتم.	I picked up the book again
تشریح کننده ایمان و آرمان سیاسی حزب برای تمام جهان.	the worthy expounder of the party's political faith before the world!
همین کافی بود تا تکلیف جریان را معلوم کرده باشد.	she was satisfied at having established it.
در همان حال دستور داد جنگل نشین متخلف را بازداشت کنند و همه تماشاچیانی را که از جا برخاسته بودند از دادگاه بیرون برانند.	he ordered all those notseated driven from the courtroom which was done.
که پیوسته در حال نبرد با خودش است تا از اسارت رهایی پیدا کند.	who fought endlessly to free himself from his servitude
بهتره با کسی حرف نزنم و ده نم بسته بمو نه.	it's best if I keep me mouth shut,
او را به همراه خود به درون خانه بردند	taking him between them, hurried him into the house.
از این مرد مبرز تمنی کردم که از من نزد شاه شفاعت کند تا به من رخصت رفتن دهد	I entreated this illustrious person, to intercede in my behalf with his majesty, for leave to depart
به صندلی تکیه دادم منتظر شدم تا زمان بگذرد.	I leaned back in my chair and waited for the time to pass.
گفت که باید یک راست تا انتهای راهرو رفته	accompanied it with copious directions how he was to walk straight up the passage
اما تو خودت را کوچک مگیر و به کمتر از حکومت ایالت راضی مشو.	but do not undervalue thyself so much as to come to be content with anything less than being governor of a province.
من دلم میخواد هر چیزی رو درس به دونم.	I just like to notice things.
بعد سفارش دادم یک فنجان چای چینی که قبلا نخورده بودم برایم بیاورند.	I did send for a cup of tee a china drink of which I had never drank before.
در وسط تار عنکبوت گنبدی شکل مه آلود عنکبوتی	from the middle of the misty, domed web, a spider
برگ را در سر راه سوسک خم کرد و ساقه دیگری را پیچاند تا جانور از روی آن عبور کند.	 he asked himself, bending aside the leaf of goat weed out of the beetle's way and twisting another blade of grass above for the beetle to cross over onto it.
حالا با احتساب این بلیت چهار دلار و نودو پنج سنت دارم	I've now got four dollars and ninety five cents, including the ticket.
او نیز مانند دیگران لباس سبزی پوشیده بود و لبخند شومی بر لب داشت.	wearing green like everyone else, and a very grim smile.
به ویژه اگر پیش از این هم از او نفرت داشتید	especially if he happens to have been an object of dislike beforehand.
چنان مسلط و تیز پرواز بود که انگار جارویش تبدیل به یکی از اعضای بدنش شده بود.	he moved so easily through the air that he looked unsupported and weightless.
اجازه ندادم مرا با خودش این طرف و آن طرف بکشاند.	I didn't let him take me far.
اما همین دیروز یک سرباز فراری را تا سرحد مرگ تازیانه زدند	but yesterday a deserter was knouted to death
با کمال تأسف باید این خبر را به شما بدهم با وجود این که گفتم صد و یازده سال برای گذراندن در بین شما زمان خیلی کمی است	I regret to announce that though, as I said, eleventy one years is far too short a time to spend among you
نوک بینی بلند و تیزش به کف اتاق خورد.	the end of its long, thin nose touched the carpet.
این بود که از آن پس رفتار بهتری در پیش بگیرد	was in the resolution of her own better conduct
دیدی اون مرد توی زندگیش دنبال چه کارهایی رفته بود!	see what that man chose to make of his life!
که تا انتهای شرقی ساختمان ادامه داشتند پشت سرهم ردیف نشسته بودند.	white columns to the eastern end of the building.
تا بر غم قضا و قدر جان خود را نجات بدهیم!	we'll save our necks in spite o' fate and fortune.
منظورم این است که این یک وسوسه یا چیز دیگری نبود.	I mean, it's not an obsession or anything.
در حالی که لنگه همین چوب دستی پیشنونیتو زخم کرده.	why, its brother gave you that scar.
که بعد از مرگ به راش هورا بک شن.	so that after he died, they'd be provided for.
پس از فرود آمدن شب به سمت جنوب شرقی برگشته بود.	had hauled round after nightfall into the south west.
مرد عاقل آن است که امروز خود را برای فردا حفظ کند	it is the part of wise men to preserve themselves to day for to morrow
مثل این بود که گرفتا یک زد و خورد درونی است و در حرف زدن تردید دارد.	s though a prey to some sort of inward conflict.
انگار آن شمش نقره نه یک واقعیت عینی بلکه چیزی بسیار گسترده و نامحسوس بود درست مثل نمود حقیقی یک احساس یا تجلی یک اصل اساسی.	as though it were not a mere fact, but something far reaching and impalpable, like the true expression of an emotion or the emergence of a principle.
او همة آن کارها را به خاطر من انجام داده است.	for whose sake he has done all that he has.
چنین پنداشت که زیستن با آن شرایط محال است	he had made up his mind that life was impossible like that
با ناامیدی غریدم و سپرم با عصبانیتم آشفته شد. تغییر شکل داد و دور ما جمع تر شد.	I hissed with frustration, and the shield roiled with my irritation, shifting its shape and contracting around our side.
ماهی فروش به این تقاضا جوابی جز افزودن بر سرعت نداده بود.	to which the fishmonger had made no reply except by redoubling his gait.
عادت هم نداشت دخترهایش را توی منزل حبس کند.	he was not in the least addicted to locking up his daughters.
یک نفر را لازم داشت که به خانه رسیدگی کند و مراقب من باشد.	had to have someone to run the house and to look after me.
او پیشنهاد کرد که تمام قشون در موضع جدیدی	he urged that at this point the army unexpectedly proposed a perfectly new position away
اما من تا چشمم به آن افتاد و تزگی کاغذ را دیدم	but by the fresh look of the paper
صداها ازا ومیخواستند که تا دیوانه نشده این کاررا انجام دهد.	telling her to give this up before it drove her mad.
زبانم بند اومده بود و به او زل زده بودم	I stare at her, unable to speak.
چیزی که قابل باشد برای پیش کش ندارم جز نصیحت و اندرز.	I have nothing to bestow but advice.
من که همیشه در همه جا مدافع او بودم	I'd always stick up for him.
ولی نه آنقدر که آدم را در خود غرق کند.	but not at all overwhelming
به روی یک صندلی که بربالای تخت بود نشست	seating herself in a chair by the bedside
حال ببینید دکتر که در حق او مشتبه شده بودید.	come and see her
اما اکنون چیز دیگری هم ناگهان قلبش را فشرد.	but another feeling also suddenly stabbed his heart.
چهار سرباز با یک خیز خود را به مسلسل و تفنگهاشان رساندند.	sent the four soldiers diving for the machine gun and their rifles.
غیر از صدای ناقوس ساعت و خش خش عشقه های روی دیوار هیچ صدای دیگری نشنیدم.	there came no other sound save the chiming clock and the rustle of the ivy on the wall.
لیکن کیتریا که دلی به سختی و صلابت مرمر داشت و سردتر و بیعاطفهتر از مجسمه بود	but she, harder than marble and more unmoved than any statue
تا با دریافت 500 لیره بازخرید خدمتی به اضافهٔ یک صد لیره پاداش کشتی را ترک نماید.	to take his GBP500 severance pay, plus a bonus of GBP 100, and left the crew.
از زمانی که برای اولین بار یکدیگر را ملاقات کرده بودند	from the moment they saw each other for the first time
او از حال رفت و روی صورتش آب سرد ریختند.	cold water was thrown in his face.
بی شک او را به سوی انهدام و نابودی سوق خواهد داد	he was advancing to certain destruction
وی در پاسخ گفت خودش نیز سخت در حیرت مانده است	he replied that he could not believe that he had thought himself dying three days or so ago
زیرا من به عمر خود نه دیده و نه شنیده بودم که کسی به این خوبی و به این شباهت تقلید صدای خر کند.	for I never in all my life saw or heard anything more natural.
حتی همین تندی را در کلامش مشاهده کردم و آن را معلول رنگش دانستم.	I fancied it was in his voice too, and referred his growing corpulency to the same cause.
زیرا کم اطلاعی در این قضیه به نفع انسان است	for it's safer not.
دیدن آن موجب حیرت و وحشت او شده است.	that excited wonder and amazement
سپس بار دیگربه صحبت درآمدند و شادی و خرمی را باز یافتند	then they began to talk again, and found their old gaiety.
مهارت و توانایی بین زن و مرد تقریباً مساوی تقسیم شده.	excellence is pretty fairly divided between the sexes.
من این نکته را در کتابچهٔ خود یادداشت خواهم کرد.	I shall make a note of that.
در واقع از نظر قانون جرم شما بیش از آن دو نفر است	indeed are the more guilty of the two
فرمانده هنگ خود را به گروهان سوم رسانیده بود	said the regimental commander, overtaking the third company on its way to its quarters
او را مطمئن کردم که یک بار در طی محاصره دیدم که صد تن از افراد دشمن را یکجا دم توپ نهادند	I assured him, that I had seen them blow up a hundred enemies at once in a siege
تمام تدارکات برای رسیدن آن روز کاملاً به اتمام رسیده بود.	all preparations for its arrival were complete.
دل تو دلم نبود که مبادا از من بخواهد که همراهش بروم.	I was mortally afraid she'd ask me to go with her.
