یک بار نیم ساعت به تماشای سه سایه ایستاد	once she stood half an hour watching three shadows
پنداشتم که آنان ریزترین و خوارترین موجوداتی هستند که من تا آن زمان دیده بودم.	I thought they were the most little contemptible creatures I had ever beheld.
فقط وقتی تو از اینجا رفتی من واقعا فکر کردم .	until you went away from here.
الان برای من پانصد فرانک پول باقی مانده است.	I myself had still five hundred francs left
در آشپزخانه وسیع و در دل تاریکی سرش گیج رفت.	that the floor dipped forward like a sinking lighter.
بیشتر شبیه به قند سوخته بود تا طلای با ارزش.	was more like common caramel than valuable gold.
بازرس نیز از عقب ضربه دیگری به پشتش زد	the beadle gave him another tap behind
از آن پس روابط ما سخت بو خامت گرائید و بزودی بر طبق درخواست خودم محل سکونتم در آن سوی شهر	I requested to be quartered somewhere else, and was shifted to the other end of the town
چون هیچ کدام حاضر نبود این مقام را به آن یکی ببخشد.	for none would yield this proudest post to his neighbor.
بهر حال صرف نظر از اینکه چنین باشد یا نباشد	but, whether they were or no
من فقط مقصودم این بود که او را به خاطر بداخلاقی و سوءظن بیجایش تنبیه کرده باشم و بیش از این منظوری نداشتم.	I wished to punish her sauciness, that's all.
که به این مرد دیوانه و مست خشونت نکند.	that drunken imbecile to account.
اما حتی یک بار هم به خانه راستوفها نرفت.	but had never been to see them.
لیکن حال که اینجا کاروانسرا است و قلعه نیست	but since it appears that it is not a castle but an inn
سر هر جسد زیر پای جسد بعدی یا روی آن قرار دارد.	the head of one body lying on or under the feet of the next.
صفات زشت آن زن قادر به ربودن این گنج نیستند.	that her qualifications were ill adapted to win from him that treasure.
در سر راه این ازدواج یک مانع غیر قابل حل هست.	an insuperable impediment to this marriage exists.
رو زا نیز به نوبهٔ خود وقتی که او را دیده بود حرکتی کرده بود تا به سوی او بیاید	when she saw him she had made a movement towards him
اما راه قابل عبور نبود و لشکرهایش در گل فرومانده بودند.	but the roads were impassable, and his divisions stuckfast in the mire.
هر چند در حدی که مربوط به این نقل است رفیق خواب من شد	though but a sleeping partner one, so far as this narrative is concerned
انقباض عضلات خود را باز کرد و خود را به دست اراده بدنش سپرد.	relaxed his muscles, and surrendered to the will of his body.
سپس به زور وی را دوباره روی صندلی نشاند.	he forcibly sat her down in her place.
از کف تا سقف را آستر یا کاغذی از غشاء سفید براقی که مانند ابریشم عرسوان درخشان است پوشانده است.	from floor to ceiling, lined, or rather papered with a glistening white membrane, glossy as bridal satins.
او را بلعید و به اعماق خلیج زنده انهدام فرستاد	swallowed him down to living gulfs of doom
صورتش از شدت ذوق و شوق گل انداخته بود.	her face pink with excitement.
اگر کسی که ثروت و جاه و جلال را از اعماق گرداب پستی و بدبختی خود بیرون آورده است تا به اوج عزت و سعادت برسد	if this person whom fortune has raised from his original lowly state to his present height of prosperity
که نه زمین نابود خواهد شد و نه هیچیک از موجوداتی که در خود دارد.	that neither earth should perish, nor one of the souls it treasured.
بدین سبب است که پهلوانان سرگردان حق ندارند از هیچ زخمی بنالند	because knights errant are not permitted to complain of any wound
که شاید زیباترین کوری است که در سراسر جهان وجود دارد	which is probably the most beautiful thing in all the sphere of music.
هیچ احساسی بجز غرور نسبت به ازدواج دخترش نداشت.	had hardly any feeling but pride in her daughter's marriage.
اگه همین روزها یکی دو نفر از این دارو دسته تو هچل نیفتادن	if something don't go wrong with one or another of that bunch one of these days
پس از ین دو سایر رجال در یک طرازند.	the rest of the great officers are much upon a par.
چنین بود که هورتنس با خودشیفتگی تمام از گریز خود ترسیم کرد.	was the way she narcissistically painted her flight.
اگر نفرت آقای کازوبن از ویل ترحم دور تا را نسبت به او برنینگیخته بود	if he had not already been recommended to her mercy by her husband's dislike
من به او گفتم نیت من نیز این است که در عزلت ابدی به سر برم	I told him that mine was to live in perpetual solitude
این ندا در وی چندان نفوذ کرد که او را حتی از آن ضربهء مهیب به خود آورد.	that it quickly raised her, even from that shock.
آنگاه برخاست و با سرعت خود را به نقطه دیگری رسانید و از آنجا نیز باز دور شد.	starting up to make for some other spot, and do the same, and ramble on again.
دست همدیگر را گرفتند و با نومیدی راه افتادند.	wandered along, hand in hand and hopeless.
سرخی آن چهرهء بسیاری را در آن محله گلگون کند.	when the stain of it would be red upon many there.
بعد مقداری از آن هال را با نمک و کره له کرده و گذاشت سر میز ناهار	mashed some of it salt and butter, for dinner.
او را در انزوا نگاه دارد و به دقت او را بپاید.	to lock her up, watch over her and keep her in seclusion
ولی هم پدر اِما و هم خود اِما از این تقارن کمی ناراحت شدند.	but both father and daughter were disturbed by its happening so.
به زودی همهٔ این چیزهای اسقاط را از خانه بیرون خواهد ریخت.	that he would rid the house of all such gimcrackery.
اما تلاش سختی کرد تا جلوی خود را بگیرد و دست او را بفشارد.	but with an obvious effort to control herself she pressed his hand.
محال است که او مشهور باشد و شما ناشناس بمانید.	you could not celebrate him without being known yourself.
یک بار دیگر پی بر دنبال کنندگانش گم کند.	thus to break his scentonce more.
به علامت تأیید و موافقت سر را حرکت داد.	he wanted to say and nodded approval.
این شهریار در مهمان نوازی نسبت به بیگانگان از اسلاف خود گوی سبقت ربوده بود.	this prince being distinguished above all his predecessors for his hospitality to strangers
به کشتی پکوئود نزدیک شد همه شراعهای پر باد همچون بادکنک ترکیده روی هم ریختند	the boastful sails all fell together as blank bladders that are burst
بعدش از اینکه وعظ را نشنیده بودم تاسف خوردم.	then I was awfully sorry I hadn't listened to the sermon
بدون آن که در وضع بیمار تغییری حاصل شود.	the sick man was still in the same condition.
یکی نیم رخ مردی نجیب زاده و موقر و دیگری نیم رخی کثیف و زخمی.	one nobly whiskered and solemn, the other untidy and scared.
بمانند مردی که جداً تصمیم به انکار دارد پای به زمین کوفت	beating his foot upon the ground, as a man who is determined to deny everything.
باز هم چه برای کره اسب آن چیزها باید جایی موجود باشند.	yet with me, as with the colt, somewhere those things must exist.
قوری را از آب داغ آبگرم کن بالای ظرفشویی پر کرد	filled the teapot from a little hot water geyser over the sink.
پدر مسکین مرا از راه حقد و حسد پاپی شده است.	pursued my father with jealous hatred
سرهنگ آئورلیانو بوئندیا هفت بار دیگر دست به آشوب زد.	he attempted seven other revolts.
من احتیاج به مدرکی محکم برای پزشکی قانونی دارم.	I need concrete evidence for the coroner's inquest.
این یک عنکبوت بسیار سیاه مو دار و مخوف بود.	it was a large, black, hairy, frightful spider.
هرچند که نحوهی انجام این کار را اصلاً نپسندید.	though not able to give him much credit for the manner in which it was announced.
چنان مراقبم بودند که هیچ مادری مراقب دختر عزبش نیست.	they watched me closer than a mother keeps an eye on an untried daughter.
جمعیتی پر سر و صدا و بشاش و پر اداست.	it is a noisy, cheerful, gesticulating crowd.
طول آن از دو قدم و چند گره بیشتر بود.	more than two feet and several inches long.
مطمئن هستم تو می تونی پیشنهادم ون رو به بهترین شکل ممکن بهش بگی.	I trust that you can present the offer in the best possible light.
من پاک اشتهای خود را از دست داده بودم.	I had quite lost my stomach.
مگر اینکه ضربتی از خارج بر اعضاء ناطقه یا سامعه آنان فرود آید	without being roused by some external taction upon the organs of speech and hearing
آن هم وقتی خیلی از پسرهای جوان فامیل حتماً پول شامشان را ندارند.	when so many younger sons can't dine at their own expense
او با اخم و تخم به آن نگاهی کرد.	he looks at it with a frown.
در چنین لحظاتی در مواقعی که زندگی و مرگ انسان به تار مویی بند است آرزو دارند که از احساساتشان درکی روشن و واضح ارائه دهند	when the chances of existence are involved, a desire to leave a correct impression of the feelings,
پیشخدمت از اتاق پذیرایی روبرو با صدای رسا گفت.	the maid said clearly from the reception room opposite.
آن مرد کلاه خود را از سر برداشت و آن را در بالای سر خود تکان داد.	he took his hat off, and waved it round his head.
خودم هم اسبم را سی پوند فروختم و روی آن پول گذاشتم و یک اسب دیگر خریدم.	I paid away thirty with my old horse in order to get another
از رجال دولت و اهل درب خانه دوستان زیاد داشت	, had preserved a great number of friends, and these
که با غرور و بزرگواری عزم جزم کرده بود نقش شخصیت فرومایه یا خیانت کار را در آن بازی نکند.	which she had a proud, nay, a generous resolution not to act the mean or treacherous part.
گناهکاران را کیفر دهند و از بی گناهان حمایت نمایند.	as well as for the punishment of vice and protection of innocence.
در حالی که در حقیقت او نو با سحر و جادو تبدیل به یک ماشین پرنده می کنه.	while really he was enchanting it to make it fly.
اما وقتی سرانجام از آستانه پا به درون گذاشتیم از سر تا پا خیس شده بودیم.	but we were quite wet before we could pass the threshold.
در آنجا دیدم که مردم نردبانهائی بر دیوار ساختمان نهاده بودند	I found they had already applied ladders to the walls of the apartment
یه وقت میاد که دی گه هیچ کس اینجا نیس.	he comes home and they ain't nobody here.
ولی ناگهان تغییر خیلی مهمی به وقوع پیوست و مگ به کلی از آن رو به این رو شد.	but all of a sudden a change seemed to come over her, and, for a day or two, she was quite unlike herself.
که در همه اعضایش و در همه وجودش یک نوع ضعف مریضانه داشت اما در نگاهش قوت بسیار مشهود بود.	who had a sort of sickly feebleness about all his limbs and his whole person, and an immense force in his glance.
جزوه کشی که سر آن را بسته بود بیرون آورد	drew from an inlaid secretary a small portfolio with a lock
عادت کرده بود که حتی بدون علل کافی بخندد	it was her habit to build up laughter out of inadequate materials.
از پایان خوش چنین ماجرای به هم پیچیده و بظاهار مأیوس کننده	at the happy issue of such a complicated and hopeless business.
محض لجاجت و هوس کاری یک نفر پیری علیل که مزاج طفلان را پیدا کرده.	as it is all occasioned by an old man relapsed into second childhood
این بانو که زن مدیر نمایش است لباس ملکه در بر کرده	that woman, the manager's wife, plays the queen
که او نیز از ریشهٔ گیاهان بیابان تغذیه نموده و برای نیل به آزادی و کمال مانند مجنونی علیه خودش مبارزه کرده باشد	who had himself eaten roots in the desert and made frenzied efforts to subdue his flesh to make himself free and perfect.
اگر کشتی یا زورقی در آن حوالی باشد ملاحان پی برند به اینکه موجود فانی بدبختی در آن صندوق زندانیست.	if any boat or ship were near, the seamen might conjecture some unhappy mortal to be shut up in the box.
من با یکی از این پرچ مداران آزادی آشنائی داشتم.	I knew one champion of freedom
که اگر روایت کسانی را که سینه به سینه از پدران خود شنیده بودند باور کنیم	that it is handed down by tradition from father to son
بدون این که فکر کند این صدا ممکن است به گوش دخترها صدمه بزند.	before recalling that perhaps such remarks were not fit for female ears.
به دنبال او خارج شد و به اتاق بچه رفت.	she followed the servant out of the room, and went to the nursery.
نه اینکه نیازهای واقعی نیروهایش را به فعالیت وادارند و پیوندش را با زندگی برقرار سازند.	instead of coming from without in claims that would have shaped her energies.
هر طور که دلم بخواهد در هوا جلو و عقب و بالا و پایین ببرم.	push it and pull it in the air any way I want!
یک امپراطور جان خویشتن و دیگری تخت و تاج خود را در این راه از دست داد.	wherein one emperor lost his life, and another his crown.
آنچه را که دیده بودم به طور کامل برایش تعریف کردم.	I told him all that I had seen.
من او را چند ساعت پیش روی پرچین حیاط پناهگاه دیده بودم.	that I had seen some hours before stride legs upon the palisade.
سپس زیر پاها را با زبانی که به قرمزی گوش ماهی بود لیسید.	licked its pads with a shell pink tongue.
از مچ به افسار و به چفت در انبار بسته بود	his wrist tied to the bolt of the door
اما اگر گناه از من است مرا به راه راست هدایت کن و به من بیاموز تا وظیفه خویش را بدانم!	but if I am myself the cause, teach me what I should do!
ولی جرأت نکرده بود با وجود بچه ازآن استفاده کند	but she dared not use it in the house not with the boy here
برای اینکه حالا دیگر میدانم که شما یک انسان واقعی هستید.	because now I know you're a real person
اشک دوباره جاری شده بود امشب خیلی گریه کرده بودم.	tears streaming againI was crying so much tonight.
تا با نوک چوب دستی خود افکارش را رسم کند.	to draw his thoughts with a stick.
ظاهرا دوباره منتظر آهنگی بود که بایستی با آن آواز دو نفری را بخوانند.	obviously awaiting the beat to start singing with her.
که در نقش رویشان دم کوچک پرو سی جانشی شاخه درخت غار شده بود.	on whose effigy the littlePrussian queue had replaced the laurel wreath.
هیچ کسی را که بتواند و یا بخواهد سر او را گرم داشتند	he saw no one who could or would trouble to entertain him.
زمانی که این دو بچه را متوجه این موضوع کردند که مرگ چندین شب و روز بر فراز این تخت پرپر زد	as they brought into the boy's mind the thought that death had been hovering there, for many days and nights
بعد از مرگ مادرش دردسرهای بسیاری برای اداره آن خانه بزرگ کشیده است	she's had so much trouble keeping house since her mother died
تپة سنگی سیاه را که آن ناظر تنها را روی آن دیده بودم پیدا کردم	I found the black tor upon which I had seen the solitary watcher
در همین حال خانم خوش هیکل تری کنار میز دیگر نشسته بود.	while a more buxom lady presided at the other.
من همه حواس خود را به شاه متوجه کردم	I applied myself to the king
ولی نتوانسته است حس رحم و شفقتی را که به خاطر بدبختی و مصیبت دیگران به دل دارم از دلم براند.	the compassion I feel for the misfortunes of others has not been thereby banished from it.
به هر طوری بود به او حالی کردند شخص مورد نظر را از آنجا تماشا کند.	signed to him to climb up and observe the person in the adjoining room.
او لا شما و این بچه باید کاری کن ین که پا از این اتاق بیرون نگذار ین.	you will begin by not settingfoot outside of this chamber, either you or the child.
سلطنت مغلوب را هم به آن پایه از افتخار نرساند که با او چون دشمن رفتار کند و خونش را بریزد.	it had not even paid to vanquished royalty the honor of treating it as an enemy, and of shedding its blood.
سعی نکنید که پاسختان را بگیرید که جز دروغ از لبان او نخواهید شنید	do not try to make her answer unless you want to hear some lie from her lips.
آنان را در جایی که من امروز شما را دیدم ببینید.	you're to be found where I found you.
من باید بگویم که درست مثل یک خانم جوان حسابی از مهمانی با کالسکه به خانه بازگشتیم	I declare, it really seems like being a fine young lady, to come home from the party in a carriage
پیرمرد پس از گفتن این سخنان بار دیگر به گریه درآمد	again he fell to weeping as before
زندگی ما ادبار و کوتاه و پر از درماندگی است.	our lives are miserable, laborious, and short.
گفتی از این قطع ناگهانی جریانات آزرده گشته است	as if angry at the interruption
به خصوص وقتی که آن وقایع به زیان قهرمان داستان باشد	if they tend to bring the hero of it into contempt.
یک آپارتمانی دارم که شاید به درد شما بخورد.	I think maybe I've got just the thing for you.
بنابراین تو اکنون از هیچ چیز مترس و غم و اندوه به دل راه مده	feel no alarm, there is nothing to hurt thee
سؤال کنم چه اقدامی در مورد شما به عمل خواهند آورد.	in the question of what is to be done with you.
پس شمشیر را از غلاف کشیده و حاضر فرمان ایستاد.	bowed, and drawing his sword, signified that he was ready.
به تصور اینکه تقدیر ماجرای تازه و خطیری بر سر راهش قرار داده است شاد و مسرور گردید.	believing that some new perilous adventure was presenting itself to him
ازون آ دما نیستم که تا ببینن دستش ون میر سه از این پیش دستی برای کارهای ناشایسته استفاده میکنن.	I am not one of those people who, because they have the advantage of the position, profit by the fact to make themselves ridiculous.
ولی هیچ کس در این مورد کاری انجام نداده است.	but no one has done anything about it.
باید خواهش کنم به یکی دو سؤال من جواب بدهید.	I must beg you to answer a question or two.
پس از یک دقیقه که درجائی تیره و تار فرو رفته بودم	after which, I was quite in the dark for another minute
حتماً امیدهایشان به نامرادی انجامیده و آ روزهایشان نقش بر آب گردیده است.	they would have been completely baulked in their ambition and disappointed in their hopes
در فاصله ۵ مایلی درماشین جلوبه جلو متوقف بودند وجاده رامسدود کرده بودند.	five miles away, two cars were parked nose to nose, blocking the highway.
می دونم تا ابد نمی تونیم پنهان کاری کنیم.	I know we can't shield her for ever.
برای آن به هیچ وجه اسم مستعاری هم نسازم	to which I will assign no fictitious name
آنهم با چنان قوت و صلابت که اگر شمشیر در حین فرود آمدن در دستش نچرخیده بود	which was delivered with such force and fury that had not the sword turned in its course
اینک ما هر چهار تن در خدمت شما حاضریم	here we all are at your service
از ین گذشته چون اسب کرند در کنارم ایستاده	my sorrel nag being by
آن به کافور و عطریات دیگر که در دیرها فراوان است آلود و همه را	with aquantity of camphor and all the aromatics in which convents abound
تا مدتی کام لا برای طلبکاران خود به این کار ادامه داده	had conducted that business for a time entirely for the benefit of his assignees
حتی بعضی اشخاص معمولی هم ممکن بود این کار را بکنند.	even some people in real life
این هم کتابی است که اگر خواستی مطالعه کن و منتظر باش که عقب بیایند.	here's a book for you to read, till they come to fetch you.
از بازویش به اندازه دو فنجان خون به سیاهی تیر بیرون کشید.	let his blood, drawing two soup plates of the thick black liquid from his veins
اینک ناگزیرم به ذهنم فشار آورم تا بتوانم به موضوعی پیش پا افتاده حالتی عالی و غیرعادی بدهم.	here I am naturally led to reflect on the means of elevating a low subject.
به او دستور دادم پیش از بازگشتم از اتاق خارج نشود.	I told her not to leave till I came.
یه جای خیلی خلوت و ترسناک عملی به شه.	in the lonesomest, awfulest place you can find
چون در این موقع دوباره سکوت ممتدی بر سراسر خانه حک مفرما شده بود کم کم حس کردم که کرختی خواب دوباره به سراغم آمده.	as an unbroken hush now reigned again through the whole house, I began to feel the return of slumber.
زنی که شاید مورد نفرت شما باشد زیرا شما از جریان کام لا آگاه هستید	a woman whom you, madam, perhaps, despise, for you know everything already
دستم را دراز کردم و یک اسکالوپ از بشقابش کش رفتم.	I reach over, and spear one of his scallops.
من حاضرم به جهنم بروم و دیگر به تو روی نیاورم.	I'll go to hell, body and soul, before I look sideways after you again.
آنگاه اهل مجلس مدتی به زبان هم سخن گفتند	they talked together for some time in their own language
این ابوالهول همه اسرارش را در گوش او گفته بود.	the sphinx babbled all her secrets in hisear.
زیرا در حدود ساعت ده و یازده شب نیز باز از برابر کافه عبور کرد.	for between ten and eleven o'clock at night he passed again.
از برادرم بعید نیست قولی به او داده باشد.	I shouldn't wonder if my brother promised him
پدر اِما خیالش از بازی سه دستی راحت بود.	her father was sure of his rubber.
من دوباره به کشتی رفته و او را بغل کرده و به زورق آوردم	so I took him round the waist and threw him into the boat and then I jumped after hiM
بچه را از پاهایش بلند کردو محکم به پشت او زد.	picked her up by the heels and swatted her firmly on the back.
در این باب حقیقة هم اشاراتی به وی شده بود	as to which she received indications
اقلا این پنجاه هزار فرانک را از برای او بگذارد و او را خلاصی بخشد	that then he would have 50,000 remaining
دیگر بسته به دور اندیشی تست که باید چه چاره کنی	I leave to your prudence what measures you will take
ما دو تا خوک داشتیم و گفتیم که کشتن و خوردنش ون بهتره	we had a couple shoats, an' we thought we might's well eat 'em.
دوباره در طول و عرض اطاق با سرعتی بیش از پیش به قدم زدن پرداخت.	walked up and down the room with even greater rapidity than before.
گفته است از این که قضاوت عجولانه کرده سخت نادم و پشیمان است.	that he began to be very much afraid he had been a little too hasty.
اما نباید به دکترهای قلابی اعتماد کنند و در صورت لزوم همیشه باید به دستورهای او رجوع کنند.	but to put no faith in foreign quacks, and to apply to him in any need.
اما ما باید قبل از همه سزای تبهکاران را بدهیم.	but we must first settle with the villain.
به مردی نظر انداخت که شیشه عمرش را در درست داشت.	looked steadily at the man whose life was in his hand
بی آن که حرفی بزند از اطاق بیرون رفت.	left the room in silence.
در هر لنگه یک سکه ده شاهی نو گذاشته بود.	in each he saw a brand new and shining ten sou piece.
به جنگل زد و در میان درختان ناپدید گشت.	disappeared in an instant afterwards among the trees.
با شه پس بهتره که من پیاده به شم.	I guess I'd better get off, he says to the driver.
آن منظره موی نرم و درازی بود بر دریا درست پیش راه کشتی و در همان جهت به نرمی روغن	by the sight of a long sleek on the sea directly and lengthwise ahead, smooth as oil
اولین بار که انعکاس نور را در آن عدسی دیدم	when first I saw the light flashing upon the lens.
بنایی بود بظار بسیار گرفته و درهم و عبوس که در حیاطی واقع شده بود.	a grave building in a courtyard
زیرا صفحات هر کتاب مانند مقوا ضخیم و صلب و سخت بود.	for it was as thick and stiff as a pasteboard.
در نقش زشت و نامطبوع کسی ظاهر بشود که به هریت ترجیح داده شده	to appear in the ungracious character of the one preferred
موضوع تسویه مکنت مهمی که برای یک عروسی بزرگ لازم بود نهفته است.	there lay the arrangements of fortune necessary for a greatmarriage.
که ربرتا هنگام سقوط در آب قطعا زنده بوده ولی الزاما به هوش نبوده است.	averring that atthe time her body had first entered the water,she must have beenstill alive, although not necessarily conscious.
ببینم که بسیاری اختراعات دیگر به حد کمال رسیده است.	many other great inventions, brought to the utmost perfection.
نوشته بود هری یک بیمار روانی و احتمالاً خطرناک است.	about how disturbed and possibly dangerous he was.
با باش صاحب اون عمده فروشی بز رگه است	her fatherowns that big wholesale grocery over there
در آن هنگام ترسی که هنوز از چنگ و دندان یاهو دارم نخواهم داشت.	without the apprehensions I am yet under of his teeth or his claws.
بهتر است اوضاع و احوالتان را به فرمان خودتان بگیرید نه من.	it is best to believe your temper under your own command rather than mine.
مگر آن که به زور چماق و دندان بر ایشان حکومت کند.	but the law of club and fang.
مثل این که ناگهان به یک نقطه میخکوب شده باشد.	as if suddenly rooted to one spot.
بلافاصله دستش را در ردایش فرو برد که چوبدستیش را درآورد	he plunged his hand into his robes for his wand
منظورم این نیست که شهر ما به درجه کمال رسیده است.	I don't mean to say we're perfect.
ازه چند دیواره محکم و سیاه رنگ را در آنجا قرار داده بودند تا از فشار جمعیت در روز بعد اندکی بکاهند	a few strong barriers, painted black, had been already thrown across the road to break the pressure of the expected crowd
بلکه از کسی هم که جسارت اهانت به او را داشته انتقام گرفته است.	but avenged him of the man who dared to wrong him.
بعید نیست از خودش دست و دل بازی نشان دهد.	I should think he would do something handsome.
چنان آن حیوان بیچاره را از جا کند که اگر قول تاریخ را باور کنیم	made him scud along in such style that the history tells us that
یکی از ابروهایم را بالا بردم و بعد رهایش کردم	I raised one eyebrow and then let it go.
چون بالاخره اگر هم توفیقی بر وفق مراد بیابی	for even if the issue he as thou wouldst have it
قبل از پیدا کردن آن ناگهان از جایش بلند شد	but before he had found it, he straightened up suddenly
وقتی به صورت غصه دار او نگاه کردم ناگهان احساساتی شدم.	I gaze at him, suddenly feeling moved.
من برای جواب دادن نزدیک پروفسور و برای فرار کردن نزدیک در بودم.	I was close to the desk to reply, and close to the door for the purpose of flight.
در نزدیکی دروازه توقف نمود و بوقش را بصدادرآورد.	parked next to the gate, and sounded its horn.
آنگاه جزیره پرنده را تا ارتفاعی مناسب فرود آوردند	the flying island being raised to a convenient height
مخصوصا مرگی که دارای چنین شرابط مشکوک و غیرطبیعی است	more especially a death under such suspicious circumstances.
دوست داشت با آدمی هم زبان شود که هوش و درکی همپای خودش داشته باشد.	she liked matching her wits against a brain as intelligent as her own.
شما هستید خوب به موقع و در سر وعده آمدید.	you are punctual, thank you!
در پشت آن بیست تیر دراز شبیه نرده کاخ مقابل کاخ اعلی حضرت امتداد داشت.	from the back of which were extended twenty long poles, resembling the pallisados before your majesty's court.
به نحوی که وقتی با نوک بسیار کوچک زوبین هم سوراخ شوند	so that when pierced even by so small a point as a harpoon
درست مثل اتاق خلوت بانوان با حال و هوایی لطیف و زنانه.	like a bit of a lady's boudoir, putting in a note of feminine and intimate delicacy.
کشتی هیسپانیولا اندکی دورتر از اسکله لنگر انداخته بود.	THE HISPANIOLA lay some way out
به خاطر ای نه که تو او نو اون چیزی که هست کردی	it's because you made him who he is.
ولی به هر حال به زبون آوردنش بی ادبا نه بود	but it was rude to say it, anyway.
از توی چل یک سیبی بردار و به من بده	get me an apple
من راز خود را به تو افشاء خواهم کرد.	I'll tell you our secret!
برای این موضوع که نامم در کتابی نوشته شود و دست به دست بگردد	nay, while I see myself put into a book and passed on from hand to hand over the world
این کاری بود که در میان بسیاری از بانوان درباری معمول بود	this was common to many other ladies of the court.
مدتی دراز بود که مردم در آنجا چشم به راه من داشتند.	where the people had long expected me.
از سه ماه پیش که با عجله آتلانتا را ترک کرده بود	for he had abruptly left town three months before
زیرا من پنداشته بودم که هر که عمر جاوید دارد پیوسته جوانی و تندرستی و نیرومندی او پاینده است.	because it supposed a perpetuity of youth, health, and vigour
سبب شد تا کلاید با غرور تکبری گام بردارد که تا آن زمان از او سر نزده بود.	caused him to walk with even more of an air than had hitherto characterized him.
که نظیرش را در برابر دخترک هرگز به یاد نداشت.	such as he had not felt as yet in regard to her.
آن دو ملاقات او را به شدت بدخلق کرده بود.	shaken by the two visits
در گوش یکدیگر زمزمه کردند که صبح روز بعد دفاع از متهم آغاز خواهد شد.	whispering to each other that on the morrow the defensewould start
حتی اگر اتفاقی ناخواسته کل کارت را به هم زده بود	even if some untoward event were yet to destroy your work
وضع خاص چشمان وال که عملا با چند قدم مکعب سر جامد میانشان فاصله افتاده است و چنان است	the peculiar position of the whale's eyes, effectually divided as they are by many cubic feet of solid head
لیکن زین از پشت اسب برگرفتن هرگز روا نبود.	but to remove the saddle from the horse never!
بنابراین کیک را حاضر کن و همه چیز را حاضر بگذارد .	so fry your cakes, and have everything ready,
سر و صورت و دستم را شستم تا در مقابل رفتار خوب او تلافی کرده باشم	I washed my hands and face, to do the greater honour to his gentility
سعی کرد چشمش به بالا رفتن بیشتر دامن او قبل از دوباره پائین آمدن نیفتد	trying not to see the way the skirt rode up even more before falling back into place
او نا دنبال چیزهایی رفتن که خودش ون دوست داشتن.	asked for all they got
می دونم کجا میتونم برات یکی ازاون تخته هاپیداکنم.	I know where I can get you a scrub board, I think.
البته فقط یک بار و اگر باختم باید از نو خدمتکار شوم.	if I won anything I should be able to continue my play
جائی که به من دادند شش گز از خانه فاصله داشت و از اصطبل یاهوها جدا بود.	it was but six yards from the house and separated from the stable of the _Yahoos_.
کلاه صاف و پهنش را دوباره به سر گذاشت.	put on his flat topped hat again.
هرکس ببین دش خیال می کنه یه خان مه.	so that one would think she was a lady!
بلکه باید بداند که چگونه و در چه موارد خرج کند.	but by knowing how to spend it well.
به علاوه چون شما تا به حال حقی در اموال خود نداشتید	moreover since you have no right to possess
شخص خود را پنهان دارم یا جانم را نجات دهم.	to conceal my person or to save my soul
به نظر من که با استفاده از معجون عشق توانسته است دل این دو پسر را به دست آورد.	I think that's how she's doing it.
پیش از مدرنش مرا به دست او سپرده که از من نگهداری کند.	he left me to her care.
از میهمان خانه بیرون رفت تا در ساحل گشتی بزند.	he went out for a stroll on the beach.
اگر در ین کار مخیرم کنند زندگانی خود را وقف خدمت علیاحضرت خواهم کرد و از ای نرو بر خود خواهم بالید.	if I were at my own disposal, I should be proud to devote my life to her majesty's service.
ولیعهد فرمان داد که من و جیم کشیک بدهیم تا هوا بهتر شود.	so the king told us to both stay on watch till the weather got better
شاید به نظر تو احمق باشم اما ترجیح دادم که با تلاش خودم به جایی برسم.	I will probably seem a fool to you, but I prefer to make my own way.
من می تونستم به گم که تو چه طور احساسی نسبت به اون داری	I could tell how you felt about him,
من بلافاصله به خانه او رفتم و او داستان را برایم شرح داد.	I called at once at his house and he told me the history.
خوشنود از تنها بودن زن و مشتاق غافلگیری او قول نداده بود که آن روز به دیدنش برود	feeling satisfied that she was alone, and wanting to take her by surprise, since he had not promised to be there today
آن مرد را واداشتم که آن جوان بدبخت را از درخت باز کند	I compelled the clown to unbind him
مثل همیشه جوراب و کفش و پیراهنش مرتب بود.	still was in correct shoes and stockings
همین جا راهم ون از هم جدا می شه.	we have reached a parting of the ways.
من یک نان شیرینی برای هر کداممان در تستر گذاشتم	I put a bagel in the toaster for each of us
با این حرکات پرمعنی و رسا خواست بگوید بین کراوات بستن و بالای دار رفتن شباهتی وجود دارد.	thereby indicating, by a lively pantomimic representation, that scragging and hanging were one and the same thing.
در اینجا در خانه مادرش که دید بسیار متوحش گردید.	alarmed him for his mother.
گذشته از این عدهٔ قلیلی در مراسم تدفین او حضور یافتند	but there were very few people at the funeral.
پیش از این که او را در جریان خود غرق نماید تغییر جهت دهد.	should be diverted before it swept her down in its flow.
مطمئن باش که هم چین کسی تو این کارخونه زیاد دوام نمی اره.	that fellow is doomed to a short stay here.
به گمونم فقط سعی داشتم خودم رو متقائد کنم که دیوونه نیستم	I guess I was just trying to convince myself that I wasn't crazy.
من بی درنگ به گریه افتادم و مدت چندین ساعت گریستم ولی ناگهان پس از شام همه چیز را در طاق نسیان نهادم.	for I really shed tears and cried for several days afterwards, and then suddenly, one afternoon, I forgot all about it.
او وضع کلبه را عوض کرد و به آن صورت درآورد.	then she converted it like that
بلکه بی سروصدا با چشمان تمسخربار تماشاچیان را ورانداز میکرد	but fell listlessly to scanning the spectators with his weary eyes.
نظر به وضع تأثرانگیز شما چند لحظه پیش مرا مأمور کرد که تنها از جانب او	she commissioned me at once just now to bring you this help from her
چنانکه هرگز زنی این چنین متعلق به سوی خود نبوده است	as much as any wife is ever to a husband
تا وادار شوم که هزار گونه حرف بیجا بزنم.	you might hear me make another couple of dozen blunders.
هنوز به پای آن عصای نبین نرسیده بودم که آن را درست در جلوی پای من بر زمین محبس انداختند.	as soon as I came under the reed it was dropped and fell inside the bano at my feet.
درست باشد که او میکوشید بین کمونیسم و نظامهای موجود پلی بزند و این کار غیر ممکن باشد.	true that he was trying to hold the balance even between communism and the familiar forms, and that this was hardly possible.
با سرعت به طرف خارج دویدم و در را از پشت بستم. نفس بلندی کشیدم و ایستادم.	I came out of the cottage hurriedly, not looking behind me, trying not to see the torn sofa
پیرمرد به گستره دریای پیش رویش چشم دوخته بود.	the old man declared, quietly, staring away upon the sea.
من هیچ فرصت نکردم با بل انش صحبت کنم.	I had no opportunity to speak to her.
قبل از اینکه بتوانم جلوی خودم را بگیرم گفتم چرا حرف زدم.	I have! I say before I can stop myself. 'I have!
که دختر باید در انتخاب شوهر خود کام لا آزاد باشد	I give you freedom.
پارچه بیرق شاهزاده آندره را فرانسویان به غنیمت برده بودند توقف کرد.	who lay on his back with the flagstaff that had been dropped beside him.
با این دوست گرامی خود لازم است که اجرا دارد.	against the grief of his friend
سربازان خود را به خشکی پیاده کرد و به استحکام مدخل بندر پرداخت	landing forces fortified the mouth of the harbour
که وضعیت و اوضاع تا به این درجه است	that the sentiment had been carried so far.
تا نخستین اطلاعات مربوط به حرفه وال گیری آن پسران به هیچ عنوان دست خوش طرفداری و جانبگیری طبیعی اما بی موقع پدر یا هراس و نگرانی نادر بایست او نشود.	so that their first knowledge of a whaleman's career shall be unenervated by any chance display of a father's natural but untimely partiality, or undue apprehensiveness and concern.
سرش به حالتی قرار داشت که انگار سر تا پا گوش بود.	with his head posed as if he was listening.
دلم نمی خواد با جون خودت بازی کنی .	I won't have you take your life in your hands.
پیش از آن که بتوانم خود را مالک آن خانه حس کنم ساکن آن به آسمان پرواز خواهد کرد.	the inmate would escape to heaven before I could call myself possessor of its clay dwelling place.
این برایم در میان آن همه رنج و غم دل خوشی کوچکی بود.	that was an atom of sweet in much bitter.
به قول معروف اندک اندک جمع گردد وانگهی دریا شود	many littles make a much
اما متوجه شد که باز دیگر آن را در جیبش گذشته است.	but he found that he had put it back in his pocket.
در همان زمان که او تصمیم گرفته بود بدون شوهرش به زندگی ادامه دهد.	when she had decided to go on living without her husband
با اعتراف به خود که بسیار به دیگران شباهت دارد	by dint of admitting to himself that he was too much as other men were
در مدتی که اقامت داشته با بسیاری از مردم گفتگو کرده	where, during his residence, he had conversed very much
اسباب و اثاثة مهمانخانه واژگون و درها به ضرب لگد باز شدند.	urniture thrown over, doors kicked in
بازوانش را روی زانویش قرار داده بود تا مبادا هیچ کجای پوستش در معرض آفتاب قرار گیرد.	her arms about her knees to make sure all exposed skin was shaded.
به سرعت شروع به پا زدن و دور شدن کرد.	began to ride hurriedly away.
در صورتی که غیر از شما داخل در این کار شد	so soon as another is admitted
که اکنون نمیتوانست تصور کند چگونه میتوانسته خود را برای ادای چنان کلمات عجیب و زشتی حاضر کند	that she could not conceive now how she could have brought herself to utter those strange, coarse words,
در همین خاموشی و این گریه و زاری بود که به این کاروانسرا رسیدند	thus in silence and tears they reached that inn
اما این بار احساس میکرد باریکبینی و دقت شوهرش بیشتر موجه است.	but now she felt that there was more ground for the prince's touchiness.
به تصور اینکه چندان درنگ کرده است که مجال کافی برای صحبت کردن و حتی خوابیدن به هر دو داده باشد	imagined that he had stayed away so long as to have afforded them time enough for conversation and even for sleep
چون دیوانه سازها مرگ رو احساس می کردن و به وجد میومدن.	because the dementors could sense it, they got excited.
اینجا دیگر نقل سحر و جادو و امثال آن نیست.	there's no enchantment here
لیکن مترجم عرب چنین صلاح دانسته است که این بحث را به سکوت برگزار کند	but the translator of the history thought it best to pass over these and other details of the same sort in silence
با چشمان باز در کورسوی چراغ کوچک کنار تختنش دراز کشیده بود.	she was lying with eyes wide in the dim light of the little lamp beside her bed.
در همان مکان و زمان مرگش با او قرار ملاقات گذاشته بود	made an appointment with him at the very place and hour that he met his death
در حمایت از ساختن آسیاب بادی نطق غرایی ایراد کرد.	broke into a passionate appeal in favour of the windmill.
اما پیش از آنهمحرف زدن او را زیاد ندیده بودم.	but she had always been silent.
لکن این اطاق حتی کف نداشت و چیزی جز تیرهای لخت و تو فال و اندود سقف زیر نبود.	but they found that there was not even a floor, nothing but joists, and beneath them the lath and plaster of the ceiling below.
حال اگر خلاص شویم تو باید مرا به آنجا ببری	now he added with a sigh it is you who will conduct me thither
چون تنها ثروتش در دنیا یک تکه زمین کوچک و دو سیاه بیش نبوده است.	because he was not quality and had owned only two slaves.
در حالی که او را چنان رنگ تیره شده که مافوقی بر او متصور نبود	more pale from terror than he had been just before from hunger and misery.
من که از اینکه این تا حالا دوام آوردی تحت تاثیر قرار گرفتم.	I'm impressed you've lasted this long.
این دفعه این مشاهده هنگام صبح صورت گرفت نه غروب.	on this occasion, in the morning instead of in the evening.
خود را روی پشته ای در میان خلنگها انداخت و همانجا آرام ماند.	threw himself down on a swell of heath, and there lay still.
بریدن ناگهانی طناب لنگری که سخت کشیده شده باشد	a taut hawser, suddenly cut, is a thing as dangerous
قبل از این به هیچ روی در فکر خانهٔ تو نبودم لکن به محض اینکه آن را دیدم	I had never before imagined what sort of a house you would live in, and yet no sooner did I set eyes on this one than
در این شب طوفانی با یس خیلی سردتون با شه و خیلی هم خیس شده باشین!	how wet and cold you must be, such a wild night as it is!
دی گه برای نگه داشتن او نا به دیوار و دریا احتیاجی نیست.	they don't need walls and water to keep the prisoners in
ولی زینت و پیرایه جنگی از لباس و تجهیزات بر آن مزید شده بود	but with a shade of martial swagger in their clothes
پای راستش را به او نشان داد که زیر تخت سنگی له شده بود.	he showed her his right foot, crushed where a rock had fallen.
حتی به وی سپرد که شخصاً با خود دیوانه صحبت کند	to have an interview with the madman himself
هنگامی که توله یاهو دردست من بود دیدم که تنی عفن دارد.	I observed the young animal's flesh to smell very rank
از اینکه هایده را واداشتیم بر گفتن این حکایت.	for having been so cruel and thoughtless in my request
پهلوان چون مرد مو دب و بانزاکتی بود و همواره حاضر و آماده بود که موجب سرور و نشاط خاطر مردم گردد	courteous as he was and ready to please everybody
اما آن شب به راستی خلقش را تنگ کردند.	but his temper was somewhat tried on the occasion.
ولی من نه یکی و نه دو تا تلگراف نکردم	I should think, for telegrams are not sent from abroad for nothing.
آخه من قسم خورده بودم که به هیچ کس چیزی نگم.	I promised I wouldn't tell anyone
اما درنگ نکرد تا با دقت بیشتری نگاه کند.	but he did not stop to look more closely.
یا لااقل کارگران او را اجیر کرده بودند که برایشان آبجو بیاورد.	at least he was hired by the men to get their beer.
من یه دفعه یه نامه برای یه بارون که این طوری بود بردم.	I once carried a letter to a baron of that sort.
هر چند برای مرد مسنی مانند من مشکل است که دست از عادات دیرین خود بردارد	although it be hard for a man late in life to remove old habits
من هم خندیدم و پا به درون اتاق نهاد.	I laughed too and came forward into the room.
آدمی که این پیام عجیب را فرستاده توی چنگمان بود.	we could lay our hands straight upon the person who sent this singular message.
اما بر حسب حسن اتفاق عنوان منزل جدید خود را گذاشته است.	but she had left her new address.
با وحشت دریافت که از خشمگین شدن پدر پشیمان نیست	for having angered his father
آدم اونجا بنشی نه و خستگی هشت ساعت کارشو درآ ره.	jus' settin' here till you put in your eight
ارباب من که اینک در خدمت ایستاده است پهلوان نیست	this master of mine is not a knight
ولی آقای وستن بقیه را از خواب بیدار کرده.	but he must have knocked up every body else.
روی زانوان شوهرش نشست و او را نوازش کرد و مثل کبوتر ماده عشوه و غمزه آمد.	she sat on his knees, caressed him, cooed to him
هرچند ممکن است من به نظر شما آدم فضولی جلوه کنم	though I may seem to put myself forward without being asked
این گودال لبریز از آب زلال باران و عمق آن حدود دوپا بود و در حدود نیم میل و دو فوت پهنا داشت.	, brim full of deliciously clear rain water in a narrow channel two feet deep, and perhaps ten feet wide, but half a mile long.
گفته شد که جور دن در دور ماقبل نهایی توپش را از یک موقعیت نامناسب حرکت داده است.	a suggestion that she had moved her ball from a bad lie in the semi final round.
تا اینکه روزی بتوانم از آنجا به کشوری دیگر بگریزم و نزد همنوعان خود بروم.	till I could make my escape to some other country, and to creatures of my own species.
زیرا درد مداوم شدید دندان مانع از آن بود که حتی بتواند به دلخواه سخن بگوید.	his jaw twitched impatiently from the incessant gnawing toothache, that prevented him from even speaking with a natural expression.
من هرگز میل ندارم که تو مانند این دوشیزگان احمق اجتماع ما بار بیایی.	I don't want to have you like our silly ladies.
شغال در این هر دو کار او را یاری کرد.	the jackal assisted both.
که مشت محکم تو می به شدت بر سینه پیرمرد فرود آمد	that it lighted on the chest of the merry old gentleman
ولی اگر به طیب خاطر قبول نکردید این نیزه و این شمشیر به یاری زور بازوی من جبراً شما را به اطاعت وا خواهند داشت.	if you will not voluntarily, this lance and sword together with the might of my arm shall compel you to comply with it by force.
هرگز قبلاً نشنیده بودم که او اسم من را بر زبان بیاورد.	I'd never heard her speak my name before.
اون یکی هم هم ون بدجنس لباس پاره بود.	t'other one was a rusty, ragged looking devil
ولی نمی تونم همه چیز و برات توضیح بدم.	I can't tell yeh everythin
همین که این را گفت تبرزین روشن دور من در تاریکی به جولان درآمد	so saying the lighted tomahawk began flourishing about me in the dark.
باور کنید به محض اینکه او در میان مردم ظاهر شد	so, since she appeared in public
معمولاً آدم یه فن جون و یه نون می خوره.	you get a cup of coffee and a piece pie.
این جایگاه را با بزرگ شدن هم از دست نداد.	he kept his place with her as she grew.
فقط باید به دست آوردن آن را مشکل جلوه دهیم.	it is only necessary to make the thing difficult to attain.
تعجب من در این باره کمتر از تو نیست.	I wonder as much as you.
به نیکی و زیبایی و حقیقت یا اهمیت اعمال خود پی برد.	goodness, beauty, or truth, or the significance of
بازوی خود را محکم گرد کمر او حلقه کرد.	got his arm securely round the daughter's waist
هر چند بعضی از افراد کنجکاو که شجره نامه تمام عالم را پشت در پشت میدانند	though some knowing ones, who have all the pedigrees in the world by heart
از لای کراوات و یقه پیراهنش که کمی گشاد بود پوست گردنش پیدا بود.	between his cravat and his neck the somewhat loose collar of his shirt showed the skin
صاحب فرزندانی شود که این همه آرزویش را داشت.	have the children she wanted so badly.
لااقل بستگی به امید شما به امکان پیشرفت کارها در تحت مدیریت خودتان.	at least, on the good which you are encouraged to hope for from having it under your control.
در عجب بودم که این مهمانی به چشم کسی که از دور شاهد بود چگونه است.	I wondered how the gathering would have looked to an outsider.
من این بازی را به سادگی از او نخواهم برد.	I'm not simply going to beat this woman.
ازدواج با همسر بیوه یک رجل عالی مقام برای شاهزاده تحقیرآمیز نخواهد بود.	the prince would no longer be making a mesalliance by marrying you,
بجز نفر اول یا شاید دختر بزرگ خانواده مایه مباهات خانواده	except the leader himself, or perhaps some grown girl, the pride of the family
به تشریح نقشه عملیات اردو کشی مزبور پرداخت و توضیح داد	as he went on to explain the plan of operation for the coming campaign.
شما مخصوصاً باید بگویید که او از پیش خود آمده بود و پنهان کنید که به دستور شما چنین کرده بود!	you certainly ought to have said that he came of his own accord, to have concealed your part in it!
چه مرا آن زبان و آن گفتار نیست که بتوانم حق مطلب را چنانکه هست ادا کنم.	wanting the words wherewith to glorify them!
کلاهش را روی سر فرود آورد و به سوی در رفت.	clapped his hat on his head, and turned towards the door.
چو همدردی بجویی باز گو دردکه او بار غم و دردت سبک کرد	for it is still some comfort in misfortune to find one who can feel for it.
من از حالا تا وقتی که بمیرم شما را دوست خواهم داشت و با شما زندگی خواهم کرد.	I will love you and live with you through life till death,
از تحقق پیش بینی های خود به شوق آمده و منتظر بودند	rejoiced at the fulfillment of their predictions,
از این پهنه پیش از آن که برخاکش پاگذارد متنفر بود.	hating it before she had so much as set foot on it.
اما بسیار آزار دهنده بود که سعی کنم از میان خاطرات انسانیم ببینم.	but it was irritating to try to see through the human memories.
ای نه که دندونای مصنوعی او نا از جای خودش در نم یاد	they don't pull out their false teeth.
با هیچ خطری مواجه نشدند و چیزی نشنیدند و ندیدند	they met no danger, and heard nothing, and saw nothing
زن تعجب میکند که زمانی چنین امری به نظرش غیر ممکن میآمد و با خنده برای آن دو شرح میدهد که این راه چه قدر ساده تر است	she was marveling that it had once seemed impossible to her, was explaining to them, laughing, that this was ever so much simpler,
این بود که با به خاطر آوردن قولش سر را بار دیگر خم کرد.	so, remembering her promise, she bent her head.
رفته رفته نسبت به من سخت دلسوز و مهربان شد.	she was soon reconciled, and by degrees grew extremely tender of me.
از برای خدا از من عفو جرایم مجرمی را مخواهید.	for heaven's sake, do not ask pardon of me for a guilty wretch!
که تا زمان حیات من کسی نباید ایرادی و اعتراضی به وصیت پردرم نماید.	that during my life time my father's will shall never be questioned, my position forbidding any doubt to be entertained
اما این سیستم چنان پیچیده و در عین حال چنان برای عموم غیرقابل کشف و با سوء ظن همراه شد که بعد از دومین مرحله آن را لغو کند.	but the system turned out to be so complicated and was open to so much suspicion that he gave it up after the second attempt.
آنقدر برود تا به ساحل خلوت و متروکی برسد که امواج خروشان دریایی غضبناک بکوبندش	then treads the barren, lonely shore of the sea mostly a tempestuous and stormy one
تا آنکه کم کم باورش شد که دنیا برای لذت و تفریح او ساخته شده	until he came to think that the world was made for his pleasure
کشیش بنام رحم که چیز دیگری جز حد اعلای عدل نیست.	the priest speaks in the name of pity, which is nothing but a more lofty justice.
اگر او شما را به حال خود گذاشت مکلفید که باز به دنبال من برگردید و مرا پیدا کنید	if she leaves you free to do yours, you are in like manner to return and seek me out
در چشم برهم زدن نردبان طنابی باز شد و به بیرون پنجره آویخته شد	in the twinkling of an eye the rope ladder was unrolled outside the window
قول داده بودم پولش را فردا به خیاط بدهم.	I promised I'd give her the money tomorrow.
جمع کثیری از تماشاچیان به او چشم دوخته بودند.	while alarge crowd surveyed her.
اگر پدر خود را با چنان مبلغی قلیل برای ایام پی ریش بجا گذارم	to leave my father with such scanty means in his old age
اما در همین مدت سوراخ نسبتاً گودی کنده بودیم.	but we had a good deal of a hole to show for it.
نگران بود که نکند این تدبیرش هم به موفقیّت نینجا مد.	he was anxious that his little jaunt should be a success.
راستی که خیلی از مردم خیلی سختشان است یک کار درست بکنند.	how hard it is for some people to get things straight.
باید به او قول شرف بدهم که در ین سفر همراه او باشم	I must give him my word and honour to bear him company in this voyage
پیشنهاد کردم که در کالسکة خود به منزلشان برسانم.	offered to take them home in my carriage.
داشتن 17 پوند پول که کسی از آن خبر ندارد.	I had seventeen quid which nobody else had heard
فقط باید خوب گشت تا دلیلش را پیدا کرد.	if their cause be fairly searched out.
چنان آن جانور را درهم بمالد که سقط شود.	squeeze the brute to death.
هرگاه آن اتفاق پیش بیاید هری باید با آن مواجه شود.	he would have to meet it when it did.
از مسیر هفتاد به مسیر صد و یک پیچیدم.	I took the turn onto the 101 at seventy, not bothering to look.
بعلاوه بداند که قدرت تغییر این وضع را هم ندارد.	to know that you cannot alter this.
این عمل او به طوری عجیب و زننده بود که من از خجالت سر به زیر انداختم.	I blushed for her while she stared
من هم دوست ندارم این جور چیزارو در مقابل خانم محترمی مثل شما به زبون بیارم.	I regret having to tell a lady such a thing.
از ای نرو به ارباب خود گفتم که در کشوری که من از مردم آنجا هستم	I therefore told my master, that in the country whence I came
که پوست زردی بر استخوانش کشیده بود هر جز لایه نازکی ماهیچه چیزی نداشت.	that was sallow skin over bone with little in between except a paper thin layer of muscle.
برخلاف کار پینه دوز که انتهای کار در وسط آن است و ابتدای کار در انتهای آن است.	not a cobbler's job, that's at an end in the middle, and at the beginning at the end.
وحشت کامل سفر در زمینه تاریک نهان نگاه داشته شود	that the full terror of the voyage must be kept withdrawn into the obscure background
امیدش به این بود که از ساندویچی که در کشتی خورده بود لقمه ای مانده باشد.	maybe there was a bit left of the sandwich he had eaten on the ship.
احساس کرد که در طول این سخنرانی دراز تنها بوده است.	feeling lonely in the long speech.
صورتم را لمس کردم و کمی با آن وررفتم.	I rub my dry face, playing for time
عصرها در خانه دنبال هم دویدن و شوخی و خنده به راه بود.	or frolicked at home in the evening
تا همه حیواناتی را که جان سالم به در برده بودند به قتل برسانند	the survivors killed
مثل درخشش ماه جوان آن گاه که ظریف است و داس گونه و نیمی پنهان در ابرها.	as the young moon shows when it is thin and sickle shaped and half hidden among clouds.
من به صبر کردن برای دیدن کمی پشیمونی در تو ادامه می دم.	I keep waiting to see some remorse.
وگرنه نه تنها فریاد او به گوش کسی نخواهد رسید بلکه خود او نیز صدای خود را نخواهد شنید.	where they won't know what to make of her, or she what to make of herself.
انتظار داشتم که کسی را ببینم تویش دراز کشیده.	I just expected there'd be somebody laying down in it
خود را زیر درخت بلوط محبوبش افکند و احساس کرد	he flung himself under his favourite oak tree and felt that
که بی درنگ دست به کار تکه کته کردن آن شوند.	customary to proceed at once to the business of cutting him in.
مثل یک پرنده سرش به یک طرف کج شده بود.	with her head cocked a little on one side, like a bird.
هر قدر که بخواهید در بیرون دکان هم حاضرم صبر کنم تا پول تهیه کنید	but that I would wait for it, as he desired, outside
بدین ترتیب خانه ری دل بدون سکنه ماند و رو به ویرآنی گذاشت.	which, in the absence of inhabitants, started to fall into disrepair.
ولی قبول کرد یک ماه بره پیش پدر و مادرش.	but to going up therefor a month, yes.
زن جوانی بود که گردنبند مروارید به گردن داشت.	was the young woman with the string of pearls.
در پنج سال گذشته حتی زنان در کو شه نشین و منزوی نیز این بیهودگی را احساس کرده بودند.	now, which even the most cloistered women had not seen and known in the last five years.
بر مالکی که او را نخریده است بلکه به زور بازوی خود او را فتح نموده	not by purchase but by right of conquest
همان که آن آپارتمان را برایش پیدا کرده بود.	the one for whom he'd found the flat.
ولی چند لحظه بعد باز گشت و سینی شام را نیز در دست دیگرش نگه داشته بود	but he brought it back immediately, with the supper tray in his other hand
هر آن منتظر بودم و آرزو داشتم که واپسین دم زندگانی من فرا رسیده باشد.	expecting, and indeed wishing, every moment to be my last.
نیشخند زدم و هارمونی ساده را با او کامل کردم.	I grinned and completed the simple harmony with her.
گذاشت تا دشتی از گل بروید. یک دشت وسیع پر از گل شقایق.	she allowed a field of poppies to bloom.
ارباب را مطمئن کرده بود که قسمتی از تن من سفید	his vale assured him, some part of me was white
من آدمی نیستم که تحمل کنم مرا سگ صدا کنند.	I will not tamely be called a dog, sir.
مردان روستا این بار در اجرای تصمیمی که گرفته است پشتیبان وی نخواهند بود.	the men of the village would not back him up in his undertaking.
نام خود را در میان تمام ملل متمدن کره زمین مشهور و محترم خواهد ساخت!	shall become famous, and his name honoured throughout all the civilised nations of the earth.
به پرنده بیماری با چشمان بی حال و پروبال در هم ریخته شباهت داشت	she was like a sick bird with languid eye and plumage ruffled
این بود که جریان بیش از نیم فرسخ سرعت نداشت.	so there was not more than a two or three mile current.
از روی گلزارهایی که در ظلمت فرو رفته بودند.	the rosebushes in the shadows
که فقط محتاج اندک دور گشتن و وقت کشتن و زحمت بود تا آن را بگیرند و بکشند و بجوشانند.	requiring only a little circumvention and some small application of time and trouble in order to kill and boil.
هرچه ممکن به شه کمتر بیرون می مو نم.	I shall be away as short a time as possible
زیرا همه از هیجان فرصت فکر کدن به غم و غصه را نداشتند.	for everyone was too busy and excited for either solemn thoughts or tears.
از آنجا که به علاقه صمصمانه نسبت به کلیه امور فضیلت وحشیان ملتفت بود	being gifted with a devout love for all matters of barbaric vertu
ممکن است کسی در بیرون مراقب ما باشد و ما را ببیند!	they might come and watch outside.
خود نیز دیوانه شده و به دنبال چیزی افتاده است	, he makes a madman of himself and goes looking for what
به خدا که اگه دلم بخواد از اینجا هیچ کجا برم.	I wouldn't want to be nowhere else but here.
از نظر من ایراد غیرقابل رفعی برای کشیش شدن ندارد.	I confess I see no insuperable objection to his being a clergyman, as things go.
اگر بخوابد تنها در بیابان و آن هم مانند جانوران وحشی بر سر خاک است.	when he sleeps, if he sleeps at all, it is in the field on the hard earth like a brute beast.
من خواهش کرده بودم بیاین که یه دعایی به خونین	I ast you to come to say a prayer.
فورا میرم نامه رو میر سونم و می تونم بم وقع به سنگر برگردم	I will go and deliver the letter at once, and I shall get back in time.
تلاش من در برآوردن خواست مادرم که در ابتدا وجود سیه روز مرا بر سر راه شما قرار داد بی حاصل بود.	it was the always vain endeavour to discharge my poor mother's trust that first brought my fatal presence near you.
دستی سخت و قوی او را پس کرده و در را بسته	but a strong hand pushed him back
در این صورت از ضعفش حداکثر سود را خواهد برد.	she would only take advantage of his weakness
لوکوموتیو دوباره سرعت گرفت و از نظر ناپدید شد.	the engine plucked up heart again, and away they went.
پسر را به یاد آن روز در صحرا انداخت که اسب کیمیاگر را که روی دوپا بلند شده بود بالای سر خود دیده بود.	it reminded the boy of the day when that horse had reared in the desert,
سطری چند نوشت و توضیح کرد که چگونه خود را عمدا به کشتن داد	a sort of codicil, clearly explaining the nature of his death.
قیافه وال شاخ دار تماشایی و پلنگ آسا است.	pertaining to a land beast of the unicorn nature.
آستین بارانی را بالا زدم. آهسته آهسته به طرف دریا حرکت کردیم.	I unrolled the sleeves of my mackintosh caught by the sea spray.
پابرهنه رفتنو از پوشیدن این کفش بهتر می دونم.	I prefer to go barefoot.
وی در هر کار چندان از پند و اندرز من پیروی خواهد کرد	he would enter into any engagement to follow my advice
در تمام این مدت از عشق سرکش و مقاومت ناپذیرش به سوندرا حرف زده بود.	to the compelling and directing power of his passion for her
ناگهان مانند کسی که از خواب پریده باشد یکه خورد	at which he startled like one awaked on the sudden
به این فکر افتادم که شاید هر چه باشد	I began to think that after all
آرنج راستش را بر زانوی راست و مشتش را به زیر چانه نهاده بود	the right fist cupped for the chin.
بی درنگ در خواهی یافت که به راستی همین طور است	you will see at once that it is really so
که بال رفتن وی از پلکان قالی پوش را اعلام داشت روی پاگرد همان مجسمه قبلی قرار داشت به دربان سوم	that preceded him as he ascended the easy, carpeted staircase, and saw the statue on the landing, and the third porter at the top doors,
در حالی که کلاه سفیدم به تقلید از تابلو در دستم بود.	smiling, was my hat in my hand, like the girl in the picture.
جناح راست به گشودن آتش شدید به روی دشمن مبادرت کنند.	will open a heavy fire on seeing the attack commence on the right wing.
نفرت داشتن من از او به علت دیوانه بودنش نیست.	it is not because she is mad I hate her.
من از حال شما و از بدبختی که به شما روی آورده است خبر دارم	I have heard of you, and of your misfortune.
به او اطمینان داد اگر این امر با رعایت عاقلانه مقررات کلیسای رسمی همراه شود اشکالی ندارد	could assure her of his own agreement with that view when duly tempered with wise conformity
که تو هم مثل من باید دسته دسته عکس امضا شده همراهت داشته باشی	when, like me, you'll need to keep a stack handy
هیجده واگون پر از نظامی از جلو من گذشتند.	while eighteen open trucks
در دیوار پشت اژدر شکافی عمودی پدید آمد و مانند در باز شد.	as the wall behind him split in two.
سپس هر دو قشون با قوای کمکی جمع شده از هم وطنان که ساکن استان تحت فرماندهی شما هستند	instant, and both armies with their united forces will defend our compatriots of the province entrusted to your care till our efforts
اما مسلم بود که پس از باز شدن دوباره بسته شده است.	but it is certain that it had been closed again.
من هنوز هم برای خشم مقدس او احترام قائلم.	I love her for it now could add.
مردی دیگر در انتهای راهی را که او هموار کرده بود راهنما شده بود.	another man had shown her the end of what he had begun for himself
تمام گناهان مرد هرزه فاسد را نیز به این جهت خواهند بخشود که در تفریح و شادی افراط کرده است.	all will be forgiven him, for he enjoyed much.
تنها در آغوشش ایستادم و به او زل زدم.	just stood in his arms looking up at him.
با ظلمت و ان ده از در دیگر بیرون رفت.	moved in clouds and darkness out at one door.
تا سالگرد تولد کیت به لک ول را با او جشن بگیرند	ghosts come to help celebrate her birthday.
از ای نرو او ترا در این باره به جنایت متهم کرده.	so he accused you as a traitor on that account.
درک شخصیت یا قضاوت در مورد یک حادثه بیش و کم امری معجزه آسا را دارد.	some appreciation of character, or a judgment upon an event, bordered on the miraculous.
یک نوع مستی رخوت انگیزی به من دست داد.	I could smell the faint, soft magnolia scent as I sat here, on the lawn.
اما گفت بیم دارد که وضع و حالش او را بترساند.	but said he was afraid of frightening her by his condition.
من هفت تا کوچولو دارم که باید نان بخورند.	I have seven small children who must be fed.
چنین وانمود کرد که برای این حادثه اهمیت زیاد قائل است.	began to listen with some interest
با هر جان کندنی بود آن را دوباره به کف اطاق و درست در زیر پنجره کشو مانند سقف که تازه آن را گشوده بودم با پیچ و مهره متصل کردم	having made a hard shift to screw it down again, directly under the slipping board that I had lately opened
به اتاق خصوصی خود رفت و در انتظار آمدن کارهنین به باز کردن اسباب و اثاثیه پرداخت.	went to her own room, and occupied herself in sorting out her things, expecting he would come to her.
این صفت گران بهایی است که آدمی را از بد بودن بازمی دارد.	a preciousquality which prevents one from ever being wicked.
هر چند در واقع نتوانسته بودند پس از جستجو در آب انبار تا آن مقدار از ارتفاع کم که در هوای بالنسبه سنگین ممکن بوده نقطه نشر آب را پیدا کنند.	though, indeed, they could not find it after searching the hold as low down as was possible in rather heavy weather
قیافه و نگاه مردی را داشت که در هوای آزاد بسیار اندک زیسته بود.	he had the look of a man who lived too little in the open air.
زبانش صرفاً افزار سخن گفتن بود همین و بس.	his tongue a speaking instrument nothing more.
این مرد پدر آن کسی است که بیانیه را نوشته.	that's the father of the fellow who wrote the proclamation
این عمل را از صمیم قلب و ته دل انجام دادم و دست خود را به دور گردنش حمایل ساختم و او را در آغوش کشیدم.	which I did with great heartiness, and with both my arms clasped round her neck.
اتاقی بود که دلیلی نداشت دقت کنید کجا بنشینید.	it was a room where you had no reason for sitting in one place rather than in another.
ما در عوض هرچه در دل داشت برای او گفت.	to him he told all that was in his soul.
نمی دونم چطور با خونسردی ایستاد و داستانش رو تعریف کرد.	I don't know how he even stood up and told his
به نظرم ما هرگز نتوانیم درست بفهمیم چرا کسی چیزی را که ما دوست داریم دوست ندارد.	I suppose we never quite understand why another dislikes what we like, mother
سپس چون همه چیز در تاریکی فرو رفت کماندار گریخت.	then, all being in darkness, he went out
زیرا هردو بچه بدون سر و صدا از وسط خیابان رد شدند	for the two boys walked stealthily across the road
تا اینکه با آن روشنی که دیگر بازتاب بلکه احساس است	than to conceive with that distinctness which is no longer reflection but feeling
بیش از آن قشنگ است که مال این جهان فانی باشد.	TOO beautiful for this mortal earth.
من فقط از آشنایی با شما مفتخر و سعادتمندم.	I am only happy to have had the opportunity of making your acquaintance.
این بچه طفلک چقدر وقت این جا بیکار نشسته!	that poor lad sitting idle here so long!
آنان را از بالای حصار پرتاب کردند تا از بوی تفعن لاشه ایشان آسوده و راحت شوند.	they were thrown over the parapet and removed later on that they might not stink.
چند صندلی چوبین و یک تفنگ دولول آویخته به دیوار.	a few wooden chairs, and a double barrelled gun hanging on the wall.
از همان ابتدا سرنوشت خود را با او یکسان دیده بود.	because she always identified his fate with her own.
در همین ضمن از خیال خود منصرف شد و پرید روی گاری و روی چمدان من نشست	when he changed his mind, jumped into the cart, sat upon my box
دریچه را باز کرد و با یک خیز خود را به زمین رسانید.	but, opening the chaise door, leaped out
وب طور خیلی خودمانی نسبت به وقایع شب گذشته در موقع صرف شام مباحثه بکند یا ایراد بگیرد.	comments on the dress or appearance of the dinner contingent were exchanged in friendly confidence.
در حالی که اینک هیجان واقعی در شمال جریان دارد.	while up north the true world thundered by.
مرد دو قطعه چوب دیگر را نیز در سبد انداخت.	he threw two more billets into his basket
نقش حاشیه آن نظرم را به خود جلب کرد.	the embroidery in the corner caught my sight.
اون می خواد از تکنولوژی علیه ما استفاده کنه	gathering the tools of technology against us
زیرا که آمدن من شاید موجب خلاصی شما باشد	for it is for you that I came and my journey will be your salvation
قلعه رو دور زدم و به سراغش ون رفتم.	doubled around behind them, went to meet them.
پر و بال زنان یکدیگر را به خود خواهند خواند.	they will flutter their wings they will call upon each other.
زیر درخت سد ابی نشست تا توفان فروکش کند.	sat beneath a wilga to wait it out.
او و همراهانش در یک اطاق مخصوص جا گرفته بودند و	she and her party occupying a reserved family saloon.
یک راه پله را تمام کرد و بعد با خیال راحت شروع به خندیدن کرد.	got down one flight before the laughter escaped her and flew free.
برای رسیدن به بیمار من ناگزیر بودم از این قسمت بگذرم.	I had to pass through that part, to get at the other.
شنیده بودند که این جادوگر میتواند خودش را تبدیل به باد کند و نمیخواستند به او نزدیک شوند	they had already heard about the sorcerer who could turn himself into the wind, and they didn't want to go near him.
منظورم این است که گاه گاهی لازم است آدم غرغرویی مثل من برود و دلش را صفا بدهد.	I mean, sometimes it's agood thing for an old grouch like me to go off and get it out ofhis system.
معنای آن کاملاً مشخص شده و تمام معانی فرعی حذف و به فراموشی سپرده خواهد شد.	with its meaning rigidly defined and all its subsidiary meanings rubbed out and forgotten.
تازه روزاموند از بهترین تترون و کتان برای خود پارچه خریده تا زیر پیراهنی بدوزد.	she has begun to buy in the best linen and cambric for her underclothing.
موهایش بور بود و کت مخمل مشکی و شلوار دارای طرح اسکاتلندی پوشیده بود	fair haired, dressed in a black velvet jacket and tartan trousers.
در میان ایشان بانوی سفید پوشی است که بر زین راحتی نشسته است و او نیز بر چهره نقاب دارد.	with them there is a woman in white on a side saddle, whose face is also veiled
کابین درآمد تجاری نداشت و فقط برای مقامات مهم و میهمانانی بسیار عالی قدر در نظر گرفته شده بود.	had no commercial purpose but were reserved for high ranking officials and very special guests.
چنانکه گویی موضوعی نیست که در داستان یونس از آن چشم پوشید.	as if it were a thing not to be overlooked in this history
به نظر من از لحاظ اخلاقی کاملاً درست و بجا بوده است	I regard it as an act of virtue
امروز صبح قبل از این که بیدار به شه زدیم بیرون.	we left home early this morning before she got up
در باب شب زنده داری و پاسداری با سلاح رزم نیز آداب لازم رعایت شده است	that he had now done all that was needful as to watching the armour
موسوم به بازی خانه یازده هزار شیطان ساخته شده بود.	which was called the tennis groundof the eleven thousand devils.
بلکه برای خشنودی خاطر او حاضر به هرگونه فداکاری بود.	but felt ready for any sacrifice in order to satisfy him.
که راهزن بدون اینکه خود بخواهد اندکی خود را عقب کشید	that the housebreaker involuntarily drew back his chair
به چند تن از نوکران خود دستور داد تا بی درنگ به کاروانسرایی که چندان از آنجا دور نبود بشتابند	he desired some of his servants to go on to the inn, which was not far distant
دلیلی نداشت از سفری بی سوءنیت که پیش از این تصور کرده بود به آن دست نخواهد زد شرمنده شود.	there was no reason for him to be ashamed of having taken an innocent journey which he had beforehand supposed that he should not take.
یه ماشین خریدین و حالا اوم دین پس بدین.	you bought a car, and now you're squawking.
اگر قرار بود جای دیگری برویم شک داشتم ما را ببرد.	I only doubt whether he will ever take us anywhere else.
که چند بار خود را آماده ساخت تا همه چیز را ترک کند و از خانه بیرون بشتابد.	that several times she was on the point of abandoning everything and running away from home.
دایه جوراب را روی زمین نهاده به جانب پنجره رفت و سر را از پنجره بیرون کرده خواست لنگه پنجره گشوده را بگیرد.	her nurse, putting down the stocking she was knitting, went to the window and leaning out tried to catch the open casement.
پشیمان نیستی که به من اعتماد کردی و مرا به اینجا فرستادی.	you do not regret the confidence which you showed in me when you sent me down.
هر طور باشد امشب به خانه باز خواهم گشت.	I'll either break or burn a way out of the house.
عاقبت آقای میکابر متاثر و در گریه با من و زنش شریک شد.	the more he asked her to compose herself, the more she wouldn't.
روح زمانه این چنین او را در برگرفت و درهم شکست	thus it took her and broke her
وی برای آنکه تجارت را ایمن سازد و آن را به حق جلوه دهد	to make the transaction safe and lend a colour to it
همان دم از دنبال آن دست بدن صاحب آن هم پیدا شد.	instantly that hand was followed by the body it belonged to
توده خودتان هستید! من خودم به اندازهٔ شما بورژوا هستم!	I am as much of the middle class as you.
اما در افکارش در این مورد هیچ تیرگی و سیاهی ای وجود نداشت.	but he thought of it without bitterness.
که در ین میان یکی از درو گران بده قدمی برآمدگی شیاری رسید که من بر روی آن دراز کشیده بودم	when one of the reapers, approaching within ten yards of the ridge where I lay
تا چه حد مفید بوده و در میان مردم چه انعکاسی داشته مسأله دیگری است	in how far it was useful and had any effect on the people is another question
روحش آکنده از نفرتی تلخ تردید و حرص و آز و خشم بود.	a soul of gloomy hatred, irresolution, avarice, and fury.
اشک ریزان و فریادکنان تک تک و یک تنه او را آغوش گرفت	weeping, embracing, and shouting, all by turns and all together
سپس ابروان را در هم کشید و ساکت شد.	then he scowled and was silent.
این شخص با آن هیئت و لباس با کمال آسودگی در کالسکه نشسته	to see this rascal throwing himself heavily down on the cushion beside the young
ببینید که اگر وجود من به نحوی از انحاء برای شما مفید خواهد بود بگویید	remember, if you demand of me ought wherein I can render you a service
در راهرو با یک درخت کاج بزرگ مواجه شدند که راهشان را سد کرده بود.	they found a large fir tree blocking the corridor ahead.
اما بلافاصله با دیدن زن جوان بیست و چهار پنج ساله و زبروزرنگی که سرگرم کمک به این داروساز بود از تصمیمش منصرف شد.	only, as he could see from the front, he was being briskly assisted by a young woman of not more than twenty or twenty five.
اما اگر این ضربه از پهلو و از میان آب مقاوم بیاید	but if it comes sideways through the opposing water
بعد از آن صدای حبس شدن نفس کسی به گوش رسید.	a gasp from within the stall
به چش ماش نگاه کن ین تا بفهم ین قضیه از چه قرا ره.	watch his eyes, that's where you see it
زیرا اگر چه نخستین بار از خوردن آن ابا کرده بودم	for although I had refused them at first
نیمی از جسد او درون و نصف دیگر در خارج از چادر بود.	half in and half out of the sleeping bag
زیرا داستان شفاهی به پیچیدگی و پرآب و تابی روایت مکتوب نیست.	for the spoken story was never so rounded or so finely coloured as the written.
اون سعی کرد تو رو هم بک شه ولی نتونست.	he tried to kill you, too.
اما هیچ کجا برای فاش کردن اسرار میان دوستان مثل رختخواب نیست.	but there is no place like a bed for confidential disclosures between friends.
این سر پدرم بود که در بالای دروازه نصب کرده	, pointing as she did so to a head which was placed over the gates
اما موفق به شلیک گلوله درست بر روی نشان صلیب خاکستری نشده بودند.	but they had missed the cross of ashes.
دستور اخیر فورا به اجراء در آمد و برای فرد متخلف هم احضاریه صادر شد.	then the offender arrested and ordered arraigned on the following morning.
حال نوبت دیگران است که تکلیف خود را به عمل آورند.	now let others do theirs.
من دور از تو چنان پریشانم و از تحمل بار هجران تو چندان ناتوان	I find myself so ill at ease without you, and so incapable of enduring this separation
سعی کن شاید مرا به اسم یکی از خویشان خود در خانه او جای کنی.	I wish you would try and find me a situation with him as grandfather, since he holds the money chest!
من تو رو می خوام و تورو برای همیشه می خوام.	I want you, and I want you forever.
بهتر است در آفتاب میان نور قرار گیرید که بهتر شما را ببینم.	nearer, come nearer the light! I want to have a good look at you.
که در ابتدای این حکایت شرحی از او دادیم	with which our readers were made familiar at the beginning of this story.
زیرا که من حاضرم جامه خود را پاره کنم.	for I was ready to strip myself.
این آن چیزهائی بود که به خواهرش تعلق داشته و یا با خاطرهٔ او در هم آمیخته بود.	those which had belonged to his sister or were bound up with her memory.
او آن را پشت سر خود بست و قفل کرد.	she shut and locked it behind her.
که در خلوت اتاق ملاقات با مادرش حرف بزند.	he was permitted to talk with his mother alone.
طبق معمول برای پیدا کردن جایی گرم و نرم نگاهی به این طرف و آن طرف انداخت	who looked round, as usual, for the warmest place
ناگهان با صدایی آرام و کوتاه که شبیه ناله بود رفت سراغ اصل مطلب.	gave it up suddenly with a low little sound that resembled a moan.
زیرا که بعد از این ملاقات نخستین ملاقات دومی هم دارم که در پیش من کمتر از ملاقات اولی نیست	for after this first visit has been paid I have another which I am most anxious to pay
بر آن شد که از پذیرفتن پیشنهاد سر باز زند.	he decided to refuse
هرگز قادر نخواهند بود او را با تصویر استاندارد یک مادربزرگ تطبیق بدهند.	they were never able to connect her with the standard image of a great grandmother.
بر تیرک بزرگ کشتی چراغ مشتعلی را میخکوب کرده بودند.	nailed to her main truck was a brazen lamp.
سرعتم را کم کردم و بعد چند قدم به عقب برداشتم	I slowed and then paced back a few steps.
اسکار لت ناگهان از تعجب دست بر دهان گذاشت و تازه یادش آمد که او را کجا دیده است.	her hand went to her mouth in horror, for she knew who he was.
که با وجود آن سپر مطمئن گفتی کوهی گران بر سرش کوبیدند	smiting him full over the cushion and over the head, that even so good a shield proving useless as if a mountain had fallen on him, he began to bleed from nose
جنگ و گریز آغاز نهادند و به حمله و دفاع دست بردند	attacked and retired
از او خواهش کرد بی سر و صدا آن را ببند و خود به جستجوی چراغ رفت.	requested him to close it softly, while he got a light.
همه نیروی ذهنیش به سوی نیکی و حقیقت کشش داشتند.	the reaching forward of the whole consciousness towards the fullest truth, the least partial good.
بنابراین تو نباید کاری بکنی که دیگرون خجالت بکشند.	so you oughtn't to say a thing to another person that will make THEM feel ashamed.
سپس اولین ارتباط فیزیکی با شوهرش را انجام خواهد داد.	allowing the first contact with her husband.
خواهش کردم بگذارد بروم و هوای پاکیزه دریا را در سینه فرو برم	desired leave to take the fresh air of the sea
از خودش که این طور بدمهمان شده بود تعجب کرد.	on the ungracious sound of his words.
چون برگ توتون باید شبی که ماه قرص کام له چیده به شه	since the fluxweed has got to be picked at the full moon
اما باز فکر کرد که معنی آن این است که خبط کرده	she judged that this would be construed into a confession that she had been in the wrong
از آجودان پرسید که آیا به وی اجازه داده خواهد شد	asked the aide de camp whether
حتی قتل موجودی که بیشتر از هرکسی مورد تنفرم است.	even of what I most hate.
اما هنوز هیچ فکر بکری به ذهنش نرسیده بود	no stroke of brilliance came to him
با فریادی پر از شور و شادی به دل آب زد.	dashed into the sea with exultant cries.
به پایان رسد تا مطلبی را به او بگوید.	in order to tell him something.
جز پای بز و گرگ و سایر جانوران وحشی به آن نرسیده است.	or never trodden except by the feet of goats, or of the wolves and other wild beasts that roamed around.
از لبه قایق بالا رفت و رو به روی ناخدا ایستاد.	climbing the gunwale, stood face to face with the captain.
زیرا شما اگر چه سر مرا هدف گرفته بودید	aiming at my head and hitting me on the shoulders
راضی بودم به جای اظهار آن رنجش ملامت زا راه حلی پیدا کنم تا احساسات خود را با ظاهری کمتر شرورانه ابراز دارم.	fain find nourishment for some less fiendish feeling than that of sombre indignation.
اما هدفش نه عدالت خواهی بلکه نشان دادن عطوفت و مهربانی بود.	her ideal was not to claim justice, but to give tenderness.
تابلوی بزرگی را که روی آن نوشته بود خراب است نادیده گرفت	ignoring the large OUT OF ORDER sign
نخستین ایام عشق با همسرش و دوران آبستنی او را به یاد آورد	he remembered the days when he first loved her.
ایشان را به چمن سبز و خرمی هدایت کرد که در پس صخره سنگی در همان نزدیکی بود.	he led them to a green plot which lay a little farther off round the corner of a rock.
اما بالای آن باز است و پرده جنبی متحرکی دارد	he being the original inventor and patentee
او را نشان داد و سرش را تکان دا	nodding towards him
من این جام تا برای یه چیز دی گه شهادت بدم.	I stayed to witness something else.
چون نزدیک او بودم این تشنج را که حاکی از خشم یا ناامیدی بود کاملاً حس کردم.	near to him as I was, I felt the spasmodic movement of fury or despair run through his frame.
سر پیچ به درشکه دو چرخی کوچکی که به یک اسب سفید بسته شده بود	with a little tilbury harnessed to a white horse
این تفریحات برای او هدف زندگی و پایان کار نبود.	these pleasant activities were not the end and aim of life to him.
من به نوبه خود نخست مصرانه از وزیر تقاضا کردم	I, for my part, begged him personally most urgently
برای تعمیر حصار دور پارک که پانزده مایل مساحت داشت چه مبلغی لازم بود	how many hundredweight of nails at fivepence halfpenny a gill were needed to repair the fence round the park, which was fifteen miles in circumference.
برای این سفر دریائی یک زورق مناسب سه دگلی در اختیارم بگذارد.	I should be provided with a small convenient bark for the voyage.
آب به اسب من بدین و تم وم به شه.	let my horsebe watered, and let that be the end of it!
در همین دو بار هزار و پانصد فلورین باختم.	with the result that, in all, I lost fifteen hundred florins.
اما به زودی اسبابی فراهم آمد که از ین کار پشیمان شدم	which I had soon too much cause to repent
شروع به دویدن کرد ولی پایش به چیزی گیر کرد	broke into a run he tripped
لنگان لنگان خود را به طرف بالای کوه کشیدم.	as I hobbled towards the upper valley
ابتدا برای کارهایی که داشت ترتیبی از پیش داد.	he arranged his occupations beforehand.
زندگی خصوصی که هرچه علایق مادی آن کمتر باشد آزادتر است	his individual life, which is the more free the more abstract its interests
برای مردمی که زیر پرچم عقاب نشان روسی گرد آمده بودند نطقی ایراد کرد.	under the sign of the eagle, began to address the assembled people,
باز توئی که من بهتر از هر کسی دوست دارم.	I still love you the best.
نوشته های مربوط به اقتصاد سیاسی و آثار سوسیالیستی را درباره ی این موضوع میخواند	he read both the economic and socialistic books on the subject,
یک ساحل در طرف راست برج فانوس و یکی دیگر در سمت چپ.	one lay to the right and the other to the left of the lighthouse.
هیچ هفته نبود که برای استخفاف او چند سطر موذیانه در ستون خبرهای کوتاه روزنامه ننویسد.	not a week passed but there appeared in the column headed _Echos_ a spiteful paragraph ridiculing him.
بخار خنکی از روی رودخانه به هوا متصاعد بود	a cool mist rose from the broad river
هم اکنون منظور واقعی خود را از این جریان برای تو شرح خواهم داد.	I'll inform you of its whole scope
که نزدیک است این دلبستگی پیدا شود باید آن شیئی را بدهند.	that they are growing attached to this object, they must give itup.
بیخود نیست که هاگ رید این موضوع و مخفی نگه داشته	but'blimey, no wonder he keeps it quiet
قبل از آن که نامه برسد حسابی به اضطراب افتاده بود.	before the letter arrived, had worked herself into a state of real distress.
سربالایی آن قدر رفتم که به سر جزیره بتوانم برسم بعد به آن طرف رفتم	I went up stream far enough to make the head of the island, and then started across.
از تمامی علقههای زندگی به منافع هنگ و دوستانش بیشتر دلبستگی دارد.	of all the interests of life had the interests of his regiment and his comrades nearest to his heart.
بلکه چشمش پیوسته از چیزی به چیز دیگر در گردش بود.	his eyes continually wandered from one object to another.
دوباره در نیزار فرود آمدند و برجای خود نشستند.	to settle again to their places in the swamp.
چون که کمیته میخواست فرعی را بشنود گزارش سران چند کمیته.	because the committee was going to hear reports from the heads of several subcommittees.
به وضعی دچار شده بود که اکنون در آن بود	lost in the sphere she had now chosen
که سر کارد شکسته و داخل سینه کنت نگردید.	the knife, instead of piercing the count's breast, flew back blunted
من دی گه نمی تونم این جا بمو نم.	I can't stand much more of this
پس از سه ماه توانستم جوابهائی به او بدهم که چندان بد نبود.	in three months, could give him some tolerable answers.
فقط گفتم هیچ احدی به غیر از تو تا به حال به من نگفته دوستم دارد.	I only said that no mortal ever made love to me besides you.
شتاب داشتند که هرچه زودتر به کاروانسرایی که در کمتر از یک فرسخی آنجا پیدا بود برسند	in haste to take their noontide rest as soon as possible at the inn which was in sight not a league off.
یک نوع اتاق زیر شیروانی به اندازه وسیع بود	was a kind of moderately spacious attic
گویی انتظار داشت کسی را سر پیچ بعدی ببیند.	as if she expected to meet some one round the corner.
ولی او را با همراه آن مرد اخمو به بیرون نفرستند.	rather than send him away with that dreadful man.
به نظرم قدری هم مرطوب بود مثل اینکه زوبین انداز اسرار آمیز یک روز بارانی آن را به تن کشیده بود.	I thought a little damp, as though this mysterious harpooneer had been wearing it of a rainy day.
من به خاطر همین ساده دلی است که او را به اندازه تخم چشم خود دوست دارم	for this simplicity I love him as the core of my heart
اگر اجازه بفرمایید مطلب دیگری هم به عرض حضار برسانم.	if you would allow me I should like to make a further statement.
با مردی ازدواج کند که ثروتش با طرز تربیت او هم خوانی داشته باشد.	she might meet with a husband whose wealth corresponded to her habits.
چه در زمینه لاستیک و چه در هر زمینه دیگر تجارتی	whether in rubber or in some other area of trading
بد نیست تا حدی در اینجا به تفصیل بپردازیم.	let us in some measure expatiate here.
اکنون هوا و هوس من منحصر در پیدا کردن تقصیرات دیگران	I never rest till I have torn the disguises from my fellow creatures
معلوم ساخت که صاحب مسافرخانه در هر حال قصد دست انداختن مرا نداشته	showed that the landlord, after all, had had no idea of fooling me
این است که ما باید به قول معروف شبیخون بزنیم	so we would lay in ambuscade, as he called it
دلی که به راستی حداقل دو لیور وزن داست.	indeed it must have weighed more than two pounds
اما با این فکر ناگهان قایق را به دست باد سپرد و سرعت را کنترل کرد.	but at this thought by a sudden touch of the tiller he threw the lighter into the wind and checked her rapid way.
حتی اگر مثل حالا نا نخور زیادی و بی کس هم بودم	though equally dependent and friendless
همچنین من تفاوتی در آموزش و پرورش پسران و دختران به علت اختلاف جنس ندیدم.	neither did I perceive any difference in their education made by their difference of sex.
بعد هم با رضایت خود اورسولا او را برای چند ماهی به آسایشگاه سربازان برد	for several months took him to live in the barracks, with 'rsula's consent
اکنون خشکش زد و سپس به کلی از هم وارفت.	now stiffened and then wilted.
هیچ علتی ندارد من خود را از کسی پنهان کنم.	I have not the slightest reason to hide myself from anyone,
شما بهتر است سوار اسبتان بشوید و هر چه زودتر به خانه برگردید.	you'd better be riding home
می دونم که دلش ون به حال من میسوزه	I know they're sorry.
موجی عظیم در راه است و تو برفراز آنی	there's a great wave coming and you're on the top of it,
شاید در خانه نباشد و تو بتوانی در جلسه به سراغ من بیایی.	perhaps they'll not be at home, and then you can come to the meeting to fetch me.
درست قبل از آن که در را باز کند	just as the door opened.
اما به نظرش رسید که دختر همان دختر نیست.	but it seemed to him that it was no longer the same girl.
بی آنکه فرصت تفکر و مطالعه داشته باشد و بداند که این حرکت سریع به کجا منتهی خواهد شد.	with no time to consider what this movement might lead to.
حرفی زدم و او را از جا پرید و جیغ کشید.	I spoke to her, and she started, and cried out.
نیمه برهنه در حالی که به جای اسلحه فقط تکه چوبی داشتند که چاقویی به نوکش بسته شده بود .	half naked, with often only a knife tied to a stick for a weapon.
یه جا خوندم که وقتی مردم 28 سالش ون می شه دچار این اختلالات می شن.	I read that people get those when they're twenty eight.
بلافاصله تقاضای یک کت و شلوار حسابی کردم که کتش مد روز بود. آن روزها کت کمری مد بود	I instantly started demanding a 'grown up suit', with a kind of coat that was fashionable at that time, a 'cutaway', I think it was called.
که تأخیر بردار نبود و تنها او میتوانست پاسخ دهد	which did not admit of delay, and which only she could answer
در نگاه او چیزی آتشین و مشکوک نهفته بود.	by something fiery and suspicious in his glance.
یه مقدار از این که زودتر به من نگفته بودی رنجیده شدم.	I'm a little miffed that you waited so long to tell me.
خوشبختانه مجروح همان مردی بود که تفنگ شم خال در دست داشت.	lucky it was for him that it was the one that had the musket.
پادشاه جزیره به علت ظفر یافتن در جنگ بزرگی که در آن پنجاه تن از دشمن تا ساعت دو بعد از ظهر کشته شده بودند بر پا کرده بود	on the gaining of a great battle wherein fifty of the enemy had been killed by about two o'clock in the afternoon
آن را رد نکردم چون خیلی اشتها پیدا کرده بودم.	I did not refuse it, for my appetite was awakened and keen.
چون ابزارها سست بودند چند بار در حال چرخ و غلت به روی عرشه بپر تاب شده بود به علت آنکه با وجود گذاردن مانع باز هم سکان بایست آزادی عمل داشته باشد	even though preventer tackles had been attached to it for they were slack because some play to the tiller was indispensable.
صراحی پهن مذکور نیز تا در آن امتداد داشت.	the broad balustrade going all the way up to it.
که گویا باید آخرین گفتگوی لازم را با او در میان بگذارد.	looking as if she had to give some final necessary instructions.
به من بگویید که موضوع رنج و اندوه شما چیست	what is the nature of your trouble
رقت و کنجکاوی ما را بر آن داشت تا راه خود را کج کنیم	out of curiosity and pity we left our direct road and resolved to come
هرگز به او نخواهد گفت گرچه ممکن بود که او اندکی بعد در اینجا بمیرد.	would never let him know even though he died here later, as well hemight.
ولی در صبح آن رو زخبری در آنجا نبود.	but there was nothing that morning.
تفنگ را به جای خود گذارد و روی عرشه رفت.	returning the gun to the rack, he went to the deck.
یعنی ابتدا از افسران ارشد و تیمسارها شروع خواهد کرد	at that moment starting with the generals
سراپا به لرزه درآمده بود و گویی دچار سرمای سختی شده	shuddering as though some deadly chillness were passing over her
ولی به شرط اینکه به پهلوان مغلوب فرمانی داده نشود و تحمیلی صورت نگیرد که از حدود مقررات و قوانین پهلوانی خارج باشد.	provided what is commanded and imposed upon the vanquished be things that do not transgress the limits of chivalry.
یادت میاد اون روز بهت گفتم تو زندگیم رو تباه کردی	I know I said you ruined my life the other day.
به خصوص که تونس تن این موضوع رو از من مخفی کنن!	not least, keeping it quiet from me.
یعنی اگر سود خالص سفر را هر مبلغ که باشد به دویست و هفتاد و پنج قسمت کنند یک قسمت یا یک جزء سهم من بشود.	if we had a lucky voyage, might pretty nearly pay for the clothing I would wear out on it
من هیچ وقت نفهمیدم که این چه جور مجازاتی است.	I never could understand how it was a punishment.
به همان نسبت میانشان با واقعیت نیز ارتباطی وجود نداشت	yet equally unconnected with anything that was real
از راه لطف و تفقد او را به حضور پذیرفته است رنجیده خاطر شده بود.	was making a favor of receiving her
بی درنگ او را به مجالس آتی خود دعوت کردند	as promptly invited him to affairs of their own
ولی برایش دشوارتر است که در چنان پایگاهی دوام آورد.	but it is more difficult for her to maintain her grip on them.
که من دوران کودکی و جوانیم را گذرانده بودم	where I'd been a child and a boy and a young man
شلاق را کشیدم به جان مادیان و هنوز ده دقیق نشده رسیده بودیم.	I whipped up the mare and we were there under the ten minutes.
ولی بعد گروه دوستان نزدیک را تا در خانه همراهی نمود.	but she accompanied the last group of intimate friends to the street door
اما قبل از آن که کاغذ کادو را به طور کامل باز کند	but before he could unwrap it properly
اصلا به یاد ندارم که حتی یک دفعه منو ملامت نکرده با شه.	I cannot remember when the old gentleman did not disapprove of me.
من تصمیم گرفتم او را تشویق کنم تا هرچه زودتر برود و بیش از آن در حیاط نایستد.	I resolved to encourage him.
با این همه تا آنجا که از دستم برمی آمد کوشیدم که مانع از نفوذ آب شوم.	I endeavoured to stop them as well as I could.
اما من عقیده داشتم که حضور او به سود ما بود	but I really believe his presence did us good.
از وفور ثروت دنیائی که این دختر جزئی از آن بود بیش از پیش به حیرت افتاد.	was all the more overawed by the plethora of the world to which she belonged.
اکنون با تمام استقامتی که در خود سراغ داشت و در عین حال با لرزش سرد و پنهانی در دل اعلام کرد که همواره حقیقت را گفته است.	announced, with all the firmness thathe could muster yet with a secret quavering chill in his heart that he had sworn to the truth.
اما دست سرد احتیاز او را از این کار منع کرد.	but the cool hand of caution stopped her.
چون تو هیچ نوع تجربه فنی نداری نمیدونستیم چکار کنیم.	kind makes it very difficult for both of us.
فقط منظورم این بود که خیال شمارو راحت کنم.	I only thought to ease your mind.
در غیر این صورت تو تنها کارها را به روب راه خواهی کرد.	otherwise youll manage on your own, I reckon.
این یک به نوکران امر کرد که آرام بگیرند	who told the four servants not to be uneasy
من نفر دوازدهم بودم که برای رقص با او اسم نوشته بودم.	I was the twelfth on her list
امیدوارم زیاد طول نکشد که خودش هم به این نتیجه برسد.	I hope it will not be long before he does.
خود نیز چندان در خور عزت و حرمت بود	so estimable herself
پیش از بستن در به آخرین نگاه یهودی با حرکتی مهرآمیز پاسخ گفت.	answering his parting look with a nod of intelligence, closed the door between them.
من باید برای آخر هفته به مسافرت دیگری بروم.	I'll have to go away again at the weekend for another trip.
در هنوز باز بود و خدمتکار کنار در ایستاده بود.	the servant still remaining at the open door
یعنی اسب سیاهی که سوار آن ترازوئی در دست دارد	the black one whose rider holds a measure in his hand.
ناخدائی که ممکن است در هر لحظه تغییر عقیده بدهد	a captain who could at any time change his mind
متوجه شدم که هیچ کس از جایش تکان نخورده بود	I realized that no one had moved.
اما یقینا مثل ادمی که قصد خوکشی داشته باشد نبود.	but she certainly didn't strike me as being suicidal.
چشمش به گروهی از این افراد افتاد که فاصله چندانی با او نداشتند.	his eyes fell on a huddle of these weirdos standing quite close
از آن شکل سر صحبت باز کردن خوشش آمده بود	delighted at her mothers overture
غیر از این بیش از دو هزار دلار دیگر به شما بدهکارم	I owe you over two thousand more.
وقتی در ساختمانی که برای 400 نفر ساخته شده 9 نفر زندگی کنند معلوم است که جا برای آن 9 نفر کمی گل و گشاد است.	when nine people occupy a house that was built for four hundred, they do rattle around a bit.
او را از آن مغاک سردرگم بیرون آورده است.	for having been rescued from the intricate labyrinth
آنان این نکته را به گوش مأمور گمرک رسانده بودند و همین که به خشکی رسیدیم او به دقت سراپای مرا جستجو کرد	whereof these gave notice to a custom house officer, by whom I was examined very strictly upon my landing.
با آنکه وقت پیاده شدن یعنی موقع صرف غذا بود و معهذا تصمیم گرفت وارد آنجا نشود.	he could not bring himself to enter it though it was an hour when he might well have done so, for it was dinner time,
که در باز شد و شخص ناشناسی وارد اطاق شد.	when the door opened once more, and another figure appeared.
من قسم خوردم که همه چیز را به او بخشیده	I swore that I forgave her everything
که در چه وضع عجیب و مشکوکی گیر کرده است.	suspicious were all the circumstances surrounding hispresent position.
مادر و پدر و برادر مات یلدا سوار ماشین شدند و ماشین زوزه کنان از آنجا دور شد.	then the mother and father and brother were inside the car and the car was pulling away with the tyres screaming.
یک آستین خالی نیم تنه او مثل آستین ابریشم دوزی پالتو سوار کاران از پشت او روان بود.	one empty arm of this jacket streamed behind him like the broidered arm of a hussar's surcoat.
آنگاه به آسانی از روی بناها گام برگرفتم و از ین چهارپایه به آن چهارپایه پا نهادم.	I then stept over the building very conveniently from one stool to the other.
تا حالا حرفی در این باره با من نزده.	he's never mentioned it.
در حضور همه که پس از مراجعت از تآتر سر میز چای نشسته بودند	at tea to which all had sat down after the opera
هردو در پنهانی آخرین قطعات کیک و ساندویج باقیمانده را مثل خدمتکاران خانه خوردیم.	we crumbled up the remains of the scones and ate them, feeling like conspirators.
من که از پیدا کردن کاترین خوشحال شده بودم و خاطرم آسوده شده بود با ظاهری عصبانی گفتم	I exclaimed, concealing my joy under an angry countenance.
همچو حرفی با من نزنید! از خودم بدم خواهد آمد.	don't tell me that! I should hate myself.
در صورتی که مسئله راجع به شرافت و موقعیت کسی است	which concern the honor
سن و سالم آنقدر هست که در حکم پدرتان باشم.	I am old enough to be your father
لکن این شبهه نیز بعد از آنکه آن ثبات قلب و فراغت خاطر را از دانتس مشاهده کرد که دانتس نه از اهل زندان و نه از مأمور گمرک است زائل شد	but this supposition also disappeared like the first when he beheld the perfect tranquillity of his recruit
در این موقع انبوه کثیری از افراد در کنار گردان دوم جمع شدند.	a large crowd had gathered near the second battalion.
اما نه با چشمانی به لطافت چشمان روت بلکه با چشمانی که خوش ظاهر و سرسخت بودند.	but with eyes that were handsome and hard,
ولی دیگر به رنگ عسل نبود. رنگ حلبی داشت.	but it was the color of aluminum, not honey
اما شیرین کاری با لامپ اتاق را تصادفی انتخاب نکردم.	I didn't randomly choose to experiment on the light bulb.
از جایش برخاسته مسیر آن را به طور معکوس در پیش گرفت.	in search of its origin she went through the pantry
کشیش در جواب گفت که فعلا فقط باید برای او دعا کرد!	the priest replied that there was nothing to do now but pray for her.
هرگاه بخواهم پس از ظهر همین روز قایق بن گن را پیدا کنم	if I were to find the boat that evening.
اما هیچ ذکر دیگری از دعوای حقوقی دیگری وجود نداشت.	but there was no further mention of any lawsuit.
هر کی یه نگاه تو صورت شما بک نه فکرتونو مثل کتاب میتونه بخونه.	I don't want no better book than what your face is.
وقتی هم مرا در آنجا مدفون سازند بهتر آرام خواهم گرفت.	you'll have a better chance of keeping me underground, when I get there.
چون درست روز بعد مجبور بود برای مدت کوتاهی به لندن برود.	whither he was obliged to go the next day for a short time.
باید اعتراف کنم که اندکی به هیجان آمده بودم.	I confess that I was a little excited.
پس از اینکه با اشارات سر و مطالبی که آهسته با دخترک رد و بدل کرد و موفق شد او را مطمئن سازد	after he had reassured the girl, by dint of friendly nods and muttered encouragements.
که من و همکارانم قصد خرابکاری و حتی انقلاب داریم.	that there was something subversive and even revolutionary in the outlook of himself and his colleagues.
صدای خنده روشن او را در گوش خود ایجاد نموده	I would recall the tones of that clear laugh
نگاه کینه آلودی بس وی گل شکفتهٔ خاور افکند.	staring fiercely at the happy rosiness of the east.
آن هم موقعی که جسد شوهرش هنوز در قبر سرد نشده بود.	when the body of her husband was still warm in the grave.
روی تختش به حالت درازکش در نور ماه معلق شد.	suspended in the moonshine.
جوان پاک و دلیر پشت به آشپز کشتی نمود	this brave fellow turned his back directly on the cook
یک جفت جوراب به پنج فرانک به شما فروخته خواهد شد.	that pairof stockings for five francs.
فکر نکنم دیشب تصمیم به انجام کاری گرفته باشم.	I don't know if I decided to do anything last night, he muttered.
بلکه برعکس چه راش غیرطبیعی و در نتیجه نامطبوع شد.	on the contrary it gave her an unnatural, and therefore unpleasant, expression.
پسرکی را که در پایین مخفی شده بود صدا کرد.	called to a boy who had been hidden somewhere below.
تا زانو در نوعی از گرد و خاک فرو رفت.	found himself up to the mid leg in a sort of dust.
چون ناخدا معتقد بود که سیگار کشیدن برهنه نحس است.	because he had the superstitious belief that smoking naked brought bad luck,
ولی پیش از هر کار دستست را به من بده	but reach me here thy hand
حالا هم که در حال مرگ بود همچنان از من نفرت داشت.	dying, she must hate me still.
اما من یه خورده بیشتر از بیست سال پیش گاز گرفته شدم	but I was bitten a little over twenty years ago.
خود از ترس اینکه مبادا مورد خشم و عتاب آن پهلوان جسور و غضبناک واقع شود ناگزیر از گشودن در قفس شیر نر است	that it was impossible for him to avoid letting out the male without incurring the enmity of the fiery and daring knight
که از اداره کردن زندگی فردی خویش هم عاجز بودم.	to undertake the whole charge of my own existence, that often
هرگز از من خواسته نخواهد شد که برای چنین چیزی مجادله کنم.	I shall never be called upon to contend for such another.
منظورم این است که او حتی یک بار هم به من نگاه نکرد	I mean he didn't even like look at me once
می تونم برات اب انبه و موز بگیرم و برای تمدد اعصاب گل بابونه هم توش بریزم.	I could make you a mango banana blend with camomile flowers, throw in some soothing nutmeg.
پیر گفت این کادروس همواره ما را دوست دارد	said the old man he is so much attached to us
که پس از گرفتن گربه ترکش گفته و در چند قدمی میز بر زمینش گذاشته بودند دیده بود.	which they had abandoned for the catand had left on the floor a few paces from the kitchen table.
بلی باید هرچه زودتر این کار صورت بگیرد و چند نفر از شر وجود چنین موجود خبیثی آسوده شوند.	it's time to make an end!
شیاطین دارن رو بدنم ون تاخت و تاز می کنن و این توهم تنها راه نجات ما از درده.	demons ravaging our bodies, and this is our only way out of the pain.
با آرامش کدبانویی مهربان مبل روبروی خود را به او تعارف کرد	pointing to a chair opposite, with the quietude of a benignant matron.
از میدان گذشت و حتی نگاه خود را هم بالا نیاورد.	until the child of his vision had crossed the plaza, looking to neither the left nor the right.
بدون شک به مقدار کافی پول بدست آورده بودند.	they'd no doubt earned.
شاید در این صورت قلب مأیوس جنایتکار آخرین اثر ایمان را از دست بدهد	perhaps then a fearful thing would happen, perhaps the despairing heart of the criminal would lose its faith and then what would become of him?
چوب دستی من یه ذره زیادی هیجان زده شده.	my wand is a little overexcited
حتی پس از آن که برای دخترانش ازدواجی ترتیب داده بود که تنها آرزویش بود.	even after he had obtained for his daughter the successful marriage that had become his only reason for living
هر جا که بودند از گذراندن ساعات فراغت و خوش گذرانی هم غافل نبودند.	but wherever they went they carved out moments of time for themselves.
ضمناً امیدوارم که حال شما هم خوب شده باشد.	I hope you're feeling better.
که سرنوشت دختر جوانی که جشن نا مگذاری اوست باید در آن روز تعیین شود.	that the fate of the young girl would be decided that evening.
شاید حتی اصلاً به گوشش هم فرو نرفته بود.	it did not go in at all.
با قیافه ملامت بار از کالسکه بالا رفت تا جای کنتش را مرتب کند.	but with an aggrieved look on her face, hastily got into the coach to rearrange the seat.
حاضر بودم که آنچه پول داشتم بدهم تا اجازه بدهند که شبانه وسایلم را ببندم و با کفش و کلاه بخوابم.	I would have given any money to have been allowed to wrap myself up over night, and sleep in my hat and boots.
باید یادتان بیاید که چقدر مطالعه زیاد حساسش کرده.	you must consider how sensitive he has become from the wearing effect of study.
در حال حاضر که ظاهرا رده بندی جدیدی پیدا شده	now that there seem to be new classifications.
یکی دو مرتبه هم ما را در قایق سوار کرد و گرداند.	once or twice he took us for a row.
شاید تنها وفای پایدار جما بود که توانست او را از یأس برهاند.	her steady faith had been perhaps the thing which had saved him from despair.
فوراً حیوان را از آن وضع نجات دادم و به طرف عمارت رهسپار شدم.	I quickly released the animal, and lifted it into the garden.
آن گاه سر به سمت آخوری گرداند که پشت آن ایستاده بودند	nodding towards the horse box, before which they were standing,
کاش هیچ کس عیب بدتری در او پیدا نکند.	I wish no one said any worse of him.
بعد از آن دوستی نا برازنده با مردی که زمانی همسرش دلباخته او بود	forming inappropriately friendly relations with a man with whom his wife had once been in love
گذشته از اینکه در این اواخر روابط من با این آقا سرد شده و بریده بود.	for of late that gentleman and I had stood on the most strained and distant of terms
تا وقتی که دیگر بیرون از جنگل و درست در جلوی او ایستاده بودم.	until I was out of the woods and I was standing right in front of her.
بنابراین من آن روز را در باشگاه خود گذراندم	I therefore spent the day at my club
که چه فاصله زیادی را در حالت ترسان نیمه گیج خود طی کرده است.	e must have walked an incredible distance in his semidaze of fear.
اما اگه گذاشتی از طرف تو رد به شه	but if you let him get away
اما چون هوا روشن گردید و در روشنایی روز به دقت ملاحظه کرد محقق شد که فاریا فوت شده و بازگشت دیگر محال است	but as soon as the daylight gained the pre eminence he saw that he was alone with a corpse
فی الحقیقه حسود هم دشمن حقیقی من بوده است	for this envious person is a real enemy
منم حسابی خسته شده بودم و توی کرجی دراز شدم و گفتم هرچه باداباد.	I was good and tired, so I laid down in the canoe and said I wouldn't bother no more.
ولی در زندگی چیزی نیست که من دوستش داشته باشم.	there's nothing in life for me to like.
از لحاظ خانوادگی بر پزشکان روستایی دیگر برتری دارد.	he was better born than other country surgeons.
بلکه همه معتقد بودند که کار صحیح و درست همان بود.	but that had seemed the only thing to do.
نه عزمش برای ایستادگی در برابر گیجی و تمایل به رها کردن متزلزل گردد.	the determination not to be put off, not to be bamboozled.
کش و قوسی اومدم و به این نتیجه رسیدم که به اندازه کافی استراحت کردم تا بتونم کمی کار انجام بدم.	I stretched and decided I was rested enough to get some work done.
نیمی از قصبه سوخته است و جز تیرهای سیاه شده چیزی از آن باقی نمانده است.	nd half the huts were burnt down, there were only the charred beams sticking up.
به محض اینکه از جنسیت نوزاد مطلع شوم به تو خبر خواهم داد.	I'll let you know as soon as I check out the plumbin'.
تا هفته پیش کل اصطبل آتش گرفته بود و کام لا سوختهب ود.	the barn would have burned merrily to the ground a week ago.
می دون ستم که اگه بهت زنگ بزنم جواب نمی دی.	I knew you wouldn't listen if I called.
این موضوع اورا وادار کرد که ازترس و وحشت خرناس بکشد	something that terrified him into a series of soft whimpers
اما تمام قوه متخیله را صرف کرد بر اینکه نقشه در ذهن خود ترتیب بدهد که از آن قرار رفتار نماید	but it brought reason to the aid of imagination
پس شهریار بالاستحقاق آن است که ملت او را انتخاب کرده باشد	the legitimate monarch is he who is loved by his people
به این امید که گذشت زمان به تدریج نظر بدی را که دخترش در مردم نسبت به خود بو جود آورده بود تخفیف دهد.	in the hope that time may wear away some of the disgrace she has incurred.
مدتی طولانی با دقت به روی نوشته خم شد.	pored over it, long and earnestly.
اما نه آن سرمای سخت و خشن در چله زمستان.	not the barren dead of winter.
مرد دو دستش را با هم بر چوبدستیش تکیه داد.	the man rested both hands on his staff
قادر نبودند تمامی آنچه را که آن سان به تعجیل صورت گرفته بود درک کنند.	unable to understand all that had been done in such haste.
اجازه بدهید موضوع را یک سر به دست فراموشی بسپاریم.	let us say no more about it.
این نهایت خودخواهی است که نگذارد چنین وصلت مناسبی سر بگیرد.	it would seem the height of selfishness if he were to stand in the way of her making so brilliant a marriage.
به دخترک پیشنهاد کرد با هم بروند و از برج فانوس دریایی طلوع خورشید را تماشا کنند.	he suggested to the girl that they go to the lighthouse to watch the sunrise.
سخنان او خودبه خود بهتر از آن چه قبلاً آماده شده باشد بر زبانش جاری خواهد شد.	his speech would flow of itself better than he could prepare it now.
آئورلیانو سگوندو دقیقاً دستورالعمل را مو به مو اجرا کرد.	he did it with such good faith that
به راستی ذهن ارلاندو چنان لبریز از افکار متضاد بود	in truth, his mind was such a welter of opposites
من می تونم این قاطرها رو یکی پنج دلار ازتون بخرم و بعدش هم بفروشم.	I can get five bucks apiece for them mules for dog feed.
تصمیم دارم از محکومین برای کار در کارگاه استفاده کنم .	I've about made up my mind that I'll lease convicts to work the mills.
بیشتر در معرض خطر گرایش به سوی مطالب و موارد غیر سالم قرار خواهد گرفت.	the more it would be in danger of turning in the unhealthy direction.
زیرا اکنون دیگر از تماشای باغ نفرت داشت و پنجره رنو به باغ همیشه بسته بود.	for she now had an antipathy to the garden, and the blinds on that side were always down.
به جای آنکه صبر کند تا من در را برایش باز کنم.	instead of waiting for me to get it for her.
او گذشته از خنجر کتابی هم در دست دارد.	he had a book as well as a knife in his hand
این بیماری سبب شده است همه دلبستگیش را به نمایش بگذارد.	the illness had made a festival for her tenderness.
واقعاً چه مدت بود که برایش عزیز شده بود!	as every feeling declared him now to be?
مجددا او نو اسم گذاری و بسته بندی کرد و به جهانیان فروخت!	repackaged it and sold it to the world!
تا او بتواند صدای آهنگ را از بستر خود بشنود.	so that she could listen to him in bed
من آن دو را در تالار پذیرایی تنها گذاشتم	I left them together
سعی کرد که خود را بلند کند و به مرفق تکیه کرد	raising himself on his elbows
من منتظرم که از جنگل برگردند و همه چیز تمام شده باشد.	I look forward to seeing them coming out of the forest and everything settled.
به او و همه کس در زندگی سعادت و آرامش عطا فرماید.	her too, and to give them all, and her too, peace and happiness.
یک دستش را به صندلی تکیه داد و خودش را نگه داشت.	he had to steady himself by a chair
آنقدر هیجان زده بودم که واقعا پاهایم قدرت بالا رفتن نداشت.	I was so excited that really and truly my feet would hardly take me up.
آن شب خانم گریفیث گفته بود که شوهرش این برادرزاده فقیر را از غرب به لیکرگس آورده است تا به او کمکی کرده باشد.	who had said that he was a poor nephew whom her husband had brought on from the west in order to help in some way.
جواب درست را زمانی که نگاه کوتاهی به سمت او انداختم از سرش بیرون کشیدم.	I picked the correct answer out of his head while I glanced briefly in his direction.
از پشت میز بلند شدم. سخت خشمگین و آزرده شده بودم.	got up from the writing desk.
از ورود به این اجتماع زشت و نامطبوع متاسف بود.	he felt it unpleasant to have dropped in on bad company.
قبل از اینکه بگذارید این بچه بیمار را به زندان ببرند	before you let them drag this sick child to a prison
سپس نمک به داخل سرکه ریخته و با آن نیز وی را شستند و پس از آن هم با آب لیموی مخلوط با خاکستر او را مالش دادند	they rubbed him with salt and vinegar, then with ashes and lemon
فرصت مشاهده در هر یک از دیدارهای بعدی مرا بیش از پیش مقاعد ساخت که در نخستین برداشت خود از شما مرتکب اشتباه نشدم	each succeeding opportunity for observation has given the impression an added depth by convincing me more emphatically of that fitness which I had preconceived
من باهات کاری نخواهم داشت و تو هم با من کاری نداشته باش.	I won't bother you, you won't bother me
با این همه قیافه مته من و با نشاط خویش را از دست نداده بود.	but his good manners remained with him to this day, in spite of all.
ممکن نبود که در محاسبه خود به خطا رفته باشد.	he could not be deceived in his calculations.
پدر تکه کاغذی در دست گرفت و به پسر گفت	the father said, reading from his bit of paper.
بهترین همسر دنیا رو فراموش کنم و مث یه حیوون همین جا توی این گل و کثافت	forgotten the best wife any man ever had enough to take you here in the mud like a
فکر کنم نمیتونه این نکته رو هضم کنه که چرامن بااون نموندم وبا توهمراه شدم.	I don't think he understood why I was with you instead of him.
اومدم ازت موقت ما ملحق به شی دعوت کنم که به کمیته	I came to ask if you'd serve on our little ad hoc committee
عواطف پایمال شدهء منتج به انتقام جویی در پسرک روستایی.	the peasants, all trodden down sentiment, and passionate revenge.
تقریبا مثل اینکه با کسی از اخگر سخن گویند و از شعله هیچ نگویند.	very much as one might talk of the firebrand and not of the flame.
متأسفانه گزینش شغل برای شما تا حدودی محدود است.	I'm afraid your choice of professions will be rather limited.
درست در اولین شبی که او بیوه شده بود.	on her first night as a widow.
در این هنگام ناگهان بی آنکه خود اندک تصوری بکند	but when he least looks for it
من برعکس از دوری شما بسیار متأثر خواهم شد	I am only too unhappy at losing you.
فقط صداهای خشن و شاد و خنده های بلند ایشان و طنین برخورد داسهایشان را میشنید.	he could only hear rough, good humored voices, laughter, and the sound of clanking scythes.
فردا کارتون فقط پائین آوردن کارتنکها از طبقه بالاست.	I'll just let you bring down webs on the floor above to begin withto morrow.
حروف ۶ متر ارتفاع داشتند و به رنگ سبز لیمویی در زمینه مخزن نوشته شده بودند.	etters twenty feet high and lime green against the white of the tank.
اما دیگر برای جبران مافات خیلی دیر شده بود.	but it was too late for any attempt at rectification.
اما من فقط یک دبیرستانی بیچاره با پول توجیبی محدود بودم.	but I was just a poor high schooler with a very limited allowance.
این آن چیزی است که در نظرشان شایستهٔ احترام است!	these are the things which they hold worthy of respect!
چون پودر سفیدی که پوف کنی یا در وزش باد برود.	with white powder puffs flashing cheekily.
در عین حال بسیار بعید بود که بتوان گناهش را به گردن قاتل واقعی انداخت.	yet it would be hardly possible to bring home the guilt to the real murderer.
چون دانست که پیک مخصوص است او را به مدخل دیگر هدایت کرد.	learning that he was a special messenger led him to another entrance.
اگر چه از آن مرحله تا سرمنزل کمال راهی بس دور و دراز بود.	though very far from any degree of perfection.
آن روز حتی یک بار هم او را ندیدم.	for I did not see him once that whole morning.
به او هم عرض خدمت و ابراز عنایت کرد.	making offers to her further services and favours.
این تصور که او میتواند و باید برای خود زندگی جداگانه ای داشته باشد به نظرش چنان مهیب آمد که با شتاب آن را از خود راند.	the idea that she could and should have a separate life of her own seemed to him so alarming that he made haste to dispel it.
مگر در سایه بهداشت صحیح و نی رمند سال 1789.	, thanks to the healthy andvigorous hygiene of 1789 alone.
وجدانم پس از پیروزی بزرگی که به دست آورده بودم راحت شده بود.	my conscience, was quieted by the great conquest I had made.
بعد بی این که با کسی حرف بزنی بری خو نه.	walk home without speaking to anybody.
این کار وی رویه مرفته با آن آگاهی قلبی که از حجب و حیای زنانه داشت هیچ سازگاری نداشت.	it did not tally altogether with his prepossessions about the modesty of the feminine temperament.
کافی است که من به تو حقیقت را بگویم بنابراین دهانت را ببند	it is enough that I am telling you the truth, so shut your mouth.
در آنجا برای معالجهٔ حفره چپ کارشناسی خواهید یافت	there there's a specialist who will cure your left nostril.
وادارشان کرده بود در این صبح زیبا از دستورش اطاعت کنند.	making them do his bidding, on this fine morning
در حالی که شمع را به جلو گرفته بود	thrusting the candle farther out
در بالین مرگ خود این اسرار را به من بازگفت	on her death bed, she bequeathed these secrets to me
یا لااقل نذارم شب و روز با دخترهای دیگر گرم به گیره.	or if not that, then by her presence to prevent him from devoting himself too wholly to these others.
باز کرد و در آستانة آن مات و مبهوت ایستاد.	he flung it wide and stood still in the doorway, dumbfoundered.
شما خیلی بی دست و پا و بیکاره هستید.	instead of standing there like a stock.
باز تنها کسانی بودند که با او آشنایی داشتند	they were the only friends he had ever known
این خانه در محل مناسبی واقع شده بود و اسباب و اثاثیة خوبی داشت.	were central and well appointed.
اولین کسی که ثابت شه باز دست به غارت برده .	the first man caught looting
برای اولین بار در عمرش خوشحال بود که روز تولدش فرا رسیده است.	for the first time in his life, that it was his birthday.
بدین ترتیب در زمان استقلال در انتخابات شرکت نکردند.	so they never voted in the election at independence.
در ضمن صدای غلتان عظیمی را هم شنیدند به بلندی پنجاه فیل که در هودج خود بجنبند.	they heard, too, an enormous wallowing sound as of fifty elephants stirring in their litter.
ازدواج نه تنها مانع کارم نخواهد شد بلکه باعث پیشرفتش هم خواهد شد.	marriage would not be an obstruction but a furtherance.
او را با سرعت به خود چسباند و به گرمی بوسیدش.	drew him rapidly to her, and kissed him warmly.
در آن حال که روی صندلی نشسته بودم استشمام هوای دلکش بهاری و تماشای آسمان آبی و درخشان و مناظر زیبای اطراف حال جذبه و شوقی در من پدید آورده بود.	I was comfortably revelling in the spring fragrance around, and the beautiful soft blue overhead
اینم خوب می دونم که با کتک هم درست بشو نیستی.	probably nothing a good beating wouldn't have cured
که اگر نتواند ما را باهم دوست کند زیرا که بدبختی امر را غیر ممکن ساخته	if not to make us friends which, alas, fatality renders impossible
من تنها به گفتار قناعت نخواهم کرد بلکه بکر دار خواهم پرداخت.	I not only say it, I shall do it.
ولی موجب شگفتی است که این گدا امشب به این قیافه درآمده است.	but it is a strange thing that the beggar should take that shape tonight.
در یک صف قرص نعنایی با موهای صاف فرو ریخته ایستاده بودند.	were standing in a peppermint line with their hair slicked down
وقتی هولمز از کوره راه خارج شد تا آن را بردارد	as he stepped from the path to seize it
این سوای سهم عادلانه او از 550 صندوق جین است.	exclusive of his fair proportion of that 550 ankers of gin.
مشیت خداوندی بر این قرار گرفته بود که این مرحله از مراحل طرح زندگی را به انجام برسانم.	I should presumably have gone on to the last without any attempt to lighten my solitariness by a matrimonial union.
در مقایسه با دنب لویاتان نیز خرطوم فیل ساقه زنبق است.	much less the creatures to which they respectively belong.
که البته همان روز توانستم آن را به عمل درآورم	which I failed not to execute that day
بدین گونه در مدت چند روز به مدد حافظه بسیار نیرومند خود در زبان آن قوم بصیرتی یافتم.	thus, in a few days, by the help of a very faithful memory, I got some insight into their language.
تا او مسأله را حل کرد ما لااقل یک ساعت در خدمتش ایستادیم.	we attended at least an hour, before he could solve it.
اکنون که من نیاز مبرم به لطف و عنایت خاص تو دارم از این دعا و تضرع و زاری هدف و مقصودی جز این ندارم که تو این لطف و عنایت را از من دریغ نورزی.	for they but ask thee not to refuse me thy favour and protection now that I stand in such need of them.
تیراندازی فراوان و طولانی تا آنکه شورشیان اگر خام باشند مرتکب خطای جواب دادن شوند و تجهیزاتشان به پایان رسد.	to fire for a long while, in order to exhaust the insurgents' ammunition, if they commit the mistake of replying.
من هم تحت تاثیر این نزدیکی قرار گرفته بودم.	I, too, was overwhelmed by the proximity.
پس مسلما در آنجا پای شخصی در میان است.	it was because a young lady was there
در این موقع هنوز حواسم به جا بود هر چند قادر به حرف زدن نبودم.	I still possessed my senses, though just now I could not speak.
مخصوصا برای اینکه او دیروز جدا از من دعوت کرد که نزد او بروم.	I was especially invited yesterday.
در مورد مخارج و تاریخ شروع و پایان آن هم برآورد نسبی نمود	made rational calculations about costs and dates
اخرین نگاهش را به کارد کرد و از اتاق بیرون رفت.	took one last look at the knife, and left.
در ثانی وقتی که آن آقا از او پرسید آیا مایل است شاگردی کند	say, when the gentleman asked him if he wanted to be apprenticed
بنا کردند روی تختخواب به پس و پیش دویدن.	ran smelling backwards and forwards on the bed.
حال سفارش نامه هم اگر لازم است از برای شما از وزارتخانه بفرستم.	should you like a letter to the minister that they might explain to you
من بهتر دیدم به جای اینکه شب را در مهمانخانه بین راه بمانم در گرینج آقامت کنم و صبح روز بعد به سفر خود ادامه دهم.	I conceived that I might as well pass the night under my own roof as in an inn.
جرالد سخنان او را قطع کرد و نگذاشت کار به جاهای باریک برسد.	suddenly and guiltily aware that the conversation
حالا دیگر از آن خانه بزرگ چیزی بر جای نبود.	there remained of it only a forlorn pair of stone steps and a walk, leading up to nothing.
اسب میراند و از تکتک درختان با جوانه های برآمده و سبزه ی بالنده لذت میبرد.	he rejoiced over every tree, with the moss reviving on its bark and the buds swelling on its shoots.
سر را بالا گرفت و دوباره خود را در آینه دید.	tossed her head to observe the effect.
منظورم اینست که مرگ شما از همان تردستی و مهارتی که مورد تحقیر و تمسخر شما است ناشی شود.	I mean that you would be stretched dead there for despising skill with the sword.
چگونه و در چه محلی باید هر چه زودتر به وی جواب دهند.	how and where to let him know immediately.
به حکم عقل و عدالت مستحق مدتی تعطیل کار بودند.	in the nature of reason and common justice they deserved an interval of loafing.
حدس زدم که ساعت در حدود هشت شب است.	I conjectured was about eight o'clock in the evening.
فوری پریدم توی کرجی و پاروها را برداشتم و و مشغول پارو زدن شدم اما کرجی از جایش جنب نخورد.	I jumped into the canoe and run back to the stern, and grabbed the paddle and set her back a stroke.
چنان او را به دیوار فشردند که ناگزیر از هرگونه مقاومت دست کشید	he had come that in spite of all his determination he had to give in
مشکل عمده بلند کردن و نهادن من در ارابه بود.	the principal difficulty was to raise and place me in this vehicle.
عزم راسخ او بر این است که هرگز نباید آن بناها برای اقامت او تعمیر شود.	firmly resolved that those buildings should never be repaired for her use.
ولی صدام ربوط به بسته شدن مجدد در آسانسور بود.	but it was only the elevator door sliding shut for the second time.
اما در این مکتب هر یک طیف عقاید به خصوصی داشت.	but, in that party, each had his own special shade of opinion.
هر یک از ایشان به سهم خود دو نفر دیگر را تربیت خواهند کرد و در نتیجه همه ایشان ارتباطی محکم با یکدیگر برقرار خواهند ساخت	each of them again training two others and all being closely united, everything will be possible for our order
ظاهرا چهره پریشان هم صحبتش او را مبهوت و متحیر ساخت	was evidently struck by the troubled expression on his companion's face.
بهش پول دادم تا بعدا او نو به رام بفرسته	I've left them the money to send it on.
اگه به اونجا برسین کار گیر میا رین و آسوده میشین	if you get through, why, you'll be a workin', an' stuff'll be easy.
من اصلا نباید انتظار راستی و درستی و شرافت از تو داشته باشم.	I shouldn't have expected either truth or honor or fair dealing from you, knowing you as I do.
تور آن را صاف و با نوک انگشتان گیسوانش را مرتب کرد	adjusted her veil, and applied little touches of her finger tips to her hair
با قیافه گرم و پرمحبت و جالب خویش سر و گردن زیبایش را برافراشته به اتاق پدر رفت.	his handsome head held high, entered his father's room with the good humored and victorious air natural to him.
به این یکی اتاق آمد تا از قضایا سر در آورد.	came to find out what it was all about
مهم این بود که من باید به بازی رولت بروم.	at the present moment I must repair to the roulette table.
با این حال حساس و در نتیجه سخت عاطفی بود بی آنکه از شم عمل بهره برده باشد.	yet sensitive and therefore highly emotional and without any practical sense whatsoever.
چکی به مبلغ دوست گینه به او داده بود.	handing her a cheque for two hundred guineas.
آن گاه فهمید که در یک تونل باریک و کم ارتفاع ایستاده است.	saw that he was in a very narrow, low, earthy passageway.
اینکه بروم و در بازی رولت هرچه بیشتر برایش برد دربیاورم.	to win what I could at roulette.
که سیستم پلیسی و امنیتی کارآمد و با کفایتی دارد.	which has an efficient police and security system.
از لذت گفتن اسم او به سادگی متحیر شدم.	I asked, surprised at the pleasure there was in simply speaking her name.
اولین نوار منگنه شده را در جایش روی پیانو قرار داد	he placed the first roll in the pianola
تبسم خفیف خرسندی و رضایت بر لبش نقش بست	with a slight smile he began to examine his nails.
برخی ایستاده و ساکت و برخی افتاده بر خاک.	some standing and silent, some cast upon the ground.
باید اعتراف کنم که در فکرش نبودیم امسال شوهرش بدهیم.	I must say, we weren't thinking of giv ing her in marriage this autumn.
زیرا که جمیع وسایل را ملاحظه کردم غیر از این وسیله چاره دیگر نیست.	I confess I can discover no other safe and satisfactory way.
آن قدر به مغزش فشار آورد که گویی زندگی و مرگش به حل این مسأله بستگی دارد	he pondered it as if life and death hung on the solution.
ارباب یک ملک پنجاه هزار جریبی هم مثل آدم نیست.	an owner with fifty thousand acres, he isn't like a man either.
غیر از نوارهای زخم بندی که به دور بدنش پیچیده شده و تنش را پوشانده بود چیز دیگری در بر نداشت.	naked except for the bandages that covered his body.
چنان به خود تلقین کرد که آن همه ماجراهای ساختگی حقیقت محض بوده	it so possessed his mind that the whole fabric of invention and fancy he read of was true
صداهایی که در سرش طنین انداز بودند او را هراسان کرده بود.	cringing from the voices in his head
گفتن همان قدر حرف را هم مدیون همسرم هستم.	I owed it to my wife to say that much.
که وسیله اصلی برای مطیعی ساختن ایشان آن است	that the chief way to make them obey is to show no suspicion
در حالی که کلاه سرخ خویش را در دو دست گرفته بود پیش آمد.	advanced with his hand to his red cap.
که وی در کمال تقدس در هشتاد و دو سالگی بدرود حیات گفت.	who had died in the odor of sanctity at the age of eighty two.
نه تنها ایشان را از دیگر مردم بلکه هرکدام را از دیگری تمیز دادم.	not only from the crowd, but from each other.
مضافاً بر اینکه من هرگز چنین مرکبی را حقیر نمی شمارم	moreover I shall not hold it any dishonour to be so mounted
او را وادار خواهد کرد که عمل انجام شده را بپذیرد	accept an accomplished fact
تا آنکه در آخرین شب تعطیلاتشان ناگهان دریافت که اگر اصولاً بخواهد صحبت کند باید هم اکنون بدان مبادرت ورزد.	until, on the last evening of their holiday, he realized suddenly that he must speak now if he would speak at all.
بسیار وحشتناک است که انسان تا این حد در چنگال مرد دیگری اسیر باشد!	it's terrible to feel oneself so in this man's power
اگر مایل باشید کالسکه را برایتان خواهم فرستاد تا شما و کودک را بیاورد.	I will send it back to fetch you and the child, if you like
اکنون نیز مقدمات زایمانی را که در پیش بود	now he felt still more offensive the preparations for the approaching birth
ولی ما باید با یکدیگر رفتاری دوستانه داشته باشیم و مثل سابق ادامه بدهیم.	but we are all to be friendly, and go on as before.
یعنی در حدود آن مقدار روغن به دست خواهد داد.	that is, it will yield you about that amount of oil.
برای آن انگشتر کوچک دفعة پیش دو اسکناس به شما دادم	I gave you two roubles last time for your ring and one could
کافی بود که خود را به جای کسی که دارای روحی بود گذاشته باشد .	but, as a matter of fact, she only borrowed one .
در طرف چپ که حقیقة توپخانه در آنجا قرار داشت	now swayed and that there really was a battery to their left.
این که تا پای جان در برابر زورگویی ایستادگی کنند.	to resist tyranny to the death.
به صورت توده متراکمی از ابخراه به حرکت درآمده بودند	spread out in a dense and sluggish mass of vapour
مرا تماشا کرد که طره ای از موی آویخته ثریا را از صورتش پس زدم.	watched me push back a loose curl of her hair.
زیرا با نگاهی پرس نده به پسرش خیره شد.	fixed his stern eyes on his son.
نه عاقلانه هست که برای شنیدن چیزی توقف کنیم	nor is it reasonable we should stop to hear anything
هنگامی که چند لحظه پیش از من خواستید موضوعی برای تابلوی نقاشی تعیین کنم	when you asked me for a subject for a picture
من همین الان میرم و بهش اخطار می دم.	so I don't have to obey your rules.
گوسفندان کشته را که بالغ بر شش الی هشت رأس بودند بر دوش نهادند	took up the dead beasts, of which there were more than seven
نشان داد که در دنیای ادبیات بسیار نادان است	became excessively ignorant and inquisitive about literature with McKisco
بعد دستمال سرش را پاره کرد و به طرف باتلاقی که در آن سوی جویبارها قرار داشت دوید.	tore his head cloth off, and raced along the marsh, bounding over the red channels where water clotted among the reeds.
ما باید از فرصت استفاده کرده و بگوییم که چقدر برای شرح حال نویس ارلاندو ناراحت کننده است	we must snatch space to remark how discomposing it is for her biographer
این خلنگ زار با رمز و رازها و سکنة عجیبش همچنان اسرارآمیز و ناشناخته است.	the moor with its mysteries and its strange inhabitants remains as inscrutable as ever.
اما هرگاه من او را صدا زنم بی درنگ از جای برخواهد خاست.	but if I call to him, he'll jump up in a minute.
که پک پنجاهم آن علائم برونی را که قبلا نام بردیم در دسترس طبقه بند قرار بگیرند.	a fiftieth part as available to the systematizer as those external ones already enumerated.
شاید هم به خاطر همین ایمان خودم احمق کودنی بیش نباشم.	perhaps I may be an old fool for doing so
چیزی شبیه اندام واقعی وال را برای شما خواهم کشید	something like the true form of the whale
این بود که دو بار دیگر همین کار را کرد.	so he tried twice more.
برای پیدا کردن شخصی که همیشه در آنجا با او باشد زحمت زیادی کشیدم	I had some trouble in finding an attendant for her,
در همان هفته اول ورود دنبال کار گشته بود.	he'd started looking for work the same week we arrived.
انسانیت را دوست دارد شاید به راستی وجود خارجی داشته باشد	who loves mankind so obstinately in his own way, existing not by chance
برای مدتی عقل و هوش را از کار میندازد	suspended every office of reason for a time
بعد مودبانه موی سرش را از روی پیشانی کنار زد.	he politely pulled his forelock.
وی را به درون خانه برد و به وی پیشنهاد کرد که چاشت صرف کند.	he led him to the house, offered him lunch
چون مثل تمام کسانی که لاغر مردنی هستند همیشه بسیار سالم بود.	because he had always had the iron constitution of the sickly.
به علاوه غذا در خانه نداشت و گرسنه بود.	besides there was no food in the house, and he was hungry.
سپس با نارضایتی سرش را تکان داد و سوار اتومبیل شد.	shook his head, got back in the car
