یه دقیقه پیش گوشت خوک رو توی ماهیتاوه انداخت.	I heard her slap the salt pork in the pan a good time ago.
بر اثر سرعتی که با آن خود را پرتاب نمود	swift as the arrow it speeds.
در آنجا به چهار حوضه بزرگ که محیط هر یک هشتصد گز و تا مرکز دویست گزی فاصله دارد بریزد.	where they are emptied into four large basins, each of about half a mile in circuit, and two hundred yards distant from the centre.
به خاطر داشته باش که تمام این اعمال بدون اراده و توجه و در وضع بیماری و با حالت خشم انجام گرفته و سپس فراموش شده است.	that it was all done casually in a moment of anger, of illness, and was after wards forgotten.
به صورت یک مادر به خطا هم از دنیا خواهم رفت.	I'm going to die a son of a bitch.
در تمام مدت انتظار داشت که خطر یا تهدید مرگی متوجه آقای مورس شود تا او سریعاً بپرد وسط و پدر روت را نجات دهد.	longing all the while for some quick danger of death to threaten so that he might spring in and save her father.
پاهایم را روی هم انداختم و پلک زدن را تمرین کردم.	I crossed my legs and practiced my blinks.
در ضمن از او خواهش کرد به نامه نگاری خود ادامه دهد	he wished him to continue writing at intervals
برای اینکه بتواند پایینشان بیاورد ناگزیر بود روی صندلی بایستد.	he stood on a chair to get them down.
لکن دخترانش او را از این تصمیم باز داشتند	but her daughters dissuaded her
این امور به نظر ژاور بم نزله مشاهده شکافی در زجاجه پهناور نیلگون آسمان بود.	to behold a rift in the immense blue pane of the firmament!
اگر به موقع کمک برسد ممکن است بشود مقداری از اشیاء قیمتی کاخ را نجات داد!	valuable objects may be saved from the flames by timely aid!
شخص دیگری خواسته بود که هری وارد مسآبقه بشود و به هدفش رسیده بود.	someone else had wanted him in the tournament, and had made sure he was entered.
بهتر از این هم مسیو زیرا که من شما را خلاصی دادم	I do better than that sir I save you
او نا نمیتونن تو رو به جرم کاری که حقیقت ندا ره با صندلی برقی اعدام کنن. من که رضایت نمیدم.	they're not going to electrocuteyou for something that isn't true not with my consent, at least.
چه او به یقین خالی شدن تفنگ اسکوایر را نشنیده بود.	the sound of the squire's shot not having reached him.
شک ندارم که جناب ناخدا این تصویر حقیقی را برای دریانوردان خود ساخته بوده است.	I doubt not the captain had this veracious picture taken for the benefit of his marines.
من هیچ وقت نفهمیدم استالاگمیت با استالاکتیت چه فرقی داره.	I never know, what's the difference between a stalagmite and a stalactite?
از این قبیل نباشد که تکلیف شغل من حکم به اخفای او نماید	do not interfere with my scruples or my conscience
با این تبسم خواست نشان دهد که جمله اخیر فقط جنبه شوخی و خوشمزگی داشته	as if to intimate that the latter fragments of discourse were playfully ironical
چهارچرخه بجایی خواه دش برد که اونجا راحت خواهد بود و همین که شما دویست هزار فرانک کوچولو رو به من داد ین به شما پسش خواهن داد.	the trap will conduct her to a place where she will be quiet, and just as soon as you have handed over to me those little two hundred thousand francs, she will be returned to you.
حدود ساعت نه شب بقیه افراد خود را روی زمین انداختند و گریه را سر دادند و از پیشروی خودداری کردند.	at about nine o'clock the others flung themselves crying down on the ground and refused to go further.
وکلای مدافع تقاضا دارند که برای تنظیم لایحه دفاعی مهلت درازی به آنان داده شود.	the defense would require a considerable period of time to prepareits case.
لینتون سپس رویش را از من برگرداند و چشمانش را بر هم گذاشت.	he turned his face on to his arm, and shut his eyes again.
به غیر از این تفاوت مختصر وی همان کسی بود که چندین سال پیش برای نخستین بار پا به درون آن اتاق نهاده بود.	perhaps, and no other difference.
زیرا من استعداد دروغ گوئی را پاک از دست داده بودم.	for I had quite forgot the faculty of lying
یه فن جون قهوه و یه دو نه ساندویچ بیشتر نخوردم.	I had a cup of coffee and asandwich.
خود را میان بازوهای او که حیرت زده بود انداخت.	she cried, and threw herself into his astounded arms.
اما انسان کمال مطلوب چنان بزرگوار و فروزان و موجودی چنان شگرف و درخشان اشت	but man, in the ideal, is so noble and so sparkling, such a grand and glowing creature
با بصیرت روباهی که یک دسته کبک را دنبال کند.	with the sagacity of a fox scenting a covey ofpartridges.
به نظر من شما هیچ تقصیری نداشت ین و فقط می خوا ستین کمک کنین.	you just tried to lend a hand.
این پسر را هم به ترک خود سوار کن!	take up this lad behind you.
او را از یقه گرفت و پیش از این که دودها از بین برود	had him by the collar before the smoke had cleared away
چقدر زحمت کشیده بود تا این سفارشات را گرفته بود.	the biggest she had ever had and a rush order at that.
این است که شما در سیاست گاه مقتول شوید.	is that you should perish on the scaffold.
کنجکاوی به خصوصی نسبت به این خانم در من پیدا شد.	I felt some curiosity and excitement about this lady
ولی باید از سکوی نه و سه چهارم سوار قطار به شم.	I just take the train from platform nine and three quarters
با یک نگاه می فهم هرکسی چه جور آدمی است	I can read character at a glance
یادم هست که صبح روز اول زود از خواب برخاستم	I remember that on my first morning I awoke early
باید بدانی که اکنون مشغول جبران زمان از دست رفته هستم	you must acknowledge that I am making up for lost time
از این رو به نامزدی خود با او درهمان شب و برای همیشه پایان داد.	so broke the engagement that very night for ever.
برای کسی که بیست سال این بار غم را تحمل کرده	who has for twenty years alone borne the heavy burden of grief
اما جرأت نداشت پنجه هایش را روی سینهی لهوین بگذارد.	but not daring, to put her forepaws on his chest.
به جان خودم قسم که اگر وضع به همین ترتیب پیش برود پسرم از دست خواهد رفت	I swear, on my salvation, he's going to his grave
با این همه از بیانش ناگزیر شدم تا مبادا خواننده چنین پندارد که آن موجودات عظیم زشت بودند	however, I could not forbear, lest the reader might think those vast creatures were actually deformed
آنگاه با گفتن سخنان آرامش بخش با صداهای الفی زیبایشان آنان را ترک گفتند.	then speaking words of peace with fair elvish voices they left them.
او در وهله اول به کدام رشته از این کسب و کارها مشغول خواهد شد.	what branch of manufacture he would be instructed in, first.
درباره جزییات کارزار و میزان تلف شدگان تحقیق نمود.	inquiring into details of the action and our losses.
تا نشانت بدهم که رفتار کنونی تو کار بی غیرتان است.	I will make you know that you are behaving as a coward.
راه رسوائی و فضاحت را در پیش گرفته باشد.	perhaps social disgrace into the bargain.
زیرا من شخصی ضعیف و سبک و جلف و دارای اخلاقی بچگانه هستم.	for I very well know that I am a weak, light, girlish creature
مقدرشان این است که سلاطین دیوانه برایشان حکمرانی کنند.	it is their fate to be governed by mad kings.
او از این دین و از پستی خودش شرمگین بود.	he was humiliated by that three thousand on account of his own meanness!
ولی آن مرد دوباره دیگر این سئوال را تکرار کرد تا مطمئن شود که محکوم آن را شنیده است	but it was twice repeated before he seemed to hear it
در خلال 3200 کیلومتر آخر آن فقط پنج روز استراحت کرده بودند.	during the last eighteen hundred of which they had had but five days' rest.
بی آن که اصلاً از این طرز رفتار آزرده خاطر بشوم نشستم.	I sat down quite disembarrassed.
به قدری قوی بود که مرا زمین بزند و به جنگل بکشد.	strong enough to knock me down and drag me into the woods.
من حتی نمی تونم دستمو به اون نقطه بر سونم تا مالشش بدم.	I don't seem to be able to get at them to rub them properly.
شاید هم به خاطر آن بود که همسرش از این کودک رضایت نداشت.	perhaps, because his wife disliked him.
من چندین بار با پای برهنه قطر و محیط آن را قدم کردم.	I paced the diameter and circumference several times barefoot.
در این موقع تابوت را بر دوش آن چهار نفر گذاشتند	the bare coffin having been screwed down, was hoisted on the shoulders of the bearers
زیر یک درخت بزرگ بائوباب کالکه را متوقف کرد	stopped under a large baobab tree.
ورانسکی هم دستور داد همین نوشابه را برایش بیاورند.	he ordered a glass of the same for himself.
من بیش از این تمنایی ندارم که جزئی از شما باشم.	I ask no more, so I remain a part of ye.
اکنون با چشمانی پوشیده از غبار تشویش همان جا خشکش زد.	now paused in wonder, the swiftly becloudingmist of apprehension shining in her eyes.
یکی دیگر از مردان را از پای در آوریم.	pick off another man.
ولی قبل از آنکه بگذارد او سوار شود در برابرش به زانو درآمد	before he could mount, he went on his knees before him
خاطرات درماندگی وحشتناک خودش در مدرسه به مغزش هجوم آورد.	memories of his own terrible misery at school came flooding back to him.
چیزی بسیار غمگین و وحشتناک در این بیانات بود	as if there was something supernaturally gloomy and terrible in the expression
اما هرگز نتوانست به وضعیت همزیستی خودشان از نظر اجتماعی سر و سامان بدهد.	but who never made up his mind to make the situation public
هنوز از کلکی که خورده بودم قدری دل چرکین بودم	I was still rather raw over the deception which had been practised upon me
از چشم خود پاک کرد و نامه را خواند و کنت را تسکین داد	then having dried her own eyes she comforted the count
در عوض کمتر قادر است در سراشیب بض و کینه جلوی خود را بگیرد.	but we seldom stop in the steep, downward slope of hatred.
از برای مجلسی که برای عقد بایستی منعقد گردد	that so important an event as the signature of a marriage contract was going on
گاری کام لا روباز بود و روپوشی از پارچه یا از ترکه بید نداشت.	the cart was open to the sky, without a tilt or cane roof
بنابراین بهتر است مراسم تدفین را انجام دهیم .	so we will sober ourselves with a funeral,
نبوغ در تاباندن نور خود دست خوش بوالهوسی است	save that genius is much more capricious in its manifestations and
تا چند نفر از اهل ده عقلشان زیر فشار آن هیجان ناسالم برد.	until the reason of many of the citizens tottered under the strain of the unhealthy excitement.
اما زن دست خود را بر بازوی او قرار داد.	but she laid her hand upon his arm.
باران شدیدی شروع شد مرا به حال آورد اما خیس شدم.	the rain fell fast, wetting me afresh to the skin.
من هرگز یکی رو ندیدم که درسشو تم وم کنه	I never knowed one of 'em that finished up.
از همان اول احساس کردم که او برای من ساخته شده است	from the first I just felt that she was made for me
این چیزها احتمالا برای توضیح آنچه اتفاق افتاد کافی است	these things are, perhaps, enough to explain what happened.
من او نو روی چمن خونه ای شاید هم خونه خودش پیدا کردم.	I found him on the lawn of a househis house
یک چشمشان رو به هوا و چشم دیگرشان رو به زمین بود و به طرف خودشان برگشته بود.	one of their eyes turned inward, and the other directly up to the zenith.
وقتی که اون به بوفه رسید چیزی توش نبود و سگ بیچاره هیچی گیرش نیومد	when she got there the cupboard was bare, an' so the poor dog got none.
اگه اصول و قائدهای به رام مو نده با شه.	if I have any principles left.
که این خود از نتایج اضمحلال عمومی طریقه بود	this forms a part of the general death of the order
از در کوچک پشت عمارت که مخصوص آمد و رفت خدمتگزاران است وارد خواهم شد.	I could enter perfectly well by the back door
در مقابل کسی سر فرود آورد و هرگز نوکری کسی را قبول نخواهد کرد.	to talk about not wishing to cringe to anybody and not be anyone's lackey
به محض پیدا کردن بهانه از سر میز بلند شد.	as soon as he could excused himself from the table.
اما مرد غریب در همن نقطه و به همان وضع مانده بود.	but the stranger stillremained in the same place and the same attitude.
دست به دست هم داده و بر ذهن خام و خیال پرداز و احتمالا هوس باز او تأثیر بدی گذاشته بودند.	had affected his perhapstoo pliable and sensual and impractical and dreamy mind.
چه کور و نابیناست کسی که نتواند از پس غربال ببیند!	how blind is he who cannot see through a sieve.
سه روز پیش پول هم داشتم و نتوانستم کلاهی تهیه کنم!	I had the money the day before yesterday and did not get a cap to wear instead!
اگرچه ناخدا سعی بسیار کرد که بلکه دوباره او را اجیر نماید نشد	who at first tried all his powers of persuasion to induce him to remain as one of the crew
ادعای برتری شما بستگی دارد به این که شما از عمرتان و از تجاربتان چطور استفاده کرده باشید.	your claim to superiority depends on the use you have made of your time and experience.
سپس صدای تالاپ خفه و سنگینی به گوش رسید.	then a dull, heavy thud.
من هم سفران خود را پشت سر نهاده بودم	my shipmates I had left behind
دختر یک آن خیره خیره به آن نگاه کرد.	she gazed a moment
من تا به حال این قدر آشفته و نگران نشده بودم.	I have rarely been so distressed.
نمی تونم بفهمم که به چه دلیل این کار رو کردم. چرا فرار نکردم.	I cannot understand why I did not desert.
مسافرینی که نشسته بودند به این زوج جایی دادند	seated passengers made room for the couple
تمام مدت چشم به راه رسیدن خبر او بود.	hungry for news of it.
او نه دزدی کرده و نه کسی را کشته	he has not robbed or killed or murdered
به همین دلیل به عنوان اولین رئیس شهرداری آنجا تعیین گردید	he was therefore its first mayor
در آنجا به من دستور داد پارچه برای شش دست لباس انتخاب کنم.	there I was ordered to choose half adozen dresses.
که از جاده نزدیک انبار صدای سم سه اسب به گوش رسید.	when they heard the clatter of three horses' hoofs on the road not far from the shed
همان که در آخرین روز محاصره شهر دیده بود.	whom she had seen last in the days of the siege.
آن نیزار صندلی پشتی شکسته به وجود آمده بود.	made out of a broken backed chair cut down
موقع خداحافظی هم طوری برای کاترین سرخم کرد که کاترین در عمرش سرخم کردنی به آن قشنگی ندیده بود.	making her one of the most graceful bows she had ever beheld, when they parted.
وقتی در را بست و خارج شد از آن همه سماجت و یکدندگی خود پشیمان شدم.	I felt I had forfeited her sympathy by my refusal to go down.
به قدری عصبی بودم که کلمات خرناس مانند از گلویم خارج شد.	I was so tense I almost growled the words.
کلاه خود را این دست و آن دست کرد	fumbled with his cap
جمالش را بر سر هر چهار راهی به همه نشان دهند	nor exposed either at the corners of the market places
به فکر او نباشم و تا وقت یکه مراجعت نکرده فراموشش کنم.	not think of him but forget him, quite forget him for the present.
دیدم که طول آن درست یک گز و سه گره و نیم است.	found it exactly four feet and an inch in length.
آهسته پاهای مرا گرفت و آهسته بر میز تحریر نهاد	set me gently on my feet upon the scrutoire
افسر اولش با ضمانت شش ماه حقوق ناخدای جدید بشود	his own first mate to be offered a minimum six month contract as the new skipper
کنت از آن خانه بیرون شده و داخل کوچه گردید	he rushed into the street
ناگهان متوجه شد که لبخندی بر لبش نقش بسته است	he caught himself smiling
این روزها کار و بارم همین است و اینجا قاعد تا بهترین جا برای این کار است.	I do a lot of that nowadays, and this is the best place to do it in, as a rule.
تا اینکه نقض پیمان خود نمایم برای خاطر امپراتور سابق.	to break my vow in behalf of the ex emperor
من از راه ترحم نسبت به شما این مطلب را تذکر دادم.	I spoke because I felt sorry for you.
در مقابل قوای متفق دشمن از خود دفاع کند	defending himself against superior forces of the enemy
افسر پیر سبیلو با قیافه بی شاد و خوشبخت و چشمانی درخشان شمشیرش را بالا برد	the old mustached officer, with happy face and sparkling eyes, raised his saber
پس دلخور مباش و با کمال آسودگی خاطر تشریف ببرید	I am sure you cannot grudge it to me
اما وقتی دید من آدم مشهوری شدم و قمارباز عجیبی از کار دراومدم بیشتر عصبانی شد.	e but put my poker playing to excellent advantage and supported myself royally by gambling.
به تقلید بسیاری از پهلوانان دیگر که چنین کرده بودند	following the example of others in the same case
من او را بیش از همه چیز در جهان دوست دارم.	I love her more than anything in the world!
زیرا هوا آنقدر کم بود که چیزی نمانده بود خفه شوم.	for want of which I found myself almost stifled.
او نیز به عنوان یک پهلوان کامل عیار خواست نام وطنش را به نام خود بیفزاید	he, like a good knight, resolved to add on the name of his
همه از سخن گفتن باز ماندند و خاموشی گزیدند	stopped at once, all.
پس از آنکه سخنانم پایان یافت کراراً به هم شیهه کشیدند.	when I had ended, they neighed frequently towards each other, as if they were
تمام آنچه از مردانگی برایش باقی مانده بود سفت کرد	fastened everything that remained to him of his manhood
واقعا سپاس. گزارم که دیگران این کار خسته کننده رو به رام انجام می دن.	I'm grateful I have others to deal with the tedium.
اجباراض دو دلداده را برای مدتی از هم دور نگه داشت.	the obligatory withdrawal and they separated for a time.
تمام ماجراهایی را که به سرش آمده بود تا ماجرای به قفس انداختنش	told him the whole story of his adventures up to his being confined in the cage
به کاترین و لینتون اطلاع بدهم که نباید بار دیگر چنان صدایی راه بیندازند.	inform them that he wouldn't have that noise repeated.
جرأت نکردم آشکارا به نزدشان بروم و گفتگویشان را قطع کنم.	I durst not interrupt them openly.
احساساتش را با وی در میان نهاد و از او خواستگاری کرد.	declared his feeling and tried to persuade her to marry him.
تا وقتی که زمان یا مکان خاصی به دست آید که همه امکانات بدل به احتمالات شود	when all possibilities would become probabilities
اما هیچ وقتی به آنجا فرود نیامده و توقفی نکرده بود	but never touched at it
مثل این که فکر کرده بود من منظورم پسر او بوده.	I dare say she thought I was speaking of her son.
یا حتی شاید با چند تکه بیسکویت تنها در قایقی مانده باشد.	or even alone in a boat with a biscuit.
قول می دم. این موضوع رو فراموش کنم و دنبالش رو نگیرم.	OK! I promise I'll forget all about it.
از همین قرار روز قبل از دیروز به من گفتند	from what they told me the day before yesterday
تا این که دیگر نتوانست آن را تحمل کند.	until he could hardly bear it
بدون سر و صدا ولی با قوت تمام میله خود را درآورد و به کار مشغول شد.	plied the crowbar vigorously, but with little noise.
من فقط میل دارم به شما ثابت کنم که منافع و مزایای قسمت سوار از منافع و مزایای قسمت پیاده بسیار کمتر است.	I only want to show that in the cavalry the advantages are far less than in the infantry.
هردو نفر خنده طولانی و پر سر و صدایی را شروع کردند.	they joined in a burst of laughter both long and loud.
با این همه عده بسیاری از تخم پرندگان به دست آوردم	however I got many birds' eggs
یا آن نفس برون آمده با آبی که از دهان به درون رفته آمیخته و از سوراخ تنفس بیرون ریخته است.	or whether that exhaled breath is mixed with water taken in at the mouth, and discharged through the spiracle.
حال آنکه مادرانشان با سبدهای کره و تخم مرغ در سایه درختان نشسته بودند.	while their mothers sat under the trees with their baskets of butter and eggs.
در یک لحظه او را گرفت و به سطح آب بالا کشید.	grabbed her and pulled her to the surface.
چون محاکمه یا حتی تقبیح علنی مفسدین سیاسی غیرعادی بود.	since it was unusual for political offenders to be put on trial or even publicly denounced.
من بدون هیچ شک و تردیدی به او توصیه کردم ازدواج کند.	I had no hesitation in advising him to marry.
مقدر آن بود که اینان همچنان بر گرد آن به بافتن بنشینند	where they were to sit knitting, knitting
چون دفعتاً با این مسئله روبه رو شده ام درباره اش فکر نکرده ام	this has come upon me so suddenly I had not thought
کاترین این سخنان را با لحنی ادا کرد که معلوم بود مخصوصاً قصد تحقیر و برانگیختن خشم شوهرش را دارد.	 asked the mistress, in a tone particularly calculated to provoke her husband, implying both carelessness and contempt of his irritation.
به نظرم رسید مثل این که حق دارم از اینجا راهنمایی بخواهم.	I seemed to have something like a right to seek counsel here.
این بانگ و فریاد از روستاییان مادیان سوار بود	which were uttered and made by the men on the mares
این مدت صرف مبارزه پرمشقت من با مشکلات شد تا خودم را به مقررات جدید و وظایف غیر عادی عادت دهم.	it comprised an irksome struggle with difficulties in habituating myself to new rules and unwonted tasks.
صدای شیونی از قسمت فوقانی عمارت به گوش من رسیده بود.	I had heard cries proceeding from an upper chamber.
فرصت کافی نیافته بودند تا حصار محکمی برایش بسازند.	therehad been no time to make a palisade for it.
مبنی بر اینکه چون خنجر در سینه مارکی نشسته بود	that when the knife struck home
در این حال لبخند کوچکی بر گوشه لبانش پدیدار شد.	as he did so his face broke into an expression of amusement
پس به آنان مدلل سازیم که آنچه کردیم از روی شرافت نفس بود	that we are worthy of compassion.
تنها سبزی ناچیزی از زیر قشر نازک غبار پیدا بود.	only a little green showing through the film of dust.
که در دیر اختیار سخن گفتن از موجودات انسانی گرفته شده	that throughout the wholeconvent, speech had been withdrawn from human creatures
تنها کاری که کردم آن بود که از جایم بلند شدم و از اطاق بیرون آمدم.	I got up and walked from the room.
دست کم یک بند انگشت بلندتر از سایر سرداران و بزرگان همه امپراطوری به هوا بجهد.	at least an inch higher than any other lord in the whole empire.
آن را به لب سوزان خود گذاردم و چند بار بوسیدم.	I kissed the back of it
در دو مورد خاص هم یک لیوان شراب عالی برایش آورد.	on two occasions a glass of fine wine.
دسته و نیام آن از زر و آراسته به گوهر بود.	the hilt and scabbard were gold enriched with diamonds.
اما امیدوارم که موجبات رنجش شما را فراهم نکرده باشم.	but I hope I have not offended you.
جایی که یکی از دوستان صاحب نفوذش برای او به عنوان تحصیلدار زیردست شغلی دست و پا کرده بود.	where a friend in power had procured for him the post of subcollector.
قشون ما با فریادهای هورا فرانسویان را تا مسافت بسیاری در آن سوی آتشبار چنان عقب راند	our troops shouting pursued them so far beyond the battery
وقتی تلگراف رسید روح او به آسمان رفته و خود را تفویض کرده.	by the time the cable arrived hed already been spirited away somewhere and disposed of.
هرگاه بخواهیم این دخترک بینوا را از برنامه خود حذف کنیم	placing this poor girl entirely out of the question
چون به ما هشدار داده شده که وقتی شب فرا رسید کسی نخواهد توانست کار کند.	warned that the night cometh when no man shall work.
ولی او که به جز درد مغز دردی ندارد.	but it is in the brains, what he has got.
کدام دلایل متقنی شما را بر آن داشته است تا به اینجا بیایید	or what can have been the cause that could have induced you to come here in this way
دوست دارم به من بگویی که چه اتفاقی افتاد!	I wish you would tell me what happened!
برای من این موضوع حیاتی است که یا باید در راه ترقی پیش بروم یا در منجلات رکود باقی بمانم.	I must resolutely make up my mind at once to make my way, or stick in the mire for the rest of my days.
زیرا در آن دم آخر به یاد عبادت و دعا افتاده بودند.	because they died with prayers upon their lips.
خشمگین و کف بر دهان شکار خود را دنبال کرده بیشتر کار شیطان است تا انسان!	foamingly chased his prey more a demon than a man!
همه را با دست خود خواهم شست و خواهم بست.	I would bind them up and wash them with my own hands.
از این تصور که اگر در تمام آن مدت اعتقادش به بخشایش و عفو تااین حد کم بوده پس حال بخشایش چه معنیای میتوانست برایش داشته باشد.	at the thought what absolution would mean to her if she believed in it only ever so little.
چون هر چیز بشری که تصور شود کامل است به همان دلیل بدون استثناء عیب ناک است.	because any human thing supposed to be complete, must for that very reason infallibly be faulty.
در عجب بود که ترس و وحشت وجودش را فرا نگرفته است.	wondered why he didn't feel more scared.
ولی خیلی وقت است که این موضوع را میدانم.	only I've known it a long while.
بزودی این ما جری پایان خواهد یافت و به محض اینکه آزاد شدم نزد او خواهم شتافت.	I shall have done with all this directly, and as soon as I'm free, I'll be with her, she'll see, let her wait.
در اتاق چشمش به پیراهن همسرش افتاد که هنوز به پایه تختخواب آویخته بود.	say her dress still hanging at the foot of the alcove
یک آگهی دیواری راکه همراه داشت به زمین پرت کرد و جما را در آغوش کشید	threw down the placard he was carrying and flung his arms about her.
به خاطر دارم که از بس این بچه خوشگل بود.	I remember that once
خوش نداشت با دانش پزشکی خود به حل و فصل این معضلات کمک کند.	any lapses or tangles not heavily sponsored by others.
بینی کوچک و صاف و پوستی درخشان و قهوه ای.	a small straight nose and luminous, nutbrown skin.
پایین پایه فانوس در یک نوع محفظه کوچک جای داشت	underneath the lantern in a littleiron box
این مه فوم را بسیار ساده و روشن برایش بیان کردم تا خوب بفهمد.	expressing the idea very plainly, so that he could take it in.
این یک یادداشت کوچک بود که با مواظبت ظریفانه زنانه بسته و مهر شده بود.	folded and sealed with a woman's elegant care.
فرصتی برایش باقی نبوده که به سر و وضع خود برسد.	he had not been able to bestow any attention on his private clothes.
بیست تای آن را روی دوازده شماره وسط گذاشتم	I placed 200 of them on twelve figures, to see what would come of it.
توضیح داد که او به طور ناگهانی به دنبال کودک به دویدن پرداخت	observing that, in the surprise of the moment, he had run after the boy
بیا بریم بالا پو لارو بشماریم و بدیم به دخت را.	then take and GIVE IT TO THE GIRLS.
آن همه مار و اژدها و دیو و غول و عفریت و حوادث عجیب	monsters, and giants, and marvellous adventures
هرچند به روی خود نیاورد اما چون چشمش به نام کلاید افتاد دچار حیرت شد.	yet not without a little of outwardly suppressed surprise when she saw the name.
از همین حالا فکر و ذکرش متوجه وضع ویل است.	already her mind is occupied with his fortunes.
لباسشان یکپارچه سیاه بود و فقط چشمانشان دیده میشد.	dressed in black garments that showed only their eyes.
آنقدر به وحشت افتادهاست که اگر پیرزن نیم دقیقة دیگر همچنان بدون صحبت به او بنگرد حتماً از پیش او خواهد گریخت.	so frightened that if she were to look like that and not say a word for another half minute, he thought he would have run away from her.
دلاک برای آنکه بداند عنوان کتاب چیست خم شد و آن را برداشت	who took it up, curious to know whose it was
آن لردان و بانوان گمنام از یاد نبرده بودند	the unknown lords and ladies who lived there never forgot
سپس با سر وارد حفره شد و خود را جلو کشید.	hoisted himself into the hole headfirst, and pushed himself forward.
متعاقب این جمله دستم را رها کرد و فرمان اتومبیل را گرفت تا از پیچ جاده بگذریم.	he said, and he let go my hand because we had reached a bend in the road.
حتی با زحمت بسیار ملکه را هم وادار کرد که بگذارد او را همچنانکه در تخت روان نشسته است از زمین بلند کنم و به فاصله دو گز از صحنه قرار دهم	with great difficulty persuaded even the empress herself to let me hold her in her close chair within two yards of the stage
کمی در صندلیش پس نشست تا خوب او را ببیند.	she drew back a little in her seat to watch him
یعنی درست چیزی را میگفتند که فکر یا احساس میکردند	that is to say, had said only just what they were thinking and feeling
تنگی و گیلاسی که شربت نارنج داشت که مشروب عادی مارکیز بود.	which stood a bottle of orangeade, her usual beverage, and a glass
که باید هر چه زودتر با این شخص کنار آید و اگر ممکن باشد تکلیف خود را با او روشن کند.	that he ought at once to come to an understanding with that man and to make what terms he could.
هرگز هیچ سحر و جادویی در مورد آن وجود ندارد	that there is no enchantment about it at all
زیر یک تیر چراغ ایستاد و نامه را دوباره خواند	he stopped under a lamp post and read the letter again
نقشه ساختمان جدیدی را مقابل خویش نهاده چشم بدان دوخت	spreading out before him the plan of the new building and fixing his eyes upon it
به هیچ وجه میل ندارم به او رأی ندهم.	I am the last man to withhold my vote
در آن لحظه به دو چشم معلق در هوا تبدیل شده بود	he had become a pair of eyeballs, floating a few
با آن پیراهن ساده و سفید رنگش به نظر ریزه و جمع و جور میامد.	very small in her simple, white frock
کیمیاگر همان سخنان پادشاه پیر را تحویل او داد.	said the alchemist, echoing the words of the old king.
از او تقاضا کرده بودم بر سر قولی که به من داده است تا چندی پایدار بماند	entreating him to allow some delay
برای آن که رنگ سبز را به دقت توصیف کند به بیرون نگاه کرد	in order to match the shade of green precisely he looked at the thing itself
ناگزیرم که به رغم همه عالم از همین راه بروم.	by it I must travel in spite of all the world
که انگار دیوار بلند عبور ناپذیری مابین آنان کشیده شده است.	was as sharp as though cut by a knife or divided by a high wall.
قصد داشتم هم امشب هنگام خواب این زندگی را ترک کنم.	I thought I was dying in my sleep last night.
به جای آن پوست یاهو را که در آفتاب خشکانده بودم به کار بردم.	I supplied it with the skins of _Yahoos_ dried in the sun.
علایم سرور و اشعة فتح در سیمایش ظاهر شد.	restored the sunshine to his face.
اگر چه وی فرمانده هیچ یک از آن دو کشتی نبود.	though he was not commander of either ship.
اگه نذاری این طور به شه خیلی از دستت ناراحت میشم	I'll be very put out with you if you don't let her be.
پس دوباره همه به جای خود رفتند و شعایر مذهبی از نو شروع گردید.	then the people resumed their places and the service continued.
مستوجب مجازات دیگری نیست مگر اینکه مرتکب جرم دیگری بشود.	does not deserve further punishment unless he commits some new offence.
اما چشمان تیزبین و باتجربهی بلورفروش تشخیص میداد که این پسر دیناری پول در جیب ندارد که چیزی از او بخرد.	but the practiced eyes of the crystal merchant could see that the boy had no money to spend.
موجب گردید که وی به اجبار تقریباً سراسر زمستان را در منزل بماند.	he confined him indoors throughout the whole of the winter, nearly without intermission.
سپس نوک شمشیر خود را مابین دو چشم او نهاد	presenting the point of his sword to his eyes
پیرزن به طرف دیگر جاده نگاه کرد و دید صفی از راسوها درآنطرف وجود دارد.	old woman looked at the other side of the road and saw that it was lined with them
کسی برای ورود به اینجا محتاج به اجازه گرفتن نیست.	there is no need to ask permission.
آری آن زنی که اولین نامه عاشقانه زندگی او را لای کتاب دعا برایش برده بود.	the woman who had brought him the first love letter he had ever received in his life, hidden in her prayerbook
میل نداشتم او را ببینم و از اینکه باز سیمای نفرت بارش با آن دو چشم مکارانه مقابلم قرار داشت ناراحت بودم.	I had turned quite cold all over at the sight of her, and at first I could not find my voice.
در غم آن نبود که امتناع از دادن آن مبلغ گزاف بر او چه اثری خواهد گذاشت.	about the disposition towards himself which what he held to be his justifiable refusal of a rather exorbitant request might call forth.
یک جین تشبیهات متفاوتی را در ذهنم زیر و رو کردم اما هیچ کدام دقیقا مناسب نبودند.	I traded a dozen different comparisons in my mind, but none of them fit exactly.
او تنها صدای دروازه را شنید که برهم آمد و دیگر هیچ.	he heard the gate clash again, and all was quiet.
هر سه به صفحات نم دار و پر از لک کتاب نگاه کردند.	the three of them bent over the damp spotted pages.
از زندگی عادی و طبیعی در روستا محروم باشد	in spite of being deprived of the country life to which
بعد به همراه خانم مهربان و پرمحبت پرورشگاه به درون اطاق آمد.	was led into the room by his benevolent protectress.
اما قبل از پایان مراسم مذهبی دوباره با یکدیگر به مکان خود مراجعت کردند.	but returned to their places one after the other before the service was concluded.
به هر کجا که روی آسمان همین رنگ است.	where those placards invite one to go, and everywhere and always,
چنان محکم که جز در صورت بریده شدن گوشت تنش نتوانست حرکت کند.	drawn so tight that he could not move without their cutting into the flesh.
نامه را در اتاق خود به او دادیم تا بخواند	in our cell we gave him the paper to read
که کت و شلوار پوشیده و پاپیون زده بودند.	in bow ties and dinner jackets.
بی آنکه به ربرتا خبر بدهد به سراغش نرفت	he had departed without a word, trusting to what might come to him
او را بین راه دیدم و نظر او را پرسیدم	I met him on the road and asked.
چنانکه گویی آدم سفید پوست چیزی را تشخص تر از سیاه پوست سفیداب مالیده است.	as though a white man were anything more dignified than a whitewashed negro.
با دهان نوار پیچ خود درصدد برآید که فک حیاتی وال را با مرگ فرو بندد.	with his bandaged mouth seek to gag in death the vital jaw of the whale.
ولی این هم شاید جزء زیبایی تو با شه.	but perhaps that's part of your charm.
بنابراین با هر بغل هفت هشت جلد از مجلدات قطور و بزرگ را برداشت	seizing about eight at a time
بپرسد کاری برای او از دستش ساخته است یا نه.	inquire if she could do anything for him.
که رفته شهود خود را به خدمت شما بفرستم	of sending my seconds to you
قدم به قدم اینجا پر از شاگرداییه که برای آن جام ندادن تکالیفش ون عذر و بهآنه میارن و دروغ می گن.	students in every direction lying about why they haven't done their homework.
با دیدگانی متعجب و نگران به وی نگاه کردم.	I looked surprised.
که نگذارد گریه نیز بر عشق و پشیمانی او گواهی دهد.	from completing the proof of his love and repentance in the sight of all.
چانه زد و زندانم را به سی هزار پول نقره خرید.	she bargained with him and bought me off for thirty thousand silver pieces
زخم روی پیشانیش که به صاعقه شباهت داشت حتی از لابه لای موهایش کاملاً نمایان بود.	on his forehead, clearly visible through his hair, was a thin scar, shaped like a bolt of lightning.
بعد چه جور تام خودش را به زور از آن سوراخ بیرون کشیده بود	how he pushed his way out at the hole
ولی بلناپ توانست سفر مرگ را به سفر تغییر دهد.	but thelatter managed to have death trip changed to trip.
قلب او نیز رازی را در خود پنهان داشت.	he, too, had his secret heart.
این در حالی بود که خود او هم یک پایش به این ر اهها کشیده شده بود.	while she had but one foot on those same roads.
مخالفت با ازدواجی شتا بزده یا نامزدی زیاد طولانی.	forbid alike either a speedy marriage or an engagement which must be too lengthy.
بدون آنکه حرکتی نمایی و سعی و کوشش کنی	without even attempting to contend with it?
چند عدد زنگوله به خود بسته بود و سه بادکنک باد کرده نیز که به انتهای چوبی گره زده بود با خود داشت.	armed with three blown ox bladders at the end of a stick
زیرا همه چیز در کریستف تازه و جوان بود	it was sensual, but not vulgar, because it was altogether youthful
خانم وی زلی تعداد زیادی پیراشکی گوشت خانگی نیز برایش فرستاده بود.	a large quantity of homemade mince pies.
قیچی و دو ورق کاغذ برداشت وبر زمین نشست.	found her scissors and two sheets of brown paper, and sat down.
پر واضح بود که از این کار نیتی جز آن ندارد که سر و صدایی کرده باشد	evidently with no other object than to make a noise there.
برای نخستین بار شهامت نگریستن به او را در خود یافت.	now for the first time had the courage to look at him.
در دفاعیه هم ذکرش کنم تا به نظر نر سه که کلاید قایمش کرده بوده.	mention it, maybe, so as to offset the look of its being hidden
میل کرد برود و درکنار آن صاحب نظر بزرگ بنشیند	had the spirit to move next to that great authority
در همان حال به خود نیز امیدواری و قوت قلب بدهد.	repaired his own at the same time.
گویی دزدها عادتشان اینست که برای انجام کارهای خود اولاً وسط ظهر را انتخاب کنند	as if it were the established custom of gentlemen in the housebreaking way to transact business at noon
ولی مخفی نماند که صدای خندة او گوش خراش بود.	a very unmelodious laugh she had, I must say.
موقعی که جلوی دکانی رسید و خواست تقاضایی بکند	when he showed his nose in a shop
از ین گذشته چون دارای زر و سیم و شکر و تنباکوی فراوان نیستند	nor abound either in gold, silver, sugar, or tobacco
بعد به لیکرگس برگردد و هرگز برای چنین مدت درازی آن شهر را ترک نکند.	then to return, never to leave for so long a period again.
برداشت و در آب فرود برد و شروع به کف مالی صورتش کرد.	stand centre table, dipped it into water and commenced lathering his face.
تا حضرتعالی بتوانید در خدمت آن بزرگوار زور و بازو و نیروهای ذاتی و فراست خویش را که از این همه بالاتر است نشان بدهید.	in whose service your worship may prove the worth of your person, your great might
هری پیش از آن شکلاتی به اون بزرگی ندیده بود.	he had ever seen in his life.
دو دست خود را کام لا غریزی به پیشخوان جلوی بخاری دیواری گرفته بود.	by instinct, a stand with his hands behind him in front of the fireplace.
کارتن خود در صندلی پهلوی کالسکه ران قرار گرفت.	he took his seat beside the driver.
در هر سختی و مصیبتی باید خیالش راحت باشد.	must be a comfort to him under any distress.
اجازه دادند که بهترین رخت خود را که دست کمی از رخت نو نداشت بپوشم	letting me put on my best suit of clothes, which were as good as new
اما ظاهرا هیچ کدام اعتنای چندانی به او نکردند.	neither of whom seemed to pay much attention to him.
من جوان نادانی هستم که اگر کمکی را که تقاضا دارم از من مضایقه کنید همه با من مخالف خواهند شد.	I am a novice, and my blunders will set every one against me, if you do not give me your counsel.
که کامیاباند و یقین دارند که همه کس به کامیابی ایشان اذعان دارد.	who are successful and are sure of the recognition of their success by everyone.
هنوز چیزی نشده به پلیس و کلانتری هم رشوه داده	he had already bribed the magistrates and police,
به دانش آموزان نگاهی کرد و لبخند زنان گفت	he cried, beaming around him
من انتظار دارم از این بابت بر خود ببالی و احساس غرور کنی.	I expect you to feel flattered.
سعی خواهم کرد که یک خانم خیلی مغرور باشم و پایم را هم روی زمین نکشم.	I'll be as prim ad I can and not get into any scrapes, if I can help it.
تاریخ فراگرفته بود به ویژه برای آنکه با شناختن علل در خویشتن تولید بیزاری کند.	had learned history with the express object of raging with full knowledge of the case.
سپس با محبتی وافر و عشقی سرشار به خواب رفتم.	so dropping lovingly asleep.
یعنی جایی که پسرهایش عادت نداشتند کلاه بر سر بگذارند و یک دسته قایق در ساحل دریاچه داشتند	where the boys never wore hats and had a fleet of boats on the lake
من قلبا میل داشتم که او باشد و نه من.	I should be awfully glad to think that it was he and not I.
یا دیگران او را به هر کوی و برزن بکشند	nor dragged through the streets
روی سر هر یک کلاه خود و تاجی دندانه دار قرار داشت.	upon each head there was a crumbling helm and crown.
در جهان بدترین بلایی که ممکن است بر سر انسان بیاید مرگ است	for the worst of all is death
از هم از شیرینی محبت و سپاس آکنده است.	yet full of the sweet things of love and gratitude.
از آن شب به بعد دیگر او را ندیده بودم.	I'd never seen him since then.
که پناهگاه آرام و خاموشی دور از تمام اضطرابات زندگی بجوید	only in search of rest from life's turmoil
اما چرا اعتراف نکنم که از همان ابتدا قول داده بودم که دخترش را بگیرم.	for why should I not confess it, at the very beginning I promised to marry her daughter
منظورم این است که شماها مشتی خاک و سنگ در آن تابوت دفن کردید.	I tell you that you buried paving stones and earth in that there coffin.
تا به حال وعظ به این خوبی نشنیده بودم.	I never heard a better sermon.
بعد زد زیر گریه و مردم هم به دنبالش	then he busted into tears, and so did everybody.
دورتا موقع را مغتنم شمرد تا تضمینی را که از اجرای آن بازش داشته بودند عملی کند.	she felt that the opportunity was come to her which she had been hindered from hastening.
تا دوباره در روی دریا به اسکله آمده بود	to get to sea again.
آن شب دیگر دوباره به فکر سوال هایم نیفتادم.	I didn't think of my questions again for the rest of that night.
یا بهتر بگوییم اگرچه اختلاف عقیده داشتند در عمل به توافق رسیده بودند.	or rather, though of different minds, they concurred in action.
پرستار بچه را در بغل گرفت و به راه افتاد.	the nurse picked up the baby and carried it.
آن وقتی است که وال را از درازی بر پهلوی کشتی افسار کرده باشند.	when it is lengthwise hoisted up and down against a ship's side.
ولی به زحمت توانست تا به آخر پایداری نماید.	but he found it hard to keep himself going.
این حقیقت که موفقیت حتماً یک چیز تضمین شده نیست.	the fact that success isn't a guarantee
من به تو می گم که چی می دونم.	I'll tell you what I know
چون ممکن بود با آن به خودش آسیبی برساند	because of the possibility that the boy might wound himself.
با حرکتی سلانه سلانه که غیرقابل توصیف است از برابر پاسبان رد شد	preceded the jailer, with a rolling gait altogether indescribable
گفت که باز هم پول بیشتری در راه است	he said there'd be a lot more comtn'.
کتاب را خوب زیرورو کردم ولی چیز دیگری پیدا نکردم.	I ransacked it, but couldn't find anything else.
برای آنکه به همین زودی آن طور که ظاهر است دکتر خواهم شد و ضرورت قطعی ندارد که من با دکتر بودن احمق هم باشم.	because I am going to be a doctor, apparently it does not follow that it is absolutely necessary that I should be an imbecile.
گفتگویی با هم آغاز کردند که برخلاف مذاکرات خشک و جدی اربابان ایشان بسیار شیرین و دلچسب بود.	between them there passed a conversation as droll as that which passed between their masters was serious.
که البته به خاطر جوهر قطران موجود در رنگشان خیلی سریع و آسان گرفتند.	which, being creosoted, burned well.
کلمه ههون ههون را که در راه ادا کرده بود تکرار کرد	repeating the _hhuun_, _hhuun_, as he did upon the road
کارهایش نیز بدون هیچ نظم و ترتیبی در اینجا مانده بود.	leaving his affairs in great confusion.
با دشمن شاه درآویزد و او را شکست دهد و بر چندین شهر او دست یابد و همچنان از فتحی به فتحی بشتابد.	conquers the king's enemy, wins many cities, triumphs in many battles
که تا ارتفاع قریب به دویست گز رو به بالا انحنا یافته است.	shooting up to the height of about two hundred yards.
درست به اندازه من از این قضیه اطلاع دارید.	you know just as much about the matter as I do.
وجدانم به شدت معذب شد که به هر مستمسکی اجازه داده بودم از پیش چشمم دور شود.	my conscience reproached me bitterly for having on any pretext allowed him to go out of my sight.
سر خود را بلند کرد و دید در مقابل همان خانه و کنار در ورودی آن ایستاده است.	he lifted his head and saw that he was standing at the very gate of _the_ house.
خیلی خوب است. نزدیک است به کلی دیوانه این کوچولو شوم.	he is very nice. I am in a fair way to go out of my head over that little fellow.
ولی آنان را به سبب وحشیگری هایشان دوست نداشت.	but he disliked them for their boorishness.
به عقیده آن نماینده چون سکنه این دیار هوس کرده بودند که یاهوها را به خدمت خود بگمارند	that the inhabitants, taking a fancy to use the service of the _Yahoos_
حاضرند تا آنجا که برای آن دو میسر و مقدور باشد از دل و جان به وی خدمت کنند.	which, indeed, his personal worth and his honourable profession made incumbent upon them.
این مرد شریف و شایسته که در علم و دانش بضاعتی مزجات داشت	so this honest worthy gentleman, who had some tincture of learning
شرح حال نویس باید توجه همگان را به این نکته جلب کند که	the biographer should here call attention to the fact that
باعث شد که وی نتواند دعوتی درست و حسابی از اوبه عمل آورد	she was unable to give the full invitation she wished
بلافاصله با آرامی و صلح شترم را متوقف کردم.	I stopped my camel peaceably.
تو رنج زیادی به من دادی که تاب تحمل آن را بار دوم نخواهم داشت.	I have come, through you, to a knowledge of a pain so sharp that I do not think I could endure it a second time.
در این هنگام سری از پنجرهء کالسکه بیرون آمد	a head was put out at the window
بدین طریق رقص و نمایش به خرسندی و رضای خاطر تماشاگران پایان پذیرفت.	with this the dance wound up, to the great enjoyment of the beholders.
بدن خود را به داخل خم کرد تا کاملاً پنهان شود	leaning over the parapet the better to conceal his figure
اگر فکر کنم به خاطر از دست دادن من غمگین است هرگز خوشبخت نخواهم شد.	I should never be quite happy if I thought he was unhappy for the loss of me.
ناچار خواهی بود که در ظاهربعنوان دستیار من بیائی.	you'll have to come ostensibly as my assistant.
سپس ناگهان جستی زد و سبیل و بینی او را لیسید.	then suddenly jumped up and licked him right on his nose and mustache.
درست مثل یک قایق بادبانی که وسط دریا گرفتار طوفان شده باشد.	like a sailing ship set adrift.
ظاهرامردم در تعمیر خو نه هاشون دچار جنون شدن.	it looks like folks have gone crazy about rebuilding.
زیرا در این موقع صدای پای ناشناس روی پلکان بلند شده بود.	as a man's step was heard upon the stairs without.
که یقه هرکس را بگیرند و به بازداشتگاه بکشند چقدر احمقانه است!	whoever it might be, should be dragged to the lockup by his hair'?
هنگامی که ساکنان پانسیون پشت سر هم برای صرف صبحانه به سالن غذاخوری میامدند	when the boarders trooped into the dining room for breakfast
یا زخم برداشته و خونشان مسموم شده بود و یا به سوانح ناگوار دیگر دچار گردیده بودند.	or they had cut themselves, and had blood poisoning, or met with some other accident.
این قضیه کمی بیشتر طول کشید تا روشن بشود.	remained a little longer doubtful.
آنهم باوقار و متانت بی سر و صدائی که خاص اشخاص بسیار موفق است و بس.	singly as a rule, and with the noiselessvigor and reserve that characterizes the ultra successful.
حالا حتی یک ذرّه هم به آن چیزها علاقه ندارم.	I don't care a damn about all that.
من بسیار خوشوقت خواهم شد اگر آقایان زودتر به اینکار رسیدگی کنند	I shall thank the madg'strates to dispose of this here little affair
بی شک همان به بار خواهد آورد که در طبیعت اوست.	it will surely yield the same fruit according to its kind.
که او نیز از میان جمعیت راهی بازمی کرد تا خود را با و برساند.	as she made her way towards him through the crowd.
من انتظاری جز آن ندارم که به من اجازه داده شود بدون تا خیر به این امر برسم.	I demand no more than the opportunity to do so without delay.
ولی جلو خودش را گرفت و گذاشت قضیه فیصله پیدا کند.	but she struggled, and let it pass.
هیچ وقت مانع ورودش به خو نه خودم نمی شم.	I will not forbid him the house.
به شما هم واقعا از این بابت مدیون هستم.	I am really very much obliged to you
اگه کار ای نه بهتره آدم از گشنگی بمی ره	I ruther starve all over at oncet.
لکن در برخی از ساعات دشوار آدمی میل دارد بعضی از آشنایان در پیرامونش باشند.	but there are people whom to have near one is a blessing at such times.
برای آن نطق بلیغی و به اقناع آن بسیار کوشید.	harangued it andmade very great efforts to convince it.
از اینکه بالاخره درست حدس زده بودم خوشم آمده بود.	I liked that I'd finally guessed right.
آن قدر نزدیک که بتواند دستش را دراز نماید و آن دست عزیز را لمس کند.	, so close that he could have put out his arm and touched the dear hand.
هر دو تن برای بزرگ کردن واقعیت تخیل نیرومندی داشتند.	an equal quickness to imagine more than the fact.
پیش از آن در کشتی رنج بسیار برده و سخت خسته و فرسوده شده بودیم.	being already spent with labour while we were in the ship.
چه جور چند نفر را توی یک قایق دیده بودند	how some men came along in a skiff
مدادی برداشت و غرقه ی مطالعه ی اوراقی شد که به مشکل فعلی ارتباط داشت.	he took a pencil from a rack and plunged into the perusal of a complex report relating to the present complication.
تا همین چند لحظه ی پیش صحرا بی انتها و آزاد بود و حالا تبدیل به دیواری شده بود که نمیشد از آن عبور کرد.	the desert only moments ago had been endless and free, and now it was an impenetrable wall.
بلکه اموال و شغل خود را نیز کما فی السابق مالک خواهند بود.	but restores to him his fortune and his possessions
خودش هم برای امرار معاش مجبوره کار بک نه.	one who was compelled to work for her own living.
باید یک جوری به او کمک کنم. باید این کار را بکنم.	I must help him. I must.
که انتخاب کننده و صاحب عمارت مهتابی دار سه طبقه زیبایی است	who is an elector and the proprietor of that handsome house with a balcony
باری همین که تمام مقیمان کاروانسرا در مقابل دستگاه خیمه شب بازی جا گرفتند و بعضی نیز ایستادند	so, all who were in the inn being arranged in front of the show, some of them standing
من برای آرامش مردم یک قربانی به ایشان فدیه دادم	to appease the mob I gave them a victim
به قول خودم یخدان ترا به سوی کشتی برانند.	ordered them to tow my chest, as they called it, toward the ship.
همه چیز و به راش توضیح می دم باهاش مهربون میشم .	I'll be so good to her.
به زودی بازگشته اعلام کرد که همه جا ساکت و آرام است.	returned to announce that all was quiet.
چون مطمئن باشید که این توصیه مراعات خواهد شد.	for it shall be attended to.
صدای نواخته شدن آلات برنجی موسیقی و طبل را توأم با صدای هورای کودکان شنید.	he heard the distant brass instruments, the beating of the bass drum and the shouting of the children
که باز پایین بیاید و پرچم دیگر و چکش و میخ بر دارد و آن را به دکل بکوبد.	that perch, to descend again for another flag, and a hammer and nails, and so nail it to the mast.
پسر کلنگ برداشت و در مقابل درجدولی را که از گل پر شده و راهش گرفته بود پاک کرد.	the son took his mattock and cleared the little gutter in front of the door which the mud had obstructed.
منتظر رفتن میهمانان او شد تا سر گفتگو را باز کند.	where he was walking about waiting for his guest's departure.
به سمت انتهای راهرو دویدند اما در آن جا با یک در بسته مواجه شدند.	right to the end of the corridor where they slammed into a door ' and it was locked.
بدرودی اندیش ناک و شیرین با یک جان بدبخت بود.	it was a gentle and pensive farewell to an unhappy soul.
در برابر هر یک مرد ده تا زن وجود داره.	I venture to say there are ten women to every man.
هرلحظه منتظر بودم که صندوق من دو پاره شود.	expecting every moment to see my box dashed to pieces
او از یک خانوادهٔ نجیب است و هرگاه تصمیم گرفته بود این پول را برباید به نظرش سرقت نبود بلکه استرداد مال خودش بود.	for he is a gentleman born, and if he did bring himself to steal, it would not be regular stealing
مثل مردمی که از خستگی جانشان در رفته باشد	as people usually are who are nearly tired to death.
چون وقتی علی بابا داخل غار بود درب خودش بسته شد ولی وقتی بیرون آمد درب همچنان باز بود .	for it had shut of itself while he was within, but remained open while he was out.
در محلی که جای دو مرگ خوار خالی مانده بود ایستاد.	stopped, staring at the space large enough for two people
بی آنکه توجهی به زمان یا عوامل و شرایط دیگر داشته باشم	without any regard to time or other circumstances, while I strictly adhere to truth.
زیبارو با موهایی سفید چون مهی سیمین رنگ و ریشی اصلاح شده	handsome and pale in a silvery mist of white hair and clipped beard
جادوگر قد بلند بود و سبیل باریک مشکی داشت.	the other was tall and strapping, with a thin back mustache.
نیز در این جا مقام سلاح جنگاوران را در خواهند یافت	here you will find arms in their supreme excellence
دید که هم سفرش در کنار یک ظرف آبجو با کارگری خودمانی و دوستانه مشغول صحبت است.	he found that worthy in close fellowship and communication with a labouring man, over a pint of ale.
بر سر سفره چشم از معشوق برنگیرد و پنهان از حاضران به جمال او بنگرد	all the time he will never take his eyes off her, stealing stealthy glances, unnoticed by those present
والاّ خدمت و رفتار و اطاعت نمودن به میل و هوس خانمی جوان و خوشگل	even to gratify a pretty woman, which is
با سینی چای و مقداری کیک وارد اتاق شد.	bearing a tray of tea and crumpets.
من نیاز سریع و عجیبی به پلک زدن داشتم. مثل اینکه به خورشید خیره شده بودم.	I had an odd urge to blinklike I was staring at the sun.
حق اینست که به همه مهر باطله یا علامتی زده شود	would deserve, each of them, to have a sambenito put on it
حالا به ما کمک کنید و به این ترتیب جبران کنید.	help us now and so atone.
دو بار هم آن را روی پایش انداخت و پایش درد گرفت.	twice he dropped it painfully on his foot.
درنگ کردم.سعی داشتم راهی پیدا کنم تا چند ثانیه تنها باشم.	I hesitated, trying to think of some way to get a few seconds alone.
من در حال حاضر کمی برای جانشین پیدا کردن برای او دستم تنگ است.	I'm a bit stuck for a replacement at the moment.
دکتر که از قیافه جذاب و متین ربرتا خوشش آمده بود	pleasantly and reassuringly, impressed by her attractive
که همه را به شک انداخته بود که آن ازدواج به خاطر عشق نبوده	that it seemed as if she had done so not for love
با خشونت از وی پرسید که جزو ابو ابجمعی کدام هنگ هستی و فرمانده تو کیست	in a stern voice asked him to what regiment he belonged, who was his commanding officer
سنگ هم مثل چیزهای دیگر آفریده خیال من بود.	I dreamed about the stone, as I did all the rest.
مرد چاق و دختر کوچک بیدار و ساکت دراز کشیدند.	the fat man and the little girl lay awake in silence.
من این پا و این چشممو از دست دادم .	I lost this here leg and this here eye.
از من بشنو و باور کن که ما بهتر از شما اطلاع دایم	we are as well informed as you
من نمی تونم سنگینی بار یه هم چین مسئولیتی رو روی وجدانم تحمل کنم	I can't have that on my conscience.
عکسی که او به من داده بود نگاه کردم.	 I looked at the photo she had handed me.
بر آن تختی خوابیدم که در اتاق ته کشتی بود.	I lay down in the old little bed in the stern of the boat
اما بعد از این هم دیگر سراغی از او نخواهند گرفت	they'll ask no questions after him
تقاضا خواهم کردکه دخترم ثروتش را در جای امنی بکار بیندازد.	I will demand that her money should be invested in her own name.
همین قدر که هوای خود را داشتند بیش از توان ایشان بود.	more than enough was it for them to look to themselves.
که او در این جنگ بیست و شش اوت نشان داد	has shown or displayed in the battle of the twenty sixth
هر تیر و میله ژرخ که در هوا به حرکت درآمده ما را بسا ید.	when every flying beam, and shaft, and wheel, is grazing you.
اما باید همه چیزهای جزیی رو به من بپرداز ین.	but I must bepaid for all those little things.
به خصوص که هیچ یک از دو یار او حاضر نبود در این کار به دیگری تسلیم شود	particularly as his two comrades would not yield
چند تن از آنان شوخ چشمی را به جائی رساندند که تیر بس وی من افکندند	some of them had the impudence to shoot their arrows at me
میخ وام بهش به گم قبل از این که قیمتش بیشتر پائین به یاد همه رو بفروشه.	I am telling him to sell out at once before they drop any further.
با فروختن یکی از هفده ماهی کوچک طلایی پول کتاب را تهیه کند.	got some money by selling one of the seventeen little gold fishes left in the workshop
که مرا شتاب داد که از شما معذرت بخواهم.	which induces me so readily to excuse you
چنانکه سرانجام دوباره نیرو و سلامت خود را به دست آورد.	she began to recover physically.
زیرا مرد بازوان خویش را تنگ به گرد خود تافته داشت.	but, in vain, for he slept with his arms crossed upon him
وقتی درست حسابی کافئینه شدم دربارش بهت می گم.	I'll tell you about it once I'm properly caffeinated.
او را در قلب جنگل که ایمنی کافی دارد جا بدهم و خیالم را از بابت مراقبت دائمی او آسوده کنم.	in the heart of a wood, made my conscience recoil from the arrangement.
برای خودم دلایلی دارم که دقیقاً به فکر وضع تحصیل او باشم.	I have my own reasons for thinking her a curious study
در این مورد یکسره آن احوال و عادات را از یاد برده بود.	they were rather out, in this particular instance.
این دختر را تنها به خاطر ازدواج با مردی فقیر از خانواده و ارث محروم کردند.	to cut off the girl from the family protection and inheritance only because she had chosen a man who was poor!
نه اصلانشان داد که متوجه حضور من در اطاق شده است.	nor notice my presence in the slightest way.
او تندیس بهت و حیرت و نومیدی شده بود.	his face a perfect statue of surprise and disappointment.
با یک تکه روی پوشیده شده بود و همیشه بسته بود.	with a sheet of zinc and kept constantly closed.
همه در کنار هم و در یک طرف راهرو قرار داشتند	were all in arow and on one side only of a corridor
شاید هم امکانات کافی ندارد که در خارج شهر زندگی کند.	perhaps she may not have resources enough in herself to be qualified for a country life.
خوب کاری کرده بودم که به ان جا رفته بودم.	I was right to come here.
ناگزیر بودم که افکار او را دوباره متوجه موضوعی کنم که برای من ضرورت حیاتی داشت.	I was obliged to recall him to a theme which was of necessity one of close and anxious interest to me.
اون وقت اوقات تلخیم از می ون می ره	, it's all down again
فوراً آماده خواهی شد هر کاری که باعث نزدیک شدن تو به آن هدف است انجام بدهی.	you will be ready to do at once whatever furthers that end.
اما این پیرمرد وفادار به این نکته توجهی نداشت.	but the true hearted old gentleman never calculated about that.
صورت دخترک را در میان دو دست خود گرفت و بوسید.	he caught her face between his two hands and kissed her
حالتی شهبانووار داشت و اندیشه و دانش در نگاهش هویدا بود.	yet queenly she looked, and thought and knowledge were in her glance
تمام روز را از فک اسفل او تاب خورد.	swing all day upon his lower jaw.
بنا بر قوت مزاجی که طبیعت برای او داده بود به همین قدر قلیل از غذا تقریبا به همان حال نخستین خود برگشت و در خود دیگر ضعفی و فتوری ندید	thanks to the vigor of his constitution found himself well nigh recovered
راسکلنیکف گویی سخنان خود را از پیش حفظ کرده بود	he repeated it as though it were a lesson
وقتی پروفسور لو پین از در وارد شد همه مشغول گفتگو بودد.	were talking when he finally entered the room.
کلاید حق نداشت تعالیم دوران نوجوانی خودشو فراموش کنه.	clyde should have remembered the teachings ofhis youth.
اگه ماشیون رو طوقه هم برونم بهتر از ای نه که یه شاهی به این مادر به خطا بدم	I'll go on the rim before I'd give that son of a bitch a dime.
همین باعث شد که عصای نی ین تا چهار روز ظاهر نشود.	for which reason the reed delayed its appearance for four days
ابرهای انبوه خورشید را یکپارچه بلعید و آماده شد تا آتش آسمانی را به رزمین ببارد.	as the vast deep clouds swallowed the sun whole and prepared to spew solar fire over the earth.
زیرا که حتما کسی از طرف پلیس به او مراجعه کرده	for someone must have been to see him from the police
چنانکه از گفتار و کردارش به خوبی مشهود است	as they might perceive by his deeds and his words
بولست رود به راستی از بازگشت او وحشت داشت.	that certainty was a terror.
اندیشید که این تصمیم نهایی به شک و تردیدهای او خاتمه خواهد بخشید.	thinking that that final decision would put an end to his doubts.
ذوق و قریحه جهان داری او شایسته تحسین است	endowed with admirable talents
بدبختانه برای بسیاری زا بینواهای صنعت شیلات همین گونه هم هست	such, alas! it proves to many a poor wight in the fishery
اندکی توقف کرد و با فرمانده هنگ سخن گفت و به طرف آتشبارهای بالای تپه رفت.	halted, spoke to the commander of the regiment, and rode up the hill to the guns.
یکی از ظروف پر از کف صابون را برداشت	caught up a bowl of soap suds
به خاطر همین هم مادرم زیاد به فکرش نیست.	that she does not think much about it.
هر ناخدا یک جلد از این مجموعه در اختیار دارد.	every captain is provided with it.
جز یک راه برای نجات دادن خود و آسوده شدن ندارد و آن اینست که بندهای کیسه پولش را در اختیار زنش گذارد.	there is but one way of extricating himself from the quandry and of procuring peace, and that is to let his wife control the purse strings.
اما سه روز پشت سر هم هیچ اتفاقی نیفتاد.	but nothing happened during three days
از داخل آن یک بسته که کاغذی به اطرافش پیچیده شده بود بیرون آورد.	taking from it a parcel wrapped in paper,disclosed
من از پست امروز یک بسته شکلات داشتم و عکسی که همیشه دوست داشتم از رویش کپی کنم .	I had a box of chocolate drops, and the picture I wanted to copy,
برای من همان قدر که در اختیار تو باشم	for so long as I am thine
بعد با محبت تمام دست پسر خود را فشرد	pressing her son's hand, affectionately
زیرا برای چنین امری دو ساعت وقت کافی بوده و حال آنکه پهلوان بیش از چهار ساعت بیدار مانده است.	for all requirements were satisfied by a watch of two hours only, while he had been more than four about it.
بدن او ً آفتاب سوخته سفیدی شورت در زمینه چشم رامیزد	their whiteness was nearly dazzling against his tanned skin
اخیرا از مشایعت کاروان دولتی مراجعت کرده و خبر آورده است	had recently been away driving a government transport, had returned with news
تازه وارد از نزدیک شدن به این جمع اکراه داشت.	the newcomer recoiled from this company.
در میوه که خود از درخت بچیند زهر خواهید دید.	in the fruit you pluck from the tree.
من اگر فرصتی گیر بیاورم موضوع را به پدرم خواهم گفت.	some time I'll tell him so.
کسی بوده است که بیشتر از من رنج برده است	there have been some who have suffered more than I have
او را برای شهادتی که در دادگاه داده بکشد.	killed him for testifying in court.
این قدر فهمیدم کهشریک دست در حنا بسیار خشمگین شده تهدید به اقامه دعوی کردهبود.	I gathered that the deserted partner was very angry and threatened proceedings.
این مرد خواهد رفت وهرکار ناشایستی را انجام خواهد داد تا از زن فرار بکند.	he will descend to the basest trickery to leave her.
قدری گریه کرد و آب دماغش را بالا کشید.	performed some affecting tears and sniffs.
منظورم این است که خیلی جدی مشغول مطالعه هستی .	I mean studying hard.
هیچ یک از کسانی که مرا از خود راندند سرزنش نکردم.	I blamed none of those who repulsed me.
امروز یه کار مهم دی گه هم باید انجام بدم.	I have important business elsewhere today
ولی تا خانه پیرزن بیش از پنجاه قدم فاصله نداشت.	but the house was at least fifty paces away.
به خاطر بقیه تجملی که او را مانده بود	the remains of luxury prevented him from sinking into his actual position
این احساس مخصوص لحظات وحشت و ترس شدید است که آدمی کام لا هوشیار است	you know the sudden feeling one has in moments of terrible fear, when one does not lose one's wits
اما نتوانسته بود آن را به خواننده انتقال دهد.	but he had failed to transmute it.
چندان عمیق که رؤیای هر یک از آن دو در رؤیای دیگری فرورفته و غوطه خورده بود.	so deeply was the revery of the one absorbed and sunk in the revery of the other.
چون بلند شد دیگر حلقه طلا بر انگشت آن دست نبود.	when he rose there was no longer a ring on the hand.
از بالای کتاب با کنجکاوی به این صحنه نگاه کرد.	was watching this performance over the rim of her book with some interest.
اجناسی با کیفیت خوب که به ازای پولی اندک از انبار حکومتی قابل تهیه بود.	articles of good quality, which could be obtained in the storehouse of the administration for very little money.
سپس هوس کرد که زودتر فارغ شود تا بداند مادر شدن یعنی چه	then was anxious to be delivered that she might know what it was to be a mother.
تقریبا قبل از اینکه بفهمم چه خبر شده است	almost before I realize what's happening.
در واقع او هنوز اطمینان نداشت که آن مرد ترشرو و سیاه چهره که لبخند استهزا آمیزی بر لب داشت پدر وی باشد.	indeed, he was not yet certain that the grim, sneering stranger was his father.
لرزان یکدیگر را بوسیدند و آنگاه از یکدیگر جدا شدند.	but they kissed tremblingly, and then they moved apart.
من اینکا رو به دلایل شخصی انجام می دم.	I do this for personal reasons.
که قطعا او وقتی خواهد رسید که کار تمام شده است.	that he should arrive after all was over.
ولی یادم میاد اونجا که بودیم یه دختری رفته بود پیش یکی از این دکترها	I did hear once of a case over there, though, where a girl went to a doctor
برای شوهر و جهیز دختر خود ثروت سرشاری بجا گذاشته است.	that he was very rich in consequence of the dowry left to him with the daughter.
از برکت ذوق و خوبروئی و ثروت خود رندانه چنانکه در خور شباب است	because of their looks, taste and means indulging themselves in phases of libertinism the proper wild oats of youth
ساختن همین خانه جدیدشان که نقشه آن طوری ریخته شده بود که در دوران خوش پیری نیز آشیانه راحتی برایشان باشد	their building of this new house,planned to comfort them through a happy old age
باید بگویم این مطلب در عمل به کار شما ربطی ندارد.	I really don't know that it is your business.
الا اینکه آشفتگی و ناراحتی تو را احساس کردم	I must have been actuated by real uneasiness
یک مرتبه احساسی کردم که از دروغ گفتن خودم بیزارم.	I was underhand.
از باری که تا به آن درجه معذبش کرده بود سبک شد.	he found himself relieved of the burden that had given him so much discomfort.
در این هنگام بود که چیزی در چشمان پیرمرد نهان شده بود	now it was that there lurked a something in the old man's eyes
از اول هفته تا حالا در حال آتیش خاموش کردن بودم.	I've been putting out fires all week.
یقین دارم که در میان ما نمک فراوان به کار بردن حاصل زندگانی پر تجمل است	I am confident that the frequent use of salt among us is an effect of luxury
اما چون یگانه مقصود من خیر و صلاح جامعه است	but as my sole intention was the public good
قرار بود که آن شب ساعت نه او وسوندرا همراه با چند تن دیگر	where at nine he and she, along with a number of others
گروه در حسرت شنیدن مابقی داستان او خواهد مرد.	as he felt the greatest anxiety to know the end of his story.
آخرین هوس جدید زایران نیز این است که به آن حوالی بروند و از او دعای خیر طلب کنند.	the last new freak is for the pilgrims to go round that way to ask his blessing.
پس بازویش را دوستانه در بازوی او حلقه کرد	so he tucked his arm companionably through hers
هرچند که این گنج بیش از یک ماه به کار شخص نباید	among others thatof possessing a treasure
حالا که بهش گفتی دوستش داری همه چیز رو بهتر درک می کنه	now she will understand better since you have told her you love her.
تا با هم یک لیوان چای خوشمزه و حسابی بخوریم.	we'll have a nice hot cup of tea.
ترکیبی نادر که یار و یاور ساعات کار باشد	adapted to supply aid in graver labors
سپس یکدیگر را بوسیدند و با چشمان گریان از هم جدا شدند.	kissed, and parted with tears in their eyes.
هوا سوت کشان از گلویم پایین رفت و گردها را به چرخشی گردبادی واداشت.	the air whistled down my throat, swirling the motes into a vortex.
شایسته این شوند که بنا به حق موروثی مشاور شاه و مردم گردند.	to qualify them for being counsellors both to the king and kingdom.
بر سر آن بودند که اگر بجنبم مرا با تیر از پای در آورند.	ready to shoot me if I should offer to stir.
این هیئت مرکب از دوازده تن بود که چهار تن از آنان کارمند دولت و دو تن کاسب و شش تن نیز روستائی و خرده مالک شهر ما بودند.	four were petty officials of the town, two were merchants, and six peasants and artisans of the town.
شخصا در این وصیت چیزی نیست که شما را دلخور نماید	this unexpected will need not personally wound you
اما راننده ی ماهر در یک طرف نشیمن نشسته بود و تیرمالبند را بالای شیارها نگه داشته بود	but the dexterous driver sitting on the box held the shaft over the ruts,
همان خونی که او خط سیرش را گرفته و به اینجا رسیده بود.	she saw the starting point of the thread of blood
حتی در حق خود نیز این ظلم را روا داشتید.	to you also.
هرگز ندیده بودم این کار به این شکل انجام به شه.	but I've never seen it done that way before.
در به روی خود ببندد و تنها بماند و امور خویش را سامان دهد	to shut himself up alone and put all his affairs into definite shape.
سپس بدون سر و صدا به سوی میز رفت	he followed him quietly to the table
که او یکباره از این همه جلال و فخامت به حیرت افتاد.	as he saw it, that he was quite stirred by the dignity and richness of it.
هم مرا در حسن انتخاب تحسین فراوان کرده بود	full of honour at my esteemed order
از او خواهش کرد که به دیدن نمایش بیاید و ضمناً تأکید کرد که آن نمایش بسیار دیدنی است.	to come and see it, for it was worth seeing.
با دقت و بدون بریدن کلامش گوش داد و به تفضیل او را راهنمایی کرد که به چه کسی مراجعه کند	heard her to the end attentively without interrupting her, and gave her detailed advice as to how and to whom to apply
درست مثل آن است که هر دومان سر از قبر درآورده و در موضعی برابر	just as if both had passed through the grave
گفتم احتمال دارد یکی دو هفته در آنجا مهمان باشم.	told her I should probably be a visitor here for a week or two
دل سرهنگ و سایر سرکردگان زیردست او را بدرد آورد.	the colonel and his officers were in much pain.
که احساس کلاید نسبت به او فرق کرده و سردتر شده است.	this time, that his mood in regard to her was different, colder.
ولی با این همه هیچ کدامشان کاری نکرده بودند.	but remaining inactive nonetheless.
ما شش نفر که در هوا بودیم چنان به هم نزدیک شدیم	we six men in the air came so nigh to each other that
حالا روی هم رفته پول من چهار هزار فلورین و هشتاد فردریک شده بود	of course, to a total of four thousand florins, eight hundred gulden
در آنجا محبوسش ساختند و در آن را نیز بستند.	there locked him up.
برای آن سومی آینده خفه شده است و آزادی در خطر.	to yet another the stifling of the future to the peril of liberty.
سپس درباریان با رعایت تشریفات کامل مهر از سرنامه برگرفتند	which was opened with great ceremony
که به عموی خود بفهماند که استحقاق کار بهتری را دارد.	that he would like to impress on his uncle that he was cut out for something better.
از کنفرانسی که در کلاس خودم داده بود هم بیشتر به آن گوش کرده بودم.	I heard more of that than the lecture in my own class.
که فوری گفت هوا خنک شده و بهتر است کمی قدم بزنند.	almost immediately say something about its being chilly and suggested taking a stroll.
چون آنان عقیده داشتند بزرگواری یک بانو به ثروت اوست نه به تبارش.	because their pretensions to gentility were based on wealth, not breeding.
ترسیدم که به مسافتی دراز در آن سرزمین پیش روم.	I was afraid of venturing far into the country.
حالا بهتر است هر چه زودتر از اینجا بروی.	now you'd better go!
اما از این بابت بمیرد بهتر است تا اینکه از خجلت و شرمساری.	but better so than die of shame
یعنی موجودی که در نردبان اجتماع هیچ گونه جا ندارد زیرا که از آخرین پله این نردبان نیز پایین افتاده است.	that is to say, a being who has not even a place in the social ladder, since he is lower than the very lowest rung.
دستی که به نظرش سر برداشت. هیکل بزرگ سیاهی کنارش راه میآمدغ دستی بزرگ بود دسته سطل را گرفته و با قوت بلندش کرده بود.	a hand, which seemed to her enormous, had just seized the handle, and lifted it vigorously.
همین طور ادامه یافت تا آن که شام روی میز آماده شد.	lasted till the venison was on the table.
چون نوبت او بود که برای بقیه شیرینی دونات بخرد.	because it was his turn to bring donuts.
اما اون چیزی درباره تغییر این یکی قانون نگفت.	but she didn't mention anything about this rule changing.
آن اینکه من بعد وقتی حضرتعالی دیوی نابکار و یا پهلوان دیگری را مغلوب ساختید	that is thinking what is to be done when your worship conquers some giant, or some other knight
فکر کردم ممکن است بیایید پدر برای همین گذاشت مش توی کیفم.	I thought you would come, father, so I put it in my bag.
از هنگام بیماری بچه همواره اضطرابی به دل داشت.	since the boy's illness she had always been anxious.
بالاخره او را بلند کردند و به تسلی وی پرداختند.	they were lifting him up and trying to quiet him.
فقط با نیروی فکر و منطق خویش این مسأله را دریافته بود	he knew it only with his intellect
تنها تقاضائی که از شما داریم اینست که خدمتی برایم انجام بدهید که هم برای شما کم زحمت است و هم باعث راحتی من.	I only ask of you a favor which will cost you but little, and be of very great service to me.
که بیش از هر کس اوست که باید همسر خویش را در سیه روزی یار شاطر باشد و نه بار خاطر.	representing that it was she of all the world who must uphold him in his misery and not augment it,
تو جالیز دو حلوایی یه سگ سیاه بزرگ نشسته.	where you will find a large black dog sitting in the pumpkin patch.
تا به وی دستور دهد که آن شب بستر را در کجا بگسترد.	show him where to set up the bed for that night.
مثل هر وقت دیگر که تحت تاثیر شراب یا عواطفش قرارمی گرفت	but moist, which always happened when he had been drinking, or when he was touched.
آن است یک صندلی که در پهلوی کوزه گل ژرانیوم است	there is one by that geranium
قلاب سنگین پیه گیری که اکنون پاکیزه و خشک بود هنوز به انتهای ابزارها بسته بود.	the massive curved blubber hook, now clean and dry, was still attached to the end.
از نگه داشتن آمار دهقانهائی که دی گه اسب ندارن برای شخم و کارهای زراعتی.	I was sick, anyway, of counting the number of horseless peasants
بعد دوباره یک مشت چیپس چپاند توی دهانش و اضافه کرد	she added, stuffing more crisps into her mouth.
ولی ما این شانس را داریم که او هنوز چیزی در این موردنمیداند.	but the chances are that he still knows nothing about it.
خانم کارکشته با یک دست محکم گلوی او را گرفت	the expert lady, clasping him tightly round the throat with one hand
من بیش از پیش در تصمیم خود راسخ هستم.	my resolution is firmer than ever.
پس از ادای این کلمات بشتاب بس وی انبار دوید و دیگران نیز در پی او روان شدند	so saying he went into the room and the rest after him
شنیدن نخستین کلماتش دریافت که این جوان به محیط اجتماعی که او خود بدان تعلق دارد متعلق است	the first words he uttered recognized him as a man of her own class
او اسنادی را برای حفاظت به شما سپرده است.	that you have even accepted papers from him for safe custody.
زیرا که این ازدواج در تصور من برای او خوب و پسندیده است.	because I consider it would be a proper and eligible match for her to make
عشقی که پیش از به دنیا آمدن او به هیچ کس احساس نکرده بود.	a love new to her, before he was born.
متوجه شد این نور و روشنایی آفتاب هم فقط برای این است که او تنهائی و تأثرات خود را بهتر ببیند.	but the light only served to show the boy his own lonesomeness and desolation
به شرافتم سوگند که قصد آزردن او را نداشتم.	ma parole, je n'ai pas voulu l'offenser.
طوری که اورسولا حاضر بود باقی عمر خودش را بدهد تا موجب تسلی خاطر او گردد.	rsula's lap and she would have sold her soul in order to comfort him.
من حاضر نیستم حتی دیناری برای خاطر او خرج کنم.	I won't spend a farthing on him.
چند بار درِ اتاقت را زدم ولی جواب ندادی.	I knocked at your door but had no answer
من بچشمان او دقیق شدم و او نیز به دیدگان من نگاه کرد و همه چیز را دریافت.	I looked into his eyes and he looked into mine
که محل بعدی کجاست و تو چه روزی باید به آنجا وارد شوی.	with the next destination and the day you have to arrive.
یادم به میز تحریر افتاد که با تمام وسایل در اتاق آماده بود.	I thought of the writing desk in the morning room, the docketed pigeonholes all marked in ink by that slanting pointed hand.
کوشیدیم که از کشتی و تخته سنگ با شتاب فراوان دور شویم.	made a shift to get clear of the ship and the rock.
ظاهرا منظورش از اظهار این سخنان بیان منافع صلح و بحث در اطراف امکان یا عدم امکان انعقاد صلح نبود	evidently no longer trying to show the advantages of peace and discuss its possibility
عده ایشان به دویست هزار نفر هم خواهد رسید.	there will be two hundred thousand of them.
همه از بزرگ و کوچک و غنی و فقیر و عالم و عامی و وضیع و شریف	extolled by great and small, rich and poor, learned and ignorant, gentle and simple
اما همیشه از این وحشت داشتم که یه روز بین کی بمی ره.	but I was obviously dreading him dying, wasn't I?
تمام مهمات را آتش بزنند و متفرق شوند و هرکس به خانه خود بازگردد.	explode the ammunition, and all return home as quickly as possible.
چگونه توانستم بیگانگانی را که به کشورهای مختلف تعلق داشتند وادار کنم که پس از زیانهائی که بر من رسیده و حوادثی که بر من گذشته بود به خدمت من درآیند و جان خود را با من به خطر افکنند.	how I could persuade strangers, out of different countries, to venture with me, after the losses I had sustained, and the hazards I had run?
راستی که با این همه زر و زیور و جواهراتی که عروس به زلف و گردن و بر و سینه خود آویخته است	for the trinkets she has hanging from her hair and neck look just like them.
آن ساق پا! غولت رین وال سر زا که تا کنون قایقی را خرد کرده آن پا را بلعید و جوید و له کرد!	it was devoured, chewed up, crunched by the monstrousest parmacetty that ever chipped a boat!
پیرتر از او نم که بتونم باریک دروغ بزرگ دی گه رو رو شو نه هام بذارم .	I'm too old to shoulder the burden of constant lies that go with living in polite disillusionment.
خیلی خوشحالم که تشویقش کردم فردا تدهین اضافی بکند.	I am very glad I persuaded him to receive extreme unction tomorrow,
قصد ازاین کار یافتن اطلاعات در مورد اوضاع درآن دیار بود	the purpose being to gain intelligence about what's really going on over there
دختر کوتاه قد و لاغری بود اما موی بور و زیبا و چشمان آبی بسیار جالبی داشت.	with fair hair, rather pretty, with wonderful blue eyes.
آن وقت سه دلیل قاطع مبنی بر موفقیت کامل را پهلوی هم بگذارد	having summed up three leading reasons for complete success
دقیقاً هی چیز خوب یا بدی در درون خود ندارد	is nothing absolutely good or bad in itself
یک داستان واقعی برای شما حکایت کنم که دلیلی باشد بر بیانات جناب آقا اشاره به کشیش و بر عرایض خودم.	tell you a true story which will confirm this gentleman's word and he pointed to the curate as well as my own.
اما اونچه که مردم میبینن فقط سحر و جادو ا.	but all people see is magic.
من می خوام ببینم که تا چه مسافتی رو می تو نه پوشش بده	I want to see how far she can extend.
گوشش را تیز کرده بود بلکه دوباره آن صدا را بشنود.	trying to catch the voice again
سپس منقارش را در جام آب پرتقال هری فرو برد و به پرواز درآمد.	dipped her beak briefly into his goblet of orange juice, then took off again
سه ساعت بعد از نیمه شب در معیت ایشان راه باران شسته پاریس را پیش گرفت.	hence he started with it on the wet, wet roads at three o'clock in the morning.
هر دفعه سعی او با همین قضاوت سطحی و بیقیدانهی کنونی روبه رو شده بود.	every time he had been confronted by the same superficiality and triviality with which she met his appeal now.
چون که در فقط یک چفت چرمی داشت و و از کردنش خیلی آسان بود	you only have to pull a buckskin latch string
از پایه ستون بالا رفت و روی آب تیره رنگ خم شد.	he climbed on the pedestal and bent over the dark water.
تا رضایت و خرسندی و عیش همگان را برهم نریزد و انتظاراتشان از وی به نومیدی مبدل نگردد.	he wished to spoil the general pleasure and disappoint everyone's expectation.
با در نظر گرفتن ثروت پایان ناپذیر ادویه و ابریشم و جواهر و کلاه و عاج که هزاران جزیره را در ان دریای شرقی غنا بخشیده است	considering the inexhaustible wealth of spices, and silks, and jewels, and gold, and ivory, with which the thousand islands of that oriental sea are enriched
خود برای آنکه چیزی نشنود هر دو گوشش را با دست گرفت.	not to hear him she stopped both ears with her hands
از هم اکنون تا قوزک پا در برف فرو رفته بود.	it was already ankle deep about his boots.
چه برای زن هر گفتاری که شوری از عشق نیافته باشد مرده است.	for whom all words are dead that are not kindled by love.
نو مسلمان ایشان را دلداری داد و به ایشان گفت که به هیچ وجه اسیر نیستند	the renegade comforted them by telling them that they were not held as captives
هر چهار نفر پتو به دور خود پیچیده بودند.	all of whom were wrapped in thick blankets.
بلکه باید با کمال تأثر و تأسف اموال خود را واگذارند و از مسکو بگریزند.	sorry as they were to abandon their property to destruction.
به هر حال انگشت سبابة دست راستش به زمین خود.	touching it with his finger.
تمنی کردم که دیگر مرا به آن لقب نخواند	I begged he would forbear applying that word to me
در حقیقت من باید این عادتم را ترک کنم.	I really ought to break myself of the habit.
من چهار هزار فلورین را که صبح برده بودیم روی قرمز گذاشتم.	but to stake the whole four thousand gulden as she had directed.
به جای آن که زنگ معمولی کلیسا را بزنند ناقوس را زدند.	the bell began to toll, instead of ringing in the usual way.
این چند تار موی او را بر است ین من یافتند.	they found these upon my sleeve.
بعد به جنگ وحشیانه خود برای غذا ادامه دادند.	then went back to their vicious squabbling over the diminishing feed.
چطور ممکن است خودم آن را روی خودم ریخته باشم!	I most certainly did not knock it over myself!
میدانم که هر چه بیشتر با او زندگی کردهای احترامت در نظرش بیشتر شده است.	I know that the longer he has lived with you the loftier you have been in his eyes.
زیرا این مأمور که به حرف آن آقای سفیدپوش زیاد اعتقاد داشت	for that functionary, on whom the prediction of the gentleman in the white waistcoat had made a very strong impression
اما قیمت اتاقی که مسافر در آن استراحت فرماید بیست فرانک است.	but a chamber in which onereposes costs twenty francs.
چشمانش به دیوار سفید مقابل خیره مانده بود و حکایت از آن داشت که افکار آرام او در اثر یک خبر غیر عادی پریشان شده باشد.	her eyes, fixed on the blank wall opposite, expressed the surprise of a quiet mind stirred by unwonted tidings.
معتقد بود که از این برتری باید بهره بگیرد.	should of course profit by that notion.
تا هنگامی که به کلی خالی نشود آن را کنار نخواهم گذاشت.	I would not turn away from it till I had drained it!
آنقدر زیبا که آدمی بیم دارد درست شما را نگاه کند.	so beautiful that one is afraid to look at you.
در را نخواهم بست و به انتظارت خواهم بود.	leave the door open for you.
زیرا تمام دستورها صادر و حتی اینک اجرا شده بود.	for the orders had all been given and were now being executed.
پس همان نیمکت اولی را از جهت طولی رو به تنها قسمت دیوار که چیزی به آن نیاویخته بود گذاردم	I then placed the first bench lengthwise along the only clear space against the wall
او یک شب خوابیده بود و من در کنارش نشسته بودم.	I was sitting by him one night
آنگاه دو تن از یاران خود را در جلو مدخل دیر به پاسداری گماشت	he left two to guard the gate
که تقریبا یک صد هزار فرانک برای من صرف کردید	who placed at my disposal 100,000 francs
در چنین موقعی که غروب خورشید با مهتاب متقارن شده اصلاً نباید به فکر خوابیدن افتاد.	surely no one can wish to go to bed while sunset is thus at meeting with moonrise.
همان است که کار بسیار مهم و سختی بود	it was a very serious charge
چون من در وضعی نبودم که از چیزی برنجم	as I was not in a condition to resent injuries
منتها خانم گریفیث حاضر نبود چنین حقیقتی را تصدیق کند.	only she would never have been willing to admit that.
چوبدستیش را دوباره در ردایش گذاشت و به اطرافش نگاه کرد.	slipped his wand back inside his robes, and looked around, listening again.
تنها در بند این باشد که به خاطر کسب شهرت و افتخاری جاوید آن حوادث را حسن ختام بخشد.	bent on bringing them to a happy and successful issue, all to win a glorious and lasting renown.
آرزو میکرد ای کاش در همین لحظه میمرد و با مرگش همه چیز برای ابد به پایان میرسید.	wishing that he had died, and that everything would end forever at that moment.
از طرف من مطمئن باشید که این راز را ابداً به کسی نخواهم گفت و برای همیشه نزد من مکتوم خواهد ماند.	I won't say a word to anyone.
با من این طور برخورد کند و به من هیچ گونه محبتی نشان ندهد.	to give me such a greeting, and show me no affection.
فقط باید دعا کنم که اوضاع خوب پیش برود.	I'll just have to cross my fingers and hope for the best.
از این که این حرف را زدم همیشه خوشحالم.	I've always been glad I said that.
ذوب نماید و با آن برای کودکی که گذاشته بود از سرما یخ ببندد یک تابوت طلا بسازد	he had better melt it down and make a golden coffin out of it for his starved child
اما آیا ایپولیت به تو نگفته است که چگونه دلش از اشتیاق و علاقه به شاهزاده خانم عزیز ما شکسته است و چگونه شاهزاده خانم او را از خانه خود بیرون کرده است.	didn't he tell you how he himself was pining for the dear princess, and how she showed him the door?
همه از عالی و دانی از لحاظ سود نه به مزدهای ثابت است	all of whom, high or low, depend for their profits, not upon fixed wages
هر لرزش متناوب آن در حقیقت به همان اشتغال دارد	its every alternating vibration, indeed, only tending to that
من او را پنج دقیقه پشت در نگاه خواهم داشت.	I'll keep him out five minutes
که روی آن یک بطری آب معدنی سلتزر و یک تنگ براندی قرار داشت و تعادل میز را بر هم زد.	on which there was standing the seltzer water and the decanter of brandy, and almost upset it.
از روی جزیره سر از میان امواج دریا بیرون آورده است	since the island arose out of the seas.
قربان فکر کردم دندان اسب پیشکشی را نمی شمارند.	I thought I was not to look a gift horse in the mouth, sir.
منتها تا مجبور نشوم دیگر میل ندارم در هتل کار کنم.	though I don'twant to go back in the hotel business either if I can help it.
در ابتدای این قصه که او را دیدیم سی و شش سال داشت امروز قدم به پنجاه نهاده	who in his thirty sixth year at the opening of this history was now in his fiftieth
وقتی همه در تالار گرد آمدند کشیش دیر را بدرون آوردند	all being assembled in the hall, the priest of the parish came in
اما باز هم فرمان داد که طاغیان فوری به سر کار خود باز گردند.	but still commanded the insurgents instantly to return to their duty.
مغز هامون بیشتر از قبل با هم در ارتباط بودن. چون هردو سعی داشتیم مثل هم فکر کنیم.	our minds were more closely linked than they had ever been before, because we both were trying to think together.
امروز صبح دو تا گنجشک دیدم که زد و خورد می کردن.	this morning I came across two sparrows fighting
سرانجام نسبت به طبع بشری معرفتی شایان حاصل کرد	he at last arrived at a competent knowledge of what human nature
ولی هرگز رسماً و قانوناً او را به فرزندی نشناخت	he never recognized him as his son before the law
صدای بیرحمانة تق و تق پاهای دمپایی پوش بدون بدن به گوش رسید.	came the relentless slipslap of disembodied feet in slippers.
اما در چنین وقتی این کوشش فوق استطاعت او بود.	but this simple operation upon the most delicate organs of our frame
هری برای این که از او عقب نیفتد مجبور بود بدود.	he had to jog to keep up.
اما ترس از آینده مجهول در دل باک خانه گرفته بود	but the fear of the future was strong upon him
بعدها دکتر گتر خوش را در کهنه فروشی یافت و تنها کسی بود که آن را نشناخت و به آن نظری حاکی از تمجید فراوان انداخت و آن را از گتر سابق خویش بهتر یافت.	where such things were taken in exchange for gin, was more than once observed to handle them approvingly, as if admiring some curious novelty in the pattern, and considering them an improvement on his own.
یک اتاق غذا خوری مخصوص ساکنان و دو ااق خواب دارای حمام بود.	, a dining room where the boarders ate, and two bedrooms with bathrooms.
اون بهتون می گه در فلان ساعت برین فلان جا و بعد می ره	he'll tell you where to go, an' what time, an' then he'll go on.
چون اکنون که عضو جامعه شده است توجه دارد که بر ضد چنین شخصی عاجزو زبون است.	for, a member of society now, he realises accurately enough that against him he is powerless.
نگاهی به میز خود انداخت و پاکت مربع شکل نازک محتوی تلگرام را برداشت و به آنا داد.	glancing into his room, he took out and gave her the thin square envelope of a telegram.
این موضوع حسی را در او بیدار نکرده بود	although it in no way disquieted her
بعد از آن رفت به طرف کتابخانه و غایب شد	then he disappeared
اگر خود را در معبر او بگذاری و با او ترک ملاعبه ننمایی.	if you attempt to intercept their movements.
او هم در میان خندیدن بلندش پاسخ داد که برای مردان برازنده نیست که خرافاتی باشند.	she replied amid loud laughter that she did not think it was right for men to be superstitious.
به چه دلیل نبرد نهایی عمر خود را چنین به سرعت و ناتمام واگذاشته است.	had left the final battle of his life unfinished.
گاه ناجوذر و گاه به قوت و گاه بی قوت و به واسطه اختلافی که در ضربه آخر بود	sometimes hitting the woof slantingly, or crookedly, or strongly, or weakly
حالم از این زالوهای بوگندو به هم می خوره	I'm sick of all these reeking bloodsuckers.
این بود که به جای این که دل او را نرم کند	so, instead of winning him
لازم نیست در برابر من گریه کنی و خود را غمگین و متأثر نشان دهی.	don't snivel before me.
یک بطری له شده که تا نیمه پر از مایعی شیری رنگ فن یل بود با چترهای شناور سیاه رنگ در آن.	a squash bottle half full of a milky liquid phenyl with floaty black things in it
از زمانی که او یک سرباز در جوانیش بوده است	from having been a soldier in his youth
شام سبکی در زمین بازی دبستان محلی به همراه ۶ آبجو خورد.	inside he took a six pack of beer from the dead cooler.
به یاد آورد که یک آشنای نزدیک و گرامی وی در آن سر میز نشسته بود.	someone near and dear to him sat at the end of the table.
ولی کیفیت خاص خود را از زمان کودکی تا کنون حفظ کرده بود .	but the expression in them had not altered since the days of her unworried girlhood.
من نومید شده بودم که هم گنج را از دست بدهم	I was about desperate to lose that much blunt
ارباب دست فرزند را گرفت و وی را بر آن داشت تا با آن مرا آهسته نوازش کند.	which my master took, and made him stroke me gently with it.
از تأثیر آن تنها در طول یک روز یازده بار در لگن خودشان رفع حاجت کردند	they sat down at the same time on their pots eleven times in a single day
ما به پشتی تخت تکیه داده چهار زانوی خود را جمع کرده دو بینی خود را روی زانوان خود خم کرده بودیم	leaning against the head board with our four knees drawn up close together
او میل داشت با وضع آن خانه آشنا شود	he wanted to know it
شوهر بار دیگر طفولیت خود را که فرزندانش از او ربوده بودند به دست آورده بود.	because he had returned to the childhood his children had taken away from him.
مگر در آنچه نداشتنش مایه زیان من است یعنی در قدرت و سرعت و کار و کوشش	except where it was to my real disadvantage in point of strength, speed, and activity
برای اینکه به او کمک کنم اثر بزرگش را بنویسد	I might help him the better in his great works.
اما پس از فروش نخواست پول آن را با رفقا قسمت کند.	but would not share the spoil with his companion.
نخواهد توانست در پیرامون هیچ مرد دیگری قصرهای خیالی بسازد	that no other man could be the occasion of such delightful aerial building
فکر کردند بهترین کار برایش این است که برود بخوابد.	, and sleep seeming to be her likeliest friend,
تن و اندام او متناسب و موزون و حرکات او متین و رفتارش شاهانه است.	his body and limbs well proportioned, all his motions graceful, and his deportment majestic.
ولی اگر جلف از خود راضی وراجی بود زیاد برایش وقت نخواهم گذاشت و زیاد هم به او فکر نخواهم کرد.	but if he is only a chattering coxcomb, he will not occupy much of my time or thoughts.
چون تبریزی بلندی که جای خوابشان را پناه داده بود حالا افتاده بود.	because the great sycamore, the shelter of their beds, was a ruin now
که کنار پیشخوان طویل تالار بزرگ مرمری ایستاده بودند	who were standing nervously at the counter that ran all along the great marble hall
بار دیگر شما نیز ابتکار جدیدی به خرج دادید و نقشه آنان را نقش بر آب ساختید!	then you thought of another plan and hoodwinked them once again.
در همه عالم نه یک تن پروای مرا دارد و نه من پروای کسی را.	I care for no man on earth, no man on earth cares for me.
ولی در عین حال من خوش بین بودم و امید داشتم همان وضع مورد دلخواهمان عملی شود. زیرا در آن صورت من میتوانستم سر خانه و زندگی و کار خود باشم	yet I did hope, and began to cheer up under the prospect of retaining my home and my employment
سعی کردم یک بار دیگر او را ترغیب کنم.	I gave persuasion another try.
تازه آن وقت بود که انگار باکسر صدای جارو جنجال را شنیده باشد	just at this moment, as though he had heard the uproar outside
در حالی که با دریافت تنها هزار دلار هم حاضر به سپاسگزاری بود.	the while his hope would be immutably fixed upon a gratuity, at any rate, of no less than a thousand.
خود با مهربانی دست در بازوی او انداخت تا همراهیش کند.	put his hand beneath her elbow courteously to guide her
ولی امیدوارم شما هم به این اخبار توجه نشان بدهید.	but I hope you mean to take an interest in this news.
کنیزک را فراخواند تا موش مرده را با انبر بردارد	calling the maid to take up the dead rat with a pair of tongs
در همین لحظه چهار تا دستمال از جیبش بیرون کشید.	at the same time producing four pocket handkerchiefs.
من پرش زودتری انجام دادم تا از قدرت جدیدم برای شکست او استفاده کنم.	I took a chance and made my leap early, trying to use my extra strength to win.
اما مرا ترجیح داده و مرا طرف معامله قرار داده	he has given me the preference
در عین حال اطمینان داشتم که اثر الکل هنوز مانع از این بود که بتواند تصمیم فوری و قطعی بگیرد.	he was still not sober enough to carry it through.
در واقع آن رفیق به من گفت که پدرش تمام ثروت خود را مابین سه پسری که داشت تقسیم کرد	for he said his father had divided his property among his three sons
تراکتورها از راه رسیدند و در کشتزارها رخنه کردند.	THE TRACTORS came over the roads and into the fields
دو لحاف به روی او انداخت و خود برایش عرق بیدمشک آورد	covered her with two quilts, and herself brought her some lime flower water
اقدامات ضروری رو به انجام بر سونی ممکنه بتونیم این وضعیتو حفظ کنیم.	take the necessary measures, we may still be able to save the situation.
من این همه را بدین سبب گفتم که اگر اشتباه نکنم	I say this because, if I mistake not
بدتر آنکه صدای آهن و زنجیر همچنان بلند بود	more especially as they perceived that the strokes did not cease
اگر بخواهیم امور خطیر را با جزیی مقایسه کنیم	to compare great things with small
اما به هر حال جای هدر دادن یک لحظه هم نیست.	I don't know, but let it not be a minute later!
که جزئیات آن را کام لا به یاد ندارم.	I don't remember everything as it happened.
تفنگ را برگردانیده لولهٔ آن را گرفت و آن را همچون چماقی تاب داد.	reversed the gun, gripped it by the barrel, and swung it clubwise.
هر چیز دیگر را که دستشان بود به زمین انداختند.	dumped their other traps on the ground
در دو قدمی اطاق خانم اپانتچین شاهزاده ناگهان توقف کرد	but when he was two rooms distant from the drawing room, where they all were, he stopped
با این کار ممکن است دشمن از حضورمان با خبر بشود.	it might tip off our enemies.
من او را ترک کردم و به بازی پرداختم.	I went out then and ran to play.
زیرا من فریاد نزدم و فریاد زدن را دون شأن خود دانستم .	for I thought it below me to cry out.
ما همه از قراری که پس از تفکر بسیار در جلسات مشورتی خود با هم گذاشته بودیم نکته به نکته پیروی کردیم	all following out the arrangement and plan which, after careful consideration and many a long discussion, we had decided upon
بلکه بیشتر به فکر خود و قبولاندن توضیح نیم بند خود است تا به فکر او.	he was more concerned about himself and his own partially explained defection than he was about her.
وقتی زمستان بی بهار از راه برسد بهاری که شاید آمدنش را هرگز نبینم.	when winter comes without a spring that I shall ever see.
خیلی مختصر و رسمی عذرخواهی کرد که زودتر سر نزده.	she made a slight, formal apology, for not calling before,
صبر داشته باش! پیروزی خود را به آسانی خراب نکن.	don't be too certain of your triumph.
اما ممکنست در خلوت زن پرحرفی هم بوده باشد.	but it may be that in private she had a copious conversation.
سعی کردم بهش علامت بدم ولی لیا اصلاً منو ندید.	I gave her a warning glance she didn't see.
خودش پذیرفته بود و اجازه داده بود که با او همین طور حرف بزنم!	of her own accord she had allowed me to tell her as much .
خود من فکر خواهم کرد تا این گرهی را که در کار تو افتاده است و باعث آن شوهرت بوده است باز کنم.	I shall find my wits and unravel this skein of your husband's winding.
چنین قیاس گرفتم که باید مرد شوربختی را در آن گودال افکنده باشند.	concluded that some unhappy man must be shut up in the cavity.
تا دو ساعت دیگر آن قصه چندین بار گفته شد.	the story had to be told and retold for a couple of hours more.
که در آن زمان هفتاد و دو سال داشت	who at that time was seventy two years old
اما امشب به هیچ وجه اثری در او نکرد.	, but this evening he took no notice of theM
این از دنبال کردن وال در دریای آرام بدتر است.	this is worse than pulling after whales in a calm
در حالی که غرور و کبری که داشت او را وادار بر مقاومت کرد.	striving to struggle against this triple force and his own emotion
که بانوی فرمانروای مطلق زندگیم فرشته نجات بخش یا هلاک کننده با ظاهری متواضع در آن نقطه منتظرست.	my genius for good or evil waited there in humble guise.
کم کم راز این سرزمین جادوئی را بر او آشکار ساخت.	little by little delivered up to him the secret of the enchanted land.
وضع کلی تا در نظر والانتین تغییر کرده بود.	, and certainly it was less difficult now for her to believe
مردم به آن اوضاع و شرایط جدید عادت خواهند کرد	which will seem quite ordinary to others
اما عنصر اصلی سرنوشتش و اساس ضروری سیاستش نبود.	but was no longer the principal element of her destiny, and the necessary base of her politics.
سیگار برگی آتش زد و چشم انتظار آن بود که کسی پیدا شود و او را سرگرم کند و از فکر و خیال نجاتش دهد.	lighting a cigarand looking for some one who would come and play with him and save himfrom thinking.
همین که وی را نقش بر زمین دید بانگ بر کوبنده زد تا دیگر چماق خود را بلند نکند	seeing him fall, cried out to his assailant not to strike him again
دیروز من به کلی با او به هم زدم و بسیار متأسفم که چرا زودتر اینکار را نکردم شاهزاده!	I broke with him last night, and am very sorry that I did not do so before.
چند روز قبل از این تاریخ اتفاق افتاده است.	occurred a few days before that date.
هر یک ضمن شرح واقعه در وصف عرعر کردن همکار خود داد فصاحت دادند.	each crying up the other's perfection in braying.
پس شانه را بالا انداخته به اتاق خود رفت.	then shrugging his shoulders went to the door that led to his own apartments.
باز مؤدبانه از من دعوت کرد که به بستر بروم	again politely motioned me to get into bed
مأیوسانه به این زن خپله غر غر و با آن بازوهای پهن برهنه خیره شد و در حیرت بود که اصلا چطور شده که این زن اینجا پیدایش شده.	he stared bleakly at this plump and fussy woman with the broadbare arms, and wondered how she had ever come here.
حالا از شما تقاضا دارم بوی غذای کافی بدهید	I should like you to ply him well with the victuals, my dears
تختخواب بلند مباشر با لحاف چهل تیکه قرار داشت به دهلیز سر کشیدند.	where the steward's high bedstead stood with its patchwork quilt.
من تابه حال هم چه پولی ندیده بودم که به آسانی گیر کسی بیفتد.	I never see money hauled in by the wagon load like that before.
به نظر من بهتر است فقط باید متوجهش کرد که نباید خودش را خسته کند	I think it desirable for him to know nothing more than that he must not overwork himself
هیچ کس جرات نداشت از او بخواهد تمام کار چاپ را از سر بگیرد.	no one had the heart to ask him to redo the whole print order.
مستخدمه بی آنکه رویش را برگرداند پیچ آن را چرخاند.	the waitress, without looking, reached behind her and shut it off.
به قدری که از یک تا ده شمرده بشود	while one might count ten
اما هنگامی که روی تپه و زیر درخت بلوط تنها بود	but directly he was alone on the mound under the oak tree
چهره او بیش از اینکه شبیه قیافه انسانی باشد به حیوانی شباهت داشت که به تور افتاده باشد.	with a countenance more like that of a snared beast than the face of a man.
از هیچ روی نگاه غرض آلود و حسودانه جغدی نبود که به دو کبوتر بنگرد	it was not the least in the world like the scandalized and envious glance of an owl at two turtle doves
اما اگر این گروه را با کار مرد جنگی مقایسه کنند و با هم بسنجند	but, contrasted and compared with what the warrior undergoes
اما کشیش هردو را با عشق و احترام بوسید.	but the priest kissed them with love and respect.
با محبت و لطف تمام چنان نگاهی بر او افکند	looked so kindly and loving in his face
من فقط دارم چیزی رو بهت می گم که خودت هم می دونی	I'm just telling you what you already know.
به دلیل اینکه تو خواستی آمدن خود را از من پنهان داری	well you wished to conceal your journey from me
اما امکان نداشت بتواند تصویر وقایع اطرافش را از ذهن خود پاک کند.	but it was impossible to shut out the vision of what was happening all around her.
گوششان را تیز کنند تا صدای چکیدن آب را بشنوند	listen for dripping wate
من به گلم احترام میذارم و کاری رو انجام می دم که براشون بهترین با شه	I honor my pack. I do what's best for them.
هر چند در یک روز صبح بارانی چنان خیالی داشت.	as he attempted to do one rainy morning
معتقدم پیشنهاد او برای این کار به مورد بوده است.	I believe him to be proposed from unimpeachable motives.
به پوست سفتی که باران روی کشتزارهای ذرت گسترده بود حمله برد.	it worked at the rain crust in the corn fields.
قبل از من چیزی نبودند و بعد از من هم چیزی نخواهند بود	before me they were nothing after me they will be nothing
لابد تقریباً همان لحظه که به اتاق رفته مرده است.	she must have died almost the moment she retired.
هنگامی که آسانسور صدایی کرد و روی زمین ایستاد	thought when the lift bumped on the ground
ولی هیچ چیز مثل داشتن شش دست لباس نو نیست.	but nothing compared to the dizzying experience of owning six new dresses.
در این اوان منشی به سراغ شمشیر دانشجو رفته بود	not caring to wait for the notary who had gone for the sword
به خصوص آنکه تا حال ذکری از دوربین به میان نیامده بود.	with what, since no thought of the camera had come up as yet.
عملی که با وجود ممنوع بودن قانونی باز هم معمول بود.	which was the custom despite the laws prohibiting it.
امشب وقتی بدان جا میآیم تو را از آمدن خود باخبر خواهم ساخت و آنگاه تو مواظب خواهی بود وقتی کاترین تنها باشد بدون اینکه کسی متوجه گردد مرا به درون عمارت راه دهی و دقت کنی تا به همان ترتیب نیز از همانجا خارج گردم.	I'd warn you when I came, and then you might let me in unobserved, as soon as she was alone, and watch till I departed
چون بعضی از دوستان من خشن و تندخو هستند	some of my hands being rough
تاپدر شما وارث شما شود و اموال مسی و نوار تیر هم به پدر شما منتقل گردد	it is because your father would inherit your property
فقط پنجره اطاقی که پسرک در آن محبوس شده بود آزاد بود	except one small trap in the room where the boy was locked
حال آن که جنسیت زیر لباس کام لا متضاد آن است	while underneath the sex is the very opposite of what it is above.
آنگاه به شتاب قایق را به عقب کشیدیم و در همان حال سخت جویای مفر دیگری شدیم.	then giving way rapidly, and at the same time earnestly watching for another outlet.
که گویی بمبی است که هر لحظه ممکن است منفجر شود	like a bomb that might go off at any moment
این پیراهن چنان با عشق و رؤیا و اشک و تنهایی درآمیخته بود.	it was so tied up with love and dreams, tears and loneliness
پس از این سخنان با حالت تهدیدآمیز نگاهی به سوی من افکند.	making a clutch at me
مگر تا آن حد که با خویشتنخود او سر و کار پیدا کنم.	except in so far as it touches upon his character.
به اینهجهت هر امتحان که برای ما روی دهد جز خیر و صلاح ما نیست.	so whatever befalls us is for our good.
دیگر درصدد برنیایید که بار دیگر بخت خود را بیازمایید.	do not seek to tempt fortune a second time.
خود من بودم که این فکر را در سرش انداختم!	I put it in his mind myself,
به عرصه کارزارها که در پای تپه گسترده بود نظر انداخت	he viewed the field of battle opening out before him from the hill
جمعیت در این مورد نیز از وی حمایت کرد.	wherein she was likewise much commended.
به خصوص وقتی نمی دونم حرف طرفم هم همینه یا نه اما به نظر می رسه که حرف درستی زدم.	especially when I'm not sure of it, but it seemed like the right thing to say.
اما من در صدایش هیچ نوع موسیقی دلنشینی حس نکردم.	but its song had no music for me
فقط می دونم که پرندگانی زشت خو هستند و تا فاصله زیادی میتونند ببینند.	except they are mostly ugly natured birds who can see a long ways
من تقریبا دیگر وجود خارجی ندارم و خودم هم این حقیقت را میدانم.	I know that I have almost ceased to exist.
گویی صاعقه او را بر جای خود خشک کرده بود.	as though thunderstruck.
بلکه چنان هار شده بودند که در شورای عمومی شکارچیان تصمیم گرفته شد	but were so jaded that at a meeting of the huntsmen
هزران ادا و اطفار خوشایند برای او از دست رفته بود.	a thousand good quips and cranks would be lost to him.
رفتم به غار توتون بردارم که یک مار زنگی دیدم.	I went to the cavern to get some, and found a rattlesnake in there.
اماموهایش چنان پرپشت و آنبوه بود که موفق نشده بود.	but found he had too much hair.
یکی از دوستانش در حضور همسرش به او گفته بود	a friend told him, with his wife present
گوشش را تیز کرده بود تا علی رقم وجود صدای پای خودش چیزی بشنود.	trying to listen over his own pounding footsteps
این که اول چطور سر به سرش گذاشته و با او از در شوخی وارد شده بود سپس با او دعوا کرده و رهایش ساخته بود.	how she had flaunted it, teasing him, then withdrawing.
تا آخر عمر چون دوستی صمیمی و غمخوار و راهنمایی شفیق با دخترتان بمانم.	I'll stand her friend and counsellor to the last.
من سکوت خواهم کرد و از گفتن حقایقی که به عنوان یک مهتر خوب باید به شما بگویم خودداری خواهم کرد.	I will hold my tongue and leave unsaid what as a good squire I am bound to say
تا جایی که یاد اون همه. دیگر پرستار به جای سه سر دوران دار فقط یک سر داشت.	until the nurse had one head instead of three heads floating side by side.
نوعی اشاره مبهم از مرگ بود که از طریق پدرش درک کرده بود.	was in a way an early sign of death in the person of his father.
بهتر است امشب ما دو نفر را با هم نبیند.	it is better she should not see us together to night.
آنگاه چون کشیش دانست که حاضران را محظوظ خواهد کرد	seeing which, and considering that he would give pleasure to all
آنگاه ساعت شد و با حال اعتراض و رنجش منتظر ماند.	waiting with a defiant and offended face.
من هرگز پیشنهاد نکردم که همه ما به سوی کاری که مناسب آن نیستم بشتابیم.	I never suggested that we should all rush into work for which we are unfitted.
بعد هم با حالتی مضطرب و ناراحت به دکتر نگریست.	with a most ludicrous mixture of fear and perplexity.
او حاضر بود در مقابل این زن زانو بزند	he was ready to get down upon his knees to the woman
احساسات و تأثرات فراوانی در قلبش بیدار ساخته بود	what a crowd of emotions were wakened up in his breast
چهار صد فلورین را روی سیاه گذاشتم و بردم	four hundred upon the black, and won
لیکن کشیش از نقشه نخستین خود که سکوت درباره مطالب پهلوانی باشد عدول کرد و	the curate, however, changing his original plan, which was to avoid touching upon matters of chivalry
نمی دونم فقط همین یه رقص گیرم میاد یا بیشتر	I don't know if I get more than just this one dance,
نه کیسه مرا پر کن و نه خالی ساز.	but do not fill or empty mine
که در آن قسمت از کشور خیلی مورد توجه بود.	which was much admired in that part of the country.
سپس ناگهان مادر را در آغوش کشیده بوسید و شروع کرد بخندی دن.	then caught the mother around the neck with the same hand, kissed her, and laughed.
در میان اشیاء و لوازم کوچک خود عینکی داشتم که در جیب سری خود پنهان کرده بودم	I kept, among other little necessaries, a pair of spectacles in a private pocket
اما برادر کم! مردم اینجا به کلی وحشی و خشمناکند.	here, friend, the people are quite beggarly.
حتی اگر پس از شش ساعت پرواز بدون خواب باشد.	even after a six hour flight without sleep.
آهسته به سوی جنگل ممنوع چرخید و از نظرها ناپدید شد.	started to drift lazily toward the forbidden forest and out of sight.
پدر و دختر در آن نشستند و دور شدند.	the father and daughter departed in it.
همین موضوع برای ما بهانه خوبی شد که آن شب مسئله انهدام خط آهن را فراموش کنیم.	winning thereby good excuse for doing nothing this night to the line.
یا اینکه خود سیب در آفتاب پلاسیده و خشک شده است	because it is dried by the sun
یادم هست که یکی دو صندلی هم برگشته بود	I remember a couple of overturned chairs
من از تو تقاضای کار کردم تو هم به من جواب رد دادی.	I asked you for help and you wouldn't give it to me.
اوه! تو را به خدا ببین بیچاره رو چه جوری اذیتش کردن.	look at t' poor lad, he's fair choking!
به او گفتم که تو شخص بسیار خوب و شریف و زحمتکشی هستی.	I told her you were a very good, honest, and industrious man.
گفتنش با کتاب خون دن هیچ دردی دوا نمی شه.	he says it don't do no good to read books
به نظر من در این موقع خیلی عجیب است.	I think it's wonderful for the time of year.
تسلیم اراده او شوم و فرمان اراده خود را نادیده بگیرم.	to rush down the torrent of his will into the gulf of his existence, and there lose my own.
تا موقعی که جز یک پیراهن پاره به تنشان نماند دوباره راه دریا را در پیش گیرند.	to sea again in their shirts.
درست مثل اخلاقیون موعظه گری که صادقانه به حقانیت خود ایمان دارند.	the convinced and earnest tone and look of the moralist who knows that he is right.
در کنار هر نقطه با حروف ریزتر اسمی نوشته شده بود.	each labeled with a name in minuscule writing.
بعدها شاید همچون مادری مهربان ما را در آغوش پر مهر خود بگیرد	afterwards, he may come to fold us in his arms as our mother did
چه این هردو بلا در واقع یکی است .	the two scourges are one and the same .
باید یادآور شوم که از آن پیرمرد خیلی خوشم آمد.	 I liked that old fellow
مرد گفت همینه که بهتون می گم آدم یه چشم زندگیش به دلخواه خودش نیس	I tell ya, a one eye' fella got a hard row the man said.
در بین راه یک جای ارابه خراب شده بود و مدتی آن را نگه داشته بودند تا تعمیر کنند.	for the carriage being stopped a while, to adjust something that was out of order
اما این نه گفتنش ضعیف است و قانع کننده نیست.	but weakly, unconvincingly.
لوله بخاری که به شکل نخل بود سایه خوشه طلایی رنگ خود را گرد بر سقف سفید اتاق انداخته بود.	the stove pipe, in the shape of a palm tree, spread its gilt leaves over the white ceiling
تا آن سن هر کس کارش را کرده است و بعد از آن هر کاری که بکند تکرار مکرّرات است.	by then a man has done his best work, all he does after that is repetition.
یکی از فضایل او سلاستش در این زمان بود.	it was one of his accomplishments to speak with fluency.
ویرانی این وجود حالا بسته بزمان بود و بس.	it was only a question of time and the mechanism itself would be destroyed.
یک وقت می دون ستم ولی حالا تقریبا فراموش کردم .	I knew once but I've half forgotten.
کنت پیر را نزد خود فراخواند و بدون توجه به وارد ین لژ خود مهربان و متبسم با وی بگفتگو پرداخت.	paying no attention to those who had entered her box began talking to him with an amiable smile.
منم یواش رفتم طرفش و دستامودورش حلقه کردم و تم وم شب منو گرم نگه داشت.	I creeps up agen her and puts me arms round her, and begod she kept me warm all night.
که خورش خوب بوده یا آن که گوشت خوب بریان شده بود.	that her sauce was good or the meat well cooked.
زیرا که این یک اشتباه است که میگویند با خود حرف زدن در طبیعت نیست.	for it isan error to suppose that the soliloquy is unnatural.
من این حرف هار و از او نا شنیدم.	I've heard them all suggested.
خانمش موافقت کرد که کمی چای برای ما درست کند.	she would make us some tea.
چون که آن دو نفر با هم دوستی داشتند.	because they were friends.
از دادن هر خبر خوشی که دل مرا خوش کند دریغ مدار.	deny me not the happiness thou canst give me by such good news.
ولی من از سحر و جادو هیچی سردر نمیارم.	but I don't know anything about magic at all.
اما در آن عمق وقار آمیز او چیزی بود که توجه مرا جلب کرد.	but there was something in her grave intentness which excited my interest.
من کاری که از دستم برمی آمد انجام داده بودم.	I'd done what I could.
مثل وقتی که از دست آن درخت شیطانی فرار کردی.	like when you escaped from the demon tree.
ازوپ را با دو بردهٔ دیگر به معرض فروش نهادند.	_AEsop was put up for sale with two other staves.
همچنانکه اعضاء مختلف بدنشان دچار لنگی و زخم و آسیب گردد	as well as other maims and hurts in the several parts of the body.
بگذارید من این نکته را به متهم خبر بدهم.	I'll tell the prisoner so.
من تو روزنومه خوندم که به را چیدن انگور و پرتقال و هلو یه عالمه کارگر می خوان	I seen in the paper how they want folks to come an' pick grapes an' oranges an' peaches.
از یک عده بخواهد از کنار بخاری بلند شوند و در چنین هوایی بروند دیدنش.	he asks people to leave their own fireside, and encounter such a day as this,for the sake of coming to see him.
به رام نامه فرستادن که امروز حتما باید باهاشون نهار بخورم.	I got a note saying they expected me to come there again to day for dinner sure.
که از وسط به دو شبکه آهنین جدا شده.	divided by two upright gratings
جز اینکه چندین سال پیش همسرش آن را گفته بود.	except that a long time ago his ex wife had said it to him.
در عوض پدرش هم او را بی نصیب نگذارد و سیلی محکمی به گوشش نواخت تا مواظب باشد و از آن پس چنان حرکت زشت و بی ادبانهای از وی سر نزند.	earning for her pains a sound blow from her father, to teach her cleaner manners.
زندگی من باید در زندگی تمام ایشان منعکس شود	but so that it may be reflected in them all
که عزم و اراده او را به کلی درهم شکست.	too much for his own strength of will and purpose.
این مرد هنوز یادداشت او را دریافت نکرده است.	that he had not yet received her note.
دست زیبای بی دستکشی تکیه گاه صورتش شده بود	one beautiful ungloved hand pillowed her cheek
اولین جن خاکی را که در پرچین گیر کرده بود بیرون بیندازد	just to drop the first one he caught over the hedge
اهمیتی نمیدم که یه کانگروی گردن قرمزم بوده با شه	I don't care if it was a wal laby,' she said.
او در تاریکی و تنهایی لحظاتی طولانی نشست و فکر کرد.	sat in the dark in his office, thinking about her.
این راه شه و زنا اغلب این جوری سوزن نخ میکنن اما مردا درست به عکسش میکنن.	that's the way a woman most always does, but a man always does t'other way.
بنابراین بهتر آنکه هرکس مراقب رفتار و کردار خود باشد	let each look out for the arrow
ملاحان بی درنگ با سر و صدای زیاد ر به حرف زدن مشغول شدند.	they began capering about most obstreperously.
روزی که هر دو به چمنزاری در بیرون شهر به گردش رفته بودند	that on one occasion when the two were strolling together outside the city
آنگاه پهلوان بیندیشد که این بیماری بر اثر درد هجران او است	the knight thinks it is from grief at his departure
قیافه زیرکانه و مصصم او ظاهرا به عادت یا به عمد تغییر یافت	intelligent expression on his face changed in a way evidently deliberate and habitual to him.
میل داشتم قلب خودم را برایتون بشکافم تا ببین ین چقدر خیر و خوشی شما را طالبم.	I want to open my heart before you, so that you may see how I wish your welfare.
میل داشت این دختر بدیع و پرشور را که خاطرات مطبوعی از خود در وی باقی گذاشته بود در خانه ببیند.	he wanted to see that original, eager girl who had left such a pleasant impression on his mind, in her own home.
اما من باید هم جان فرمانده کل و هم لیاقت و حیثیت او را محافظت نمایم.	but it was my duty to safeguard my life and dignity as commander in chief.
لذا وقتی در حیاط سنگفرش عقب ساختمان از اسب پیاده شدیم هوا تاریک شده بود.	so it was dark when we dismounted in the paved yard of the farm house
در همان جا که ایستاده بودم دراز کشیدم و صورت خود را روی زمین گذاشتم.	I sank down where I stood, and hid my face against the ground.
صدای امواج که سایر صداها آن را خفیف یا مخفی کرده بود ناگهان همچون رعد در گوشش طنین انداخت و موجب شد سرش را با وحشتی غریزی بلند کند.	this sound which had been obscured and concealed under the other sounds suddenly thundered hollow in her ears and made her look up with an impulse of terror.
اما چنگ و ناخن از برای این کار کافی نشد	but they were too weak
تا پدرش در آستانه مرگ مضطرب و غمگین نشود.	to hide it in order not to sadden his dying father.
در این ظهر گرمان از شدت حرارت نمی شه بهش دست زد.	it's far too hot to touch this noon!
سر هنری قدری با تعجب به دوستم نگاه کرد	glancing with some surprise at my friend.
من در آشپزخانه بودم که صدای شلیک گلوله را شنیدم.	I was in the kitchen when I heard the sound of gunfire.
بلافاصله خود را در یک رختخواب گرم و خشک یافتم.	soon a warm, dry bed received me.
به ایشان دستور داد در پیش بروند و چارنعل به طرف آن فریادهای ممتد به دامنه تپه پیش رفت	told them to follow him, and trotted downhill in the direction from which the shouting came.
کلاه سواری مچاله شده که در عقب سرش قرار داشت	a crumpled shako on the back of his head.
وقایع برجسته آنچه را تاکنون تعریف کرده است به خاطر دارم.	I can recollect its chief incidents, as far as she had gone.
وقتی داخل سرسرا شدم دیدم دستکش و روسریش روی صندلی افتاده.	I saw her scarf and gloves lying on a chair in the hall.
فقط همان آشنایی نامعلومی که از اول در او دیده بودم.	only that vague something which I knew I'd seen before.
هرمین روبان پر زرق و برقی دور گردن کج پا بسته بود و ظاهراً به همین دلیل کج پا نارحت و عبوس بود.	was looking very grumpy, with a string of tinsel tied around his neck.
تو نیز دختر عزیزم به نزد ما خواهی آمد.	you, darling child, shall come to us!
او را به شک انداخت که نکند در قضاوت خود اشتباه کرده باشد.	caused him to decide that he might be wrong.
که آیا مسی و مادلن بازگشته است و به زودی به درمانگاه خواهد آمد.	whether the mayor had returned, and if he would not come to the infirmary soon.
آنچه با کوشش و دقت او فراهم آمده اینک با دستی نامرئی یکباره خراب و تباه شده است	that the whole affair, carefully prepared by him, had now been ruined by somebody
که آرنجها را روی میز گذاشته و خستهوار به جلوی روی خود نگاه میکند و ظاهراً آمادهی عزیمت است.	on which he rested his elbows, looking dejectedly before him.
لکن در ساعت یازده ماه از دریا طلوع کرد و هوا روشن نمود	but at eleven o'clock the moon rose in the midst of the ocean
اما من می خوام تو رو کم کم وارد ماجرا کنم.	but I want to break you in gently.
خود را آماده کرد تا آخرین سبک رقص را به او یاد بدهد.	was trying to teach him the latest dance steps.
بهترین و زیباترین خصایص را به آنان نسبت میداد و برای حدس و گمان خود دلایل مثبت مییافت.	endowed them with the most marvelous and noble characters, and found confirmation of her idea in her observations.
من می دون ستم که او نا تا مدت طولانی ای به دویدن ادامه خواهند داد.	I knew they wouldn't stop running for a very long time.
ایشان به راه افتادند و پل را گرفتند و از آن عبور کردند	off they go and take the bridge, cross it
اما این جور شعر گفتن مثل آب خوردن است.	but they're cinches.
اولین باری که چشمم به آن بچه افتاد نفرت او را در دل گرفتم آن موجود لاغر نق نقوی مردنی!	I hated it the first time I set my eyes on it a sickly, whining, pining thing!
اما خانم کوخلاکف سخن او را قطع کرد و یادآور شد	but she interrupted him at the first words.
ثمره آن سه فرزند بود که به نوبه خود ازدواج کرده و صاحب فرزند شده بودند.	which left her with three children who had married and had children in turn
پس می تونیم یک اعلامیه مشترک در این مورد برای پلیس بفرستیم که خیالشان برای همیشه از جانب ما راحت باشد.	I wonder if we should send a formal announcement to the police?
خواهم رفت تا با او مشورت کنیم و فعالیت نماییم و به قشون کمک کنیم که تبهکاران را نابود سازد.	to consult with him to act, and to aid the army to exterminate these scoundrels.
کافی است که خود را خوشبخت و مأجور بدانم.	I will count myself happy and fortunate.
بار دیگر با همان دست مضروب و مقتول شده است	has been again struck by the same hand
حتما تصور کرده بود که خود را مخفی ساخته است.	I'm sure he thought he was hiding.
مدتی دوندگی کرد تا کاری کم زحمت پیدا کرد.	was, for some little time, at a loss for the means of a livelihood, not burdened with too much work.
بعد از روی لجاجت جلو دهانش گرفت و ادامه داد	raised it stubbornly
سعی کرد با مواد منفجره در را از بین ببرد	he tried demolition charge to blow the door
خود را تا زانو درست در وسط سرگین یافتم.	found myself just in the middle up to my knees.
هر قدر وضع ظاهر و آرایش این چهره را تغییر دهند باز صوتش نازیبا خواهد ماند.	that however they might change the setting and adornment of that face, it would still remain piteous and plain.
از خانه بیرون دویدم و خود را به روشنایی آفتاب رسانیدم.	I dashed out of the door into the clear sunlight.
یادم هست راجع به او زیاد برایت نوشته بودم.	I wrote you so much about her.
خیلی زود این خبر درز پیدا کرد که هر خوکی روزانه نیم لیتر آبجو سهمیه دارد	the news soon leaked out that every pig was now receiving a ration of a pint of beer daily
با هم دعا خواهیم خواند و روانه خواهیم شد.	we will pray and go together.
امروز هذیانش شدت کرده قریب به سر حد جنون است.	to day her delirium is almost madness
بوی یاهو میان بوی راسو و بوی روباه است	the stink was somewhat between a weasel and a fox
مرا چندان به یک سو متمایل کرد که ناچار شدم با همه سنگینی خود به سوی دیگر فشار بیاورم و نگذارم که زورق برگردد.	made it lean so much on one side, that I was forced to balance it with all my weight on the other, to prevent overturning.
در جایگاه شهود قرار گیرد فورا از جا برخاستند و بیتا بانه گردن کشیدند.	was at once upon its feet, craning and stirring.
اتومبیلش در واگن آخر قرار داشت که ما در آن را قفل کردیم.	his motor car was on the end of the train, and we shot it up.
خانه جایگزین معصومی برای خیانت به شوهرش شده بود.	an innocent substitute for infidelity.
گروه مهمانان آن روز را صرف گردش و تفرج در نواحی مجاور کردند.	it was devoted by the party to an excursion to some site in the neighbourhood.
او با انگشتان در دست پوش فرو رفته و سر در کلاه گوشی پوشیده به مطالعه ریاضیات در آن لانه کلاغ مشغول بوده است و از قطب بیش از سه چهار آواز خروس فاصله نداشته است.	while with mittened fingers and hooded head he was studying the mathematics aloft there in that bird's nest within three or four perches of the pole.
حقیقت این است که برای دفاع از خودش به روی یک فرد عامی شمشیر کشیده است و برای نجات جان خودش به من حمله کرده است.	he drew to defend himself'thrust at me with all his skill for his life.
روی تنه درخت چشمم به چند لکه خون افتاد.	I observed several splashes of blood about the bark of the tree
تنها به تماشا کردن و شنیدن سخنان ما قناعت نمود.	but she looked, and listened
درست است سابقا بیماری چنان آسیبی به من رسانیده که به سرحد جنون نزدیکم ساخته است	that though I once was so ill that I really was little better than an idiot
فی با یک کلمه تشکر خشک و خالی آن را گرفت	she took them with a brief, expressionless word of thanks
امشب هم قبل از رفتنت بار دیگر از تو قول خواهم گرفت	I'll make you promise again, before you go.
کتب و شلواری تیره با یک ژیله در زیر کت	a dark suit with a vest
ما نقشه داریم که 42میلیون دلار را کش بریم	we plan to yank 42 million dollars
چون خیلی کهنه بود دوباره آن را سر جایش گذاشت	being a very old one, he deliberately put back again, after trying it on his own countenance.
به نظرم کم و بیش اصل مطلب رو گرفتم.	I think I more or less got the gist.
تمام بشقابم را برداشتم و درون سطل زباله خالی کرده و پنجره را باز کردم تا به وی غذا را تهویه شود.	I took the whole plate and shook it into the garbage, then opened the windows to chase away the scent.
اما اینکه حال استری کلند نتیجه سازگاری روح او بود یا تضاد آن معلوم نیست.	but whether this was due to equanimity of soul or to contradictoriness it would be difficult to say.
من با وجود این هیچ کاری نمی تونم بکنم.	I've got no chance with these on
اسکار لت اسلحه را پایین آورد و سر جایش گذاشت.	she shoved the pistol down into the upholstery
تنها در این اندیشه هستی که خرس از دست تو فرار نکند!	your only thought is not to let him get away!
اگرچه ساکت نشسته بار دیگر بافتنی را به دست گرفته بود	quietly though she sat, taking up her stocking again
اما عبارت دوستت دارم او را به عصیان آورد.	but the word love threw her into revolt again.
من هیچ چیز راجع به کار و کاسبی نمی دونم .	I'm such a goose about business.
ولی کمند کسانی که شایستگی نام پهلوان داشته باشند.	but few they who deserve the name of knights.
بلکه با تمام جریان تاریخ ارتباط دارد و از روز ازل مقدر شده است.	is related to the whole course of history and predestined from eternity.
هیچ در فکر این نیستند که دیگران ممکن است چه چیزهایی از دست بدهند.	not of what other people may lose.
به دست وی رسید شگفتی و خشم و غضب کنت را برانگیخت.	the same this information astonished and irritated the count .
سخنان دیگری نیز با ادب تمام به گفته افزود	to this he added more to the same effect
حالا ببینم دی گه چه پرتی داره از خرافات به گه.	I'd like to see her get around THIS with her rubbage about superstition.
پالتو نگهبانی هم بیشتر جنبه پاکت یا پوست اضافی دارد تا جنبه خانه	so a watch coat is not so much of a house as it is a mere envelope, or additional skin encasing you.
مبصر ما از طرف همه به وی تبریک گفت و به قدری به افتخار او هورا و فریاد کشیدیم که صدای همه دورگه شد و گرفت و از چشمان همه اشک جاری شد.	had made a speech to him through the head boy, and had cheered him until we were hoarse, and until he had shed tears.
ولیکن بهش گفتم که افتادم توی آب و این بود که معطل شدم.	but I told him I fell in the river, and that was what made me so long.
از شما مطالبه احسانی عبارت از پنج میلیون بنمایم.	to receive alms to the amount of five millions from you.
آنگاه فانوس را به ملاحی سپرد و خود به اطاق رفت و تا فردا صبح بیرون نیامد.	then handing his lantern to a seaman, went his way into the cabin, and did not come forward again until morning.
اما آنکه بود از آنان نبود که چشم آدمی بتوان دشان دید.	but the person who was there was of those whom the human eye cannot see.
لااقل امیدوارم که بستن گردنبند جلوی دعا خواندنم را نگیرد	I trust that the wearing of a necklace will not interfere with my prayers.
این ما زه شاخص مانند رایت بایستد و روی سطح لغزان آب سایه بیندازد	this gnomon like fin stands up and casts shadows upon the wrinkled surface
اما در نهایت دیگر بار به راه آمده فرجام کار خویش را در برابر دیدگان داشت.	but who at length struck into his road and saw its end.
با توجه به ماهیت چنین عملی تصور این امر غیرمنطقی است که جوان با شخصیت و معقول به این کار دست بزند.	it is unreasonable to presume that a young man of sense and character would attempt it
سرانجام روزی یک سره خاموش و نابود خواهد شد	will at last be wholly consumed and annihilated
در نتیجه یک چهارم افراد قشون خود را از دست داد و خط جبهه خود را بیشتر گسترش داد.	losing a quarter of his army and lengthening his lines of communication still more.
رفتارش سنگ محکی برای رفتارهای اجتماعی و تربیت افراد بود	strict in her notions of decorum and with manners that were held a standard of good breeding
اما این جا نگهبان هابسیار هوشیار و مراقب بودند.	but here the guards were alert.
ولی آن کتاب را در زندان به ازای دویست رئال به گرو گذاشته است.	has left the book in the prison in pawn for two hundred reals.
قایق اسباب بازی از خطوط کشتی رانی قابل تشخیص نیست.	the toy boats become indistinguishable from ocean liners.
پس شاید بد نباشد کارم را با آن شروع کنم تا برای ادامه کار آماده شوم.	so I might as well start there and treat it as a warm up.
