بستگی او به پیشرفت و به نسل جوان ما سودایی بیش نبود.	he attached himself to the cause of progress and our younger generation from enthusiasm.
اینجا آشپزخانه است	this is the kitchen
من کاری ندارم به شما بدم .	I have nothing for you to do.
با شتاب از اطاق بیرون رفت.	she hastened from the room.
دیگه طاقت ندارم.	I've had enough of it
بیل و کلنگ را آنجا برده بودند.	they took the spade and the pick there.
سپس من او را پیدا کردم و میخ وام همین الان به او عشق بورزم	then I've found him and I want to go to bed with him.
آهی کشیدم و سوییچ را به او دادم.	I sighed and gave her the key.
بی آنکه در رفتار او نشانی از شتاب یا گرفتاری مداوم به وجود آورد.	yet never seeming to be hurried, or to have too much to do?
این حادثهٔ غیر مترقبه چنان بر من ناگوار آمد که نزدیک بود عقل خود را از دست بدهم	I was so overwhelmed at this unexpected circumstance that my mind was positively clouded.
شاید بتوانیم این بیچاره را نجات دهیم.	we may be able to save her.
سپس به اطراف خود نگریستم	I looked round
تو با آقای لایدگیت نامزد بشوی من خبر نداشته باشم	you should be engaged without my knowing it
کسی تو هر چیزی ازش جلوتر با شه.	anyone beating him at anything
که پیش از آن سابقه نداشت.	that had never happened before.
شستشو با میع ساتورن و تحریک با آب سرکه را بیفزایید.	lotions made with the subacetate of lead, and fomentations of oxycrat.
ضمناً نشان داد که مهارت خاصی در انجام کارهای دستی داشته	she had a remarkable ability for manual work
از این فرصت رفع خستگی و هیاهو خوشنود بودند.	they were like schoolboys after a few hours in school.
اگه من رو با خودت از این جا نبری از بین میرم.	I shall perish if you do not take me away.
او به حمله عصبی دچار شده بود!	she had an attack of hysterics.
من تنها از شما سپاسگزار نیستم	I am not exactly thanking you
اما این بار خطر از بیخ گوشش گذشته بود.	but it had been a narrow escape
در خور راهزنی باشد	as became a pirate
خم شد و گونه او را بوسید.	bending, kissed her cheek.
روی جسد خم شده بود.	bent over the body.
حیوانات را به دام اندازد و آب پیدا کند.	tracking animals and finding water.
بدین قصد اتاق را ترک گفتم.	I quitted the chamber.
من یادداشت را خواندم	I read the note
اینک بازگشته بود.	had come home.
پول نسبتاً زیادی در حدود 200 پوند در بانک داشتم	I'd still got plenty of money in the bank, nearly two hundred quid
که از غصه نزدیک است که گریه کنم.	you would make me weep, if such a thing were possible.
به بنائی رسیدیم که از چوب ساخته بودند و الوار را در زمین فرو برده بودند	we came to a long kind of building, made of timber stuck in the ground
منظورم جنگ واقعیه.	I mean real fighting.
من همونطور که خودش خواسته بود کتابو واکردم.	I opened the book at random, as she proposed
ما رو جای جن یا غول گرفته.	took us for ghosts or devils
در آستانه در ایستاد تا شوهرش را آزاد بگذارد.	lingered on the matting, that she might leave her husband quite free.
سرم را برگردانیدم	I glanced over my shoulder
آری الماس را تمام به خودمان داد	yes nothing more true
پیرمرد اخلاق سگ را پیدا کرده است.	the old man is as surly as a dog.
ما به زودی قایق را روی دریای صاف و شفاف به حرکت درآوردیم.	we were soon skimming swiftly over a smooth sea.
چنان از زیردستان خود توقع احترام دارند	extorting almost as much outward homage
نمی تونم با تو همخونه به شم	I can't move in with you.
ساعت و اوضاع و احوال و دور و بر همه با این کار سازگار بود.	the hour, the circumstances,the surroundings,were in keeping with it.
بعد هم با پایمردی کامل اعلام کرد که از کاترین تقاضای ازدواج خواهد کرد.	as steadily declared his intention of offering her his hand.
درها باز نگه داشته شده بودند تا هوای خنک وارد شود	the doors were propped open to let in the balmy air.
اما دختر با سر اشاره کرد که خواهد ایستاد.	but she declined availing herself of it
چند جرعه بزرگ چای نوشید و به این ترتیب کلک لقمه او را کند	took a series of large bites, which finished his first hunk of bread and butter
اما برای من یک ساعت ساییدن اضافیه!	but to me it's an extra hour scrubbing!
بازوها و پهلوهای خود را نیشگون گرفتم	I pinched my arms and sides to awake myself
من که جوراب لازم ندارم.	ask about some socks.
که ناشی از افراط در احساسات است	from the indulgence of our passions, and
صدای یکی از آن سه معلم عالی رتبه بود.	one of the upper teachers
آیا باید نشان آفتاب را که رقیب بر سینه خود منقوش دارد با شمشیر به دو نیم کرد	whether or not the sun is to be divided and portioned out
زینش بک نه	to saddle them
انتظار داشتم ناامید باشید	I thought you would be hopeless
یک لحظه به آن نگاه کرد	looked at it a moment
من هیچی نگفتم.	I'm saying nothing.
که این شایعه را تکذیب نمایید.	to contradict this statement
آنگاه کاغذ را اندکی از خود دور کرد	then pushed the paper a little way from him
زیرا دید که هیچ کس در شک و تردید او با وی سهیم نیست.	as an unqualified fact because no one shared her doubts.
تنها یکی از پاهایم را با زنجیر به تخت خواب بستند	only fastening one of my legs with a chain, near my bed
التماست می کنم که بگذاری اینجا بیاورمش.	I beseech you to let me bring him here.
گمانم جوابش مثبت باشد.	I must have, I suppose.
در لذت و هیجان این کشف شریک آنان گردم.	to enjoy the sport of the search.
آن هم وقتی با پررویی تا نزدیک مردنش صبر کرد.	when he's had the impudence to show it at the last.
این صدا معنای دیگری جز طنین آرام ساعتی که از دور وقت را اعلام کند نداشت.	these noises meant no more than the chiming of a dull clock in the distance, marking the hours of the night.
خودم را از این حال علاج کنم.	I'll cure myself of this.
دوستش داشته باشد	she loved him
تاکسی صدا زدم	I stick out my hand and hail a taxi
گفتیم که تونل منشأ جادویی داره و فقط با جادو بسته می شه.	that the tunnel is of magical origin and can only be closed magically.
کسی که از برادرش چیزی بدزدد هرگز شرف ندارد.	but if he robs his fellows there is no honor in him
از این موضوع سخت نگرانم.	I am dreadfully afraid.
اشک وب بالایی تقریبا تمام شده بود.	upstairs almost all the rooms were finished.
او را در رواق صومعه یافتند که با یکی از زنان راهبه به صحبت مشغول بود	whom they found in the cloisters in conversation with one of the nuns
خانه رو به رویمان قرار داشت.	the house lay before us.
من میل دارم که تو همین جا در جوار من و در مصاحبت این نیک مردان بنشینی	I desire that thou seat thyself here at my side and in the company of these worthy people
سبک او این بود	that was his style
واقع آنست که چندان توجه با ین تفصیل نکردند.	they hardly heeded this detail.
سرباز دیگری جلوتر بود.	one single soldier left behind
تا شده بود.	was folded one over another.
یک قهرمان بزرگ نیست	he's not a hero!
کمک حالی واجب برای بانوان میزبان.	indispensable to hostesses.
اسلحه دولول را بادو دستش محکم گرفته بود.	a doublebarreled shotgun clutched in both hands.
من کاملا به آزادی اراده و توانایی خودم برای دست یابی به موفقیت معتقدم.	I believe absolutely in my own free will and my own power to accomplish and that is the belief that moves mountains.
از حالا تا فردا وقت بسیار است	there are a good many hours between this and to morrow
صدای خشم آلود و عمیق مردانه را نشناختم.	I didn't recognize the male voice, fierce and deep
که باید از این جهان روشن و خوب به مکانی برود که در آنجا همه چیز تاریک و آشفته و درهم برهم است.	bright world to somewhere where everything was stupid and confused.
قاعد تا به نظر بقیه بوی خوبی بود.	it probably smelled good to everyone else.
همان طوری که گفتیم	as we said
من وقتی بالای سرش رفتم	when I got round to him, not he.
به نظر من هر چیزی خارج از روال معمولی زندگی ارزش اطلاع دادن را دارد.	I think anything out of the ordinary routine of life well worth reporting.
صدای خش خشی از داخل اشکاف شنیدم.	I heard a rustling there.
هیچ بار جز بار تخیلات خود بر سر نداشت.	he carried nothing but his revery, however.
بلکه به آن ایمان و آن آرامش و اطمینان دست یافته است.	but that he had it and peace completeand secure.
من تک و تنها پهلوی او بودم.	she and I were alone.
من به شما اطمینان دارم.	I may count on you
مرد جواب داد	replied the man
هر یک از دو قطره اشک بزرگ را بوسید	kissed each of the two large tears.
من دختر کلفت.	I'm the servant girl.
او را کمی برانداز کردم.	I stare at her
راستی هم که.	I bet it is.
دیوانگی او مفرح است بر خلاف این یکی	for his madness is amusing
حال و روزم خوب نبود	I wasn't in a very good mood
تا نیروهایشان را تحکیم بخشند و در آوریل یا مه سال بعد.	they would not be able to spare enough warm bodies to man the plows.
زود از هر کسی خوشش بیاید.	a great readiness to be pleased with other people.
وقتی دست روی بازوی من نهاد	when he laid his hand upon my arm.
اما تا آنجا که من از ین امور اطلاع دارم این عمل سهل و ساده نیست.	but as far as I know the facts, I can't.
با شرکت در گفتگوی مربوط به قارچ همگان را به حیرت انداخت.	surprised everyone by joining in the conversation about mushrooms.
این وضع به نظرم بسیار بدیع و زیبا رسید.	I thought all this very pretty and engaging
پس هر یک در محلی نشستند.	they sat down.
او باید این انتصاب را به مین نحو تلقی کند.	that he was so to regard it.
یه دفعه یادم افتاد امروز روز تولد مه.	I just remembered that today's my birthday.
الآن بی فایده است.	it's no use now.
دست به من نزنین	don't touch me don't!
معذرت می خوام اگه سرزنش کننده به نظر رسیدم.	I apologise if I seemed critical.
تا این که صدای پایشان کاملاً دور شد.	listening to their footsteps dying away.
جلوی حفره منتظر ماند تا در باز شود.	waited for the portrait hole to open.
اگر ممکن شود با هر شیطنت زاییده از یأسی کشتی را تسخیر کنند	if by any devilishness of desperation possible, seize the ship.
فقط دلم هوا تو کرده	I just want to have sex!
آن موقع من توی انباری بودم	I was in the box room at the time
بنابراین امیدوارم منو ببخشی که نمی تونم تو رو از انجام تکالیف امروز معاف کنم.	so you will excuse me if I don't let you off homework today.
اما این بار هم صدایی از دهانش خارج نشد و فقط یک حباب بسیار بزرگ از دهانش بیرون آمد.	but once again, nothing came out of his mouth but a very large bubble.
یک سر طناب را محکم به آن بست	fastened one end of the rope tightly and firmly round it
مخزن روپیداکنم هیچ وقت به فکرم نرسید محل تخلیه.	I never even looked for where they were venting the tank!
به ظاهر اخیرا و به صورت موقت مورد استفاده قرار گرفته بود.	recently occupied and temporarily used.
من دوست ندارم دروغ بگم	I don't like to lie
به نظرش رسید که اطاقک آسانسور به کوچکی باجه تلفن و بعد به کوچکی یک تابوت شد.	suddenly the elevator seemed no more than telephone booth size, then coffin size.
ربرتا با جیغ کوتاهی خود را روی صندلی نرم بلم انداخت.	she dropped to the cushioned seat with a little cry.
بهتر است تو هم این را بدانی.	so now you know.
او فرمان داده است که آن را بیا ری و راهنمائی من مجهز کنند.	he had given orders to fit up, with my own assistance and direction.
زیرا شبهه نخواهید داشت که ده سال است که ما با هم دوست هستیم	so since we have really been friends for the last eleven years
چگونه او را دوست خواهد داشت و چگونه تمام صفات و خصایل او کام لا تغییر خواهد یافت	how she would love him become quite different
کمی از آن حالت خشم هیجان آمیز من کاست.	took a little of the excitement out of me.
خانم خیلی آدم نامعقولی است.	she is so very unreasonable.
بعد تمام کارمندان جوان ادارات به اتفاق	then all the young clerks in town in a body
که در کلبه باز شد	when the front door opened
زیرا هم خیلی غیرمنتظره و هم این که از طرف کسی بود که ستایش و تعریفش برای جو خیلی ارزش داشت.	because unexpected and from the person whose commendation she most valued.
برای گناهان کوچک مراسم اعتراف دیگری دارند موسوم به کیفر	they have for their venial offences whatthey call the coulpe.
بالبخند جنون آمیزی احساس اوراتائید کرد.	with a sardonic giggle confirmed that this was so.
بازتاب درخشش پوست خودم را هنگامی که خورشید روی آن تابید را در چشمان ناراحتش دیدم.	I saw my reflection glimmer in his agonized eyes as the sun touched my own skin.
یا هیچ اعتباری بر دلالت سیمای شخص نیست.	or man's countenance is no longer to be relied on.
گمان کنم تو هم حقیقت را هیچ ازش پنهان نکردی.	I take it you did not conceal the fact from him.
ولی او به ما مسئولیت راه یابی اعطا کرده است همه.	but to each of us he has given the responsibility of NAVIGATION.
بیان و ببین.	come and see.
به پیشکار دستور داد که بقیه را بیاورد	ordered footmen to bring the others
به همین منوال یک ماه گذشت	I HAD led this life about a month
حدس اینکه این نیک مرد کهن سال به کجا رفته است دشوار نبود.	it was easy to surmise where the good old man was gone.
ژان وال ژان در حدود صد فرانک پول سفید را که در یک گنجه گذشته بود	he did up a hundred francswhich he had in a cupboard, into a roll
تو فکرش هستم.	I'll think about her.
به نصیحت تو احتیاجی ندارم.	I don't want your advice.
که با خیره شدن در آن از دید	that gazing on it, in that full front view
در تربیت هر شاگرد دیگری هم موفق خواهیم بود.	we can succeed in disciplining anyone.
برخی از ذوق خود	some in their own happiness
مذهب و کشاورزی بیشتر.	religion and agriculture more.
کردم! دو روز تمام تلاش کردم.	I tried all day two days.
مزارع برنج همه از بین رفته بود.	the rice fields have gone back to marsh lands.
اگر تو به خوش رفتاری ادامه بدهی این احساسات نهفته فعلی خیلی زود ظاهر خواهند شد.	if you persevere in doing well, these feelings will ere long appear so much the more evidently for their temporary suppression.
من حق ندارم درباره مسایل خصوصب بیمارانم با کسی صحبت کنم.	I'm not at liberty to discuss my patients.
سپس اندکی از آن را با زبان لیسید.	then licked some up on his tongue.
فاصله بین مرگ خواهر و برادر به شش ماه هم نرسید.	there were scarcely six months between them.
سعی کردم از آه کشیدن خودداری کنم.	I suppressed a sigh.
وقتی رد شدند	then, when they had passed
به نظر من بهتر است به جایی برود	I want him to go away
اما او سرش را به سوی دیگر برگرداند	but he simply turned his head the other way
اما معلوم نبود که	it would be difficult to say
کمی جلوتر یک دکان سبزی فروشی بود و در انتها یک دکه سیگار فروشی که در حال فرو ریختن بود.	abutting it a small greengrocer's and next to that a tumble down tobacconist's.
صدای هوهوی بلندی از پشت سرش آمد	there came a sudden loud screech from behind him
دو گوشه دهانش که نامتساوی بالا رفته بود و لب فوقانیش	the two corners of her mouth unequally raised, and her upper lip
درست مثل دو شاگرد مدرسه که روی نیمکت کلاس نشسته و در انتظار جواب امتحان باشند.	as if waiting on a school bench to hear their final grades.
البته نیازی به خوردن ندارم ولی آدم یه وقتایی هوس می کنه یه چیزی به خوره.	I don't need to, of course, but one does miss it.
این صدا چه معقول بود	how sensible the sound was
که جواب داد	who answered him.
همین و طلاق جاری شد.	did just that, divorced her.
این خودپرستی سر سخت رنگ به رخسارش دواند	this indomitable egotism charged her cheeks with colour
سپس با شدت به عمق آب بازگشت.	then fell swamping back into the deep.
با این همه هنگامی که الیزابت اظهار داشت قصد دارد بیمار را دیدن کند نتوانستند در برابر میل او ایستادگی کنند.	though they were not willing to stay behind when she at once prepared to go and visit the invalid.
روحانیون آهسته سخنی به یکدیگر گفتند.	they whispered to one another
حالا هیچ قایق مایقی هم نمیر سه که دست تک ون بدم بیاید جلو	yet never a skiff come close enough for me to hail.
زیرا یک مرد منزوی بود.	because he was a man apart.
باعث شرمندگی می شه	that might embarrass me
همه انسانیم و جایزالخطا.	all too human creatures.
در ین هنگام بی آنکه کسی ایشان را ببیند پا به فرار گذاشته بودند.	whereupon they stole off unperceived.
دیشب خیس عرق از خواب پریدم و فکر کردم اگه این مورد حقیقت داشته با شه دی گه هیچ منطقی تو دنیا وجود ندا ره.	I woke up last night in a cold sweat and I just thought to myself, if this is true, the world doesn't make sense any more.
قوای دفاع محلی را برای جنگ آماده سازید.	call out the militia.
دوباره لبخندم را روی صورتم گذاشتم.	I put on my smile again.
این را گفت و از اتاق بیرون رفت.	he said and left the room.
تو باید باور کرده باشی.	you would have been taken in
من پولی برنداشتم.	I didn't take it!
بدون این که فکر کند چرا.	without thinking beyond the immediate cause
آن را پاک کردم.	I deleted it.
سخت در تعقیب رد دوستمان بود.	following hard upon the footsteps of our friend.
منظور او را فهمیدم و برای یک دقیقه اتاق دور سرم چرخید.	I saw what he meant, and for a moment the room swam around me.
آن پسرک زیبا و فاخری که با متانت در آنجا حضور داشت	lovely boy though she must have been
او را به اتاق نشیمن راهنمایی کرد.	leading the way into her drawing room.
هرچه باشد من قانع خواهم بود	I would gladly eat a bit of something
موجودی بود با شش پای عظیم پوشیده از موهای بلند سیاه.	it was marching on six immensely long, hairy legs
ولی حماقت نه.	but not mad.
من و زندگی حالا شبیه بمرد جوانی با نامزدش هستیم.	I and my life are like a young man and his betrothed.
دفعة پیش هم او این فکر را کرده بود	on his last visit this had struck him
پنجره و میله برق گیرم هست.	there's the window and the rod
بیست و شش گردان پیاده منتظر این بیست و شش گردان سوار بودند.	twenty six battalions rode to meettwenty six battalions.
هم مادر و هم خواهر را.	my mother and sister.
همه از این موضوع آگاه هستند.	everybody knows that.
چای تمام شده.	I've run quite out of it.
تنها از حالت ناخشنودی او بیم داشت.	she was only afraid of the expression of his displeasure.
که من باید به تنهایی چهارصد بیمار را در سه بیمارستان معالجه کنم!	I am alone in charge of three hospitals with more than four hundred patients!
اما هر چی هست امیدوارم خیلی درد داشته با شه و اذیتش کنه.	but I hope it's really hurting him
این بار نیز خلاصم نمایید.	save me again!
من باید شب را در کلبه باشم.	I shall be at the cottage this evening
بار دیگر بوق را به دهان گرفت	he again seized his trumpet
ولی از همراهی متاسفم.	but I'm damned if I sympathize.
هری نیز مات و مبهوت به رون نگاه کرد.	who looked stonily back.
سخت بهت زده شده بود	he was horribly shaken
گل سرخ خود را برگرفته به روسری خویش نصب کرد.	began to pin her rose in her head dress
شمشیر به دست گرفت	drawing his sword
از قبل برای دوباره تغییر کردن آماده شده بود.	already getting ready to change back again.
به فنجان هنوز پرم نگاه کردم.	I looked into my still full coffee cup.
بار دیگر به راه افتادم و غم و نگرانی خاطر را فراموش کردم.	as I rode on, the gloom cleared.
تغییری مانند سطح آرام دریایی که در اعماقش طوفانی برپاست.	it was like a change below the surface of water which remains smooth.
که حالا در سنین میانی چهل سالگی است	who is now in his mid forties
این یک قانون طبیعی است.	such is the law of nature.
انصاف داد که ارباب با صرف نظر کردن از گنج مکشوفه بیش از آنچه باید به او مزد و پاداش داده است.	as he considered himself more than fully indemnified for all by the payment he received in the gift of the treasure trove.
البته مشروط به این که شما مثل شاگردهای سابقم خنگ و کودن نباش ین.	if you aren't as big a bunch of dunderheads as I usually have to teach.
من یک عالی در نظر دارم .	I've such an idea for a cotillion!
من یک دختر خودخواه هستم!	I am a selfish girl!
داخل آلونک شدم	I went into the wigwam
که درست مناسب من بود.	which exactly suited me.
من رفیق دیگری مانند او ندارم و نخواهم داشت.	I have no other friend like her and never shall have.
لاک هارت قلم پر طاووسی از جیبش درآورد	he pulled out an enormous peacock quill.
البته ممکن است که تنهایی برایش ناراحت کننده باشد	but he might be rendered unhappy
نمی خوام دربارش حرفی بزنم.	I don't want to talk about it.
حالا دیگر با شماست که بجنگید.	for you to go on fighting with
زیرا بر خلاف میل شما و خر شما	for, in spite of you and your ass
من شک ندارم.	I doubt it.
بعد وحشت تاریکی کامل حک مفرما شد.	then the horror of utter darkness reigned!
شاید از شما بهتر اصولا یافت نشود.	nobody could be!
حتی به فکر آن هم نبود.	he gave up thinking about it.
باید سه چهار هفته بلاانقطاع جان بکنند و به آبجو و پیاز و نان سیاه بسازند	must toil incessantly for three or four weeks, three times as hard as usual, living on rye beer, onions,
صحبت از چیستان بازی به میان آمد اما من با مفهوم این اصطلاح کاملاً بیگانه بودم.	they spoke of playing charades, but in my ignorance I did not understand the term.
تا وقتی رو به جنوب راه نیفتیم.	till we start south.
برای همین بود که قصد داشت با من ازدواج کند.	that's why he wanted to marry me!
بوی گاز بود.	it was the smell of gas.
اما آن کس متلون المزاج است و قرار و ثباتی ندارد و اگر هم چنین نباشد دریا برای او چنین است	but perhaps he whom you await is inconstant or if he is not the sea is so to him
سرم را بالا کردم. هنوز چشمانم خواب آلود بود	I look up blearily.
من و او با هم دوست هستیم.	we are good friends with him
سراپا لباس عزا به تن کرده	dressed in full mourning
پدرش آن قدر عوض شده باشد که	her father had changed so much that
در مچ دستش صدای شکستن چیزی را شنید.	hearing something snap in his verist.
مانند یک سیلی بودند که تازه به صورت زده شده بودند.	it was like a fresh slap in the face.
ایشون احساس کردن که جونش ون در خط ره.	he seemed to feel his personal safety was in question.
در را پشت سرش بست.	closed the door behind him.
گوش موسیقی نداشت	she had no ear
اون گفت که شما استعفا داد ین.	he said you'd resigned.
اکنون چیزی که مرا باقی مانده این است که مدلل نمایم دعوی خود را.	I owe you the proofs and explanations of what I have said.
بهشون گفتم اینم نتیجه اینکه منو لو دادی!	I says, that's what you get for narking ME!
در قیافه من چیزی که خاطر شما را آشفته سازد وجود ندارد.	you'll see nothing to provoke you.
مرگ به این خانه روی کرده است	for death is in this house
به حایی که غیر ممکن بود برای کسی	where it was certainly impossible for any one
هیچ خبری از او نبود	I can't see him anywhere.
فرض کنید شما در نگاه داشتن روزه خود اصرار به خرج دهید و آنقدر گرسنه بمانید تا بمیرید	supposing you persevered in your obstinate fast, and died by that means
گله به گله را با گل و برگ و تاج زینت داده بودند.	adorned with wreaths and festoons of foliage and flowers.
گروهی به علت خیانت به وطن یا شاه خود	others, to the betraying of their country or their prince
من روی حرفی که توی نامه برایت نوشته بودم هستم.	because I meant what I wrote.
هرگز شک نداشتم که ممکن است زنی پیدا بشود	I never doubted some woman might be found
این جواب را کرده بود رهنمون خودش.	which he had adopted as his personal motto.
متوجه نمی شم	I don't understand.
این چیزی بود که تو	it was the way you
چون آن حیوانات وحشی شاید تا آن وقت هیچ آدم ندیده بودند	for the wild things had probably never seen a human being before
که از من خواسته بود در اوپرا حضور داشته باشم.	begging me to attend the opera.
چون ناخنش بدجوری تیزه.	cause those talons hurt.
اما نتوانست و صورتش را بیشتر در تشک مخفی کرد.	but could not, and hid her face still deeper in the bed.
ولی در ضمن مایل بودم وی را از آن حالت پریشانی و از چنگ خیالات و تصورات بیهوده بیرون بیاورم.	but I desired to divert him from his reverie
علتش را فهمیدم!	I know what was the trouble!
فقر خود را دوست گرفتم.	I have loved my misery.
من در آن موقع در هتل منزل داشتم	I was staying in a hotel.
اولین کسی هستی که به من برخوردی!	you was the first that found me!
احتمالا او نور شهر راه بندون دیگه ای وجود داره.	I imagine we'll find another roadblock on the other end.
من به شما تبریک میگویم.	I congratulate you.
از دخترش پرسید که چگونه این صندوقچه به دست ما افتاده است و محتوی آن چیست.	asked her how that trunk had come into our hands, and what there was in it.
من هم بعد از او از جایم پریدم.	I jumped after him.
ظرفیت زیادی برای میگساری داشت	bore his drinking better than others bore their moderation
همه چیز را!	all about it.
حالا به اطاقتان برگردید.	now return to your own room.
اما آن شاه بانوی بزرگوار پس از آنکه مرا بر میزی نهادند انگشت کوچک خود را به سوی من دراز کرد	but this gracious princess held out her little finger towards me, after I was set on the table
لکن ترسید مبادا تا آن وقت حاکم تبدیل رأی نموده زودتر جنازه را برداند	but he was afraid that the governor would change his mind and order the dead body to be removed earlier
با موهای تیره و اندام بلند و باریک روی کتابی خم شده بود	dark haired, lanky, bent over a book
نمی خوام به هم بری زه.	I don't want to freak her out.
می خوان مارو نجات بدن	they're going to save us all.
در این ارابه مجروحی خفته بود و دو نفر مجروح دیگر نشسته بودند.	in which two wounded men were sitting and one was lying.
نه. من دو جنسی نیستم.	I'm not bisexual, either!
من از صه خواهم مرد.	I should die raving mad if I believed a word of it.
اگر مرگ نیز چنین کیفیتی باشد	if this were death
وارد زمین کوییدیچ شدند.	walked out onto the field.
همه خواب بودند.	everybody was asleep.
روزنامه را تا کردم	I folded the paper
برای اولین بار با کمال تعجب حس کرده بود	because for the first time she had the overwhelming impression
حقیقت تقریبا هرگز جنبهٔ روحی ندارد.	the truth is unhappily hardly ever amusing.
شبیه همان احساسی است که به پسرم داشتم.	as I had dreamed, just like the feeling for my child.
وی دو بار کلاه حریف را از سرش پراند	knocked off his hat twice
خواندن نامه را ادامه داد.	resuming the letter.
تو هم به کار کردن بدون مزد.	you have taken to working without pay.
این خود ساخت و پاختی بود بین معلم و شاگرد.	it was an arrangement between the two women.
بعد آهسته از همان راهی که آمده بود برگشت	then he walked slowly back the way that he had come
بسته تکان عجیبی خورد	the parcel gave a strange quiver
از غرابت عجایب بکاهند	smoothing over difficulties
این پشیمانی و تأسف نیز تا دم مرگ مرا رها نخواهد کرد!	I shall regret and repent it till I die!
لیوانی آبجو برای خود ریخت	poured out his glass of ale
برای نخستین بار در زندگی به خود اجازه داد از فرمان او سرپیچی نماید.	for the first time in her life ventured to disobey him.
آنگاه به من دستور داد تا اتاق کوچک پذیرایی را تبدیل به اتاق نشیمن کنم و با کاترین یک جا باشم	I must make the little parlour my sitting room, and keep her with me.
چرا آنقدر برایم مشکل بود باور کنم که تو فقط صدا و تصویر نیستی.	I had difficulty in believing you any other than a mere voice and vision,
در سفر همیشه دوستان تازهای پیدا میکرد که هیچ اجباری نداشت که تمام وقتش را با آنان بگذراند.	he always made new friends, and he didn't need to spend all of his time with them.
این حوادث مرا سخت متأثر کرد	I was impressed by all this at the time
من از انتظار کشیدن تنفر دارم.	I hate to wait
نمیدنم معنی این حرف چی است	I don't know what that means
کفش و جوراب خود را در آوردم	I pulled off my shoes and stockings
پس با خود اندیشیدم که بهتر است با این پیشنهاد موافقت کنم.	I thought it best to comply with their proposal.
در اطاق چنان دود ضخیمی پیچیده بود	the place was so full of dense tobacco smoke
من به جنوب اومدم و رفتم به بیمارستان.	I was sent down south to a hospital
اما این کار را فقط برای ساکت کردن او آن جام داده بودند.	but they had only done it to keep her quiet.
چون حالا مالک کشتی شده بودم	as the ship was now, in a sense, my own
یک روز در جنگل نشستم	I set down one time back in the woods
تنبلتوتکون دادی چه عجب هیکل گنده.	I was starting to wonder where you'd gotten off to.
اگر کسانی در کمین نشسته باشند ما را خواهند دید.	our departure exposed to the eyes of any watchers.
چون چند گام دیگر برداشتم	a few steps farther
من آن را فورا برای شما خواهم آورد.	I'll bring it you directly.
نمایشی که قهرمانان آن نقش خود را چنان طبیعی و واقعی بازی کرده بودند	which the performers acted with such wonderfully effective truth
چون میدونستم که دلش نمیخواد کسی گریه شو به بینه.	knowing that she didnot want to be noticed.
روزی نیست که به میهمانی برود.	she is not likely to go visiting on such a day.
او یک گاوداری برای تیه لبنیات داشت.	he was a dairy farmer.
این اطمینانش هیچ اساسی نداشت بجز آشنایی نزدیکش با خلق و خوی فدرستون.	they were as likely to be disappointed as any of the relations whom he kept at a distance.
بر جای ماندن نیز در آن هنگام که خطر برتر از حد انتظار و قدرت ما است شرط عقل نیست.	there is no wisdom in waiting when danger outweighs hope
نه به خودتان اطمینان کنید و نه به او.	distrust yourself as well as him.
هر جا که میل داری مرا ببر	he might have the wherewithal to take her.
مگر اینکه بزدل باشید	except through cowardice,
من پیشنهاد کردم که همه با هم به پارک برویم بستنی بخوریم.	I proposed that we should all go and eat ices in the park.
انگشتان لرزانش یارای برگرفتن کبریت و افروختن شمع دیگری به جای شمعی که یکسره سوخته و خاموش شده بود نداشت.	for a long while her trembling hands could not find the matches and light another candle, instead of the one that had burned down and gone out.
بیشتر از این نیست	it cannot be more
از راهرو کوچکی گذشتند و وارد اتاقی شدند که رو به خیابان نبود.	along a tiny passage, into a room which did not give on the street
که خود بی توسط و مداخله پلیس در تدارک مدافعه این کار باشند.	will render unnecessary the aid of the police
بعد دست خود را دور کمر من حلقه زد تقریباً به صورتی که بخواهد نسبت به من ابراز محبت بیشتری کند	he surrounded me with his arm, almost as if he loved me
این بنای تاریک آثاری از مس کون نبودن و خلوت بودن داشت که در وی مؤثر افتاد.	this sombrebuilding had about it a solitary and uninhabited look which tempted him.
که انتقام خواهد گرفت.	will punish traitors
بعد شغل دزدی پیش گرفتم	then I became a thief
اما اشاره دست رت او را وادار به سکوت نمود.	but he stopped them with a gesture.
امیدوارم که دیگر شما را حرفی نباشد.	I hope, sir, said he, you have no objection to make.
مجبور شدند که او را روی زمین بخوابانند	they had to lay him on the floor
حس کردم در حال لغزش ام. چیزی نبود که به آن چنگ بزنم.	I felt myself slippingthere was nothing to hold on to.
ولی من شک ندارم.	I have no doubt.
تمامش نو و ارزان.	all of them, cheap and new.
بسیار خوب بود.	I enjoyed it much.
می خواد بجنگه.	more fight in her.
امیدوارم که تو این را دانسته باشی.	I hope you know that.
اما در این مورد ولو این که شکل یک آباژور سفید روی یک میز آنتیک مورد نظر بود.	but this form, were it only the shape of a white lamp shade looming on a wicker table
زیرا چند ساعت پیش از فرود آمدن از کشتی چیزی خورده و تا آن هنگام گرسنه مانده بودم.	having not eaten a morsel for some hours before I left the ship.
شاید تا دیده او زنده است	perhaps, on perceiving it was still alive
در اثر برخورد با آتشدان بخاری	where it had hit the hearth
بیش از یک دقیقه نخواهم ماند.	I won't stay more than a minute.
من آنقدر ندارم که بتوانم پول گذرنامه بدهم.	I haven't enough to pay for a passport!
بردار آن را!	so take it away
من دوستت دارم.	I love you.
هرگز موفق نشدند با هم روبرو شوند و حرفی رد و بدل کنند.	did they have the opportunity to speak to each other.
با همان اندک مایه ممکن است یک دنیا فراغ خاطر نصیب من کنی	by the venture canst afford me so much satisfaction
در این مدت من دو بار از کنار او دور شده و بازگشته بودم و نزد او بودم که عاقبت زبانش به لکنت افتاد.	I had come and gone twice, and was again sitting by her, when she began to falter.
گمان نکنم چیز ارزشمندی باشد.	I shouldn't think it's worth anything.
اگرچه چند نفری هم بودند	though several persons were there
قصد کرده است که بقیه عمر خود را در آنجا به سر برد.	where they designed to pass the rest of their lives.
مسی و چون از طرف من هم مانعی نیست	, as I shall raise none
که صدای شیهة مهیب اسبی از حیاط شنیده شد.	that the terrified neighing of a horse sounded from the yard.
باید بیشتر از این به او داد.	he must have more than that.
وقتی دستش را به طرف عینکش برد که آن را بالا بزند	when he put up his hand to push his glasses back on
اگه می تونی راستشو به من بگو.	see if you can manage to tell me the truth.
نفس عمیقی کشید.	drawing a deep breath.
تقصیر با منست.	I am wrong!
البته بهتر است انسان قبلاً سؤال کند تا بعد دچار زحمت نشود.	I thought it better to inquire from you personally to save any misunderstanding.
آن پیر دختر لاغر و مهر ندیده و آن مادر نحیف و شوریده رنگ.	again that neglected and thin spinster and her equally thin anddistrait looking mother.
اما حالا بر کوشش خود افزودم	but now redoubling my efforts
یه مژده بود	was a glad piece of news
ولی جرأت باور کردن آن را نداشتم.	but I did not dare to believe it.
او چشمکی زد	with that he winked
حیوان راه دور و درازی آمده	he has run himself faint.
من معتقدم که نتیجه سر برداشتن مجدد سلسله افکار و خاطراتی است که در مرحله اول موجب به وجود آمدن این حالت بیمارگونه بوده است.	I believe that there had been a strong and extraordinary revival of the train of thought and remembrance that was the first cause of the malady.
بیا کت تو رو ماچ کنم.	lemme hug you!
به این یک بیشتر اعتقاد داریم.	we are more inclined to the latter opinion.
ضمناً هر دو عهد کردند که به هیچ وجه سخنی از پهلوانان سرگردان به میان نیاورند	they agreed not to touch upon any point connected with knight errantry
زیرا برای او کافی بود	he had had enough of them
برساند جزو کتب ضاله و زیان بخش و مفسد اخلاق عمومیند.	or some mark by which it might be known as infamous and a corrupter of good manners.
اینک در لباس رسمی تغییر قیافه داده بود	who, also transformed by his uniform
خود را اسیر و گرفتار انسانی دیگر نمایم.	I should encumber my life with a perpetual companion.
سپس در حالی که دستش را به سکو تکیه داده بود	then, leaning with one hand on the oaken rail of the dock
این کار درد دارد.	that would hurt.
به خصوص اگر معشوق در کنار باشد	especially when the lover is in the possession of the object of his love, and
می دونم ترجیح می دی کاملاً از این قضیه خارج باشی	I know you'd rather keep out of this completely
که همیشه حاضر و آمده روی کمد بود.	that he always found ready for him on the night table
به یه پولدار برخوردم	I meet a bourgeois.
آخرین ماشین باقی مانده تو پرسنل تمام 5 نفر را رها کرد	the last car in the crew dropped all five
هیچ اصلاً نفهمید کجاست	without seeming to recollect where he was
آخه چند دفعه خطر از بیخ گوشم ون گذشته.	anyway, you've had too many close shaves already.
بی آنکه از سرعتش بکاهد.	without slowing it down.
باید راجع به آن بیشتر بدانم.	I must know more about it.
به مقدسات دینی توهین کرده است.	committed an act of sacrilege.
دراکوئن برای آنکه کودکان را در صف آورند	AtEcouen, in order to take rank in the procession of
آیا منصفانه بود که دختری مثل ربرتا از او انتظار داشته باشد	would it be fair in one of her station and considering
کنجکاو ری خود را پنهان داشت	she concealed her close scrutiny of him
الان یک ساعت است که من این جا هستم.	I've been here for an hour
بیاید ببیند جا تر است و بچه نیست.	then he would have had the misfortune to find that money turn up missing.
من نباید این قدر گستاخ باشم که دلم به راش بسوزه.	that I shouldn't dare to be so presumptuous as to feel either pity or contempt for him.
قدیس ای بهشت	saints in heaven!
چرا کاه نه جوانم ون رو هم قربانی نکنیم!	why not our young priestess too!
دستم به طنابی خورد	my hands came across a light cord
بی آن که دیده شود از کنار او گذشت.	might pass behind her back unseen.
تمام عمر آ روزی چنان سفری را در دل داشت	her lifetime dream.
برادرش چوب مالبند ارابه را باز کرد	her brother un hooked the swingle tree from the wagon
این بار بردوش او بیش از همیشه سنگین است.	his burden was heavy at the best of times.
خودم با او تنها ماندم.	we had the room to ourselves.
من در این مدرسه قانونی دارم.	in any case, I have a rule in this school that
خانم پیر روی یک صندلی راحت نشسته بود.	I found her sitting in her chair
بهتر بتوانیم با خود او کنار بیائیم.	perhaps we might do better for ourselves with him.
یکی از دشمنانمان از پای درآمد	one of the enemy actually fell
به ساعت خود نگاه انداخت.	glanced at his watch.
زیر سرش قرار داشت و لحاف سبز روشن تا کمرش را گرفته بود.	white smooth pillows, evidently freshly changed, covered to the waist by a bright green quilt
صرف افعال بی قاعده برایش مثل آب خوردن است.	irregular verbs are mere playthings.
تمام چیزی می دون ستم این بود که باید دنبال یه چیزی بگردم که نمی تونستم ببینم!	all I knew was that I would be looking for something I couldn't see!
ابتدا با نگاهی پرس نده	quizzically at first
درِ مغازه همچنان باز مانده بود	the shop was not closed
طبق همان خصوصیاتی که داشت از ما خواست تا نذری کنیم و تصدقی در راه اسد بدهیم.	, and characteristically asked us to provide the offering.
چون کار مال خود ته .	you see, it would be your own business.
برای این که ما باید امروز مسابقه رو ببریم	because we've got to win today
باز چندین بار وقوع یافت	it recurred several times
خود را بیشتر به ماکزیم نزدیک کردم و به اطراف نظر دوختم.	I get closer to him for a moment.
لحنی بود نسبتاً شیرین.	almost with gentleness.
هوا گرم است این قدر دوروبر هم دیگر پرسه نزنید.	it is too warm to hang about your friends.
باز جوابی نشنید.	still no answer.
زیرا در این صورت بچه تلف خواهد شد	on peril of his life
من هم چنان مضطرب و دستپاچه شده بودم که از جایم برخاستم تا به کمک کاترین بشتابم.	I was just worked up to risk coming to the rescue
چون طبعا موجودی ضعیف و نازک دلم.	for I am naturally a poor little
اما از چهر کنتس خواند که وقت رفتنش هنوز فرا نرسیده است.	but he saw by the face of the countess that it was not yet time for him to go.
در را محکم به هم کوبید و رفت.	but he left, shutting the door with a snap.
چیزی که لازم داشتم کمی غذا و مختصری استراحت بود.	I needed was some food and a little rest.
من دنبال کار بودم	I was looking for a job
از مناطق غیر مسکونی دیدن نماید	visit uninhabited territories
اگر غذایی در بساط نباشد.	if you've nothing to eat,
این یک رویای عجیب و طولانی بود.	an alien in a slowly unfolding dream.
گویی چنین حسی را به خود مدیون بود.	as though it were only his due.
اگر شکایتی از کارش داشته باشد	that if he complained of his situation
آنگاه آن را با سر و صدای هر چه بیشتر به قفل آشنا کرد	before he put it clumsily into the lock
من هچکدوم از این چیزها رو شایسته تو نمی دونم	I don't deserve either of you.
تنها سرش را به احترام خم کرد.	but merely bowed.
برای ساختن خانه روشی تازه ابتکار کرده بود.	who had contrived a new method for building houses
9 ایستاده و به من خیره گشته بود.	g and looked hard at me.
این استنتاق غیر مترقبه آقای لاری را تکان داد.	was the abrupt inquiry that made him start.
چه قدر عوض شده بود!	so changed she was
من به سهم خود حاضرم به شما فرصت دفاع کامل بدهم.	I for my part should be willing to give you full opportunity and hearing.
رفت تا به تیمار اسب بپردازد.	to see to his horse.
من خودم قبولش نکردم.	I have argued it myself.
رانندگان موتورهایشان را روشن کردند آرام به راه افتادند و پاهایشان راکش دادند.	drivers switched off their engines and milled about, stretching their legs.
تند به او نگاه کردم.	I looked at him quickly.
اما صبح برای پرسیدن حال آنا آمد.	but in the morning he came to inquire
آهسته از کنار چمن تازه کوتاه شده گذشت	treading silently across the springy new mown lawn
چشمانش پر از خشم بود.	I noticed her wild eyes.
نمی خوام بشنوم که تو هم چین احساسی داری این اشتباهه.	I don't want to hear that you feel that way.
من شجاعت و موفقیت شما را آرزومندم!	I wish you courage and success
من که به تو بدی نکرده بودم.	I hain't ever done you no harm.
اما اعلیحضرتا این بسیار مشابه است به سرعت این خبر آورنده که دویست و بیست لیو را در اثنای سه روز تقریبا طی نموده است	but my messenger is like the stag you refer to for he has posted two hundred and twenty leagues in scarcely three days
او جمع شده بودند ملحق گشت و به نقل داستان شجاعانه خود پرداخت.	there, surrounded by inquiring sympathizers, recounted his exploits.
زیرا که هیچ گاه بسته نبود.	because it was not fastened.
بسیاری از آنان در راه مردند	many of which died at sea
دلش به درد آمد.	felt a pang
مثل گربه با پاهای برهنه	cat like, with bare feet
دستور او را به جای آورد و لب را بر دست درشت و پر عضله پدر چسباند.	followed her suggestion and pressed his lips to the large boned, fleshy hand.
وی بلافاصله از پشت خر خود به زمین جست	getting off his ass briskly
سرانجام به چند ماه پوسیده و فرسوده شوی.	consequently, decay, and consume in a few months.
دیدم او خیلی تفنگ دارد	I take it he's got a thing for guns
عاقبت به جایی رسید که هیچ محل اشتباه نبود.	we at last came to something which there was no mistaking.
بعد پای راستش را محکم بالا کشید و از سقف پوشیده از چمن جدا کرد.	pulled his right foot as hard as he could away from the grassy ceiling.
مگر از اینکه او میل به مبارزت نکند.	namely, to find a man who will not fight
دو نفر دوست من خواهند بود.	they will be friends
تمام تقصیر من است.	I was wrong.
در صدد پیدا کردن خانه مطلوب خود برآمدند.	paused to look for the house which was the object of their search.
چگونه انسان از دفاع در برابر ناسازگاری هوا و خشم درندگان عاجز است.	how unable to defend himself from inclemencies of the air, or the fury of wild beasts.
به روی میز پهن	spread it out on a table
دختر افتاد و از یک شاخهٔ شکسته ضربت سختی نزدیک چشم بر او وارد آمد.	as she fell a broken branch struck a blow near the eye.
آمادگی این حادثه را نداشتم.	I was so unprepared.
سر خود را روی بالش چرخانید	he turned his face upon the pillow
ولی من که نمی تونم از اتاق بیرون برم. در قفله.	I can't get out of this room
سه روز آنجا خواهد بود.	where he will be staying for the next three days.
یکی دونفرتون هم می تون ین یه فکر بکر بکن ین.	a couple of you could be creatively brainstorming
که در جایش قابل دیدن بود	was to be seen in its place
یکی دو تا آه کشید	sighing once or twice
پس از آن نیز مدت مدیدی در همان جا نشستند	sat so long after it
ماه زرد کشتزار را	the yellow harvest moon
چشمانش بسته بودند.	his eyes closed.
اما از موقع ناهار به بعد باد سرد زمستانی ابرهای چنان تیره و ملال آوری با خود آورده بود	but since dinner the cold winter wind had brought with it clouds so somber
وقتی که دیدم این جو ریه.	I seen it was that way.
ای کاش به چند روز قبل تر سفر کرده بودیم	I wish we'd travelled back another few days.
تنش مثل تن مرده سرد شده بود.	he was deadly cold.
چند دقیقه تنهامان بگذار.	eave us alone for a moment.
او را به مغاک تیره و تار قبر درانداخته است!	brought him to the grave!
هر چرندی که به قلم یا دهانش آمد ننویسد و نگوید.	not set down at random the first thing that comes into his head.
من که حاضر نیستم سرم را بلند کنم.	I am determined I will not look up.
چون او مثل پدرش درشت هیکل نبود	who was less corpulent than his father
با دستش جلو نور شمع سایه انداخت	shaded the candle light with his hand
بالاخره باید در فکر خانواده من نیز بود.	then of course my family has also to be considered
هیئت و رفتار و وقار و شکل و قیافه او مرا به تعجب و تحسین واداشت.	his bearing, his gait, his dignity and imposing presence held me spellbound and wondering.
از همان جا سر جیمز را به اتاق کوچک فراخواند.	he called to the baronet to join him there.
من بدگویی از مردم را به هیچ وجه دوست ندارم	I have no taste for tattle
نه راحت و نه ناراحت.	easily or not.
من از شما ترسی ندارم.	I am in no fear of you.
کوکش توی دست خودم است.	I know the tune for him.
سرش به پایه میز خورد	cracked her head on the leg of a table.
یا ممکن است من دردسر آور شوم	, or I may become troublesome
حالم خراب شده است.	I was going to be sick.
از دست این مرد جان به لب شده بودم	I gaze at him, discomfited.
بدانید و آگاه باشید که گناه بر زمین افتادن من از خود من نیست بلکه از اسب من است.	stay, for not by my fault, but my horse's, am I stretched here
دریچه کالسکه را گشود و به درون آن رفت.	up the coachsteps, and into the coach
از هیبت وی چندان در وحشت شد	was so terrified at the sight of him
خودش نیز گوئی مرده بود.	he was himself as one dead.
هنوز آن تاج گل را دارد.	she still has her wreath.
هیچ وقت نتوانستم این بچه رو گیر بند ازم.	I never did see the beat of that boy!
من این کار را خواهم کرد.	I will do it yet.
ما هم بلوزهامونو پوشیدیم.	we're all wearing ours
بعد از اینکه همه چیز را از زیر زبانش بیرون کشیده بود.	after dragging from her those things which were most precious to her and trampling on them
اما تلاشش برای پر کردن سطل طوری بود که یک قدم برداشتن هم برایش محال شد.	but the effort required to fill thebucket had been such that she found it impossible to take a step.
احساس من هم همین است قربان	I feel that also, sir
یک روز صبح روی دیگرش را نشان داد و شروع به غر زدن کرد.	until her eventual protests, her infrequent outbursts came forth in an uncontained
سر در نیاوردم چیست	I could not make it out
بعد دید که روی صفحه کاغذ دیگری جایی باقی نمانده است.	had no more room
همچنان گوش جان خود را به صدایش که هنوز در خاطرم مانده بود سپردم.	I was still listening in thought to her well remembered tones
که حال ارباب خوب است گفتگوی مطبوعی را انتظار کشید.	understanding the mood he was in expected a pleasant chat.
سعی کردم صابون بذارم زیر ناخن شستش .	I've tried putting soap under her finger nails,
حرکات آهنگین ورزش به نحوی او را سرحال آورد.	the rhythmic movements of the exercise restored it somewhat.
با این قضیه ارتباط تنگاتنگ دارد.	is intimately connected with the affair.
این بود که به نوبت سقز را جویدند.	so they chewed it turn about
این سومین بار فرار او خواهد بود	this will be the third time
یک سطر و حتی یک کلمه خبر نرسید.	not a line, not a word reached me.
اگر خیلی کارت خرابست	if you're hard up
من هیچی زیر شلوارم نپوشیده.	I ain't got nothing on under my trousers.
اما باز هم نتوانستند بخوابند	but they could not get to sleep
رای رفیق هنگ خود	as presents for his former fellow soldier
که صاحبش او را کشته بود.	who had slain him.
هیچ کس باور نخواهد کرد.	no one will believe it.
امیدوار بودند که اگر بتوانند سخن گفتن به زبان خودشان را به من بیاموزند از استعداد و لیاقت خود مرا حیران کنند.	delighted to give me answers, hoping to raise my admiration of their great abilities if I could be brought to converse with them.
هری با صدای بلندی نفسش را در سینه حبس کرده بود.	he'd let out an audible gasp.
بدون اینکه حرفی بزند منتظر ماند تا او از نو به صحبت خود ادامه دهد.	waited in silence for him to proceed.
با آن موی آشفته و گردو خاک در چین صورتش.	with her wispy hair and the dust in the creases of her face.
خود بی آنکه به او نگاه کند به سر جای خود بازگشت.	then moved back to her place without looking at him.
بهش پیشنهاد بده از نمایشگاه ماشین دیدن کن ین.	suggest visiting a car show.
راضی نبوده که تابلو یک دقیقه دیگر هم باقی بماند.	it should not exist another minute.
برای اولین بار در زندگی او را مورد ملامت قرار داد .	pecked him for the first time in her life.
چند بار پلک زدم.	I blinked a few times
با دو قطره که از این شربت بنوشی بدون شک شفا خواهی یافت.	with drinking two drops of it thou wilt certainly be restored.
بیش از همه از تاریخ معاصر بیزار شدم	I was chiefly disgusted with modern history.
شرایط کلی زندگی در این جزیره را خراب خواهد کرد.	lower the general conditions of life in this island.
تا حسابی روشن شد	until the sun was well up
شاه آنان همین که از آمدن من باخبر شده بود فرمان داده بود که آن سبدها را برای من آماده کنند و به آنجا بفرستند.	which had been provided and sent thither by the king's orders, upon the first intelligence he received of me.
یک پارچ پر از آب کدوحلوایی یخ	a jug of iced pumpkin juice
تیزهوشی و شامه قوی این مرغ سبب شده بود که طعمه خود را از دور بیابد.	for the sagacity and smell of this bird enables him to discover his quarry at a great distance.
در خدمت گزاری از برای شاه.	I defended the king.
آنجا پگاتی مرا گذاشت و رفت.	where she left me.
من به او نا می گم که شما منو دزدیدید .	I'm telling them you all abducted me.
می تونم قسم بخورم که وقتی ما رو دید خیلی خوشحال شد	I could swear she was glad to see us when we came
با دیگران در جنگل ناپدید شود.	disappeared with the rest into the wood.
دادگاه رسمی است.	the opening of the court.
کشیش ادامه داد.	the preacher went on.
ولی اسم نخواهم برد.	I'm not going to mention any names.
دیشب تا صبح گریست و نالید و نگذاشت من هم بخوابم.	she moaning and grieving all night long, though I screamed for vexation that I couldn't sleep.
حالا دیگر جرام با من شریک شده.	now he's come into the business.
گویا چنین پنداشته بود که آن جلدیست که طبیعت به من بخشیده است	which it seems he thought to be some kind of covering that nature had given me.
سعی کردم برایش دلیلی پیدا کنم.	I tried to reason through it.
من شغل جدید نمی خوام.	I don't want a new career!
دیدم اگر همة زرهای جهان را هم به من بدهند جرأت نخواهم کرد خود را به او نشان بدهم.	I would not have shown myself for all the world
مادرش اورسولا وارد اطاق خواب او گردید	rsula visited him in his bedroom.
در این لحظه با خیالات رنگارنگ به جایی نخواهم رفت	I am not going in this time with any iridescent ideas.
بگذار فکر کنیم.	let us think,
من با کسی سر مشاجره ندارم.	I have no desire to quarrel with anyone.
بعلاوه جایی که گربه را در مکانی حبس کنند و او را بر سر خشم آورند و او بدل به شیری ژیان گردد	if a hunted cat, surrounded and hard pressed, turns into a lion
باید فکر آن منطقه الماس خیز را از سرت بیرون کنی.	you'll get that diamond field off your mind.
به سرعت از اطاق بیرون رفت.	she rushed out of the room.
باز هم از اینکه حتی در چنین قضیه مشکوکی محرم راز کلاید شود چنان خشنود شده بود	was still so pleased to think that even in connection with so ticklish a thing as this, he should be made the recipient of his confidence
مهمانخانه هم در جای دنج و آرامی قرار دارد.	a pleasant sittyated grog shop.
شلوار را با دقت تا کردم و گذاشتم توی کشو.	then folded them all up again carefully.
در همان لحظه من از جایم برخاستم و خود را به او نشان دادم.	I suddenly rose and revealed myself.
من از آن سوء تفاهماتی که میان ما وجود داشت متأسفم	I regret the misunderstandings that occurred between us
با ویولن آن آهنگ وال سی را بزند که شخصا برای او ساخته بود.	to play the love waltz he had composed for her
هر قدر هم که کوچک باشد در پشت این سفارش قرار دارد.	even a small one, was behind the order.
نعمت فراوان از آن برای شما بیرون خواهد آمد.	your abundance will flow forth from it.
باز هم راه بیفتند.	they move on again.
اون در اتاقش را همیشه قفل می کنه و هیچکس هم غیر از خودش حق نداره وارد اونجا به شه.	he allas keeps it locked, un' nob'dy iver mells on't but hisseln.
معذرت لازم ندارد!	please don't apologize.
در کمال احترام با حاضران سلام و احوال پرسی کرد.	he was most respectful in his greeting to everyone in the room.
مرا به خانه رساند.	he gave me a lift homeward.
بعد از آنکه است و تیرش زد گراز رویش افتاد.	it fell on him after he shot it.
مربوط به شماست.	it concerns you.
باید حرف بزنم.	I must speak.
من هم این را باید اضافه کنم که همین پسرک است که	it was this same boy that
مادام هومه با حالت غمگینی حرف او را قطع کرد و گفت	interrupted the good woman, with a sad air
سپس آهسته به قهقرا رفت	thenshe slowly retreated
سپس یک رشته فریادهای متوالی برآورد که تا اعماق دیوارهای سنگی نیز فرو رفت	then sent up cry upon cry that penetrated even those massive walls
درست مثل این بود که سرش لولا داشته باشد.	fell onto his shoulder as if it was on a hinge.
ولی دخترها از کنار پدرشان تکان نخورده و بنابراین مهمانان کمی زودتر مهمانی را ترک کرده	but the girls would not leave their father, so the guests departed early
یکی افسار خر و دیگری عنان یابویش را کشید	the one pulled up his ass by the halter, the other his hack by the bridle
بالاخره باهاشون درمیفتی	you slug hell out of them
اکنون وال سر زا سلطان است!	the great sperm whale now reigneth!
برای این پیچ خوردگی پا باید از او تشکر کنم.	I have to thank her for this sprain.
حال این که برداشتن راسته و ران پخته و آن جور چیزهای قیمت دار خود دزدی بود	while taking bacon and hams and such valuables was plain simple stealing
هنوز بعد از ظهر به غروب نرسیده بود که انجام شد.	before the afternoon was done
زیرا که در زندگی او بسا چیزها بود که عجیب و هولناک بود و در خویشتن خود او چیزی به کلیدور از معمول بود و در سرنوشت او رویدادهای دردناک کم بود.	there was much in his life which was strange and terrible, in his character something outrageous, and in his fate not a little that was pathetic.
چون هنوز وقت هست که از تصمیم خود منصرف شود.	while there was yet time to rescind it.
دکتر خوش نداشت با این گونه مسائل سروکار پیدا کند.	doctors disliked and hesitated to even trifle with them.
اما باید به گم که از خط قرمز عبور کردم	I think I provided a very nice red herring, if I do say so myself.
آهسته در فضائی که میان نخستین و دومین حیاط بود و دو گز و نیم مساحت داشت نهادم.	gently set it down on the space between the first and second court, which was eight feet wide.
در این گیرودار دریافته بود که امیدش به کامیابی در این تفرج نقش بر آب شده است.	realizing that his dreams of a happy outing this day were fading into nothing.
سوالن تصمیم گرفت که جرج را قانع کند که به جای تریسی کس دیگری را برای نگهداری آ می بیاورد.	I'm going to insist that he replace her.
او چنان با این پندار خو پذیر گشته بود	had grown so used to it
سپس او لای پتو پیچیده	she wrapped him in hot blankets
مردی هوسران که پایبند هیچ اصل اخلاقی نیست	a man with no other principle than transient caprice
مرا در ساحل این سرزمین پیاده کردند	I was set on shore on this coast
ولی خودداری نمود	but he restrained himself
در آن لحظه چشمش به مالفوی افتاد و نفس در سینه حبس ماند.	then he saw something to make his heart stand still.
از شیران درنده نترسد	let no lions daunt him
حتماً باید قرارومداری بگذاریم.	there must indeed.
کاملاً مطمئن نبود که این گفته ناجور نباشد.	not feeling fully certain that this remark was not in some way unorthodox.
ما نباید دمی از یکدیگر جدا بشویم باید پشت به پشت هم بدهیم	you and me must stick close, back to back like
خیلی کار دارم.	I'm frightfully busy.
یا ساعتش را در بانک رهنی گرو بگذاردو برایش یک شال بخرد.	you pawn your watch to buy her a shawl.
که چهار دقیقه آن در زیر آب داغ و شصت ثانیه آن در زیر آن یخ بود.	four of them in steaming hot water and sixty seconds under a stream of ice cold.
این موضوع کام لا آشکار بود.	that was obvious
آری همه چیز را به او گفتم.	I told them everything just as it was.
برایش توضیح دادم که من به دو هزار شتر نیازدارم.	I explained that I wanted two thousand of them.
موش رون را کنار زد	shifting the rat
بدگمانی من به جا بوده است.	the worst of my suspicions proved too true.
تو هرگز نتوانستی آن را ببینی.	you could never see it.
او در شناسایی سوارکارهای با استعداد بسیار مهرت داشت.	he was adept at spotting a natural born rider.
باید موضوعو بهت به گم	I have to say it
وقتی که دارم از سلول بیرون میرم حسابی لبخند بزن	so give me a cheerful smile as I go out
بلکه آتشی نیز که در درون داشت اکنون چنان مینمود که فرونشسته و یا در زیر خاکستر پنهان شده بود.	on the contrary, now the fire seemed quenched in her, hidden somewhere far away.
وقتی به سی و چهار سالگی رسید	when over thirty four years of age
دختر جوان این را پرسید	asked the young girl
امیدوارم که همچنان به این رفتار ادامه بدهد.	I hope it continues to do so.
خانم مدیر گفت	she was saying.
نشستم و منتظر ماندم.	I sat down and waited
دوباره ترسی سرد او را در بر گرفت .	fear pricked her again.
به محض این که خورشید طلوع کرد از رختخواب بیرون آمدم.	as soon as the sun rose I rose too.
بلکه بدان علت که نتوانسته بود خویشت نداری کند و به این بحث تن در داده بود.	but at having failed to control himself and being drawn into argument.
با نظر تو موافقم که وضعیت خاصی پیش آمده	I agree with you that this is a peculiar occasion
چقدر از این آ دما بدم میاد! .	how I hate them
من به چیزی احتیاج ندارم .	I want nothing.
به مهربانی و مردانه در آغوشش کشید	folding her gently and protectingly
مخصوصا گفته بود در وضع ظاهری خارج عمارت چیزی را تغییر ندهند	who positively ordered nothing to be altered outside
خون چندان از بدن او فواره زد	so much blood gushed forth from him
یاد گرفتن زبان آن هم بدون معلم و فقط با کمک گرفتن از واژه نامه کار طاقت فرسایی است.	it's tough work fagging away at a language with no master but a lexicon.
دستم را به سمتش دراز کردم و او آن را گرفت.	I held my hand out to him, and he took it.
حتی جوهر داخل دوات نخشکیده	the ink had not dried up in the inkwell
یکی دو بار به نشانة مخالفت سرش را محکم تکان داد.	once or twice shook his head in strong dissent.
که ظاهرا به جستجوی او شتافته بود	who was evidently looking for her
او در تختخوابش دمر دراز کشیده بود.	he was lying on his stomach in bed
آهسته نوازش کرد	stroking me gently
وقتی به سایبان خودشان برگشت	now he returned to the umbrellas.
باید فکر کنم دعا کنم.	I must think pray.
چنانکه پیش از ین شرح دادم آن صندوق در واقع اطاقی مناسب و راحت بود که سه گز و نیم مساحت داشت.	which as I have already described, was a very convenient closet, of twelve feet wide.
تا دشمن را شناسایی کند.	to recognize the enemy.
گفتم باید بیاید بالا.	I said, he must come up.
پیش از آنکه سخنی گویم پنداشت که نوعی ساعتم که یکی از صنعتگران ابداع کرده است	before I began to speak, conceived I might be a piece of clock work contrived by some ingenious artist.
اون یه کابوس بود.	I just had a dream.
متاسفم که هم چین فکری کردم.	I'm sorry I entertained the thought.
در آن زمان به صورت یک مؤسسه حقیقتاً سودمند و عالی درآمد.	became in time a truly useful and noble institution.
هم دنیا خواهد دید که عقل بر تو بیش از هوس حک مفرما است	the world shall see that with thee reason has more influence than passion.
اما در باب اینکه ممکنست میان مغزهای رهبران احزاب از حیث کمیت و کیفیت اختلاف باشد	as to the difference of brains, in quantity or quality, among those who are directors in faction
شما را اگر اطلاعی باشد به من بگویید که به او بگویم	enlighten me, and I will then communicate my information to her.
وسط حرفش پریدم و گفتم	I chipped in and said
واقعاً غیرممکن است که بتوان این کلمة آخری و شدتی را توصیف کرد که با آن کلمه را از دهان بیرون آورد.	it is really impossible to express how he twisted this ejaculation out of himself
منتظر جواب بود.	waiting for the answer.
از پنجره به داخل افتاد و همزمان با ورود من آینه دیواری بزرگی را شکست.	flew in from the street as I entered, and broke one of the large mirrors set in the wall.
چقدر از کار پشم چینی متفاوت بود.	how different it was from shearing.
هنوز ممکن است فرصتی پیدا کنیم و بیرون بزنیم.	we may get a chance to cut our way out yet.
فقط وقتمان تلف شد.	only it's wasting time.
لیلی احساس کرد هر اتفاقی ممکن است بیفتد.	anything might happen, she felt.
قزاقان از هم جدا شدند.	the cossacks went their ways
اگر طلسم شده قصد فرار کند ساحر او را به سرعت پرواز پرنده به جای خود باز خواهد گردانید.	if he attempted to escape would bring him back flying.
انگار هر لحظه ممکنه بهمون حمله کنن.	you'd think we were all going to be attacked any second.
سری تکان داده	, he shook his head
مدتی فکر کرد.	pondered a long time.
میز را رویش برگردانم.	I managed to turn the tables on him.
تنها یک امید برای نجات وی باقی است و آن اجرای دقیق دستوراتی است که برای بهبود او صادر میکند و در غیر اینصورت باید منتظر بود که هر چه زودتر در چنگال مرگ گرفتار شود.	unless she were more submissive to his directions than she had shown herself before.
جزای آدم دزد و کلاش فقط طناب داره	only hanging is too good for a thief and a profiteer
متفکرانه آن را نگریست.	regarded it broodingly.
گروهی از این خوانندگان مو لف داستان را متهم به فقدان حافظه کرده	but some have brought a charge against the author's memory
خیلی عجیب بود که زنی به سن و سال او به آن آمادگی سرخ شود.	it was singular that a woman of that age should flush so readily.
امیدوارم فردا صبح هر دونفرمان خبرهای بهتری بشنویم.	I hope to morrow morning will bring us both a more comfortable report.
من اون کار و نکردم	I didn't do that.
چه اشعه گلگونی افق شرق را روشن ساخته بود!	what rosy streaks were beginning to brighten the east.
من زور و توانایی این کار را ندارم	I'm not strong enough
او نو برات میارم	I'll bring it in.
بلاخره اون قرارداد رو بستی	on landing that state contract.
خواستم به شما هشدار بدهم که مواظب باشید.	I wished to put you on your guard.
متوجه نشدم که منظورش چیست.	I didn't altogether see why it was of course
بریم یه نگاهی بند ازیم.	let's have a look.
ضمن پیش کشیدن صندلی خود	drawing her chair up to the table
بگیرید و خود بخوانید.	but wait, and read for yourself
آن بینوای بدبخت در حالی که به خون خویش آغشته شده و با سلاح خود بدنش را سوراخ کرده بود بر زمین نقش بست.	the unhappy man falling to the earth bathed in his blood, and transfixed by his own weapon.
وردتونو به خونین	cast your charms
براتی به حواله آن به مبلغ چهار هزار و نهصد و نود و هشت لویی بنویسید	give me a draft for 4,998 louis on these gentlemen
چراغ از دستش روی زمین افتاد	knocked over his lamp
کار بسیار مهمیه.	it's pretty important.
با تک نور روی آن گرم شدند	warmed by its only lights.
بگذار فرزندش که دخترست راحت به دنیا بیاید	let the daughter have free advent
بعد خود به گوشه نیم تاریکی از اطاق رفته	sitting herself down in a dark corner of the room
دیگر پهلوانی نیست که از دل این بیشه بیرون آید	no one now, issuing from the wood
قریب چهل زنبور به بوی آن به درون اطاق آمدند.	above twenty wasps, allured by the smell, came flying into the room.
همچنان پرستار و آموزگار من باشد.	continue to be my nurse and instructor.
متر را از دست رون قاپید	grabbing the tape measure
از وقتی بچه بود ندید مش.	I ain't seen him since he was little.
ای کاش دستم به این رذل برسد.	I wish I could lay my hands on the wretch.
باید او را پیدا کنیم.	he must be found
بهت و نگرانی او را حس کردم.	I felt his surprise and sudden worry.
امروز روز تولد من است	it's my birthday
مردی از هر جهت دشوار است	a most eminent person.
دریا آرام بود.	a quiet sea.
شروع به تنظیم کردن عریضه کرد.	set to work at the petition
چرا اجازه داده بود آن دکتر از چنگش در برود!	why had he allowed that doctor to go!
زمانی که همه را جمع زدم	when I closed them
زحمت بستن در را به خود نداد.	not bothering to shut the door.
پس از یکی دو ساعت وقتی دیگر کسی در اتاق نبود وی به درون آمد ولی حالش هنوز غیرطبیعی بود.	after an hour or two he reentered, when the room was clear, in no degree calmer
وارد مغازه شدم.	I must try.
تعداد کارکنان سه برابر حجم کار بود .	there were three times as many people employed as were necessary
حتی یک بار هم در خیابان متوقف نشد تا نفس تازه کند	paused not once for breath
باز پیشنهاد معقولی در چنته نداشت.	he did not appear to be very ready with suggestions available ones.
تا ناگاه برق سختی زد که تمام آن روزنه روشن شد	when a bright flash of lightning streamed down the aperture
که جز خودش دیگری را بر آن آگاهی نیست	it has not been possible to lay hands on it.
امیدوار بودم که این طور باشد.	I hoped she did.
وعده زیادی به دلایل شخصی در مرگ نابهنگام او سوگوارند.	many will have personal reasons for bewailing his untimely end.
اما من هیچ وقت از او خوشم نیامده.	but I never liked him.
برای کرایه کردن کفش سرسره رفت.	he went off to get skates.
اما هنوز خبری نشده سرش به دوران افتاده است.	but he feels a pain in the pit of his stomach already.
بگذار تابلوهایت را ببینم.	let me see your pictures.
تفنگش نزدیک دست راستش قرار داشت.	his rifle close by his right hand.
یک قوری بزرگ را از قفسه برداشت	took an enormous teapot from the shelf
دست بکی را گرفت توی دست خودش و یواش یواش دستش را راهنمایی کرد	held her hand in his, guiding it
به سوی در ورودی ساختمان رفت.	walked to the front door.
من حاضرم رقص با شال را هم برقصم.	I'm even weady to dance the pas de chale.
بعد از خوشحالی فریادی کشیدم	then I gave a cry of exultation
هیچ توجهی به نجوای بهت زده افراد نداشت.	unmindful of the wondering whispering among the men
اگه فردا برگردم و اینجا ببینمتون بی برو و برگرد تو پاسگاه هسین!	if you're here when I come tomorra, I'll run ya in.
لااقل صبر کن تا ریشت در بیاید.	wait till you've got a beard to your chin.
به من چه.	I don't care.
هنوز خبری نبود.	nothing as yet.
تاریخ آن را یک ماه بعد بگذارید	date it one month later
خواهش کردم که احترامات این ذره ناچیز را به امپراطوری که خداوندگارشان بود و آوازه فضائل او به حق در سراسر جهان پیچیده و همگان را به ستایش وی برانگیخته بود برسانند و بگویند که من برآنم که پیش از بازگشت به کشور خود درگاه شاهانه را ملازمت کنم.	I desired they would do me the honour to present my most humble respects to the emperor their master, the renown of whose virtues had so justly filled the whole world with admiration, and whose royal person I resolved to attend, before I returned to my own country.
چشمانم را بستم و سعی کردم به خودم جرات دهم.	I shut my eyes, trying to gather some courage
در سالن عمومی گریفندور آن شب	in the common room that night.
پدر جان خودم میدانم.	I know that, father.
شب همه شب در غاری که آذوقه خود را پنهان کرده بودم بر روی زمین دراز کشیدم	I lay all night in the cave where I had lodged my provisions
خدا کنه اینو ندیده باشه.	wish he hadn't seen that.
چون حقیرتر از آن هستم که دنیا را فتح کنم.	because I'm too insignificant to conquer the world.
صورتم را با پشت بازویم پاک و سعی کردم پیراهن را درست کنم.	I wiped my face off on the back of my arm and tried to fix the dress.
خودی دیگر به درون آمد	here another self came in.
ممکن است آرامگاه خود را اعم از این که در سردابه کلیسا باشد یا در دنیای ناشناخته مردگان ترک بگوید	, might quit its abode whether in the church vault or in the unknown world of the departed
او را به رودخانه افکنده باشد.	, he had thrown it into the river
اشیای قیمتی را در گاوصندوق گذاشت	placed his most valuable possessions in the strongbox
یک بطری شراب و دو گیلاس گذاشته بود.	a bottle of wine, and two glasses
وارد آنجا شده بود به جرم شکستن یک شیشه و برداشتن یک نان.	he had entered there in 1796, for having broken a pane of glass and taken a loaf of bread.
تصمیم گرفته است که بیاید و در اینجا سکونت بکند.	had chosen it from the others for his place of residence.
ولی جین آن را پس زد	but she thrashed again
پدرم را دوست دارم	I love my father
بعد از پک اول عطسه کرد وبعد شروع به سرفه کرد.	sneezed over the first puff, and then began to cough herself.
اما جز تاریکی و نور مهتاب چیزی ندید.	he saw only moonlight and shadows.
مسلم بود که مقاومتش بی فایده است.	it was evidently useless to resist.
من از دور بودن از تو خسته شدم.	I got tired of trying to stay away from you.
هرگز هم روی نخواهد داد.	nothing ever will happen.
تنها خود او برین سر واقف باشد	might be known to none but himself
بسیاری مطالب از ین قبیل .	with many more.
حرومزاده با یه اردنگی منو به سرعت انداخت بیرون!	the bastard kicked me out in such a hurry.
سرش در حال کمین داری از بالای کناره جاده گود.	his head peering abovethe edge of the hollow road.
لازم است که من شما را ببینم و با شما دو کلمه حرف بزنم.	I must speak to you
برای خود آش و آبگوشت بپزند	cook their porridge.
مادرم گریه را سر داد.	my mother burst out crying.
بدین شرط که هیچ گاه کوششی برای دیدار مادرت نکند.	on condition that he never attempted to see your mother.
من یک جادوگر یا کندا نیستم.	I'm not a magician or a mage.
که تا نیم ساعت دیگر در تالار حاضر باشد	to be ready in the drawing room in half an hour
وای منو بگیر ین.	I'm half asleep already.
کراواتش را بست	tied her cravat
انتظار من بیهوده بود.	I longed vainly.
که دیروقت به سالن رقص رسیدند.	that they did not enter the ballroom till late.
من مستقیم آمدم.	I come direct.
چه تصوراتی به سرم راه یافته بود.	what I thought!
درست مثل کسی بود که یک دستکش تابناک خیره کننده به دست کرده باشد.	now attached seamlessly to his arm, as though he were wearing a dazzling glove.
هنوز از جنگ برنگشته بودم.	I wasn't back from the war.
نمی دونم از چی دلخوری.	I don't know what's the matter with you.
ولی او قطار را ترجیح داد.	he said he preferred the train.
دیگر در نهایت رضایت و تجمل بود.	he was in the full bloom of luxurious contentment.
با تعجب به او نگاه کردم	I look at him, puzzled.
راه را گم خواهم کرد.	I shall lose my way.
همین که سر را روی بالش نهاد به خواب رفت.	hardly was his head laid back on the pillow than he went to sleep.
که در تمام دنیا پس از این بایستی توسری و اردنگی بخورد	to be cuffed and buffeted through the world
البته اگه دلت خواست.	if you're interested.
میگویند در جهان چیزی بزرگ یا کوچک نیست مگر به نسبت.	they tell us that nothing is great or little otherwise than by comparison.
آ ره تو بمیری!	I bet they didn't!
حدود ساعت یازده بود	saw that it was nearly eleven hundred
با دو دقیقه تأخیر سوار قطار پستی شبانه شد.	he had boarded the night mail with two minutes to spare.
میخ وام یه کاربدی بکنم.	I'm going to be unladylike.
روی صندلی راننده نشستم و ماشین را روشن کردم.	I got in on my side and started the car.
مجدداً بخواهد به نوانخانه برگردد	ever came back to the parish again
اما فقط به آن اندازه که محتاج روزی یک سلاعت تلمبه زدن اضافی بود.	but only so as to require an hour or more at the pumps every day.
کلاه را کمی از جو دور برد	removed it to a little distance from the owner.
صدایش آنقدر بلند بود که لری از جا پرید.	she yelled, so loudly that he jumped.
اما به منظره من که چنان محرم یکدیگر شده بودیم.	but at seeing him and me upon such confidential terms.
از سمتی محدود به همین چپر و در بود	bounded on one side by part of the hedge, which contained the ingenious contrivance we have called a gate
این جور که با من کردی با اون نکن.	don't blurt it out as you did to me.
اما من جو ون و احمق بودم	but I was young and stupid
سپس به عمیقاً نفس کشیدم.	then inhaled sharply.
با این وجود طرفدار ماست.	but he's one of our side
همسرش به دنبالش راه افتاد	followed by his wife
ولی بعد هم اوضاع چندان تغییر نکرد.	but it never materially varied.
من به تو کمک خواهم کرد تا کاری بدست بیاوری.	I'll help you till you can get some work.
مقصود تو را نفهمیدم	I do not understand you
لکن هنگام جدا شدن از او پشیمان شدم و او را به آغوش گرفتم.	I was sorry, I kissed her as she was going.
تنها راهی که او برای پایین رفتن داشت	the only one by which he could descend
اصلاً حواسش جمع نبود.	no longer keep her whole attention.
در اطاقی را گشود	opening the door of a room
تو فکرهایت را خواهی کرد!	you must think it over.
او استادی نبود که بشود از دستوراتش سرپیچی کرد.	she wasn't a teacher to cross.
به شمردن پرداخت.	proceeded to count the sovereigns it contained.
عقب دخترها بیفتم اصلاً وقت این کارها رو پیدا نکردم	I was gonna go tom cattin''an' here I ain't had time to do none of them things.
مانند همه مردان این زندگی را ناخودآگاه به صورت سعادت بهره من دی از عشقی تصویر کرده بود	like all men, he pictured domestic life as the happiest enjoyment of love
که این هفته انگار خودم را در آینه میدیدم و خوشم نیامد.	this week I've been, as it were, looking at myself in a glass, seeing that life, and I didn't like it.
که کالسکه ما را سرنگون نماید.	that of being upset
من باید او را نزد خود نگه دارم.	I must keep her near me.
او از اینکه به خانه برگشته پشیمانست.	she's sorry she ever came home, I daresay!
شال را دور خود محکم تر کردم.	I wrap the chenille throw around me even more tightly
سر را به حال تسلیم تکان داد.	he shook his head in submission.
پیروزی را به چشم خواهم دید.	we shall see the triumph.
تا آخر گوش بده!	hear me out!
از آن ریزه کاری آخرش آن فریاد کمک خیلی خوشم آمد.	I loved the final touch the scream for help.
اول باید یادش بدهم که چطوری درس بخواند.	I shall have to teach her first how to study
خیابان را گذشت و خود را به او رسانید.	crossing the road, glided up to him unperceived.
سپس سکوت برقرار شد و بعد از آن صدای واضح تبر به گوش رسید.	a silence, and then, without warning, the unmistakable swish and thud of an axe.
دی گه خسته شدم	I am weary.
سپس فرمانده ناوگان جنگی	afterwards general on sea
من اون جن خونگی رو به اتاق اساتید احضار کردم که چند تا ردای کثیف و بدم بهش که به بره.	I called the elf to the staffroom to collect some robes for cleaning.
صدای شلپ آب آمد و طناب شل شد.	hooked the handle of the bucket on to the end of it.
شما قلب مرا شکستید.	you children have broken my heart between you.
اما خودش را نگه داشت و در را آرام پشت سرش بست.	but controlled himself and closed the door softly behind him.
خود را از تخت به زیر افکند	he leaped from his bed
این کار برای او گوئی بازی بود.	it was sport for him.
میانشان گفت و گویی چندان در نگرفه بود.	though they had been there a long time.
بدان که ارباب نه تنها جزیره بلکه کشوری به تو خواهد بخشید.	for he will give you a kingdom, not to say an island.
خیلی بد است!	that's so dreadful!
کسانی را که در آنجا ایستاده بودند از پای انداخت و همه چیز را به کام خود کشید.	carrying them off their feet and engulfing them all.
زخم شانه را الان بستم.	the shoulder is just bandaged.
چند بار در هوا چرخاندم.	waved it several times in the air.
پس چگونه طالب بخشش الهی باشم.	so how can I hope for divine forgiveness?
خود را به دست خاطرات آن ایام و آن عشق غیرواقعی سپرد.	she dared to recall for the first time the illusory days of that unreal love.
بخاری اتاق را نیز روشن کن.	rekindle the fire.
من کتابی برداشتم و چنان وانمود کردم که سرگرم خواندن آن هستم.	I got a book, and pretended to read.
یک نفر کشته شده	somebody was dead
که جواب نامه را در کجا پنهان کند.	where she expected to find his answer.
باید صحبتی غمناک نماییم.	met to enter upon a painful conversation
بی نگاه کردن لیوان آبی را به دست دیگری بدهی.	to hand a glass of water without looking
بلکه به همان سببی که همیشه طبیبان و جادوگران و هومئوپاتهای مشهور در جهان وجود خواهند داشت	but and always will be, pseudo healers, wise women, homeopaths, and allopaths.
رویاهایش مخلوط درهم و برهم واشفته ای از اتش و حوادث رانندگی و تیر اندازی بود.	her dreams were a wild kaleidoscope of fires and automobile accidents and shootings.
اکنون دیگر چیزی از تو پنهان ندارم.	I havent got a single skeleton left to hide from you
منظورم اعتراف نیست.	I don't mean confessing.
درباره هر چیزی بحث کردند و تا پایان شام از هر دری سخن گفتند.	they examined all, talked of everything till to the end of dinner.
برخی ازآنها رادرخواب دیده بودو به برخی دیگر با تفکر پی برده بود.	some from her own common sense.
با تو حرف زدم	I speak to you
بنابراین چه بخواهیم و چه نخواهیم آن را به عنوان جواهری بی بدل برداشت.	therefore whether we would or no, he took it to treasure it.
بعد به جای خود نشست	then he sat down again.
دوباره با هم دست دادند.	they shook hands again.
یک اعجوبهء واقعی!	a frightfully grand woman!
عرق سردی به پشتش نشست.	her blood turning to ice water.
ضمناتوضیح داد که نام مستعارش از پدرش به وی به ارث رسیده است.	the nickname, he said, was an inheritance from his respected father.
اون میگه یکی از چشمهاشو ازدست داده	he says he's lost one eye for good
من که او را در نوانخانه و به خرج شهرداری بزرگ کردم	I as brought him up porochially
من عصبانی نیستم.	I'm not nervous
نفسی تازه کنم و نیروی از دست رفته را بازیابم.	to recover my breath and loss of spirits.
در بخش ما پیرزنی را کشتند.	that old woman murdered in our district.
حتی به ندرت به طور مناسب با او حرف زده بودم.	much less properly spoken with him.
من دیگر او را ندیدم.	I couldn't see.
منم بدون هیچ منظوری آزادش کردم.	I sort of set it free without meaning to
همین الان دارن به طرف غرب میان.	they're on their way west already
سروان بلندقامت ستاد که موی خاکستری و سبیل دراز و قیافه خشن و صورت پر چروکی داشت	said a tall, grizzly haired staff captain, with enormous mustaches and many wrinkles on his large features
من با این چیزها مخالفم	I'm against them
مرا امیدوار ساخت	induces me to hope
واقعا ضرورتی ندارد.	I don't see why you should.
اما تصادفی تهدیدآمیز بود.	but it was a menacing accident.
الماس را مالید به شیشه	, touched the glass with it
نوکر هیچ کس نیستم!	I am no man's servant!
از آنجا مردم را برای خیزش عمومی فراخواند	from there sent the nation a call to general war.
با همان شتاب و با همان خشونت قبل از جنگ به تکاپو و تقلا در آمده بودند. و جنگ زندگی آنان را به دو قسمت کرده بود.	caring with the same urgency and the same violence that animated them before the war had cut their lives in two.
هیچ گاه نداند که رنج کشیده است.	never knowing he suffered.
روح خبیث او به جسد این حرامزاده منتقل شده است.	her soul lives in the body of this demon.
پهلوان هنوز چند لحظه چشم بر هم ننهاده بود که ناگاه از صدایی که پشت سر خود شنید از خواب پرید.	but a short time only had elapsed when a noise he heard behind him awoke him
به تو اعتماد ندارم!	I don't believe you!
تا از او سؤال کند چه گفته است.	to ask him what he had said.
منم کمی توی کوچه پایین رفتم و ایستادم.	I walked down street a ways and stopped.
جای او همیشه معین و خالی بوهاست پذیرایی کردند.	expected guest whose place was always ready awaiting him.
به یاری ایشان شتافت.	ran at once to aid them.
در جوار کارگران اعتصابی ایستاد.	took the side of the workers.
در تب و تاب این کشف بود	in the ardour of this discovery
صدها خانه با خاک یکسان شده بود.	hundreds of homes resounding with their footsteps.
اما اکنون دیگر اثری از آن شور و جذبه اولیه نبود.	but the first charm was gone out of their enjoyment.
در یک میهمانی رسمی	during a party game
انگار دنیای دیگری در آن کمد جا داده شده بود.	as if it contained other worlds.
تا پادشاه از اصل و نسب من مطمئن نشود دخترش را به من نخواهد داد	for the king will not be willing to give me his daughter in marriage unless he is first thoroughly satisfied on this point
من عقیده دارم که باید رفت و این را به آن آقای پیر گفت!	I've a great mind to go over and tell the old gentleman so!
این دو سال فلاکت بار آخر هم که میان دیوارهای خردکننده زندان گذشته بود.	these last two years somiserably between these crushing walls.
هنگام نوشتن آدرس روی پاکت دستخط خود را تغییر بدهد.	addressing the letter in a disguised hand.
گری گوری بشاش بسوی میز رفت	then strode swiftly across to the table
ولی انگار خاطرات وحشتناکی از آنجا داشت.	but at least his eyes had lost that awful dead fish look.
من با نوار لاستیکی درون ذهنم در کشمکش بودم تا دوباره از من دور شود.	I tested the elastic band, struggling to force it to remain solid as I stretched it away from me.
بر استی او را از نیمکت پراند.	sent him starting up from the bench.
لابد آمدن این همه راه به رایتان سخت بوده	I am afraid you must have had a shocking walk.
این فرصتی به من داد تا افکارم را دوباره سرو سامان دهم.	that gave me a chance to truly compose and resolve myself.
چه بر سرش آمده است و به خاطر آورد که مجروح شده بود	what was the matter with him and remembered being wounded
سراپا بر روی زمین دراز بکشم.	lie at my full length in the temple.
دی گه فکرامو جمع کرده بودم که میخ وام چیکار کنم.	I'd made up my mine 'bout what I's agwyne to do.
سه بار به در عظیم ضربه زد.	knocked three times on the castle door.
اخم کرد و جواب داد.	he answered, frowning.
این دفعه چیز بزرگی را شکسته است	he'd wrecked something very big this time
بعدش هم او نو یه جایی آزاد می کنه.	then put him back in the wild!
سپس سرنگ را آماده کردم	so that it was palm up
لاجرم پایان عمر ایشان نیز قرین ناکامی و گمنامی خواهد بود	so will have an end without a name
از این حالتی که در اینجا مشاهده کرد بر اندوه خودش افزود.	which seemed to magnify her own
به طوری که مقصدش به درستی قابل تشخیص نبود	where no doubt he ordinarily had his station.
این صدای پا چنان تند و سریع بود که هرگز به صدای پای مادرش شباهت نداشت.	steps so rapid that they could hardly be his mother's.
او هرچه لغت در قاموس زبان بوده روی آن چهارچوب ریخته	that he had emptied the whole vocabulary into his frame
مدرسه علوم و فنون جادوگری هاگوارتز	HOGWARTS SCHOOL of WITCHCRAFT and WIZARDRY
از ته دل بخوانید!	put your hearts in it!
بس است هرچه گفتید.	there's enough of that sort of talk.
او در کنارش بود.	he was beside her.
حرف هم نزنید.	you don't talk.
تقریباً با هر محیطی جور است.	you can fit into almost any society.
حتی اگه توی اصطبل جاشون بده	even if he has to bed them down in the stable.
دست بلند کرده بود که علامت بدهد اوضاع مرتب است	hand raised in the signal that everything was fine
معتقد بودند که باید چیزی بخوانم که باعث پیشرفتم بشود	thought that I ought to read something 'improving
غرض عمده من این بود که بدانم حرکات مختلف جزیره معلول کدام عوامل طبیعی یا مصنوعی است	I chiefly wanted to know, to what cause, in art or in nature, it owed its several motions
تا زمانی که خواهر خدمت گذار اتاق را ترک کرد سکوت برقرار بود.	they were all quiet until the lay sister left the room.
قرار گذاشتند عروسی شش هفته بعد صورت بگیرد.	it had been decided that the marriage should take place within six weeks.
من حسابی تحقیر شدم.	I was so totally mortified
او یک شلوار راه راه در دست داشت و نزدیک بود از ناراحتی به گریه بیفتد.	he was holding out a pair of pinstriped trousers and almost crying with exasperation.
چون وقت آن را نداشت.	because he had other things to think of.
دستور داده بود که درون ارابه از ایشان بگیرد نام برد.	from whom he told him to take the carts.
به سر خودش کوبید	cracked it over his own head
همیشه شهری را پیدا میکنند که در آن کسی زندگی میکند که میتواند لذت خانه به دوشی و بیخیالی را از یادشان ببرد.	always found a town where there was someone who could make them forget the joys of carefree wandering.
او با حالتی ماتم زده گفت	he said mournfully.
مثل یک برادر.	like a good brother, she answered demurely.
تو دوست منی.	youre my friend.
پوستش ون ناز که و قلبش ون بی جون.	they're so thin skinned and chicken hearted.
من فکر کردم که خب شاید بتونیم تو شهر به مو نیم	I thought'well, I thought maybe we could all go in town
در عین حال حقیقت دارد!	they are none the less TRUE.
نیزه وی که به درختی تکیه داشت بسیار بلند و قطور بود	his lance, which was leaning against a tree, was very long and stout
اون که فایده ندا ره.	that ain't any use.
برادرهایم را ببین.	look at my brothers.
شراعها را بلندتر کنید!	the irons, the irons!
به گمانم امشب در کاروانسرایی که بالاتر از صومعه منزل کنم	I mean to lodge to night at the inn that is beyond the hermitage
به تالار راهنمایی شد	he had been ushered into the drawing room
تاریکی عدم وجود را چند سانتیمتر دور نگه داشته بودم.	I held the blackness of nonexistence at bay by inches.
بلافاصله او را شناخت	it couldn't possibly be anyone else
ولی حالا دی گه باید راه بیفتم.	I'll have to be going now, though,
دمای هوا 7 درجه.	temperature 45 degrees
صدای تشویق پرشور جمعیت ورزشگاه را به لرزه درآورد.	the whole stadium gave him a resounding, earsplitting roar.
جز آنکه مرقع من سراپا از یک رنگ بود.	only that mine were all of a colour.
شاید هم تمام کار را خراب کند.	he may have upset the case altogether.
من خشونت را خیلی بیشتر از تملق دوست دارم.	I like rudeness a great deal better than flattery.
من نت خواه همراه نداشتم تا اجرت مهمانخانه را بدهم	I have no money to pay my bill
والا یک احمق تو دنیا کمتر می شه.	ther'll be an idiot short.
مدتی ساکت ماند	remained silent for some time.
اما لحنش موقع زدن این حرف آرام و مؤدبانه بود	but he said it as quietly and respectfully
عاقبت خشم بر من مستولی شد و از جا در رفتم.	until eventually I became so irritated that I decided to play the boor.
منظورم ای نه که من ترجیح می دم شانسمو با هیولاها امتحان کنم.	I mean, I'd rather take my chances with the monsters.
تا به محض بلند شدن صدا بیرون بدود.	was all ready to bolt out, at a moment's notice
این مسئله بستگی به نوع انسان و نوع درخت دارد.	it depends what trees and what men.
همه عزت نفس خود را زیر پای بلانشافکنده بود.	he abandoned all self respect.
چه آدم عجیبی است!	what a wonderful man he is!
چون هیچ کدام نه با فن شنا آشنا بودند و نه با قایقرانی.	for neither could row a boat or swim.
الن نیم ساعت هم بیشتر ماندیم و دیگر ماندمان لزومی ندارد.	I can't tell why we should stay.
چون به نظر من نامزدی خیلی خوب است	because I think it is nice to be engaged.
خود را با شریک زندگی خویشتن روبرو دید.	encountered the face of his interesting consort
تا آنکه به اتاقی گنبندین و از مرد و زن انباشته داخل شدند.	until they came into a large, low, vaulted chamber, crowded with prisoners of both sexes.
دماغهاشان کوتاه و سربالاست!	but they have all snub noses,
با کنجکاوی و مشتاقانه	an eager and curious spectator,
مثلاً همین شیطان که این قدر در جنب و جوش است بر و رویی دارد به تروتازگی گل سرخ	that devil, that goes about there so busily, has firm flesh
به پسرکی خپله با موهای مجعّد اشاره کرد.	he pointed to a chubby boy with curly hair
نهایت سعی خود را به خرج داد تا به عمق شریف نثری که این استادان آزموده بودند راه یابد.	did her best to fathom the noble art of prose composition as these masters practised it.
در نتیجه مترصد فرصت نشست	that he watched his opportunity
نا تالیا دست در سینهٔ خود برد	she slipped her hand into her breast
وقتی ناهار خود را خوردم باز خواهم گشت	after dinner I'll come back
دهکده را پشت سر گذاشته بودند.	the village was behind them.
برای بیدار کردنش باید یک ضربه ناگهانی به آن وارد بشود.	the shock is yet to be given which shall waken it.
همچون چیز سنگینی	as though it were heavy.
این بگفت و چهار رئال پول را از من گرفت	taking the four reals
زیرا دوباره بیدار شد و شروع به تپیدن کرد	because it has awakened and has begun to beat again
به خاطر من!	on my account!
اما من خواستار آنم.	I do want it.
لیکن این بار در انجام دادن تصمیم خود پافشاری کردم	but this time stuck to my purpose and set myself
که چگونه در لیکرگس به سر کار رفته و چندی بعد ارتقاء مقام یافته بود.	of how he had gone to work, been promoted
حتماً اون اسکی تر بدذات وقتی دیده هاگ رید حاضر نیست پشت سر من دری و ری به گه خیلی عصبانی شده	I reckon she was so mad he wouldn't give her loads of horrible stuff about me
با این همه از اتمام کار بسیار مسرور شد.	was even more glad than they were when the sittings were over
اما آقای گارت دوست نداشت هنگام خواندن نامه از او چیزی بپرسند	but he did not like to be questioned while he was reading
اما بر روی سقف سنگی تاریک اتاق هیچ چیز نبود.	but there was nothing there but dark, solid stone.
باید اعتراف کنم که از ابتدا به شما شک داشتم اما فقط دیروز بعدازظهر بود که شک من مبدل به یقین شد.	I confess I had my suspicions, but it was only yesterday afternoon they were at once resolved into certainty.
