برای او هر ناشناسی دشمن بود.	to him the stranger was the enemy.
با این همه من چندان احتیاط خواهم کرد	yet I would take such caution
سپس صدای مادر توجهش را جلب کرد.	then his mother's voice called his attention
چون اینک هواهای بلندی در سر داشت.	aspiring to something better as he now did.
آنکه زنده بود و بر من مؤمن گشت هرگز نمیرد.	whosoever liveth and believeth in me, shall never die.
مثل تمام زندگی خیلی دیر شده بود.	it was like all of my life too late.
دست به دعا بردارم که خدا روغن سالادم را از جایی برساند.	pray to heaven for my salad oil.
او دستمال آغشته به خون را همچنان در دست راست داشت و در حین دویدن آن را به جیب پشت ردنکت خود فرو برد.	the handkerchief soaked with blood he held, crushed up in his right fist, and as he ran he thrust it into the back pocket of his coat.
بعد از این همه زحمت وظیفه دارم این کار را بکنم.	I think I ought to, afterall your trouble.
چوبدستیش را در هوا تکان داد	waved his wand
امیدوارم این پسر رضایت شمارو جلب کنه.	I hope he provessatisfactory.
لذا سیخ بخاری را برداشت و با آن قفل در را شکست و قبل از اینکه به دام افتد خارج گردید.	he seized the poker, smashed the lock from the inner door, and made his escape as they tramped in.
یادم آمد آن در را قبلاً دیده بودم.	I saw a room I remembered to have seen before
پشت ماسک بزرگ و شیپور جارزنی هنوز چشمان کوچک و ضعیف ما هستند	behind the big mask and the speaking trumpet, there must always be our poor little eyes
من باید یه خورده گوشت خوک بار بذارم و نون بپزم	I got to get some pork a boilin' an' some bread made.
تفنگ را از خورجین اسبش بیرون کشید.	took his rifle from its saddle scabbard.
نخستین فکری که به سرم رسید این بود	it was my first thought
مطمئناً درست متوجه شده بودم.	without taking any kind of thought I did the right thing.
آنگاه خودش در کنار او حلقه برنجی کالسکه را به دست گرفت و دست دیگرش را به دور شانه ربرتا انداخت.	he might keep his arm about her, and both try to catch the brass ring.
من نفسم بند آمده بود. چه برسد که آرام هم باشم.	I can't breathe, let alone keep calm.
کم مانده بود از خنده منفجر شوم	I want to giggle.
زیرا تا به آن هنگام هیچ اثری از آدمیان فانی ندیده بودم که شکل و جامه و چهره آنان آن همه غرابت داشته باشد.	having never till then seen a race of mortals so singular in their shapes, habits, and countenances.
به او لبخندی حاکی از رضایت و شادی زد.	smiled at him radiantly.
پای راستش موقع پایین اوم دن در رفت.	bust his right leg.
اما مطمئن بودم که ان جا را به خاطر می او رم.	I was just so sure I'd remember where it was.
اما به فکر کردن وادار شدیم.	it was bound to start you thinking.
وقتی به وسط سرسرای ورودی رسیدند	but halfway across the entrance hall
بر انگشتری با خضوع بوسه زد.	kissed the ring reverently.
نخست باران بارید و سپس برف و باران را توأماً به همراه آورد.	brought rain first, and then sleet and snow.
زیرا که مین به خوبی پنهان شده بود.	but the mine was well hidden
بلکه از آن جهت که مردم آن عصر با دو عبارت مال من و مال تو آشنا نبودند.	but because they that lived in it knew not the two words mine and thine !
احتیاج داشتم از حرارت بدن او فاصله بگیرم تا گرما با به وی او ترکیب نشود و بر من غلبه نکند.	I needed space from her warm blooded heat so that it would not combine with her scent to overwhelm me.
کشیش نیز پس از این تغییر نقش شروع به تعلیم دادن درسهایی به رفیق خود کرد تا او بداند در ایفای نقشی که به عهده دارد چه کند	altering their plan, the curate went on to instruct him how to play his part and
این پدر من است که از اتاق خود بیرون آمده.	who has just left his study
اما هنوز نیمی از راه را طی نکرده بود	but he had hardly gone half way
پاهایش از وزن زیاد کوتوله سر شده بود.	his feet numb from the weight of the dwarf
بیست مرتبه به تو گفته بودم که وارد بحث نشود.	I've said it to you twenty times, don't enter into details.
اکنون که بساطش را آنجا گسترده است.	now that it existed
تازه من فهمیدم که چقدر کم دارم .	I saw myself as much less than a man
سر راه او در کوچه ایستاده بود.	he waylaid her in the street.
البته نه با خونسردی کامل اما با ادب و نزاکت کامل.	if not in terms of perfect composure, at least of perfect civility.
اما هرمیون حتی یک کلمه هم حرف نزد.	but she didn't say a word.
حتی اگه جلوی چشمش ون هم کسی چیزی رو جادو کنه	even if it's staring them in the face
به جمله فرانسه او با یک بوسه جواب دادم	having replied to with a kiss
باشتاب به راه خود ادامه داده و روی از او گردانده بود.	she walked hurriedly, with averted face.
منظورم این بود که شاید شما جدا مایل به مرگ پدرتان بودید.	I meant was that you probably, too, were very desirous of your parent's death.
باید خودم را برای خبری غیر مترقبه آماده کنم.	I must prepare myself to find them of a surprising nature.
با حرکت سر مخالفتشان را نشان دادند و زیر لب چیزهایی گفتند.	the members of the circle stirred, and some muttered and shook their heads.
در جاده بزرگی که اطراف آن درخت سیپیدار روییده بود حرکت کردند.	with birch trees on each side, following the infantry and a battery that had gone on in front.
یا لااقل وقتی حالش خوب شد از هویتش با خبر شویم و اگر اقوامی داشته باشد ایشان را از بدبختی او مطلع گردانیم.	if indeed his malady admits of a cure , or learn when he is in his senses who he is, and if he has relatives to whom we may give notice of his misfortune.
لبانش بلر زه درآمده سیلاب اشک از دیدگانش جاری بود.	his lips quivered, and tears rolled down his cheeks.
در زمانی که صرفاً یک کشیش ساده بود	ever since his days as an ordinary priest
هرچند نجابت ایشان دلیلی بود بر اینکه ترس من بیهوده است	for though their position might be sufficient to relieve me from this apprehension
من کاملاً یقین دارم که شما پشیمان شده اید	I am fully persuaded that you have repented
او را قانع کنم که در احساساتم نسبت به وی تغییری حاصل نشده است.	I convince him that I shall not change.
گرفتگی و سکوت جهان را در زیر این سقف سرد و خشک دوست دارم.	I like the sternness and stillness of the world under this frost.
قصدی که چندین سال است در نظر گرفته و مصمم اجرای او هستم.	which I have entertained for so many years
تو را هم از آن باد دماغت شناختم.	you by your snot.
که ساعت بین یک و دو بعد از نیمه شب است.	that it must be between oneand two o'clock in the morning.
پیش از اینکه او یک لیوان آبجو به هم بدهد	before he can order me a pint of ale.
به ساعتشان نگاه کردند و دیدند کلی از وقتشان رفته.	on examining watches, so much of the morning was perceived to be gone
این همان سرهنگ لهستانی بود که بیهوده و بدون جهت خود را در رودخانه انداخت.	colonel who had needlessly plunged into the river should be enrolled
کششی را در موهایم احساس کردم.	I felt a tug on my hair
چون خیلی به خاطر شما ناراحت شدم.	because I felt so much for his trouble and yours.
این را را دوباره و دوباره نوشته و نصف کاغذ را پر کرده بود.	over and over again, filling half a page.
آخر سر هم ممکن است با یک مقاطعه کار ازدواج کنم و الهام بخش او در کارهایش باشم.	I may end by marrying an undertaker and being an inspiration to him in his work.
کاترین با بی میلی از جای برخاست و گفت	she answered, rising unwillingly.
به کسان خود فرمان دادم که زنجیری محکم با خود بردارند	ordering his men to take a strong cable along with them
هیئت مدیره تصمیم گرفته او را به نوانخانه منتقل سازد	the board have determined to have him back into the house.
او نگاهی به سراپای قفسهٔ کتاب افکند	he wandered round, looking at the books
هیچ نشانی از وحشت و نگرانی در آنان ندیدم.	I did not perceive they were in any fright or concern.
اما چنین است و در این مورد نیز چنین بود.	but it is so, and it was so here.
من اطمینا ندارم که فردا تغییر عقیده خواهد داد.	I am sure he will think better of it to morrow,
از آنجا به اطاق ناخدا بردند.	thence into the captain's cabin.
کلاه و شلاق سوا ریش را برداشت.	taking up his hat and whip.
بهتر آنکه هی بر مادیان قزل خود زنید و هرچه زودتر خود را در مکان امنی مخفی کنید.	spur your flea bitten mare, and place yourself in safety.
خودش نیز نوشتهٔ خود را هرگز دوباره نخواهد خواند.	he never reads it again himself.
کفشی به اندازه و ترکیب آن کفش دیرینه دید.	observed that it was a shoe of the old size and shape.
جانشینت بتونه از کشته شدن دانش آموزان جلوگیری کنه.	your successor will manage to prevent any killings
با و بگوئید از ته دل آرزو دارم که به مقصود خود برسد.	I wish it with all sincerity.
با وضع پرمعنایی سر خود را تکان داده	nodded his head most expressively
امیدوارم که شما این را هم به حساب من منظور کنید	you'll put that down for me too
بر آن شد که موجب اصلی این اسراف و تبذیر را از میان بردارد	he resolved to divest himself of the instrument and cause of his prodigality and lavishness
کودک برای کمک به در این خانه آمده	comes to the house for assistance this morning
به مسکو برود و در آنجا بکوشد تا بالاخره همسر مناسبی برای خود بیابد.	a post his father had procured for him and would at last try to make a good match there.
امیدش قاطع و مطمئن و ایمانش استوار خواهد بود.	his hope will be sure, his faith steadfast.
اما چه فلک زده خانواده شایان ترحمی!	, but what a lamentable family in distress!
خنجرش را هم به دندان گرفته بود.	with the dirk in his teeth.
من کاری ندارم که نشود با یک تلفن ترتیبش را داد.	I had nothing on that a phone call can't kill.
از بیست و پنج سال به این طرف در دنیا تنها بود.	for twenty five years he had beenalone in the world.
به نظرم باید بتوانیم اول به خودمان فکر کنیم.	I think we ought to be able to think of ourselves first.
پریدم توش و با عجله راه افتادم.	I jumped in, and was off in a hurry.
لیکن این دلیل نیست که مرا چنانکه پدرم گفته است شاعری بزرگ بنامند.	but not so much so as to justify the title of 'great' which my father gives me.
باور هم نداشت چنین چیزی وجود داشته باشد.	refused to believe in its existence.
همه چیز یه مرتبه داره روم تاثیر میذاره.	all of this is starting to catch up with me.
مرد بیچاره سرش را میان دو دستش گرفت و به تخیل پرداخت.	the poor man clasped his head in both hands, and meditated.
من در مورد خودم هم اشتباه کرده بودم.	I'd got myself wrong too.
ما را مجبور کرد تا پاروها را به کنار نهیم	which obliged us to leave off rowing
از حمام بیرون آمدم و لباس پوشیدم.	I finished dressing
آنگاه به او امر کرد که به دنبالش راه بی افتد	bidding him to follow
در خانواده ی شاهزاده خانم و اطرافیان او به دلایلی این اعتقاد وجود داشت	in the princess's household and circle it was for some reason accepted
پس اجازه بده با خودمان دم سازشان کنیم.	let's adjust ourselves.
خیلی خوشحال هستم که تو اینجا خواهی ماند.	I am glad of it.
باید به سراغ کسانی برم که به من نیاز دارند.	I must go to others who need me.
مردها ظاهرا کمتر به هم شبیه بودند.	in the same tone of determined liveliness.
اما کسی نتوانست آنچه را که وی نوشته بود بدست آورد.	but they were not able to seize what he had written.
کمی از من قد بلندتر و خیلی هم مؤدب است.	taller than I am, very polite
من خویشاوندی ندارم که خودش را جلو بیندازد.	I have no kindred to interfere.
باور کن که عشق تو مرا بسیار به زندگی امیدوار کرده است	believe that your kindness has made me love you deeper
لااقل امشب او را آسوده و آرام بگذار.	let him be quiet this evening, at least
چنین مکانی منزلگاه عادی و بستر طبیعی پهلوانان سرگردان است.	the natural couch and proper retreat of knights errant, keep you company.
او نا خودش ون انتظار دارن من دست تنها سرشو نو گرم کنم.	but such cheer as she could bring, and all by herself
دیشب داستانی را شنیدم که شاید سر نخی برای ان چه دنبالش هستیم باشد	I heard a story last night that might be a clue to what we're looking for.
هنوز نفسم سر جاش نیومده بود.	I hadn't got my breath back yet.
به جای زن چوبی از استخوان فک وال دارد!	has a stick of whale's jawbone for a wife!
من هیچ حقی نداشتم که عصبانی باشم.	I had no right to my anger.
حواسم بود که سرم را از حد معمول کمی بالاتر بگیرم	I'm aware that I'm holding my head slightly higher than usual
لنگ لنگان به خانهٔ خود رفت.	limped off to his house.
قبل از آنکه داخل ظلمات گردد	greet him on his way into the darkness
دست زدن به آن در حد من نبود.	I couldn't touch it.
برای او دیگر آسمان یک صفحه تار و زمین فضای تهی نیست.	the sky is no longer a blank to him the earth no longer a void.
ظاهراً این استعداد را هم نداشتیم که در دنیای ننگ و فساد خودم در یک مسیر جدید و ابتکاری حرکت کنم	I had not, it seems, the originality to chalk out a new road to shame and destruction
ولی ارتعاش خفیفی را احساس کرد.	but he felt the dull thud of vibration.
زیرا اگر خوب به خاطر داشته باشی	for if thou dost remember
باید منتظر بود که قاتل محاکمه شود.	I must wait till sentence is passed on the murderer.
بلافاصله تخته بندهای آن قصر چوبی از هم باز شد و بر زمین افتاد	with the force of the blow the boards fell asunder and tumbled down
آقای التن نرفته بود سر اصل مطلب.	he had not come to the point.
یکی از دوستانم که تو نمیشناسیش بدهکارم.	one of my friends with whom you are not acquainted!
بلکه به ظاهر تمام حواس او متوجه شمارش صفحات آن کتاب شگفت بود.	but appeared wholly occupied with counting the pages of the marvellous book.
بالاخره این وسط باید یک چیزی هم گیر من به یاد همین الآن هم کار و شروع کردم .	I am having something to do with it now.
اصلاً در حال و هوای گریه نبودم.	I was nowhere close to tears.
من بروم یک ملاحظه از این کشتی بکنم.	I shall make the round of the boat.
بی آن که خم شود نگاهی به سگ افکند	looked down without so much as stooping
یکی دو قدم از صندلی او فاصله گرفتم.	retired back a step or two from his chair.
هنوز برای بازگشتن به آغل وقت داریم.	for we have time enough to return to our fold.
من از کاری که کردم هیچ منظوری نداشتم.	I didnt mean anything by what I did.
آهنگ او به عنوان یکی از سه آهنگ پرطرفدار هفته انتخاب شده بود.	was one of three hot prospects for that week.
که به دیوار پشتی کلبه تکیه داشت.	leaning against the back wall of the cabin.
دیدار مردم مایهٔ رنج او بود.	the sight of men hurt him.
فکر کردم احتمالش زیاده که او نا هم مثل من با شن.	I thought there was a good chance they could be like me.
راه خودش را تا وسط بیشه پیدا کرد	picked his pathless way to the centre of it
همان طور که مورد اعتراض شوهرش بود	who did not want for spirit, as her yoke fellow could abundantly testify.
به این گمان آزاردهنده افتاده بود	was being more and more weighed upon by the thought that possibly
البته اگر شما به این جور چیزها لب بزنید.	thatis, if you ever touch the stuff.
این سؤالی بود که هرگز جرأت پرسیدن آن را نکردم.	I would never know, of course, I would never dare to ask.
حرفی نداشتند که ارزش شنیدن داشته باشد.	had nothing to say that could be worth hearing,
فرمانده کل بهتر از او وضع میدان نبرد اطلاع دارد.	that the real course of the battle is better known to me, the commander in chief, than to him.
شروع به توصیف معجزه هایی کرد که خود دیده بود.	began to describe the marvels she had seen.
اما چه خودخواهی قابل توجیه و شریفی!	but what a legitimate and noble egoism.
مثل تو که کیفرت این باشد تا در اینجا از بی غذایی و بی پناهی هلاک بشوی.	such as yours would be if you perished here of want.
شاید در عوضش دزد را به ما تحویل بدهد.	maybe he'll turn the thief over to us.
حتما شما خسته هستید و میخواید بخوابید	I expect you're feeling ready for bed.
زندگی بهتر و کاملاً متفاوتی را آغاز خواهیم کرد.	far apart lead better lives
او که نفسش بند آمده بود گفت	she said breathlessly.
رفتار همه کج است و من مستثنی از بقیه نیستم	that I am not a hideous exception to the rest.
در این صورت من باید خود ترتیب کار را بدهم. آخر من پدر هستم!	what he ought to do then it will be my affair yes, my affair. I am her father.
تا من فعلا راضی شوم و دست از سوال کردن بردارم.	as I keep on asking, and I shall be content for the present.
زیرا با شنیدن آن ده دوازده کلمه	for from these dozen words
دریافت که خواهرش را رنجانده است	she saw that she had offended her sister
که مبادا تکاپویش عبث از آب درآید	after all, this quest of his was going to prove a vain one
تیرهوشی به نظر من بسیار عالی است و آن به اصطلاح زیب طبیعت و دل خوشی زندگی است.	wit in my opinion is a splendid thing, it is, so to say, an adornment of nature and a consolation of life
کلید جامه دان همیشه روی آن بود.	he always carried the key about his person.
پزشک اموات رو خبر کنه تا اون به یاد و به بینه که کسی تو دی ره مرده.	doctor is to come here and view acorpse.
اما همین که او را طرد کردند	but the very moment he is discarded
گفتار و رفتار اما به کلی تغییر کرد.	her talks, her manners, everything changed.
شاید دیگر فرصت پیدا نکنی که با من روبرو بشوی!	because if you have you had better say it now.
هشت تا ده قطره از این آب سرخ به حلق من بریز امید هست که مرض بگذرد و دوباره به حال آیم	pour from eight to ten drops of the liquor contained in the phial down my throat and I may perhaps revive
تا طلوع صبح در تب و تاب خواهم از بود.	I am full of tossings to and fro unto the dawning of the day.
یعنی چیزهای بیشتری راجع به شما بدانم	to learn more of you
فقط گل سرخی است که تیغ بسیار دارد.	but one with too many thorns.
هنگامی که آن دو را بیرون کشیدند نیمه منجمد بودند و نزدیک بود خفه شوند.	they were half frozen and all but drowned by the time they were dragged out.
البته زندگی کام لا جنبهٔ مذهبی خواهد یافت ولی یکنواخت خواهد گردید.	it would be holy, but tedious.
بلزواس تفصیلات را به وی گفت.	he related his adventure.
ممکن بود فکر کند که من چه کسی هستم.	she might start her wondering who I was
چه بهتر از این فبول کردیم و عهد نمودیم	I promise you it affords me as little pleasure to revive it as it does you
با فریادی خفه از میان هوای شفاف به میان دریا سقوط کنی و دیگر بالا نیایی.	with one half throttled shriek you drop through that transparent air into the summer sea, no more to rise for ever.
پدر شما بلافاصله چهار تن از نوکران خود را به دنبالتان فرستاد	he therefore despatched four of his servants in quest of you
در ورودی ساختمان را بسته یافت	he found the outside door was shut.
با تردید جمله را تمام کردم	I finished hesitantly.
خوش به حال آن شخصی که او این قدر برای دیدنش عجله دارد.	I sure envy the guy she's in such a hurry to meet.
نگفته بود مهماندار چه وقت به دنبالش بیاید.	but she did not send a message for anyone to come for her.
ناگهان به یاد ششلول خود افتادم	the recollection of my pistol flashed into my mind.
اما بگذارید به این مسأله مثل چالشی بنگریم.	but let's look upon it as a challenge.
ولی گویی از بیم تسلیم به احساسات خویش چهره درهم کشید	as if fearing to give vent to his feelings, he frowned
با این همه چنان در افکار علمی مجذوب و مستغرق بودند	at the same time, so abstracted and involved in speculation
زیرا سلاحی که این اشخاص در دست داشتند و با آن ما را زدند بجز تیرک مالبند چیز دیگری نبود	for the arms those men carried, with which they pounded us, were nothing more than their stakes
درباره کسانی که بر اثر اعتراف از گنه کاری برگشته بودند داد سخن داد	he enlarged on the acts of restitution that it brought about.
زیرا ممکن است مرا به هلاکت رساند.	for he'd kill me for nothing at all.
چون من سنگ را درست به چشم چپت نشانه گرفته ام.	because I have this rock pointed at your left eye.
درختان خیابان روی میزها سایه روشنی سبز رنگ گسترده بودند	the trees made a green twilight over the tables
عواطف طبیعی در آنان مرده است	dead to all natural affection
تقریباً چیزی از اثاث خانه را نتوانستند از خطر سوختن حفظ کنند.	hardly any of the furniture could be saved.
در حالی که حالتی کام لا حاکی از جوانی در او وجود داشت	yet there was something very youthful about him.
موهایش مثل آبشاری به روی رب دو شام بر آبی رنگ ریخته شده بود.	her hair a dark flood against the light blue robe.
وقتی که به جلو انبار رسید .	as he walked past the barn
در آنجا مشغول کشیدن سیگار شد.	stood there smoking.
سوگند خورد که قوطی سیگار مال او است	swore that the snuff box was his
در آن صندوق بستری را که سامان فروش علیاحضرت آماده کرده بود نهادند	to put in a bed ready furnished by her majesty's upholsterer
اما بعد به هر حال او خیلی از ما دور است و همان طور که در این کشور میگویند	but then, he is very far away, you know, and, as they say in this country
با منتهای سرعت خودم را به آنجا رساندم!	I got over there fast!
اما احتمالا علت آن ظهور جمجمه بود	but the only possible cause was the sudden appearance of the skull
بعد حبسش کردند و روز بعد بردند محکمه و دوباره یک هفته حبسش کردند.	then they jailed him, and next day they had him before court, and jailed him again for a week.
روز بعد با سردرد بدی از خواب بلند شدم.	the next morning I woke up with a worse head than ever.
بلند شدم و در اتاقم را بستم.	I stood up and shut my bedroom door.
در آن ساعت کرایه کردن اسب امکان نداشت	as a hired sledge was not to be seen yet
در آن جا جادوگرهای زیادی مراقب بودند.	there were plenty of wizards to keep an eye on him.
وقتی بیدار شدم آفتاب آن قدر بالا آمده بود که خیال کردم هشت گذشته.	THE sun was up so high when I waked that I judged it was after eight o'clock.
اموالی را که به ارث برده بود به اوباش بخشید.	abandoned the estates when he inherited them, and left them to the ruffian herd.
تصویرش بر فراز همهٔ باغ و چمن معلق بود	her image hovered over all the lawns
نشسته و به یکدیگر خیره شده بودند.	sat and stared at each other.
به طور مبهم مربوط به جسم گوشتی پیامبر و عصیرهای معدی وال	was something obscurely in reference to his incarcerated body and the whale's gastric juices.
چون بهر کیفیت که من از تو برنجم باز همان حکایت سنگ و سبو خواهد بود.	for in whatever way I may be provoked with you it will be bad for the pitcher.
ممکن بود در نهایت خونسردی ناگهان تیغ برکشد.	might turn into the keenest of blades.
حیاط به روشنایی سفید ماه آکنده بود	he strode up and down the moonlit yard
او لا اندوه آن فقدان بزرگ چنان در دل برادرم ریشه دوانیده است	first, I know that though he rarely speaks about the wife he has lost, the grief of
چون چم انش را بط رف در اتاق بالا برد از سوراخ کلید یک روشنایی دید.	as he raised his eyes towards the door of hischamber, he saw a light through the keyhole.
از شعاع های درخشان نور خورشید که از درز پشت پنجره ای صاف و مستقیم به روی صندلیها و میزهای نامرتب کنار دیوار می افتاد .	than the narrow bright lines of sunlight from the cracks in the shutters, ruled straight across the cafe over the disarranged chairs and tables to the wall opposite.
از کنار ما گذشت تا خارج شود.	crossed by us on his way out.
هیچ کس در دیر متوجه این موضوع نشد.	they paid no heed to this.
پول را در کاغذ پیچیدم و آن را در پارچه نهادم و بسته را در داخل درخت پنهان ساختم	I wrapped all the notes in the rag and stuffed it deep down in the hole.
کلاه کج او که نوار تندرنگی بدان بسته است نمای عمده او هستند.	his slouched and gaily ribboned hat betoken his grand features.
یا با کشتی هیسپانیولا بگریزند.	or ran away with the HISPANIOLA.
من موضوع صحبتم را عمدا محدود کردم	I have narrowed my subject on purpose.
بنابراین به دلیلی که عرض شد و به خاطر اینکه پاهایم نیز خنک باشد و هوا بخورد	so for this reason, as well as to keep myself cool
در همان اندوه همیشگی فرو رفت.	his face fell into its usual bitter lines.
این چیزی نبود که بر آنان که با وی هم نشین بودند گذشته باشد	it was not the sort of thing that happened to the people among whom he lived
خواهش کردم که بگذارند از آنان جدا شوم.	desired they would please to let me depart.
می دونم که امکان ندا ره بتونه تا فردا خودمو به شکل قورباغه در بیارم.	I know I haven't got a chance of turning into a frog by tomorrow morning
کنترل تلویزیون را برداشتم و تلویزیون را روشن کردم.	I pick up the zapper and turn on the television
من میل ندارم و تقریبا برایم محال است که شخصاً در این باره با او صحبت کنم.	I don't like I'm almost unable to speak about this to her.
چه عجب که او در سن بیست و شش سالگی شش سال از عمر خویش را در سر این کار بگذارد	he who was but half as old would sacrifice six
بنابراین طی راه با هم بودیم.	made the voyage with me.
اما هنوز به پیچ راهرو نرسیده بودند	but as they reached the corner
نوازش کنان به راه خود رفت.	went away caressing him.
انتهای عقبی آن به طرف من برگشت	at last presented me her stern
با اینکه می تونستی بارها ازدواج کنی.	though you could have married dozens of times.
زیرا در آنجا پیکار بزرگی به وقوع خواهد پیوست.	for that there would be a big battle there.
هر کدام یکی از این دو کیسه را برمی داریم	you shall take one, and I the other
اما از آن روز به بعد دیگر هرگز راجع به آینده گفتگو نکردند.	but after that they never spoke of the future.
دست کم صندوق یک گز از جای سابق خود بالاتر آمده بود.	at least three feet higher than I was before.
به دستور رئیس دادگاه این بخش را از پرونده حذف کردند.	the evidence was accordingly ordered struck out.
هیچ نخواهم هم قطاران خود را ملاقات نمایم.	, who would be glad never to see them again
با زور صدایم را آرام نگه داشتم	I forced my voice to stay even.
سپس در جریان باد او را بیرون انداخت.	let it into the wind stream out the window.
حتی حرکتی هم نکرد و چهره را بیشتر درهم کشید و کین توزانه نیشخندی زد.	but scowled still more and sneered malevolently.
آهسته به طرف در به راه افتاد.	passed through to the little room beyond.
ناگهان غش کرد و به زمین افتاد.	fell down in a swoon.
به یک همچون کاری بزرگی اسبی کوچک و لاغر و مردنی روستایی را بسته بودند.	in the shafts of such a cart he saw a thin little sorrel beast
به او پیشنهاد کردم در صورتی که راضی باشد حاضرم در ازای نه پنی معامله را ختم کنم.	I said I would take ninepence for it, if he pleased.
باید حتماً کتاب سرودهای مذهبی را در دستش داشته باشد.	a hymn book in the hand is as necessary
یقین داشتم که خارجه مرا خواهد کشت.	I could understand that it was all foreign and strange.
یقین کرد که رنگ به اختگی چهره و رعشه اندام او از نظر دقیق پیرمرد پنهان نمانده و حتی از دیدار آن شادمان هم شده است.	he felt that his pale face and trembling limbs were neither unnoticed nor unrelished by that wary old gentleman.
وی بعد از جنگ ریشش را اصلاح کرد.	after him that towards the end of the war he shaved his beard off.
بعد صابون را توی آب فرو کرد	then he dipped the soap in the water
نفس کشید و نگاهش به من خیره موند	she breathed, and her gaze flickered to me.
اشاره می سون به این جنایت جنسی روستائیان را به لول خوردن و گردن کشیدن انداخت.	while therurals jerked and craned at this introduction of the sex crime.
تا بتواند نقاشی آن را ببیند.	so that he could see the painting.
مگی پنجاه و سه ساله و خود هفتاد و یک ساله بود.	she was fiftythree and he was seventy one.
هرگز از این کلافه درهم بیرون نیایند.	would neverhave unravelled that skein.
به پشت روی تخت افتاد و مرد	fell back and died
در یک ماه دو مرگ بر این خانه نازل شده بود.	death had entered that house twice within one month.
در عوض سؤالی را پرسیدم که جوابش مشخص بود.	so I just asked the obvious question.
من منتظر بودم که یک وقتی شما هم با ماشینتان بیایید اینجا	I'd be expecting to have you come motoring through
آنگاه این اندیشه به سرم راه یافت که این خانه همانا به یکی از بزرگان آن دیار تعلق دارد	I began to think that this house must belong to some person of great note among them
یک گفتگوی بی معنی و قاه قاه خندیدن.	there was a scraping of chairs, a babble of conversation, and laughter.
چند زبده استخدام خواهد کرد که داخل ان را به شکل زیبایی تزیین کنند	she would find some fabulous decorator to do
کمانداران دیگر جوان چنین رفتاری را با رفیق خود دیدند.	the rest of the officers, seeing their comrade assaulted
شاید از من سؤالی کنید که نتوانم جواب آن را بدهم	you might ask me something that I should not be able to answer
از پله بالا رفتم و در اپارتمان را باز کردم.	I float up the stairs and unlock the door of our flat.
بگریزم و خود را در زیر چوب بستی ضخیم پنهان کنم	run under a thick espalier
کم شدن املاک و دارایی و ترس از فقیر شدن او را حسابی از پا انداخته بود.	the loss of money and fear of poverty were quite breaking her down.
چنین ثروت هنگفتی در اختیار دارد به دست تقدیر بسپارد و یا به چنگال نابکاران و نیرنگ بازان واگذارد.	the possessor of such enormous wealth, to the caprice of fate and the designs of rogues.
منتظر بودم تو به خانه بیایی.	I was waiting for you to come home.
هرگز آتش عشق تو در دل من خاموش نخواهد شد	I never leave off loving you.
سپس به خواب عمیق جوانی فرو رفت.	he fell into a deep, youthful slumber.
جوان ترها و خدمتکارهای محل همه داغ خبرهای ترسناک شدند.	all the youth and servants in the place were soon in the happiness of frightful news.
به سمت جنگل خزیدم که بمیرم.	I crawled away into the jungle to die.
تا کسی در حین مطالعه مزاحم کارش نشود.	so that no one would disturb his experiments.
ویژگی غریبی که توصیف آن دشوار بود.	a peculiarity difficult to interpret.
سپه سالار با بیست هزار سرباز که به تیرهای زهرآگین مسلح باشند دست و روی ترا آماج کنند.	the general was to attend with twenty thousand men, armed with poisoned arrows, to shoot you on the face and hands.
تو هم شندرغاز به راش پول بفرستی	while you sent her a little money
دکتر درو او را برادر خواند و دست او را بارها فشرد.	DrDrew called him brother, and shook his hand a great many times.
از یک طرف از شدت هول و هراس کرخت بودم	half of me is numb with horror
تعجبی ندا ره اگه چیزی شنیدی که ازش خوشت نیومده.	I'm not surprised you heard something you didn't like.
پس از آنکه نگاهی به دو طرف خویش انداخت	after having looked all round, as has been said
به جای او مردی بلندقامت با لباسی سیاه ایستاده بود.	behold in her place stood a tall gentleman in black.
جعبه به رنگ پودری سیاهی آغشته بودکه دستش را سیاه کرد.	it was covered with a powdery black paint that left dark smudges on his hands.
بدین ترتیب هر سه دست دردست جلو رفتند.	my peepers ain't what they once was.
از تمام افراد هنگ وی فقط این عده انگشت شمار باقیمانده بودند.	represented all that was left of that whole regiment.
تحمل نداشت زشتی زندگی واقعی را ببیند.	the horror of real life.
لابد خیلی از رفتنت خوشحال شدند.	I dare say they must have been very much obliged to you for coming.
شاید به نوعی پی به تغییر درو نیش ببرید.	it might give you some idea of the change in him.
من که ازت نخواستم این کار و به تنهایی انجام بدی.	I am not asking you to do it alone.
پس غذا را به روی میز لنگ و شکسته نهاده و بیرون رفت	prisoner placing the food on the rickety table he withdrew
سر برداشت و پیرامونش را جستجو کرد.	he raised his eyes and gazed searchingly about him.
آری! من روزی یک سکهٔ بیست کپکی مادرم را از روی میز دزدیدم.	I stole twenty copecks from my mother when I was nine years old.
یعنی خودکار مرگ را به پایان رسانیده بود.	she had completed the work of death.
کلماتم را با دقت انتخاب کردم.	I chose my words carefully.
چون راه دیگری باقی نمانده بود.	sincethere was no other door.
لیکن با این حال همیشه تشنه بودم	yet I always needed to drink
از درستی راهی که در پیش گرفته بود اطمینان نداشت.	was dubious as to her present course.
هر بسته اسکنان را شمرده و آن را درجی بهای دو طرف خود نهاد.	counting with surprising speed for such plump hands, and stuffing the bundles into his side pockets.
که آن را به شاهزاده باگراتیون برساند و مورد استفاده قرار دهد.	asking him to take it to its destination and make use of it.
باید اعتراف کنم که دودل شدم.	I confess, that I hesitated.
دائم به من اصرارمی کرد که به مدرسه ده توجه کنم.	he urged me to take up the school in the village.
همین طور نایست اینجا و به من زل نزن!	don't stand staring!
من هم فورا چهل هزار فرانک را به او شمردم.	I immediately counted him over the forty bank notes
خیلی سریع قرار و مدار روز بعد را گذاشتند و خداحافظی کردند.	with a short final arrangement for the next day's scheme, they parted.
خیلی وقته که اونجا زندگی می کنه.	we been there a long time
من درجه و نام فرمانده هنگ را یادداشت کردم	I took down the name and rank of their commanding officer
همه پیوسته در صدد یافتن امکان پایین آوردن این شیئی یا آن شیئی	still they went on searching for and finding possibilities of unloading this or that
سرش در نور آینده جای داشته است.	one's head has been in the light of the future.
ترس و وحشت بر او چیره شده بود	he felt afraid afraid not for his life
اما زره یا شمشیری که به قد و قامت او بخورد نداریم.	but we have no mail or sword for one of his stature.
که با وجود اضطراب خستگی غلبه کرده	, who in the midst of her grief had at last yielded to fatigue
ناگهان از پدرم شرمنده شدم.	I was suddenly ashamed of my father
یا مردمی که نسل اندر نسل با او نسبت یا دوستی داشتند.	people who shared ancestors with him, whose pasts intertwined with his.
نخست لرزه بر اندامم افتاد	which at first startled me badly
شاید فردا صبح همه چیز حال و هوای شادتری داشته باشد.	perhaps things may seem more cheerful in the morning.
چند بار به عقب برگشت تا سر خط را که گم کرده بود بازیابد.	turning back on several pages to find the thread he had lost
اما شکوفایی او خیلی زود ناپدید شد	but her bloom had vanished early
مسلم بود که مسئله برخورد افکار او را از مدتی پیش ناراحت کرده بود.	evidently this problem of double motives had often been considered by him before.
از شما متشکرم و از مراحم شما بسیار سپاسگزارم.	I thankee, sir. I'm obleeged to you, sir, for your welcoming manner of me.
این شخص مرد جوانی بود که لباسی مرتب و آراسته بر تن داشت و روی صندلی کنار میزی نشسته بود و کتابی در جلویش قرار داشت.	he was a young man, respectably dressed and seated at a table, having a book before him.
حالا من یک هدف بزرگ در سرم دارم و هیچ دلیلی وجود ندارد که تلاش کنم کارم را مخفی نگه دارم.	I already had a big target on my forehead and there was really no point in trying to keep the extent of what I could do a secret.
هنگام بازگشت به خانه برای شام دست کم پنجاه و پنج ساله بود.	come home to dinner a man of fifty five at least.
اگر قرار باشد تمام عمر از کاری که کرده است نادم باشد داشتن پول چه سودی خواهد داشت.	it would be no good having the money if he regretted all his life what he had done.
پیپ خود را به کنار لب گذاشته بود	his black, short pipe in his mouth.
این امر قدم عظیمی به جلو و نمایانگر قدرت و توانایی است.	that is a great step and a proof of strength.
تو قبلا منو کام لا عوض کرده بودی	you had already altered me so completely.
همیشه خودش پا پیش گذاشته بود.	as he would always do.
نمیخوام دوباره این وضع پیش به یاد.	I'm not risking this action again.
به سوی موجکهای چرخان و لیسنده رفت	ran down to the innocently curling wavelets.
همین که توجه آنان به این نوانخانه معطوف گشت	when they came to turn their attention to the workhouse
مغرورتر از آن بودم که همیشه کمک کنم.	I was too selfish to do it regularly.
هوا مثل قبل گرم و مرطوب و شرجی بود .	it was hot and sultry as before.
بر اثر غفلت او جوانی آزاده که با یک دنیا آرزو به حضور سلطان بار یافته بود	by which neglect a young lord of great hopes, coming to an audience
محصول هیچ وقت وضعش معلوم نیست.	land most awkward.
حالا که اون از من هم عکس گرفت	if he was photographing me, too
البته نمی تونی گرفتاری و ناراحتی مردم رو تشخیص بدی به خصوص یک بچه .	imagination and, of course, you can't appreciate the tortures of people who have one especially a child.
در آن حال که سوت کارگاه به صدا درآمد	he heard her add just as the whistle blew
زیرا آن نان را با یک خرگوش خانگی درست کرده بودند	for it was made of a house rabbit
به من تسلیم شو که به من تسلیم شدن عیبی و عاری ندارد.	yield you yield to me, do you not?
لیکن هیچ یک از ایشان از عهده بر نیاید مگر پهلوان غریب که با مزید افتخار و با خرسندی کامل شاهدخت بر آن مشکل فایق آید	none will bring it to an end and conclusion save the stranger knight, to the great enhancement of his fame
انسان باید زندان مجرد دیده باشد	I doubt you must have been a solitary prisoner
مانند میله تحقیق در تاریخچه تناردیه فرو برد.	like plummets, intoThenardier's history.
فکر تو خواب و خوراکمو ازم گرفته.	so much so that I can hardly sleep for thinking about you.
با این حال بسیار ضرورت داشت که شغلی برای خودم داشته باشم.	yet it became urgent that I should have a vocation of some kind.
آب بسیاری با لذت فراوان نوشیدم.	had a good deep drink of water
اما طبیعت که همه کارهایش به حد کمال است	but that nature, who works all things to perfection
نخست دلیری کردم و در کشو مانند سقف را که برای داخل شدن هوا تعبیه کرده بودند و شرح آن گذشت گشودم.	having first ventured to draw back the slip board on the roof already mentioned.
زیرا یکی تجسم زندگی دنیوی و دیگری مظهر حیات معنوی بود.	seeing that one is the incarnation of the fleshly and the other of the spiritual life.
نیاز به همدمی جوان و بشاش دارد	the need of that cheerful companionship
حتی کمک کنید مشکلات از سر راه برداشته بشود.	try to put difficulties in the way.
من توی این کار هیچ دخالتی نداشتم!	I wasn't involved!
که سرم فوری و کامل از تنم جدا به شه.	it had all been quick and clean, and my head had come off properly
اطلاعات نسبتاً کاملی در مورد این قضیه داشته باشیم.	I expect we shall have a fairly full knowledge of the case.
من پیش از ین مناسبتی با ارباب خود درباره حکومت عموماً و در باب مشروطیت عالی خودمان که مایه رشگ و حیرت جهانیانست خصوصاً گفتگو کرده بودم.	I had formerly, upon occasion, discoursed with my master upon the nature of government in general, and particularly of our own excellent constitution, deservedly the wonder and envy of the whole world.
به خواندن نامهٔ تو از شادی اشک ریختم.	I weep for joy as I read your letter.
زیرا مرور زمان که پرده در رازهاست	time, that discloses all things
مدت زیادی به رفتن ادامه دادم.	I walked a long time
به او فرمان داد که چنانکه قبلاً گفته بود حداکثر تا سه روز به انتظار وی در همان محل بماند	he told him to wait for him there three days at most, as he had said before
آن هر دو از استعداد من مبهوت شدند.	they both appeared amazed at my capacity.
که حافظه نخستین انسان در خاطره مشخصی بود و تمامی مردم احفاد او بودند	when the memory of the first man was a distinct recollection
چشمانی زاغ و نگاهی ظالمانه داشت	with cruel golden eyes
از این سو که راه بسته بود.	there hewas cut off.
اما از آن پس زخم خورده شد	but she was stricken after that
دیگر آنقدر برایش ارزش ندارم که مستقیم با خودم حرف بزند.	I'm beneath direct mention.
حالا دستت همان جا باشد و خوب گوش بده.	that's it now you have it.
که به دقت کنار هم چیده شده بود.	which summed it up precisely.
بازوی چپ را به میز تکیه داده بود	leaning his left arm on the table
بعضی اوقات اوضاع بر وفق مراد نبود	sometimes other things turned up
تنها نگاه کردن به بچه کافی است که درد و بیماری آدم را از بین ببرد.	I should get better at the bare sight of it
تو مو رل که من چون فرزند عزیز خودم دوستت دارم.	whom I love as my own son.
سریع به جلو رفتم و نگاهی به ان کوچه انداختم.	I dart forward and peer into the other alley.
اگه باز هم نشینی پنج امتیاز می شه پنجاه امتیاز!	if I have to ask you to sit down again, it will be fifty.
به جای او و به خاطر زن و فرزندش.	his wife and child.
با عجله اتاق را ترک کردو به فروشگاه رفت	she hurriedly left the room and went into the store
پیراهنی بد برش از مرینوس درشت سیاه پوشیده بود.	it consisted of a badly cut gown of black merino.
اینک فرصت دارد تا آنچه را دیده یا از آن آگاه است	that he would have a chance to give a reliable account
با دیدن کاترین هاج و واج نماند.	started with rapturous wonder on beholding her
چه از طرفی که کور بود چه از طرف دیگر.	blind side or other side.
محکوم نیز در همان جای خود و با همان قیافه ایستاده بود.	the prisoner still stood with the same air and gesture.
بازگوینده مردی در حال احتضار.	filled with the appeal of a dying man.
چون روزهای ایشان دنبال بدست آوردن آن مقدار پول که شب تا صبح را درجایی بگذرانند	for their days were occupied in the pursuit of enough money to get a night's lodging
مثل دو گربه به یکدیگر آویخته بودند	gripped together like cats
خیز بلندی برداشت و به پشت غلتید.	it rolled upon its back
طوری که دیده نشود پشت دین خزید.	she said, creeping up behind him unseen.
فی تلور تنباکویی را که در دهان داشت از سوی دیگر درشکه تف کرد	hastily squirted a stream of tobacco juice from the opposite side of the buggy
یا یک زردآلوی فاسد و یا یک گلابی کال از زمین بردارند.	or a spoiled apricot oran inhabited pear on the sly.
این دو کلمه را جدا جدا تلفظ کرد	slowly separating the two words.
پا پا هم چشم به راه است که ما هرچه زودتر بازگردیم.	papa will be wanting us back.
گویی وارد قاره دیگری شده بود.	as if she had crossed a continent.
همه حیاتش که چیزی جز یک توالی حسنات نبود	her whole life, which had been nothing but a succession of holy deeds
هنوز روی زمین مسابقه افتاده بود.	still lying on the field
چون من تقریباً چنین انتظاری داشتم.	as I half expected it would.
طی قرون و اعصار در بازتاب جمله صداها منعکس بود.	has been whispered by all true echoes for ages and ages.
من که به هر صورت تابع تصمیمات تو هستم.	I am at your disposal.
خیلی علاقه داشت به همه جا سرک بکشد	being as fond of going everywhere
وقتی که بیرون میومد از اینکه تورو کشته باد تو گل وش مینداخت.	bragging how he'll shoot ya when ya come out.
اما خانم وی زلی به خبرنگاران ما گفت	although his wife told reporters
خانم وی زلی هشت یا نه سوسیس در بشقاب هری گذاشت	tipping eight or nine sausages onto his plate.
سپس آن معجون را بر زخم گوش پهلوان گذاشت و محکم بست	applying them to the ear he secured them firmly with a bandage
ناگهان خود را روبروی نانسی دید.	was close upon the girl before he observed her.
من آهی از سر آسودگی کشیدم.	I sighed in relief.
به چیزی جز حرکت مکانیکی شکستن فکر نکردم.	I didn't think about the sound it was going to make.
به زودی جرأت خود را باز یافتم.	courage glowed again in my heart
تمام جمعیت ناگزیر شد منتظر بماند.	the whole crowd had to wait.
که پشت به آتش بخاری کرده	with his back to the fire
یک روستایی بدخواه و متوحش که محکم بر پشت اسب چسبیده بود	a hostile and terrified peasant, who was attached to thesaddle of a hussar
زود این کار را انجام دهید و بازگردید.	make haste to carry out her commission, and then make haste back.
به این امید که شاید بوزینه فرود آید	hoping to drive the monkey down
صفات حمیده را در شما تقویت خواهد کرد	improved in manners
حتی موقع ریختن خاک اره توی گیربکس و عوض کردن کیلومتر شمار با مته برقی هم کلاهش را از سرش برنداشت	even when putting sawdust in gear boxes and fiddling the mileages of cars with his electric drill.
همچون یک منادی بر دوش کشد	to bear his shining lamp afar
لازم بود خودم را نگاه دارم	I ought to have borne it in silence
به ماشین تکیه دادم و منتظر شدم.	I leaned against the side of the car to wait.
نتوانست یک پایش را هم تکان دهد.	he could not move his feet.
میان این دو نیروی متضاد تعادلی برقرار شد و دخترک از حرکت بازایستاد.	a balance between the two forces was struck, and she paused
اما اگر از فردی در یکجا تمجید و در جای دیگری بد گوئی شود هیچ کس نه از تمجید و نه از تف کیر او راضی نخواهد شد.	but once good is told of a man, and again evil, and some would not thank me for either blame or praise.
راه را دنبال کنیم تا به راهیی برسیم که سه چهارم به طرف راست بپیچیم	we made a corner three points to the starboard, and that done
این پسرک ناقلای خودمو نه که دمق داره میاد.	there's a young smart aleck draggin' his tail home right now
من طوری رفتار کردم که انگار نگران شما نبودم.	I've acted as if I don't care about you.
قبل از رسیدن به آنجا توقف کردم.	a little before I got to the houses I stopped again.
او در جوابش واکنشی از خود نشان نداد.	she did not return it.
که قبلاً به گفتار و رفتارش جاذبه زاهدانه خاصی داده بود.	which had formerly communicated a certain austere charm to his language and manner.
خودش در یک دسته جلودار مخصوص در اولین حمله شرکت کند!	for the front of every storm, of every attack, to lead them all!
آنچه را که صحیح است و باید انجام داد خواهد یافت و انجام خواهد داد.	decide what was right and how he should act
همه از حرف او به خنده افتادند.	getting a general laugh.
صدای شیهه اسب و غژغژ چرخ از بیرون شنیدید.	they heard the snorting of horses and the sound of wheels on the gravel.
دست از این خلبازیها بردارید	to have done with carrying on absurdities
صدای فرمانده هنگ که پیش از دیگران بدان جا رسیده	he heard the voice of the colonel, who, having ridden ahead
نگران بودم که دیگر تو را نبینم	I would have regretted not seeing you again
تو حتی نمی تونی نصف دسته شم بخری.	you couldn't afford half the handle
به آنان گفت که تختخوابی بهتر از بار اول برای وی آماده کنند.	bade them make up a better bed for him than the last time
اما برخلاف همیشه پس از باران نه دویدند و نه هیاهو کردند.	but they did not run or shout as they would have done after a rain.
ابتا صدای غرش خفیفی شنیدند و بعد صدای خر خر بلندی در فضا پیچید.	a low moan, and then a deep, loud purring.
کنت دمورسرف فقط خیره شده بود	the count could only stare
کشیش گفت مادام از راه خوب و نیت پاک	I pledge you my word madam said the abbe that my intentions are good
تمام حقایق برایش آشکار شد.	the whole story had come out.
پیشنهاد کرد که قشون را شب هنگام از جناح راست به جناح چپ منتقل کنند	he proposed to move troops from the right to the left flank during the night
تا بلکه بتواند متقاعدش کند مراسم تشییع جنازه را جلو بیندازند.	in case the funeral could be held earlier.
حالا مثل یه مرد به من نگاه کن.	now you face me, like a man
با رنج و کوشش موفق شدم که این کار را در مدت سه ساعت انجام دهم.	I made a shift to do, in about three hours.
به رام مهم نبود که زنده بمونید یا بمیرید.	I didn't care if you lived or died.
گویا همین چهار ماه پیش ازدواج کرده با زنش تو درد سر افتاده.	about four months now, I guess is in a little trouble on account of his wife.
کنتس پیر به واسطه هیجان روحی بیمار گشت.	the countess fell ill from mental agitation.
هیچ موجود جاندار نه در جنگل بود و نه در دره.	there was not a soul either in the woods or in the valley.
یا سایه مرتعشی است که از بدن موجود نامرئی بر کشتی افتاده است.	or else a tremulous shadow cast upon the deck by some unseen being's body.
تا تفصیل را از او استعلام نماید و شرح واقعه را چنان که بود بیان نماید.	who he knew was authorized not to conceal anything from hiM
اگر مشارالیه محتاج به حمایت بود	not assisting him
منظور من این است که کسی حرف شما را باور نخواهد کرد.	I mean, who would believe you?
همیشه چاقویی در آستین داشته باشد	slip a knife up his sleeve
چون هیچ گونه سبک سری نیست که ددهای زمینی انجام دهند و جنون انسان به مراتب از ان در نگذرد.	for there is no folly of the beasts of the earth which is not infinitely outdone by the madness of men.
اما گرفتاری در این بود که عایدی او بسیار کمتر از یک صد هزار روبل بود.	but the fact was that he was far from having one hundred thousand.
رویش را از آینه برگرداند.	turned from the mirror.
چیزی نمانده بود مهتر را بکشد	had just missed killing the groom
موهایش رنگ باخته و به سفیدی گرائیده است	her hair faded and colorless
که تصادفا ملحفه برای تخت دو نفره بود.	which happened to be 'sheets for a double bed'.
به کلبه پناه بردیم تا گرم شویم.	we withdrew into the hut for warmth.
اما اگر فکر کنند که هیچ ارتباطی خونی با هم ندارید رنج بیشتری خواهی برد.	but you would suffer far more if they thought no blood bond linked you together.
من معتقدم که این روز قشنگ را با دنبال اتاق گشتن ضایع نکینم.	I say don't let's waste this beautiful day in looking for rooms.
شما نباید مرا دوم شخص مفردتو خطاب کنی	you mustn't talk to me in the second person singular.
این امتیاز بزرگی در یک شوهر است.	that is a point to be thought of in a husband.
حتماً دیگر احتیاجی به آن ندارد	so he may go without 'em.
حالا اگه اعتراضی نداشته باشی برمی گردم سرنقاشیم.	I'm going back to my picture, if you don't mind.
مطمئن بودکه هنوز صبح نشده است.	he was sure it was still nighttime
در ضمن او یک زن را هم دید.	also, he saw a woman.
هیچ گاه زمان زیادی را دور و بر رئیس پلیس شهر نگذرانده بودم.	I'd never spent much time around the town's police chief.
خواست که سرپوش تابوت را روی او بگذارند.	he called for the coffin lid hatch he called it to be placed over him.
هیئت مدیره از این واقعه خرم و سرحال بود.	the board were in ecstasies.
او را به سنگ قبر ایستاده بست.	tying him from neck to ankles to the headstone.
من دختری سلاح پوشم و دستانم عاری از لطافت است.	I am a shieldmaiden and my hand is ungentle.
که با همان پول بعد از مردن قروض پیر را داده و مخارج تکفین و تدفین او نمودند	with which they paid the old man's debts and buried him decently
آن حیات را در خطرات عملی شکار گرفتار سازد یا نه.	it is right for a whaling captain to jeopardize that life in the active perils of the chase.
هرچه بر سر سفره بود واژگون گردید.	upsetting and scattering everything on it.
من یک دقیقه فرصت نیاز داشتم.	I needed a minute.
الغرض داستان شما چندان مورد مطالعه مردم قرار گرفته	in a word, it is so thumbed, and read
او را به سوی سرنوشتش هدایت کند.	lead him to his doom.
تا مگر چیز دیگری پیدا کنید که ما را اقناع کند.	you will find something that will enlighten us.
امیدوارم که به کس دیگری تجاوز نشده باشد .	I hope no one else has been raped!
همین که آن کارگر نزد او آمد به وی دستور داد که بدون تأخیر دست به کار ساختن پای نوی شود	when that functionary appeared before him, he bade him without delay set about making a new leg
می دونم که خیلی فکرت رو ناراحت کرده.	I knew you'd be worried about that point.
دی گه نمی تو نه بچه دار به شه و من می تونم	she couldn't ever have any more children and I could give you
اگر تا سی ثانیه دیگر صدایت را نگیری	if I hear you for half a minute longer
زیرا یاغیان به کشتی بازگشته بودند.	where ruffians had sat down to drink or consult
به روی شکم به سوی مردها خزید.	crept low belly toward the men.
علاوه بر سهم ملکی پدرم که سه هزار دوکا ارزش داشت	besides three thousand, the value of the portion that fell to him
اما مضر و مانع از تحصیل روزی نبود.	which could not be mixed up with her ordinary pursuits
دوست دارم تو را نزدیک خودم داشته باشم.	I like to have you near me.
باید تا پنج دقیقه دیگر آماده به شین.	I want you all back here in five minutes ready to leave.
که بلای جان مادرم و من شده بود.	which was the bane of both our lives.
که او را معهود بود حالت کسی که دائما از خود مطمئن است نظر کرده	which characterize the man who knows his cause is good
با عجله به سمت انتهای راهرو رفتم.	I hurry down the corridor as quickly as I can
بهت گفته بودم که یه نظریه دارم.	I told you I had a theory.
دوقلوها حتی به او نگاه هم نکردند وهمان طور به راهش آن ادامه دادند.	but they did not look back or answer.
مگر آنکه برای تحصیل چیزی به خاطر زیستن ناگزیر چیزی بگوید.	unless forced to stammer out something by way of getting a living.
مصمم بود که خود را از چنین پیامد وخیمی دور نگاه دارد.	if nervous, consideration to that ofmingled fear
ماجراهای عشقی فراوان داشت که همگان از آن باخبر بودند.	many love affairs notorious in the whole fashionable world.
فقط از او خواهش کردم که به من دو پیراهن پاکیزه عاریت دهد	I only desired he would lend me two clean shirts
فقط از این جهت غمگین بود که به واسطه بیماری ناتاشا باید مراجعت خود را به دهکده به تعویق بیندازد.	he was only dissatisfied that her indisposition delayed their return to the country.
اما حاضر نبود اطلاع خودش را علنی کند.	but he refused recognition of it.
از کارهای شما کمی سردر می آرم..	I understand something about your affairs.
برای شرکت در جشن مرگ پشیمان بود.	to go to the deathday party.
برای چند دقیقه بیشتر گرم و در رویا.	warm and dreaming, for a few minutes more.
همیشه نظرم این بوده که این بهترین و تمیزترین مسیر است.	that I always think it the best and nearest way.
گویی لطف بزرگی به هری کرده بود	as though this was a huge treat.
در حال تهیه داستانی راجع به این خانواده هستم	I'm doing a story about the family.
تا در صورت مأموریت بداند کجا باید برود.	so as to know his bearings should he be sent to execute an order.
شغلی در یک بنگاه نشر کتاب به دست آورده بود	he had gone into a publishing house
منتظر بود تا به سوال خودم پاسخ دهم.	waiting for me to answer my own question.
اما این کار باید با تردستی صورت گیرد	but the affair must be managed with dexterity
اما یک ساعت و نیم بعد از این زن من خواهد بود	but i n an hour and a half she will be
که بدون اطلاع او پنج بشکه آبجوی کهنه را از محلی ربوده بودند بگیرد.	who, unknown to him, had appropriated five barrels of old beer.
هرگز مباد که برخیزد از روی بستر سنگی.	never mare to wake on stony bed
بعد چرخ دستی را به سمت نرده به حرکت درآورد.	wheeled his trolley around to face the barrier.
سرجوخه پس از مدتی پرگویی رفت.	after chatting a while longer, the corporal went away.
باید نزد خودتان بماند و جای دیگری مطرح نشود.	are things to be seen, and not spoken of.
ضمناً باید احساس خشنودی و راحتی کند	so that she might feel satisfied and easy
پس مسیو به من بگویید که امیدوار باش	tell me at least to hope
چرا که دیدارشان در خانه یا رد و بدل کردن پیامی مکتوب محال بود.	for it was inconceivable that they could ever meet indoors or exchange any kind of written communication.
چنین زنی با آن صدای ملیح شبیه به بلبل و با ان دان بدان زیبائی.	does not love a pearl of a woman, with a voice like a nightingale and shaped like a model.
که مهاجم از این کار دست کشیده است.	that the attacker had retired for good.
من در ظلمت محض تنها ماندم.	I was left in total darkness.
به همین سبب در درونم احساس خوشی دارم.	I feel better within myself because of it.
تا حالا جز در یک جنگ از آن استفاده نکرده است	until now he has only fought one battle in it
تنها به این دلیل که آن اسم را دوست داشتم	because I liked the name
پیشانی صاف و گشاده دختر را بوسید	kissing her candid brow
تو سعی کردی او نو از خودت برونی و بهش توهین کنی .	you do your best to alienate and insult her.
با وجود این بسیار متأثر شده.	himself appeared deeply impressed
انگار میکروسکوپی با خود داشت.	as if she had a microscope stuck to her eye.
اون وقت دی گه ما مجبور نبودیم تحملش کنیم.	then we wouldn't have to put up with him.
برخی با دلواپسی به آسمان کوتاه چشم دوخته بودند.	some gazed uneasily at the lowering sky.
وقتی من اومدم مدرسه با بام مرد.	but he died, o' course, jus' after I started school.
تا این که درد غیرقابل تحمل شد.	until the pain became unbearable.
به شرفم قسم! من این کار و نکردم.	pon my word and honor I never done it
سرم را به نشانه موافقت تکان دادم.	I nodded, then pulled her fingers away.
از دیدگاه من برای ابد فراموش شده	that I thought were silent for ever.
در ساعت 10 همه چیز نظم و ترتیب ضروری را به دست آورد.	by ten o'clock all had been brought into due order.
حالا به فواصل دوردست رفته و به روی قطعه سنگی که از دریا بیرون آمده بود نشسته بودند.	they had settled on the water a little distance from the ship.
از سرماهایی که من به عمر خود مانندش را ندیده بودم	I think I ever was abroad in a chill
من اکنون در میانه دو قبر زیست دارم	I live, as it were, between two graves.
آه! این نکته را فقط به یاد داشته باشید.	oh, remember that!
لابد انتظار داره همه دخترها کنیزش با شن.	I guess he would like to have a girl wait on him.
معلم به طرف پیرزن دیگری رو کرد که روی صندلی بزرگی در کنار آتش اجاق لمیده بود و آن قدر لباس بر تن داشت که گویی یک کپه لباس روی صندلی ریخته باشند	looking at another old woman in a large chair by the fire, who was such a bundle of clothes
چنانچه گفتی قصد دارد آشنائی را که از مدتی پیش ندیده است بجای آور	as though searching for familiar traits therein.
با هر کس با کلامی ویژه سلام و احوال پرسی کرد	greeting everybody with some special word
لبخندی تقریباً قابل درک زد و چشمانش شادمانه درخشید.	he gave a hardly perceptible smile, and his eyes sparkled merrily.
اشتباهی شده و ماکزیم باید به خطای خود اعتراف کند.	now the only thing to do is to admit the error.
باید به گه نیمتونه اسم مرتیکه رو به کسی به گه.	whose name she would refuse to divulge, of course
زیرا بهای پنیر را به چوپانان داده بود	for he had already paid for them
اما بروید و او را به عنوان کارگر اجیر کنید	but just go and take him on as a laborer,
مقداری غذای سگ کپک زده روی دفتر و دستک جن ریخت.	scattering a handful of moldy dog biscuits over the goblin's book of numbers.
چند روزی طول کشید تا به حد نهایی خود برسد.	taking a few days to really gain momentum.
چوب دستی هر دو روی زمین افتاده بود.	both their wands lay forgotten on the floor.
اما آن قدر نداشتند که جایزه بگیرند	but none had enough
که از نظر بلندی و رعنایی قامت و کمال حسن و وجاهت هیچ کس در عالم همتای او نیست.	whether it be in bodily stature or in the supremacy of rank and beauty.
به چنین فرجام نیکویی امیدوارم باشم در جایی که پدر او از خاندانی چنان والا و غنی است	what end can be hoped for when his father is of such lofty position, and so wealthy
پس ده قدمی در خارج اتاق نرفته گرفتار قراولی خواهیم شد.	we shouldn't take fifty steps in the court without knocking against a sentinel.
برای بلافاصله پس ازنهار به هم وعدهٔ ملاقات دادند.	they arranged to meet immediately after dinner.
موقرانه سبیل خود را تاب داد.	twisting his moustache with dignity.
این کار به راش سرگرمی خوبیه.	good for him to have something to do.
اما شاید برای روحم وسیلهء گریزی باشد.	though they may in the spirit.
چون این دختر عزیزدردانه او بود.	for she had always been his favorite child
پس دراز کشید و شنلش را به خود پیچید.	he muttered as he lay down, pulling his coat over him.
شفا دادن زخم این سلاح از دانش من بیرون است.	the wounds of this weapon are beyond my skill to heal.
در آنجا نشستم گوش خواباندم	but lay there
پر از سر نیزه و پیپ و ظروف صیقل خورده و کله حیوانات وحشی بود	it was so full of spears, blow pipes, brass ornaments, and the heads of wild animals
مرا لازم است که توضیحات بدهم	I owe you some explanations for my conduct
هوا سرد و گزنده بود اما نزدیک غروب آسمان صاف و هوا گرم شد.	but toward evening the sky became overcast and it began to thaw.
جمله ساده متوجهم با حرکت تأیید آمیز سر	a simple, low I see, with an affirmative nod
مانند اثریکه از ترکه جادو پدید آمده باشد.	like the unsubstantial fabric of a magic wand.
نزدیک بود از درد فریاد بکشد.	it hurt him so that he could have cried out.
از این فقره مطمئن باشید که او مبارزت خواهد کرد	he will meet you
اما استعداد موسی قیدانی را از پدرش به ارث برده بود.	but he inherited the musical talents.
که ممنوع است علامتی آشکار نساخت.	which is forbidden, he gave no sign.
تمام این قضیه بوی نیرنگ و ریا می ده	I smell double dealing and corruption in this whole affair
گوئی که اصلا اتفاقی رخ نداده است.	as though nothing whatever had happened.
دی گه بیشتر نمی تونم برات وقت بذارم.	I have given you already the very last moments I can spare.
در صورتی که اعتبارنامه به شما داشته باشد	, if he is recommended to you
شاید بگوید با این وجود از خشونت مردان یا عشق به قدرت در او خبری نبود.	then they would say, still, she has none of the formality of a man, or a man's love of power.
در عوض جشن ما در روی خوشی بر گذار شد.	we've had a beautiful day for our fete.
سکه درخشان را روی خاک رها کرد.	leaving the coin to gleam indifferently up from the dust.
اسکار لت ناگهان گریه را سر داد	she burst into tears.
زیرا که برقی در چشمانش ظاهر شده	so did his eye flash like lightning
پس از چند بار آزمایش بیهوده سرانجام موفق شدم.	after a good many trials I succeeded
اما فعلاً باید به خانه برگردیم	but now we will pass on to the house
بعد از ازدواج مجبور است به ما کمک کند.	after I've married him, he'll have to help us.
کیتی به سنگینی بر بازوی او تکیه کرد و دستش را به پهلوی خود فشرد.	she clung faster to his arm and pressed it closer to her.
منو فرستاده که درشکه شما رو برونم .	she sont me over here to drive aroun' with you.
که بیوة بدبخت مثلاً چیزی دربارة آن نداند و فقط شما از این کار مطلع باشید.	so that the unhappy widow should not know of the money, but only you, for instance.
یعنی همان ساعتی را که چند ماه پیش برای خود خریده بود.	the watch he had bought for himself a few months before.
اما جرأت انجام این کار را نداشت.	but dared not do so.
بابت لطفی هم که به من داری خیلی ازت ممنونم.	I'm grateful to youfor your opinion
محال بود که دست کم اندکی از وقت خویش را صرف نشستن و گفتگو با ایشان نکند.	it was impossible not to spend with them at least a short time each day.
من امشب عمداً به این جا آمدم.	I've come on purpose this evening
ما هر دو از او مواظبت خواهیم کرد.	we will nurse him between us.
راهزن ناگزیر دوباره به راه افتاد.	at length he resumed his journey.
من دیگر مزاحم هیچ کس نخواهم شد	I won't stand in her way.
امیدوارم در همین وضعیت باقی بمونن که زیاد زجر نکشم.	just as long as it's not drawn out. I don't want to suffer.
موردی برای ملامت کردن خود نداشت.	he had nothing with which to reproach himself.
می دونم که الانش هم نابغه نیستم.	I know I ain't no genius now.
ظاهر و حرکاتش اصلاً ترسناک نیست.	not really frightening in manner or appearance.
اصلا مایل نیستم حرف هاتو بشنوم .	I don't want to hear a word out of you
روی زانوهایش بر پوست پیش رفت.	marched across the rug on her knees.
در این یکی دو روز من در فکر شما بودم.	I have been thinking about you.
چقدر خوشحالم که تحملم را ندارد.	I am so glad he can't bear me
خوشگلی تون اونطورا نیست که بکار من به یاد.	does not possess that style of beauty which pleases me.
من مطمئنم که یه نفر توی این قایق هست که داره گریه می کنه.	I am certain that there is somebody weeping in this lighter.
در مورد مسایل فامیلی منصفانه رفتار کرده است.	he has shown a sense of justice in family matters.
که این ملاقات روزانه به خیر و خوشی انجام پذیرد.	that the daily interview might pass off well.
محال بود خود را با گذشته معطل کند.	it was impossible for her to linger over the past.
اگه آن قدر پکر نشدی که نتونی بخوری بگیر.	if you ain't too goddamn upset to eat.
وقتی از آزکابان بیرون اومدم فهمیدم که دی گه مثل سابق محبوب نیست.	so I've heard since I escaped, a big drop in popularity.
عاشق سگ خود و عاشق آن زن بود.	he loved his dog and her
عینک دسته طلایی بزرگی به چشم زده بود	he wore large gold rimmed spectacles
اما از ته دل امیدوارم سواری خوبی داشته پاشید.	but I sincerely hope you will have a pleasant ride,
متاسفم که بگویم مادرت خیلی بیمار است.	I'm afraid your mother is very ill.
اما با وجود این از این فرض ممنونم.	still, I prefer that supposition.
قسمت اعظم روزهای دیگر را بدون دیدن هیچ کس در فاصله صبح و شب	for the greater part of many subsequent days, seeing nobody, between early morning and midnight
بعد زنگ اتاق را فشار دادم.	I went and rang the bell.
چون دوران دیدن روح قدیسین و راهنمایان معنوی به سر آمده بود	since the time was gone by for guiding visions and spiritual directors
به درون ظلمت شب خیره شدم.	stared out into the darkness of the night.
باز هم آن قسمت از وال به کلی بر خطاست.	yet that small section of him is all wrong.
ناخدا به زودی از پای در آمد	but the captain soon knuckled under
در میان صندلی راحت خود نشست.	dropped into it again.
زیرا بیشتر از همیشه کار سنگین زمستان به او لطمه زده بود.	deranged by the winter's work that every year grew heavier.
یک وقت از روی کنجکاوی تجربه کردم.	I experience a queer feeling once
آکنده از استواری و مهربانی بود.	it was controlled, kindly.
به شرط اینکه این واحد در قالب یک تیپ و با افراد خوبی باشد.	providing it were within the framework of a brigade with a good staff.
باورم نمی شه ان قدر خودخواه با شه.	I just can't believe he was being so cynical.
زیرا دستگاه من بی پول نخواهد ماند	of which I shall have no lack
از طرفی مابین آری و نه زن جای نهادن سر سوزنی هم نیست	between a woman's 'yes' and 'no' I wouldn't venture to put the point of a pin
آخرش تو را در چاله آتش فرو ببرد.	will in the end sink thee foundering down to the fiery pit
حالا باید دیگر به خانه بگردم.	I must hasten home now.
حتی به مرد تاریک هم ارتباطی نداشت.	it wasn't even the dark man's doing.
واقعا چیزی جز یک مردک خوب نبود.	he was nothing, in fact, but a fine man.
که عصای حکمرانی را به یک دست و کره عالم را به دست دیگر گرفته بود.	with a scepter in one hand and an orb in the other.
گناهانی را که در هفته مرتکب شده است	in the presence of all, the faults and sins
به او رو کردم. جمی ما من نمیخوام ازش انتقام بگیرم	I don't want to get revenge, OK? I say, turning round to face her.
باز معمولا طرفدار بخشش بودند به شرط آنکه آسیبی به اعتقاداتشان وارد نیاید.	was usually on the side of the formor gesture of clemency without, however, any violence to itsconvictions.
که دیوارهای آن از قشر ضخیمی از طلا	with walls of massy gold
هر کدام مناسب با سجایا و احوال مختلف کودکان و نیز مناسب با هر دو جنس پسر و دخترست.	suited to different qualities, and both sexes.
پاره ریسمانی سیاه را کهنه لته ای که از آن آویخته بود به زیر آورد.	took off a blackened string with a scrap of folded rag attached to it.
وی با عباراتی بسیار شیوا و پرمعنی ایشان را از وضع و حال خود باخبر کرد.	he talked to them about himself very naturally and in very well chosen language.
یعنی لطف فرمودند که خندیدند.	he condescended to laugh at it.
زیرا من لایق نیستم که افتخار هم قطاری با شما را داشته باشم	for I have no right to reckon myself one of so honourable a number
گفت که طلبکارها تعقیبش خواهند کرد	he was being sued
چشم درشتش که به مسافر ناشناس خیره شده بود	her large eyes, which were riveted on the traveller
زیرا که او کارهایی دارد و شاید بزودی سفری در پیش داشته باشیم.	because he has business, and we may go away from here.
مسائلی جزئی که او را مصمم کرده بودند	the events without number that had given rise to his bitter determination
که کالسکه آمد و همه چیز تمام شد.	when the carriage reappeared, and all was over.
اگه دی گه برنگردی اصلا برایم مهم نیست.	I don't care if you never come back.
حال آنکه هرگز از او نیازرده بودم	from which I am sure my heart was wholly free.
با کمی طلا که در لبخند پیدا باشد و به نظر طبیعی برسد.	with a gold chip in the first molar that would impart a touch of realism.
این پیامبر چه درس عبرت مالامالی است!	what a pregnant lesson to us is this prophet!
پس در این صورت امید شما منحصر به فرد است	then you have but one hope
برابر چشمان شاکیان آن را زدند و کشتند و گرفتند و تصاحب کردند	struck, killed, seized, and finally appropriated it before the very eyes of the plaintiffs.
معنی این صداها آن بود که از عمر یک نفر چند روزی بیشتر باقی نمانده است.	it meant that somebody's days were numbered.
بنابراین آن را با روح و با هیجان بخوانید.	for that reason, sing it con spirito.
چند قطره از زهر را از برای خود.	a few drops of her deadliest potion.
با هر دو دست نردبان را چسبیده بود.	holding on to the ladder with both hands
بزودی این حقیقت را به شما ثابت خواهم کرد.	I'll remind you of this, tonight.
اگر خواننده روزگاری پسربچه بوده	if the reader has ever been a boy
با حالتی عصبی به گوشه و کنار دفتر دامبلدور نگاهی انداخت.	cast a nervous look around the office
این گونه چیزها نتوانند در نهان عنصری را در او دچار خطر کنند	it was not in nature that these things should fail in latently engendering an element in him
از صدای طبل و حرکت سربازان به کلی مبهوت و گیج بودم.	quite dazed by the beating of drums and marching of troops
هیچ دلیلی وجود ندارد که از این بابت شرمنده باشم.	I have no reason to be ashamed of it.
در آن دم سخت به هیجان آمده بودم	by this time I was quite excited
دوان دوان از عقب توپ روان شده	leaped out of the window into a cluster of heliotropes and daisies
برای دیدن آن بایستی انسان سر خود را بین یک تیر عمودی و همان زاویه دیوار بگذارد	between which and a large upright beam the observer had to thrust himself
آخر و عاقبت خوبی نخواهد داشت.	I warn you of the consequences.
پاسخش این بود که باز همین کار را خواهد کرد.	, he answered that he should do just the same again.
تو هنوز در فکر آن مرد دیگر هستی.	you are still thinking about that man.
هیچ وقت قبلاً نفهمیده بودم.	I'd never understood before.
تنها با این تفاوت که اینان به صرف اجبار هیئت خضوع به خود گرفته بودند و آنان به نیت چاپلوسی کردن.	only the difference was, that these faces drooped merely to suffer and not to propitiate
مطمئنم که اصلاً متوجه منظورم نشد.	I dare say she did not understand me.
که از حیث اخلاق و مذهب کام لا پاک و منزه باش.	must be known to us as to their moral and religious character.
باز روی نیمکت زیر سایبان دراز کشید	she stretched herself on her couch under the awning
او که همچنان قادر نبود جواب دهد	she, however, being unable or not caring to answer him
آهسته دستش را دراز کرد و زنگ زد.	he slowly put out his hand to the bell and rang.
مانند دست انسان که در دستکش بی انگشت پوشیده باشد.	as the human fingers in an artificial covering.
که در سراسر منطقه برای خوانندگی بسیار هنرمندانه ومیخوارگیش شهرت داشت.	, wellkown throughout the district for his good voice and his drunken bouts.
شش هفت کلوخ به سراپای سید خورده بود و	six or seven clods had taken personal effect
پس از یک ساعت یا اندکی بیشتر دیدم آن طرف صندوق که دارای دو زره بود به چیزی صلب و سخت برخورد.	in the space of an hour, or better, that side of the box where the staples were, and had no windows, struck against something that was hard.
من جرأت نداشتم که طعمه را بیشتر کنم	for a long time I didn't even dare to re bait my hook
ماجرای دختری که قربانی هبوط عشق شده است.	a girl who is the victim of such a change of mood.
دخترک برافروخت و اشکش ظاهر شد.	she flushed crimson and the tears started
تا اینکه نزدیک بود موتور ماشین جوش بیاورد.	the engine was pretty nearly red hot.
تنها و به تازگی ترسیده بودم.	alone and newly scarred.
همین که از این خبر آگاه شد	as soon as he had learned this
در آن جا قهوه در انتظارش بود.	where coffee was already waiting for him
صدای راه رفتنت رو توی اتاق بالا شنیدم .	I've sat here and listened to you racing up and down the floor upstairs.
پاکت در عقب یکی از کشوهای میز تحریر است.	I put it at the back of one of the drawers in the writing desk,' I said.
از بین مو و گوشت و رگ و پی او رد شدند گویی اصلاً آنجا نبودند.	they cut through the fur and fat and sinews like they weren't there.
متأسفانه همه ما امشب کسل خواهیم شد.	I am afraid we shall all be bored to night.
سپس با نوک کفش خود ضرب گرفت	picked out the rhythm with her toe
لرزش بازوانش کاهش یافته بود.	the trembling of his arms ceased.
من نامه بهت نوشتم و ازت تقاضا کردم که برای بازی بینو به استودیو بیایی اما جواب ندادی.	I wrote you and asked you to come to the studio for a beano and you never even answered.
حالا هیچ چیز باقی نمانده است!	now I have nothing.
بعد سیگار تمام شد و من رفتم از فروشگاه سر خیابان سیگار بخرم.	then there were no cigarettes and I went out to buy some at the drug store on the corner.
آنگاه عینک خود را برداشتم.	I then took off my spectacles.
فکر نکن برای این اسمشو گفتم که خودمو شجاع نشون بدم.	I'm not trying to be brave or anything, saying the name
با بیزاری سرم را تکان دادم.	I shook my head, disgusted.
واقعا این حظی است که تا به امروز من نیافته و گذشته را نچشیده بودم.	I never knew
شما هم در این جا گلویم به سلامتی ما تر کنید.	you'll have grog served out for us
اومدم تبریک به گم و زندگی خوشی برات آرزو کنم.	but to wish you long life and happiness in your marriage.
نه کسی که با او حرف بزنند جز خودشان.	or anybody to speak to, except each other.
من فردا ساعت نه اینجا خواهم بود.	I shall be here sharp at nine in the morning.
بعد هر دو را سوار کرده بودند	then took them aboard
قلب هری در سینه فرو ریخت.	his heart sinking.
در را بر روی من قفل کرده بود.	had locked me in.
سپس نوازندگان یکی پس از دیگری داخل شدند	then the musicians came in one after the other
فکر کردم که فقط نگاهی به رودخانه بیندازم	I thought I'd just have a look at the river
سعی کردم از آن حرکت سر در بیاورم.	I tried to understand the motion
اعتمادش را بیشتر جلب کرد.	led him to further confidences.
با فعالیت تمام به تدارک وسایل سفر پرداختند.	all were actively engaged in busy preparation.
کنتس که هنوز بهبود نیافته بود	the countess, though not quite well
فردا از این مکان مزخرف خواهیم رفت.	we leave this vile place tomorrow.
زیرا این قبیل افراد در دورانی که هنوز پسربچه هستند قیافه مردان رشد نکرده را دارند	looking as they do, when they are yet boys, like undergrown men
تصور نماییم باز آن قدر نیست که من برای تو آرزو دارم.	you can never have so much as I wish you
منظورم این است که ما بیش از بیست سال با هم دوست بودیم	I mean, we've known each other for over twenty years.
همچو چیزی در زندگی خود ندیده بودم.	I never saw such a thing in my life.
اما لبخندش نشانه شادی او بود.	but he was positively radiant with smiles.
من چیزی بیشتر از این انتظار ندارم.	I expect nothing more.
هرروز ظهر باید تا باشگاه پیاده روی کنم	walk to the club, every singlenoon
برگشتم و داخل کتابخانه شدم.	I went back and sat in the library.
آنگاه سرخی شرم بر جای آن نشست.	ending in one of her rare blushes.
به طوری که بدنش به لرزه درآمد.	his arms trembling with the strain.
هر سه در آغوش یکدیگر گریستند.	all three wept in each other's arms.
آنگاه از قایق به ساحل آن سرزمین ناشناس درآید و با حوادث و ماجراهای بزرگی روبرو شود که نه تنها شایسته ثبت بر کاغذ بلکه بر الواح برنجین باشد.	leaping ashore in a remote and unknown land has adventures that deserve to be written, not on parchment, but on brass.
صدای اعتراض جغدی را بر بام اصطبلی در میان درختان دوردست برآورد.	elicit loud remonstrance from an owl in the roof of the great pile of stable building away among the trees.
آن را چرخاند تا اسمش رو به بالا قرار گیرد.	carefully turning it so that its name faced upward.
او بار دیگر آن را از زمین برداشت.	he picked it up once more.
آن وقت باید خوب مواظبش باشیم.	then he must be taken care on.
همان لحظه به صوب جبهه عزیمت کند.	would leave for the army that very day that
زیرا با یک گیلاس مشروب حق داشتند یک شکم ناهار خوب و داغ بخورند.	for they did not need to take more than one drink, and upon the strength of it they might fill themselves up with a good hot dinner.
سرعت پروازم بیشتر از آن است که هر آدمی بتواند به آن برسد.	I fly through the air, faster than any human should or could.
عرق آن بیچاره را آهک کرده است!	he's burnt up with brandy.
ولی هیچ یک از آنها دردسترس اونبود.	but nothing within reach.
اینکه پیوسته فریاد زدن با حداکثر نر وهای حنجره	what it is to keep shouting at the top of one's compass
همچون حیوانی وحشی آن را گاز گرفت.	biting at it like a wild beast.
به شدت یکه خوردم و خشکم زد.	I stare back in utter shock.
امپراطور چنان شادمان شده که فرمان داد تا چندین روز این نمایش و بازی تکرار شود.	the emperor was so much delighted, that he ordered this entertainment to be repeated several days.
پنج تن دیگر در طرف دیگر گودال و گودال در میان ما قرار داشت	five on the other, the pit between us
من به هیچ وجه در این فکر نیستم.	I'm not thinking of that at all,
به نظرم بشود بدون خوشبختی و امید هم زندگی کرد.	I suppose one gets a habit of doing without happiness or hope.
هر دو از میان جمعیت رد شدند	the two of them started pushing their way
افکارش را از او پنهان کرد.	veiled its thoughts from him.
حقیقت مطلب اینست که پیدا کردن پارت نر خوب کمی مشکل است.	she can't find young people to play with her.
کسی که خطاکار بوده همان بورژوا بوده و طبق اصول مسلم پلیسی او بایستی بازداشت شده باشد.	it was the townsman who was in the wrong and who should have been arrested by properly conducted police.
این نقطه به علت غروب آفتاب و نزدیک شدن مغرب حالا کاملاً تاریک بود.	quite dark now, for the sun was set and twilight gathering.
قوری آب را روی اجاق گذاشته بود تا قهوه درست کند.	she put the water for coffee on the stove
ولی بهتره که تو داستان عمومی ای رو که گفتیم بدونی نه حقیقت رو.	but you need to know the public story more than you need to know the truth.
صورتم را توی بالش فشار دادم.	I pressed my face against the cushion.
او به صرف دریافت چنین پاداشی خود را مأمور خواهد دانست و چندان راضی خواهد بود	for with this he will consider himself amply paid and fully satisfied
ولی چندی بعد که ادگار با وی بر سر مهر آمد و با هم آشتی کردند رابطه نامه نگاری مرتبی بین آن دو برقرار شد.	but a regular correspondence was established between her and my master when things were more settled.
از اینکه مرا کتک زدید عصبانی نیستم.	I'm not angry that you struck me.
بار دیگر به دوران گذشته بازگشته بودند.	they were back at the beginning.
در همان حال احساس کرد به فعالیت بدنی شدید نیاز دارد.	at the same time, feeling a need of violent exercise
تا به رون اطمینان خاطر بدهد	to say he was sure
که دیگر نتوانست صبر کند	that he did not await
میدانم که منظورتان محبت به من بود.	I know you meant it kindly
اما این جهان به رام توخالی بود.	but this world was a blank.
جلو امد و با او شروع به صحبت کرد و چند روز بعد من مدل عکاسی شده بودم	went up and talked to her, and a few days later I was a model.
من از اون روی که مارو در آن حالت دید ندیده بودمش	I haven't seen him since the handin bra incident.
یعنی احساس یأس از یک طبیعت سختگیر و خودرأی که از آن انتظار تسلیم داشته اما با مقاومت رو به رو شده	the disappointment of an austere and despotic nature, which has met resistance where it expected submission
درست ده دقیقه دیگر بیا به آلاچیق	meet me under the gazebo in precisely 10 minutes
فقط باید بهترین راه خروج از این وضع دردناک را پیدا کنم.	I have only to find the best way out of the difficult position in which she has placed me.
که لازم بود در آن زیر دامنی فنردار پوشیده شود.	which required, very nearly, crinolines and peg top trousers.
همان فیلمی که روز قبل دیده بودیم را پخش کردم و به زودی با آهنگ ملایم اول فیلم به خواب رفتم.	I turned on the same movie we'd watched the other day and quickly fell asleep to the bright opening song.
بدون آن که به پشت سرش نگاه کند	without a backward look.
نزدیک رفت و از او پرسید که کیست	came up to him and asked him who he was
جرأت نداشتم برگردم و چشمان ماکزیم را ببینم.	I dared not look at them.
مجال به پایان رساندن سخنانش را نیافت.	the mention of ourselves being naturally affecting.
من که هرگز عادت نخواهم کرد.	I couldn't never.
امّا آن را در سه هفته خرج کرده است	which he spent or lost in three weeks
ظاهراً به طور کاملاً اتفاقی به میله تکیه داد.	he leaned casually against the barrier.
اما انگار زرهی فولادی تن کرده بود تا ظرفیت تحمل بیشتری داشته باشد.	but with the faint thread of iron, the capacity to bear much.
به نظر من که اون به هیچ کس اعتماد ندا ره.	I'm not sure he trusts anyone at all
اما آنچه من توانستم در این باره تحقیق کنم	but what I have ascertained on this point
درباره اینکه هم به شما شباهت دارم و هم شبیه شما نیستم بسیار حرف زدم.	I was insufferable about liking you, and not liking you.
اما معلوم بود که بیشتر برای به جا آوردن رسم و رسم این کار را کرده است تا برای ابراز دوستی.	as though it were more a matter of form than anything else.
بنابراین باید خودم انجامش بدهم.	I must see to it myself
تو از این بابت باید مدیون من باشی.	you ought to be much obliged to me.
من باید چند دقیقه با تو حرف بزنم.	I've got to talk to you,' he said.
خیانتی که تا به آن دم پنهان مانده بود برملا شد	the guilt which had been until then so skilfully concealed was published abroad
چندین صفحه را ورق زدم و گفتم .	I paged through it.
یا خودشان را وادار ساخته است که وحشت زده به کشتی خود باز گردند.	or drive them back in consternation to their ship.
تخت خواب عروسکش را درون جعبه نهاد	furnished it with her baby's bed
من تا حالا به کسی برنخورده بودم که مث خودم با شه!	I've never met another one before!
چه بسا که همین حالا بیرون در کمین کرده باشند.	for that matter they might be waiting outside the door at this moment.
از مال دنیا. آهی در بساط نداشت.	she hadn't a penny.
همین دیروز صبح برایش وجود نداشت.	yesterday morning she did not exist for him.
امیدوارم دختر مؤدب و معقولی باشی	I hope you'll be a dutiful daughter
مردم همه رفته بودند حوادث را ببینند.	every one having gone off to watch events.
یعین کارهایی که هر عاقلی می کنه.	as proper men should.
با ان چهره و اندام اصلا احتیاجی به مغز ندارد.	with that face and body, she doesn 't need any brains.
در این اتاق ارغنونی قرار داشت که روی آن چند قالیچه گسترده شده بود	there was still an organ in it on which some rugs were piled
چرخی زد و به پشت دراز کشید.	turned to lie on her back.
من باید بفهمم که اون چی گفت.	I need to know what she said.
کوشیدم استوار و بااراده باشم.	I endeavoured to be firm.
خود از اتاق بیرون رفت.	then went out of the room.
برای خریدن مرحمت دیگران احتیاج ندارم روحم را بفروشم.	I need not sell my soul to buy bliss.
اصلاً بیشتر گرفت طرف من تا تو.	but he rather pushed it towards me than towards you.
از حرکت بازایستاد و برگشت.	in time to check herself and go back.
به عقیده ساکنان این ناحیه این اتفاق معجزه بزرگی است.	according to the assertion of the people of theneighborhood.
دیگری در حالی که روی طارمی خم شده بود	said the other, looking over the rails
با کدام پا شروع به حرکت کند بالاخره به همان آهنگ سرود بنای دویدن گذاشت	with which to start, then settled down, galloped past the company
امروز بر دلم بسیار لذیذ و پسندیده است.	is sweet to my heart.
من باید همین جا فرمانده کل را بیابم	I must look for the commander in chief here
از این خودسری ناراحت شدم.	I felt rather uncomfortable.
آن را برداشتم و به او دادم.	I handed it to her.
این مرتبه طاقت را از دست داد.	this time he could not abide them.
با هم به تبادل افکار بپردازند که وقتی آقای رئیس جمهور در پاسخ فلان سؤال پاسخ مثبت و یا در مورد سؤال بعدی پاسخ منفی داد	speculate over what the president had meant when he said yes, or what he had meant when he said no
هرگز چیزی را این طور نخواسته بودم	I wanted this like I'd never wanted anything.
من در مورد اصل بودن این اثر هیچ تردیدی ندارم.	I do not doubt it.
شب را در آن به نگهبانی بایستد.	where he was to pass the night on guard.
وگرنه ممکنه دی گه نتونم تو رو زیاد ببینم.	I may not be able to see so very much of you if you do.
من می دونم که دوری از اون چقدر سخته.	I know how hard it is to be away from her.
یه وقت دوستش داشتم ولی تو رو هم دوس داشتم.	I did love him once but I loved you too.
کنار خانه بزرگی که فقط یک بدنه آن از طرف بام آتش گرفته بود.	came upon the large house that was as yet burning only at one end, just below the roof
ترس ذهنی و اخلاقی از خطای اجتماعی و گناه بزرگی که	mental and moral fear of the great social mistake as well as sin that
امیدوارم تو از آن گروه اشخاص مایل به خودکشی نباشی.	I hope you're not the suicidal type.
مغزش دیگر تاب تحمل نداشت.	that her mind could no longer contain it.
این او را به حرف زدن وادار خواهد کرد.	I will make him talk.
اما مجبورم آن چه را لازم است بگویم.	but I'm afraid I've said my say .
جرأت مخالفت با او را نداشتم.	I hadn't the courage or the guts to say no.
مانند ماهی در گودالی که بر اثر فرونشستن آب از رودخانه جدا گشته باشد	like a fish in a little pool left by the abating flood water of a river
یقین بدانید من از کسانی نخواهم بود که از دیدن شما خوشحال شوم.	I can assure you you will not find me among the number of those who are in any way delighted to see you.
اگر برای ماندن کسی را بکشید آدمکش قلمداد خواهید شد.	you'll be murderers if you kill to stay.
از جایش برخاست و همان جا نشست.	he muttered, sitting up
همه چیز را از پیش فراهم آورده بود.	prepared everything on the evening of theirarrival.
اما دیگر نتوانست چیزی بگوید.	but she could not say more.
بلکه تکرار حوادث هرروز است	for that they had always behaved in this manner together
اعضاء کمیته مشورت میخ وام اول با بقیه کنم.	I want to talk it over with the rest of the committee first.
دویدم رفتم آن طرف و تماشا کردم.	I crossed over to that side and watched them.
در تمام این مدت کتاب را ورق نزد.	during all that time she never turned a page
زیرا هرچه باشد او مادر اطفال تست.	for after all she is the mother of thy children.
دو سوار مجروح شدند و یک نفر جابجا کشته شد.	two hussars wounded, and one knocked out
دستم را به سوی بطری براندی دراز کردم	I reach for the schnapps bottle
از این یک پی بردم که زنی بیش نیسیتی.	by them I know thou art a woman.
که غالبا روی یک ایوان دراز کشیده بود.	who slept on a wide sofa
به اتاق نشیمن رفتم و روی کاناپه ولو شدم.	I walk into the sitting room and slump down heavily on the sofa.
خودت می دونی کسایی هستن که دنبان بهانه می گردن تا روم ون انگشت بذارن.	you know there are those who would love an excuse to point fingers.
تا فردا صبح خستگی از تن بدر کرده باشید	so as to be fresher when day comes
تا از آن سرگرمی هم خسته شدند.	till that amusement grew stale.
اعتراض ایشان به ایجاز و نرمش برگزار شد.	the protest was faint and brief.
ناگهان زیر دوش آب سرد رفته باشد.	stepping through an icy shower.
از آن گذشتند تا به پرتگاه رسیدند.	until they reached the jumping off place
یقه پیراهن او را باز کردم.	I tore open his shirt at the neck
هری عینکش را از چشمش برداشت	he took them off
دلم میخواد همیشه بذاریش تو جیب تا نزدیک قلب با شه.	you'll always have them near you, next your heart, where I want them to be.
ولی دیگر اصراری نداشتند که در وفاداری مبالغه کنند.	but they did not stickle for any exaggerated notion of fidelity.
حضوراً موضوع را برایتان تفسیر کنم.	I think I can explain.
شب ابدی روی دریای تاریک گسترده شده بود	the night eternal over the dark sea
تمام جادوی من بیرون کشیده شده.	I'm magicked out.
او هم از هیچ کاری روگردان نیست.	he is a fellow who would stick at nothing.
ظاهرا هم خواننده و هم شنوندگان را اندوهگین و رنجیده ساخت.	evidently displeased both reader and audience.
بیشتر با مفهوم قدرت کلی او تناسب دارد که آن قسمت اسرار آمیز او را محل هوش و درک او تلقی کنیم.	it seems more in keeping with the idea of his general might to regard that mystic part of him as the seat of his intelligence.
تا اعتراض شما را بشنوم. لذت دارد!	for the pleasure of hearing your outcries!
تا موقعی که تو حرف نزده بودی	not till you spoke up
من هنوز هم اعتماد به ان دارم که خواهم برد.	I always felt certain that I should win.
اگر بشود نام اتفاق بر آن گذاشت.	if, indeed, it did happen.
هرگز معاشرانی چنان ناجنس ندیده بودم.	I never met with such disagreeable companions.
اون موقع باید حتما پیش ما بیائی.	we must have you out.
اکنون که از خلاصی شما مطمئن شدم .	for you are saved.
من اگر به آنجا که در نظر دارم برسم	if I succeed in my attempt
من این نکته را تنها طی دادرسی دریافتم .	I heard it for the first time that day, during the case.
اما آدم بسیار نازنین و خوش قلبی است.	but he, he's an awfully nice and wonderfully good hearted man.
سرانجام شمع خود را در دست گرفت	taking her taper at last.
در جیب نهاد و به خانه برد.	carried it home in her pocket.
با احساس شرم آن را پاک کردم.	ashamed of it, I wiped it away.
در سلک ملازمان علیا حضرت درآید	might be admitted into her service
تا این هنگام تنها یک قسمت از دانشگاه را دیده بودم.	I had hitherto seen only one side of the academy
چون احساس کرد که سگ کنار پایش خوابیده	touching the dog that lay at his feet
اما این شادمانی ظاهری بود نه حقیقی.	but the rejoicing was external and insincere.
من اینجا بودمو نه هیچ جای دیگر.	I was here and nowhere else.
امیدوارم که شما را خلاصی بخشم	be assured I shall save you
تا گرفتگی از صورتش از بین برود	till the cloud should have dispersed
سپس بانگ دل خراش عبور زنجیری را از میان حلقه صندوق شنیدم.	the grating of it as it passed through the ring.
خصوصیت قابل تمجید دیگری هم دارد	I will add this praise
حتی اگر بهترین فرد حرفه ما جای ایشان را بگیرد.	even though it might get the best man in our profession to succeed him.
خویشتن و دیگران را در محراب جماعت مردم قربانی کنند.	for sacrifices and self immolations on the people's altar.
چشم از عروس خود برنمی گرفت.	he did not take his eyes off his bride.
چون بیرون خیلی تیره و ساکت و داخل خانه خیلی روشن و پرهیاهو بود.	so dim and still outside, so full of light and bustle within.
گیتار را از روی غریزه برداشته بود.	had taken the guitar on impulse
مصاحب من یک لحظه هم درنگ نکرد	my acquaintance never paused for an instant
میل دارم همواره شما را دوست داشته باشم.	I want to love you for ever.
تا جایی که امکان داشت با لحنی عادی جواب دادم	I answered her as casually as I was able.
امکان نداشت سه نفر که اشکارا صحیح و سالم بودند همه در یک شب به مرگ طبیعی مرده باشند.	for plainly, three apparently healthy people did not all drop dead of natural causes on the same night.
این من هستم که باید بخشیده شوم.	I'm the one to be forgiven.
چنین وضعی را تحمل نخواهم کرد	I could not bear it, I should kill myself.
بعد آهسته از در بیرون رفت.	then let herself secretly out of doors.
موضوع اسکناس هزار فرانکی را شرح داد.	narrated to him the episodeof the thousand franc bill.
تا زمانیکه نیاز شد آماده باشد	, to be ready in case of need
بدتر از همه این که عین واقعیت را گفته بودم.	the worse, because they touched on the truth.
منطق او اگر اسم مطلق را بتوان روی آن گذاشت بسیار سطحی بود.	that was an empty logic, if it was logic at all.
بلکه با او هستیم . اینست راز ما!	but with him that is our mystery.
چون هر جسد یک تیر خلاص در پس گردن دارد!	because every single corpse has received the coup de grace through the back of the neck.
شما یک خودستایی و تفاخر دلازاری دارید.	you are revoltingly foppish
البته در صورتی که این بچه زنده به دنیا آمده و بماند.	if it should be born alive, and ever come of age.
پیوند من با دنیا به کلی قطع شده است.	I've done with them all.
برگردان آواز را سر داده بودند.	had broken into the chorus
بالای سر قند دان شکسته ایستاد	stood above the wreck
جائیکه انگار آفتاب درآسمان ثابت ایستاده بود ویکساعت از سحر گذشته بود.	where the sun seemed to stand still one hour from darkness
در داخل کشور دودستگی بزرگی در میان ما فرمانرواست	a violent faction at home
گویی هرلحظه ممکن بود بمیرد.	as though he were about to drop dead at any moment.
به خاطر خدا نگذار بفهمند که کسی مراقبشان است!	for heaven's sake don't let them know that they are watched!
در اطاق را بروی خود بسته بوده است.	shut herself up in her room.
معلوم بود که تردید کرده است	as if hesitating
هیئت مدیره مرا مأمور این کار کرده است تا به لندن رفته در جلسات محاکمه حاضر شوم	the board has appointed me me
شمعی در دست داشت کلاید را به درون راه داد.	a candle as was her custom in order to avoid detection as much as possible
جایی که مراسم وهله نخست شخم زنی برگزار شده بود.	where the ceremony of turning the first sod had taken place.
کار را به دعوای حقوقی نخواهد کشاند.	his chagrin wouldn t extend to litigation.
چون چشم ما به هم دیگر افتاد	when our eyes met
حالا دیگر نباید دوست باشند.	doen't ought to know no more.
دلاوری بسیار از خود نشان داد.	particularly distinguished himself.
من خودم بلدم کارهایم را روب راه کنم	I am quite capable of managing my own affairs.
برای مادرش احترام قایل بود	he respected his mother
از او پرسید که آن تلگرام را شخصاً دریافت کرده یا نه.	asked him whether he had received the telegram himself.
اسکار لت بی اختیار به او تکیه داد و دست بر بازویش گذاشت.	she leaned over and put a gentle hand on his arm, in an unconscious manner.
در برابر محراب زانو زد و بخور سوز را آهسته به جلو و عقب حرکت داد.	he knelt before the altar, swinging the censer slowly to and fro.
چون غیر فانی بودن همان همه جا حاضر بودن زمانی است	for immortality is but ubiquity in time
ولی بدون موسیقی زندگی برایم پوچ و توخالی است.	but without music, life would be a blank to me.
این عاشق شدن چه بدبختم کرد!	how unhappy that made me!
به حتم از دید او کام لا در اشتباه بود.	must be put completely in the wrong.
که با تکانی مختصر صدای پول از آن برخاست	which, being shaken, gave forth a pleasant sound, as of the chinking of coin
دختران همین که مردی چنین مسلح را با نیزه و سپر دیدند از وحشت به درون کاروانسرا گریختند	who, seeing a man of this sort approaching in full armour and with lance and buckler, were turning in dismay into the inn
هر دو به پشت روی زمین افتادند.	they both keeled over backward onto the floor
دوباره پشت پیشخوان مغازه برگردم.	I was going back to the old safe existence behind the counter.
همه چیز باید مطابق میل او باشد.	every thing gives way to her.
هردو در یک آن خارج شدند	came out into the passage
به همین دلیل دو نوع اخلاق وجود دارد.	but there are two
پس این از برای این بوده است که جدم به من اسرار داشت که من نیز بخورم	is this the reason why grandpapa has made me share
قبلاً هردو را با آب دهان تر کرد تا اهمیت موقعیت را نشان دهد	previously wetting them both, for the greater emphasis of the action
من به خاطر او حاضرم آدم بکشم.	I would do a murder for the man who would rescue you.
حتی از برای دخترانی هم که میل به ازدواج ندارند.	useful even to a girl who will not marry.
از عاقبت آن کفر گو عبرت بگیر!	beware of the blasphemer's end!
مسافران نسبت به یکدیگر و نگهبان بدگمان بودند	the passengers suspected one another and the guard
بتوانم این وضعیت را قدری بیشتر برایتان روشن کنم.	make the situation rather more clear to you before long.
صدای جیغ مانندشان زیر و گوش خراش بود.	voices so shrill it was like listening to a lot of budgies arguing.
ان قدرها هم که شما فکر میکنین آدم وحشتناکی نیستم.	I hope I'm not as dreadful as you seem to think.
یعنی چند نفر را به دست او بسپارند.	putting him in charge of somebody people.
وقتی احساس طنز دو نفر با هم کام لا فرق داشته باشد فاجعه است.	it's dreadful when two people's senses of humour are antagonistic.
محرکشان آن حس وطن پرستی پنهانی بود	did so from the latent patriotism
همان که نخستین بار در کشتزارش دیده بودم.	the same person I had first seen in the field.
اما توانست تصاویر مبهمی را تشخیص دهد.	but he could make out only hazy images.
شباهت موجود بس چشمگیرتر نیز شد.	the likeness became much more remarkable.
متفکرانه به کودک چشم دوخته بود.	gazing in wonder at the child.
نشان داده بود که جاذبه زنانه از میزان فضیلتش تا چه حد بر او کاگر است.	illustrated the effect of trim femininity on him, regardless of merit.
به نزد کشیش رفت تا اعتراف کند	he made a profound act of contrition before his confessor
اما برای ما این خبر بسیار ناگوار بود.	but it was bad news for us.
مگر اینکه فکربخصوصی در سر داشته باشد.	unless he has something specific in mind.
از ین گذشته آن مرد به من پیشنهادهائی کرد که بر استی متضمن سودی فراوان بود	for indeed he had made me several offers very advantageous
من یک ساعت دیگر با حکم کتبی برای ملاحظه پرونده خانم ملیس و جزییات ملاقات شما با ایشان باز خواهم گشت	I'll be back in an hour with a warrant for your appointment records.
که روی چلیکی در وسط میدان بالا رفته بود	, who was standing on a barrel in the middle of the square.
چند بار من به این مادر سگ گفتم!	so I've told him, I don't know how many times, the son of a bitch.
ذهن آشفته و مغشوشی داشت.	her thoughts unfocused.
فرمان دادند که دیگر کسی نباید چنین جانوری در کاخ نگاه دارد.	an order made, that no such animal should be kept about the palace.
شاید که وی هنوز بیدار باشد.	it may be that we shall find her awake.
زندگی تماماً شادی و نشاط بود.	nothing but pleasant and happy thoughts.
صدای اره و تیشه و چکش از همه طرف بلند بود.	she heard the blithe sound of hammers and saws, noticed scaffoldings rising
اما صورت واقعی او هم عیناً شکل همان صورتک بود.	but his real face was identical to the false one.
بسیار ره ین منت او خواهم بود.	I should be very much obliged to him.
با تکرار ارلاندو خشمگین شد.	when she repeated it he was angry.
ظاهر حال را حجت مگیرید و احتمال را دلیل نشمارید.	I beseech you, do not believe appearances.
کاسه راست شد و به پهلو غلتید.	little by little the shell pulled over and flopped upright.
تمام امیدهایش را از دست داد.	she gave up all hope.
حتی بسیار تعجب خواهی کرد از شنیدن اینکه رعایای تو به تو حضرت علیه خطاب خواهند کرد.	nay, thou wilt be surprised to hear thyself called 'your ladyship' by all thy vassals.
آن دو مشغول خوردن صبحانه شدند	for breakfast without getting lost once.
به اطراف نگاه کرد تا ببیند کسی صدای او را شنیده یا نه.	looking around to see if anyone had heard her
حال که بیرون نیامد یقین بدانید که تا غروب نیز بیرون نخواهد آمد.	but as he has not come out so far, he will not come out to day.
من هرگز قبل از این ثانیه آن را ندیده بودم.	I had never seen it before this second.
مادرش او را بیدار کرد و گفت	the mother said, waking her up.
زیرا کیست که بیاید اینجا و زور بشنود و تحقیر ببیند	for people would soon cease coming there to be tyrannized over and put down
به این توصیه دقیقاً عمل کردم.	I acted precisely on this suggestion.
او را به یک گاومیش تبدیل کنم.	in turning her into a yak!
این فکر راه هشیاری را گشود.	thought tipped the balance toward consciousness
در اینموقع پشت سن سه بار روی یک صفحه فلزی نواخته شد.	behind the scenes something metallic was struck three times
تا در ده هزار سال آینده به اتمام برسان دش.	to accomplish ten thousand years to come?
هنگامی که نام خود را به شما گفتم	if, when I shall tell you of my name,
وظیفه من آنست که ورود شما را اعلام کنم	I have to announce you, that's all.
سبب اندوه رنجیدگی وی آن بود که کوتوزوف او را به شورای جنگی دعوت ننموده	because he had not been invited to attend the council of war
ردایش را محکم به دور خود پیچید	drew his robes tightly around him
یک روز که بیکار بودی به خودت گفتی	your saying to yourself one idle day
که از گیاهان کوتاه و انبوه پوشیده بود	which was overgrown with scrub.
یگانه کاری که شما خواهید داشت نظارت کلی در تزیینات کاخ است و بس.	you would just be your self and look decorative.
فراگیری همیشگی آداب شاگردی خود و آشنایی با طرز رفتار آرام و منظم من لذت ببرند.	in learning their tasks regularly, in acquiring quiet and orderly manners.
در عوض فردا تمام روز با هم هستیم.	I shall have you all tomorrow.
دوباره بدنم منقبض شده بود.	I was rigid again.
سپس لیز خورد و نقش زمین شد.	then slid down it to the floor, a trickle of blood oozing from under his hair.
هر وقت موقع جمع کردن وسایلتون شد	when it is time to pack up.
از آن نامه که جگرم را خون کرد!	it tore my heart!
اما این بیهوشی آخری زیاد نپایید.	but this time it did not last long.
که گویی زیر تنه کشتی غوص کرده است.	as if diving under the keel.
فکر کردم این را به فال نیک بگیری.	I thought you would consider that a good sign
دستور بده میز کوچکی در اینجا بیاورند.	tell them to bring a small table out here
امّا باور کنید که از یک مقلد ماهر است	but it's someone skylarking someone that's flesh and blood
بزرگان را رسم بر این جاری است که مهترشان را به دنبال خود بیندازند.	that it was the custom with nobles to have such persons behind them
