من وقت بیخود ندارم که نذر شما کنم!	I can't talk to you here.
البته شاید فقط تحت حمایت من.	except, perhaps, under my protection.
نظم و ترتیبی هم در کارشان نبود.	without order or discipline.
با عجله مقداری کلوچه مربایی از قوطی بالای پیش بخاری در دهان فنگ گذاشتند.	they hastily fed him treacle fudge from a tin on the mantelpiece
برای بار آخر با وی خداحافظی کند	she wished to bid him adieu
البته فراموش مکن که پسرم را جامه نو و فاخر بپوشانی تا اصل و نسب حقیر خود را بپوشاند و چنان که باید ظاهر شود.	do thou dress him so as to hide what he is and make him look what he is to be.
زیرا دو مرد برای بهتر شنیدن روی میز کوچک کاملاً خم شده	as the two men leant over the small table in their eagerness to hear
احساس پرنسسی و هنرپیشه بودن به من دست داد	I feel like a princess. I feel like a movie star.
نخواست تا از قافله عقب بماند	not to be behind the rest
من این نکته را میدانم خوب هم میدانم	I know. I do know.
هرکاری که لازم باشد را انجام خواهم داد	I will do whatever is necessary
درست همان موقع یک صدای بلند عظیم شنیدم.	just as I heard a massive crack.
باز در خواندن اثر برای اول بار نسبتاخوب از عهده برآمد.	there was not much discipline about it.
اما اخیراً نگرانیم به وسوسه بدل شد.	but of late my worrys become an obsession.
ما به هیچ کار جدی نپرداختیم بلکه آن مدت را با شادی خانوادگی گذراندیم.	we took to no settled employment, but spent it in a sort of merry domestic dissipation.
من خودم را کشتم که اقلاً یکی دو خط برایش شعر بگویم اما فایده نداشت.	I tried to sweat out a verse or two myself, but I couldn't seem to make it go somehow.
روح از بدن پرواز خواهد کرد و برای همیشه زندگی پایان خواهد یافت.	your soul must quit your body and that you will no longer be a man and that this is certain, CERTAIN!
خداوند هر حاجت خیری که داشته باشید به دلخواه شما برآورد!	the wish of your heart be gratified as fully as you could desire
مانند کودکان بعد از تنبیه و بزرگ سالان پس از ضیافت رسمی خسته کننده	like children after a punishment or grown up people after a dreary, ceremonious reception
شاید من بتوانم به تو کمک بکنم.	I want to help you.
حیران شد که ماحصل این شیفتگی چه خواهد بود.	wondering what could be the result of such an infatuation as this.
باید یه ماجرایی به راش جور کنیم.	we just need to find a story to fit it
اما موفقیت چندانی نیافتند.	but they did not get much satisfaction out of him.
بلکه شاید کلاه خود را نیز از کلاه خود تمیز ندهند.	but perhaps never heard tell of them all their lives.
چشمم به تکه کاغذی افتاد که زیر آن قرار داشت و چیزهایی رویش نوشته شده بود.	see that beneath it there lay a sheet of paper with writing upon it.
هیچی بدتر از این نیست که توی زندگی یک آدم معمولی باشی	there's nothing worse in life than being ordinary
زیرا بلندی هر پله قریب به دو گز بود و ارتفاع سنگ بالائی بیش از شش گز.	because every step was six feet high, and the upper stone about twenty.
در آنجا با مرد چاقی که یک چنگه ریش در صورت و یک دست کلید در گردن داشت مواجه شدند.	here they encountered a stout man with a bunch of whiskers on his face, and a bunch of keys in his hand.
شما مرا به اعتراف وامی دارید	you questioned me
امروز سر کار نمیرم. تلفن کردم که مریضم.	I already called in sick at my building.
ولی قادر نیست که دل و جرأت مرا بگیرد.	but of fortitude and courage they cannot.
روی در تابوت حتی پارچه سیاه نکشیده بودند.	there was not even an attempt at a black drapery over the wicket.
امیدوارم امیدوارم همین طور باشد اقا	I I hope so, sir.
این زمان فرصت مناسبی برای گفتگو با هاگ رید بود.	they got their chance.
اما یه جور بود مثل این که دیدم.	but somehow it seems as if I did.
اهمیتی نمی دم که باعث متوقف شدن چیزی به شه	I don't care what it's interrupting.
این چیزی نیست که برای تو خواسته باشند	that's not what they wanted for you
ترس از اینکه او را کسی ببیند	the apprehension of some discovery which would subject her to ill usage and violence
خلاصه نباید هرگز به عملی دست زد که قشون روحیه خود را ببازد.	not let the army get discouraged.
من دیشب هر دو لنگه پوتینم را بیرون در اتاق گذاشتم	I put them both outside my door last night
شاید این دختر او را به عنوانی دیگر که غیر از پدر و فرزندی است دوست دارد	perhaps she loved him otherwise than as a daughter loves a father
چه قدر از وقتشان باقی مانده است.	how much time they had left.
هیچ گاه خواب به چشمانش راه نیافت.	never quite going under completely
تاریکی بر خلنگ زار حک مفرما شده بود.	night had settled upon the moor.
آیا برایمان مهم است و یا اینکه دیگر متوجه چیزی نیستیم.	whether you care much and how soon you cease to care
حتماً طی آن در این مدت کوتاه عملی نبود.	it was impossible they could have accomplished in so short a time.
اما من شخصاً موضوع را تحت نظر دارم و او را در یک فرصت مناسب بازداشت خواهم کرد.	but I will personally keep the subject under surveillance and apprehend her at the appropriate time.
آنجا که هوای تازه مانند شیشه شفاف بود	where keen the air, where pale as glass
سر را حرکت داد شاهزاده!	swayed his head.
اینکار برای من خیلی تازگی داشت.	which she did not do as a rule.
همچنانکه عادت دوشیزگان است شاهزاده خانم ماریا قصد داشت	whom she had dreamed as all girls dream of marrying to her brother
چهارده بازیکن سوار بر جارو به هوا پروا کردند.	fourteen brooms rose into the air.
سیل از دستمان خارج بشود و همه شما را بشورد و ببرد.	the flood would get out of hand and wash you all away.
این من بودم که آوردمش اینجا.	I've asked him to come down here
بلافاصله هر دو را شناخته است.	she knew them both directly.
گرچه شاید باید شما را مستثنی کرد.	though perhaps I ought to make you an exception there.
فعلا لازمه از شما چند تا سؤال بکنم.	I will explain everything to you in amoment.
تا بتواند هر کسی را به آنچه که شایسته و سزاوار است برساند.	so as to give to each one what belongs to him and is due to him.
در زد و داخل شد و پیراهن را به مادرش داد.	she knocked on the door and handed the dress to her mother.
چون سنگ به زمین افتادند.	fell like stones to the ground.
بعد در اطاقی را که وارد آن شده بودند با عجله بست	hastily closing the window shutter of the room into which it led
بعد از این نوبت مشق نویسی و درس حساب بود.	writing and arithmetic succeeded
حتی اگر هیچ کاری هم در این باره نتوانند بکنند	even if they can do nothing to him in the end
دو نامه برایش باقی گذاشت.	he left two letters for him.
اثر ساحری دانا از دشمنان من باشد	if haply its author was some sage who is an enemy of mine
به یاد ندارم که هرگز یک مشتری را راه انداخته باشد.	I don't think I ever remember her serving a customer.
به محض اینکه تلگراف را دریافت کردند	as soon as the telegraphic despatch arrived
یعنی ساعتی دو نفر به اتفاق و به نوبت به عرشه بیایند تا مسلم شود همه چیز طبق دلخواه است.	that is, two and two for an hour, each couple, the crew in rotation shall mount the deck to see that all goes well.
من همیشه در دسترس تو خواهم بود.	I'll always be in easy reach.
اما این دیگر کاری غیرممکن بود	but by then it was impossible.
دلم می خواد واقعا بهت خوش بگذره.	I intend that you shall have it.
چون او هفت تا از دوازده موشک خود را بکار برده بود	for he had used seven of his dozen rockets
قدم سه اینچ بلندتر شد و عاقبت شلوار بلند پوشیدم.	I grew three inches in a year, got my long trousers
من باید ساختمان را دور بزنم مادام.	I may have to circle the block, madame.
می دونم که شانس هم نداشتی یک دفعه برای لجبازی و یک دفعه هم به خاطر پول.	I'll admit you've had bad luck once for spite and once for money.
وی نه تنها قادر به پی افکندن کتاب دوم شود بلکه صد کتاب دیگر نیز بسازد.	as would make up not only one second part, but a hundred.
که میلی به دیدار نواده و اطفال دخترم ندارم.	family joys have no charm for me.
برق ترسی در چشمانش درخشید.	a look of fear came into his eyes.
اما حالا دیگر از آن شلوار معروف خبری نبود.	but they were not the breeches.
ممکن است آن را عوض کنم و تصمیم دیگری بگیرم.	I can substitute some other plans.
مرغی پخته در ظرفی نقره بر روی سر داشت	bearing a fowl in a silver dish on his head
من هم باید احتیاط خودم را بکنم.	I have to take mine.
به جای چشمشان یک تکه نوار سه رنگ گذارده شده است.	whichhave a tricolored cockade for an eye.
اگر چنین تصوری داشته باشد	if he had ground enough to say that.
در ضمن منم از ماجرا باخبر شدم.	I know what's going on.
بدون اینکه ظاهر سازد که ملتفت شده است	without appearing to notice the different impressions
امیدوارم دیشب سرما نخورده باشند.	I hope she caught no cold last night.
امیدوارم استپلتن با خواهرش مهربان باشد.	I trust that he is kind to her.
دهانش را با آستینش پاک کرد	wiping his mouth on his sleeve
این را بیادآورد و ایستاد.	he thought, and stopped short.
به نظر من همین بهترین دلیل بود.	I thought it a very strong proof
در این مورد در سر دانش آموزان هم چیزهایی دیده بودم.	I'd seen some of this in other students' heads.
با شادی به من یادآوری کرد	he reminded me, his voice exultant
یخدان ترا با قرقره ریسمان بلند کنند.	to raise up my chest with pulleys.
از درون کیفش نقابی سیاه در آورد	, she drew from her pocket a very thick black veil
مطمئنم که اون خیلی صمیمی بود.	I'll be bound he is.
پایش را به طرف بهاری دراز کرد	stretching his legs toward the stove.
تا قبل از صبح برنخواهد گشت.	would not be back before the morning.
با وجود این بعدا دریافتم	I heard afterwards, however
بسرعت حکایت زندانی شدن دکتر	rapidly expounded the story of the imprisonment,
با یأس سرم را تکان دادم.	I shook my head in despair.
دیشب تو رو با یه نفر دیدم	I saw you with someone last night.
اما حتم دارم که برای ازدواج با تو خیلی پیر است.	but she's certainly too old for you to marry.
اما تو باید درک کنی مخصوصاً که برای من هم پیش اومده بود.	but you need to realize that those things specifically applied to me.
لکن صندوق بکلی خالی مانده بود	but his resources were now exhausted
او در فاصله دوری از من در ایوان نشسته بود.	sat at a distance under the verandah.
من چندان فهمیده و تحصیل کرده نیستم.	I've got no education.
با شنیدن اسمم از جا پریدم.	I jerked, hearing my name.
چک کردم باز هم درست تشخیص داده بود.	I checked she was correct again.
هوای پشت سرش را لمس کرد.	felt the air behind him.
خیر این تصمیم نهائی را ابتدا مکمیلان که به اتفاق خانم گریفیث به زندان آمده بود به گوش کلاید رساند.	during whichtime, and because of his ultimate decision conveyed to him first byMcMillan
برادرزاده ها و خواهرزاده ها برادرها باجناقهایی که با خواهران عزیزدردانه خانواده های خودشان ازدواج کرده بودند یاران غار حامیان حقیقی یا حامیان برجسته و مهمی که شاید مایه ترس و وحشت آنها بودند.	nephews, brothers, husbands of favourite sisters, bosom friends, trusty supporters or prominent supporters of whom perhaps they were afraid.
من به ناخدا تعظیمی بلند کردم	I made the captain a very low bow
از میان آن اشخاصی که گرد آمده بودند	burst from the centre of the crowd
تازه از خواب بیدار شده بود.	he was standing
بعدشم او نو آورد پیش من.	he brought her to me.
این یک وقتی چنین رفتار ناپسندی از آن مردک روستایی خشن دید	who, on his part, when he found himself roughly handled by this rascally clown
ایشان حاضرند در التزام رکاب او باشند.	they would bear him company.
من از رفتن با وی امتناع ورزیدم.	I refused staunchly.
باز هم آیه دیگری یادم افتاد.	here is another thing that comes to me, just now to say.
پرسید صدایش آهسته و مشتاق بود.	she asked, her voice low and intense.
با تعجب سرم را بلند کردم.	I glanced up in surprise.
پزشک آن با خوراندن معجونی به او سعی داشتند او را هوش آورند.	who was being revived by mediwizards with cups of potion.
اعتراضش نه تنها عصبی بلکه شدید بود.	her protest was not only nervous but vigorous.
بر آن شده بود که قدم پیش گذارد و بی آنکه از جانب مرجعی منصوب شده باشد دار التبلی بی مجوز و نتیجتا بی اصالتی را اداره کند.	choosing to walk forth and without ordination afterany fashion conduct an unauthorized and hence nondescript mission.
که فقط برای شگون داد زده است.	he had only shouted for luck.
جوانکی پاکیزه با کتی نظیف بر تن و جارو به دست به پیش بازشان آمد و به دنبالشان حرکت کرد.	stable boy, spruce and smart in his holiday attire, met them with a broom in his hand, and followed them.
ای کاش بتونم دل به دریا بزنم و دو کلمه باهاش صحبت بکنم	if only he might venture to talk to her more
با سرعت داخل کوچه پیچیدم.	I spun sharply around the corner
تا باعث محروم شدن از مصاحبت با شما شئد مسی و	so far as to deprive me of the pleasure of your company,sir,
تا در شمار مردها درآیند.	that made them men.
اما اکنون آسمان صاف شده بود.	now it had not long cleared up.
حتما پول هم تهیه کرده بود	he would have found some money.
من باید درس خوبی به این آدم پر مدعا بدهم.	I should do it just to teach the stupid idiot a lesson.
جراحت چرک دار یعنی دستگاه دولت.	a running sore, the administration.
در آنجا زنده مدفون ساخت.	where he buried me alive.
اما حتی به صورت اولیه هم به حد کافی توهین آمیز بود.	but even in the original it was striking enough.
بار دیگر میگویم که میل ندارم دفاع متهم را بک سی دیگر واگذار کنم	I repeat it again, I yield to no one the defense of the criminal.
درتمام طول سفر هزار و دویست میلی روی دریای زمستانی همچنان دریا زده بودند.	they continued to be seasick all the way across twelve hundred miles of gale stirred, wintry seas.
هنوز روز به پایان نرسیده بود که دید باز هم قدر او را درست نشناخته است.	while the day was yet young, that he had undervalued.
د راین اثنا هزاران نوع از پرندگان زیبا و رنگارنگ در میان شاخ و برگ درختان به نغمه خوانی و غزل سرایی پرداختند	now gay plumaged birds of all sorts began to warble in the trees
من نیز صاحب مچی زورمند و آهنینم	I have a steady hand and a strong arm
هر نگهبان کار دو یا سه گله رابرعهده داشت.	each drover had two or three droves to look after.
جمعیت بی قرار و وراج در دم ساکت شد.	stirring audience growing completely silent.
که قدری نوشیدنی ضرری برایم ندارد.	one glass wouldn't hurt me.
می خوام تورو به شام دعوت کنم.	I'm taking you to dinner.
به نقطه بحرانی خود برسد	to lift him out of that spellbound
آن وقت حمله کرد به پاچه.	then he tore into that leg.
بطری قهوه ای و صاف یواش روی گرد و خاک سرید.	the flat brown bottle skidded lightly over the dust.
پس بهتر آن است که تا وقتی بدبختی و مصیبتی فرا نرسیده است	it is therefore better to disregard what is painful till it comes
هرچند شاید هیچ وقت معلوم نشود	though it is an imposing mystery and will always remain so, perhaps
من نیز جانی به روشنایی ماه داشتم.	I, too, have had a moonlight soul.
اگر راست باشد که خدمت دیوانی بیش از خدمت سربازی ملک و مال و ضیاع و عقار نصیب کسان کرده است	for though letters may have founded more great houses than arms
ولی من مطمئنم که خیلی ناراحت است.	but I am sure he is very uncomfortable.
هر فلاکتی تحمل کردنی است.	that no misfortune was too great to bear
برای بقیه نتایج شادی بخشی که من به دنبالش هستم	for the rest of the happy result I am looking forward to
ولی او به نوبه خویش با این وصلت موافق است	everything depend on her daughter's inclination.
تا آنکه روی آلواری رفت که در انتهای جاده نصب شده بود و روی دریا بین زمین و آسمان معلق بود.	overhung the deep water at some height, without the least defence.
تا آخر عمرش نزد وی باقی ماند.	stayed with her until his death.
اما حالا چموش و چلاق از آب درآمده.	but now it has turned out vicious and lamed itself.
با این وجود آن قدر مصاحب خوبی بود	yet was such good company
آخه اسماشون زیاد سخت نیست.	it wasn't hard.
جان احساساتش خیلی خیلی قوی است.	he has amazing strong feelings.
شوهر وظیفه سر پیشخدمت را به عهده داشت و زن وظیفه کدبانوی خانه را.	the husband acting as butler and the wife as housekeeper.
در حدود پانزده سال پیش ساخته شده است	it was about fifteen years old
اما زیاد به آن محل نگذاشتم	but I didn't give much heed to it.
که به روی کنت بسته شده بود	which he closed upon the count.
ما ازش ون انتظار داریم که این طرز فکر و بیرون از اینجا هم حفظ کنند.	they have to carry that attitude out into the street with them.
گویا فقط برای او نوشته شده است.	so much so that it seems to have been written especially for you.
که یا در نوانخانه بمانند و بر اثر غذایی ناچیز به تدریج رو به مرگ بروند	of being starved by a gradual process in the house
که به کمک سحر و جادو آن را بزرگ و جادار کرده	how it had been magically expanded
چون فاقد بزرگی و عظمتند لذا در خور توصیف و تعریف هم نیستند.	without any eminence to entitle them to any fame or praise beyond this.
که آیا این همبستگی یا بهتر بگوییم اسارت دوجانبه به خاطر عشق بود	if their mutual dependence was based on love
! من خودم کاملاً توانایی خو نه رفتن رو دارم	I am perfectly capable of driving myself home!
به نظر من در این دنیا هیچ صدای دیگری را هم نخواهد شنید.	it's my opinion that indeed she never will hear anything else in this world.
ای کاش هیچ وقت به اینجا نیامده بودم.	I wish I had never come here
به درودگر نازک کار خود فرمان خواهد داد که زورقی از روی آن طرح بسازد	her own joiner should make it
که در دورترین نقطه انبار بود جایش داد.	which was out ofuse, in the most remote corner of the shed.
ولی باز هم به این داستان اعتقاد داره.	still he will believe.
دخترش به او ملحق شده بود	his daughter had followed him
به سمت دری در طرف دیگر سالن شتافتند	toward the door on the other side of the room
قدم زدن آن روز را هم به یاد داشت.	but he recalled the walk often just the same
ثروت هنگفتی را صرف اقامة دعوا و دادخواهی کرده است.	he has spent a large fortune in litigation.
آسمان چنان رعدی زد که تمام زمین را به لرزه درآورد.	a single crash of thunder made the earth tremble
ممکن است خواهرش از او جدا شود	she might be taken away from him
زیرا برای این کار حکم کتبی دردست داشتم.	for which I had a warrant.
آرام بر روی زمین چمن فرود آمد.	he toppled gently onto the grass with
جواهری به شکل همان خزنده سفارش داده بود	he had procured a jewel made in the shape of that reptile
زیرا قسمت اعظم شخصیت من هنوز در اعماق تاریکی پنهان است.	though there are people who'd be pleased to describe me for you.
شما بر استی سخنان نغزی میگوئید.	you begin to say really witty things.
باز با زور او را روی سورتمه نشاندند.	by main strength put her on the sled again.
دوباره به تالار برگشتم	I wandered back again into the hall.
انتظار دارد که از او حمایت کنم.	expecting my support.
صدایی دورتر به آن جواب داد.	was answered by a fainter howl from a remoter distance.
هوای آنجا هم تقریبا مثل بیرون سرد بود.	also it was nearly as cold as outdoors.
نفسش را در سینه حبس کرد	holding his breath
خیلی مواظب است که چی بگوید.	considering what to say.
پس از آن مجبور شدم چند بار به اطراف اتاق بروم و پرها را از روی زمین بردارم.	I went here and there collecting it.
آن زن خانم بر یلی و کلاید را به اتاقی نه چندان کوچک در طبقه دوم هدایت کرد که اثاثیه زیاد و دست و پاگیری هم در آن نبود.	who led the way to a secondfloor room, not too small or uncomfortably furnished
برای هر دو دلایل کافی دارم.	I have a reason a good one.
من آن را نزدیک تختش بردم.	I wheeled it to his couch.
شش تن از دانشمندان بزرگ دربار همایونی را گماشتند تا زبان مردم آن سامان را به من بیاموزند.	six of his majesty's greatest scholars should be employed to instruct me in their language.
هر دو ملول و افسرده بودند.	they were bored and cross.
از نو به تعقیب او پرداخت.	followed her again.
اون احساس مالکیت نمی کنه که به راش زحمت بک شه.	he don't feel like he's earnin' his keep.
کم مانده بود که نتواند بازگردد.	he was very near never returning.
روز آفتابی بسیار زیبایی بود.	a golden afternoon
تا بتواند پایین تخت بنشیند	so that she could sit down on the end of bed
بعد چند قطعه موسیقی نواخت.	she played afterwards.
مردم فرا رسیدند و هر دو کرانه از تماشاچیان پر شد.	people ran up, both banks were thronged with spectators
یه دفعه مریض شدم حصبه گرفته بودم.	I was sick once typhoid.
برای این که پدر تنها نباشه.	I came with father.
به هیچ کس دیگر هم این را نباید بگویم.	I wouldn't say it to anyone else.
چون که شروع به ثمر دادن نموده است.	since it begins to bear fruit.
همه خاموش بر ساحل رج زده بودند.	stood in silent groups, waiting.
مجدداً به ساحل برگشتند.	then went back again to the beach.
یک لگن سلمانی بسیار نو هم از من ربودند	they robbed me likewise of a new brass basin
به او اطلاع دهید که در انتظارش هستم. نشانی مرا به او بدهید.	tell him where he can find me.
نمی تونم به گم چه بلایی ممکنه سرم به یاد یا چه بلایی ممکنه سر یکی از ما به یاد.	I cannot tell what will happen to me or what will happen to any of us.
شروع کرد به پر و بال زدن در قفس.	it was beating her wings wildly against the bars of her cage.
یک دست لباس زنانه برای خود خرید	bought herself a complete outfit of such clothes as women then wore
هیچ عمل خلافی از من سر نزده است.	I have done nothing wrong.
وآنها هم درگیر این عملیات نبودند.	which was also not involved.
من یک قرار ملاقات دست و پا گیر دارم.	I've got a beastly appointment.
حتی لبانش نیز سیاه شده بودند و	even his lips were black
پیرمرد هم با ایشان بود.	with the old man among them.
سعی کرد به امور خودش بیشتر دقت کند.	she tried to feel an interest in her own amendment
به طرف کلیسا راه افتادم.	I wandered up to the church.
شریک او هم که در پاریس بود مفقود شده.	but my correspondent has disappeared
من در این کار چندان خوب نبودم.	I wasn't very good at it.
تا رسیدند به دهانه راهی که صورت خوشی نداشت و موحش بود.	they came by a gentle declivity to the intersection of two corridors.
که در دل دختر جوان اثر کرد	that the young girl's heart was filled with gratitude.
اما در همه حال ناگزیر است که توجه خود را بکا رهای او معطوف دارد.	but at all events you can hardly refuse it the tribute of your interest.
حالا دیگر خیلی رو آمده بود.	crowned him with his speckled straw hat.
همچنین مقداری بیشتر از جواهرات جهت فریب دادن او	as many more to buy jewels to lure her
رفتارش نسبت به اولیور بسیار بدتر از سابق شده بود.	who used him far worse than before.
ولی از این که ثروتمندی از قشر خیلی بالا و یک کنت اصیل	but it annoys him that a wealthy man of the highest society, and a count
ما را لازم است که به جهت مخالف او روانه شویم.	we had better take the opposite direction, eh?
ده دقیقه بعد بار دیگر دیده شد	after ten minutes it came into sight again
حتی کلمه انبار هم توی آدرس نامه بود.	it had my cupboard on it.
خوشبختانه خو نه سالم موند.	but, after all, he didn't burn the house
پیشروی و حرکت به سوی دیوار نورانی هم موقوف شد	while the adventures toward the far white wall ceased altogether.
اما والاه باس اون سر و صدا رو بند بیا رین.	you must stop dat dam racket!
زیرا غیر ممکن است که قلبی داشته باشی	for it is impossible to have the heart
مبادا کسی دنبالشان کرده باشد.	apprehensively, as if they feared they might be followed.
ملتزمین رکابش نیز به دنبال او حرکت کردند.	accompanied by the suite, walked between the ranks.
فقط یک لحظه او را ببینم!	but a moment!
تا پنج دقیقه دیگر باز خواهم گشت.	I shall be back in five minutes.
موهای سیاه بلندش را حرکتی داد	tosses her long blond hair back
برای آن که به مقصود برسد	that to compass his ends
خواهش کرد که همان اسکناس هزار فرانکی را برایش خرد کند	asked her to go andget this thousand franc bill changed for him
اطمینان ندارم که آن وقت ما حاضر باشیم تو عضو بشوی.	I'm not sure we'll want you then.
دست آخر به صورت داستان گلوله برف در خواهد آمد.	it ends by making a snowball!
اگر در راه اجرای مقاصد عالی شما کم و کسری وجود دارد	if anything be needed for the execution of your purpose
گو اینکه این سپاسگزاری خود یک نوع ضعف باشد.	however weak it may seem.
بعدا هم می تونیم دنبالش کنیم.	I will come to that later.
به ویژه به اندازهٔ کافی بادیگران تفاوت نداشت.	there was not enough difference between them and others.
به او اطلاع خواهم داد که بی درنگ خواهید آمد.	I'll go and tell him you will come directly.
پس اگر این شخص ظریف و آگاه است	if he be a sensible man
نه به این علت که به خیال نوشتن وضع رقت بار خود به کسی باشم	not that I intended to write to anyone about my unhappy lot
حال آنکه شاید هرگز شایسته هیچ یک از این دو نبوده است.	who perhaps had the least title to either.
لیکن مردی که حامل فرمان بود به او جواب داد	to which the holder of the warrant replied that
اکنون کاملاً بیدار بود.	now thoroughly roused.
می تونستم به خاطر این کار ازت شکایت کنم و ربع میلیون دلار ازت خسارت بگیرم.	grinning, my next move would be to sue you for at least a quarter of a million.
فکر می کنه باید گنج پیدا کنیم.	she reckons we've got to find treasure.
صورتش به رنگ گلی باز بود.	his face was bright scarlet.
راز موفقیت ترانچ بول هم در همین است.	that is the TrunchbulPs great secret.
درست مانند هنگامی که در عالم رؤیا هستیم و ناگهان از خواب برمی خزیم.	like visions in a dream when we awake on a sudden.
قبری که هنوز سنگ قبر نداشت	without a tombstone
در نتیجه تمام این نقشه تاکتیکی را یکباره باطل سازد	so render the whole of this plan perfectly worthless.
من با یس مال خودمو خاموش کنم.	I can blow out mine.
من از این همه صمیمیت واقعاً خوشحالم.	I have been seeing their intimacy with the greatest pleasure.
به هر حال او از کسب اطلاعات فنی خیلی خشنود شده بود.	it was still considered improper for a lady to drive a car.
ولی اگر تصور کنید که من شمشیر بدست خواهم گرفت و با سپاهیان دشمن ولو مردمی رذل و فرومایه باشند جنگ خواهم کرد اشتباه محض است.	but to expect me to draw sword, even against rascally churls of the hatchet and hood, is idle.
در همه جا یادبودها بنا کنم و تخم خیر و نیکی بیفشانم!	benefactions on all sides and everywhere.
یا دلیل بر اضطراب و عجله او باشد	or it may point to agitation and hurry upon the part of the cutter.
تا برای قرونه و اعصار آینده نمونه و سرمشق باشند	to serve as examples and patterns for ages to come
ولی منظورم تحت فرمان خودتان بود.	but I meant self command.
بعد نفیر گوش خراشی کشید.	then he uttered a high pitched whimper.
هرطوری باشد برای خودم شغلی پیدا خواهم کرد	I shall be sure to find employment
هوا با طراوت و شبنم آلوده بود.	the air was fresh and dewy.
اگه این حیوون آب نخورده با یس آبش داد.	if the beast has notbeen watered, it must be.
من گاه به گاه به دیدنشان خواهم رفت.	I shall go to see them from time to time.
آن موقع هیچ حدسی نزده بودم	I was not half afraid at the time of its being so,
گویا در خدمتی داخل شده است.	I think he entered the service
چرا که کیتی خود او بود.	that she was himself.
مثل همه جای آن دست شویی خیس بود.	it was as wet as everything else in the bathroom.
زنی که به نحو عجیبی زیبا بود و فقط ریش کم داشت تا در سیرک استخدام بشود.	an uncommon beauty who needed only a beard to be hired by a circus.
باید یک چیزی به شما به گم.	I must tell you something.
خواهشمندم با قبول جائی در لژ من موجبات خوشوقتی مرا فراهم سازید.	I shall be delighted if you will do me the pleasure of accepting a seat in my box.
لیکن بخت یاری نکرد و ما را به لنگرگاه کوچکی رسیدیم که از پیشرفتگی خاک در آب پدید آمده است	but it was our good fortune to reach a creek that lies on one side of a small promontory or cape
که به دوربینش چنگ زده بود	holding his camera.
مبتلا به تبی که احتمالاً تب نبوده.	suffering from that flu that probably hadn't really been a flu.
گریه و زاری را به شدت سر کرد.	she burst into a paroxysm of sobs
من چیزی بیشتر از پول به شما بدهکارم که باید همچنان تا آخر عمر با سپاس گذاری و محبت به شما آن را ادا کنم.	I owe you a great deal more than the mere money, and the rest I will continue to pay all my life in gratitude and affection.
جای زخم فشنگ تپانچه که به شکل ستاره برجای مانده بود.	starbursts of gunshot wounds
اندکی به راست و بعد به چپ حرکت کرد و شیشه را به دست گرفت.	moved a little to the right and then to the left, and took up the bottle.
همین که نظر خود را به خلیفه گفت	he told the canon what he proposed to do
قسم به تمام شیاطین عالم که چنین تهمتی حاکی از رذالت بلکه کمال وقاحت است.	it is a very great slander, or rather villainy.
تعارفی رسمانه از او به عمل آورد.	whom he complimented in such rapid and measured terms.
صادقانه به او گفتم نمی دونم	I don't know, I told him honestly.
ظاهراً پسرک را خجل کرده بود.	appeared to abash the boy
می دونم که پدرت دیوونه شده	I know your father's turned idiot
نه اینکه اصلا هیچگاه با هم همکلام شوند.	not that they would ever speak.
من می دونم برای شام باید کجا رفت.	I know where we can go for supper.
بلند شدم و از اتاق بیرون رفتم.	I rise to my feet and stride out of the room, breathing hard.
همیشه کسی بود که فرمان بدهد	always somebody to give orders
اما نگذاشتند که با خود سلاحی حمل کنم مگر شمشیر	but no arms, except my hanger
از این رو به شق سوم روی آورد.	he surrendered to the third.
نیاز داشت که دوستش داشته باشند	must be liked
من و تو همیشه دوست و صمیمی بودیم.	between you and me there was never anything but kindness.
اما صمیمیت و اخلاص امروز شما مافوق انتظار من است.	but today it has surpassed my expectations.
آن پایین به بارو نت رسیدم.	met the baronet at the bottom.
بروم و به مادام اطلاع دهم.	I will go and tell my mistress.
به این قشون امر شده است که پل را منفجر نمایند و به ما اجازه عبور ندهند.	has been ordered to blow up the bridge and not let us cross?
تا آنکه دختر کوچکش شش ساله شد.	until her little daughter was six years old.
باید چند تار از موهاشونو بکن ین	pull out a few of their hairs
زیرا امکان نداشت باد او را از مسیرش منحرف کند.	because he was less likely to be blown off course.
من باید این قضیه را فراموش کنم.	I'm going to have to call it off.
باز پای او را به میان کشید	he made him his theme.
او حالا باید چقدر از اینجا دور شده باشد!	how far off he must be already!
هرمیون متوجه منظورش شد و دستش را رها کرد.	she nodded again and let go.
من نمی تونم اون ها رو تکرار کنم.	I couldn't repeat them.
از این کار اصلاً پشیمان نیستم.	that is no subject of regret at all.
هیچ وقت مجبور نبودم روی آن کار کنم.	I'd never had to work at it.
غرور سیاه در او سر برداشت.	she had darkened with pride, and her pride
از رختخواب بیرون جستم	I was out of bed
البته در طی این مدت با همسایگان کم و بیش نجیب زاده خود از طریق ازدواج مناسبات خویشاوندی برقرار ساخته بودند.	had kept a good house for three generations, in which there had naturally been much intermarrying with neighbors more or less decidedly genteel.
من هم با درد و رنج به این گریز ملال انگیز و خانه به دوشی و آه!	I thought of drear flight and homeless wandering and oh!
نگاه تندی به سوالن انداخت.	looked at her, sharplike.
با کنجکاوی براندازش کرد.	eyed it curiously.
در این موقع به یاد مقالة شما افتادم که در مجله چاپ کرده بودید.	I thought, too, of your article in that journal
پیش از آنکه بندهای مرا سست کنند مرهمی خوشبوی بدست و روی من نهادند	before this, they had daubed my face and both my hands with a sort of ointment, very pleasant to the smell
من یواش یواش کارترو در میارم	I'll tap her loose.
درس ته که من این لباس را دوست ندارم.	I don't like your gown
جمله اسباب و ابزار تجملی که در عصر و کشوری تجمل پرست شایستهء یک اشراف زاده بود.	all luxuries befitting the state of a marquis in a luxurious age and country.
آخر یک لحظه خودت را نشان بده.	but for one single instant show thyself,
امروز صبح یک دسته موی سفید توی سرم پیدا کردم.	I found half a dozen grey hairs this morning
من سر کاکاسیام که کلاه نمیذاشتم.	I wouldn't shake my NIGGER
اگر نقشه را به هر دلیل تغییر بدهید یا اجرای آن را به تعویق بیندازید جان هیچ کس نجات نخواهد یافت	change the course, or delay in it' for any reason' and no life can possibly be saved
مدتی در خصوص آن فکر کردم.	I had a long think about it.
از این جهت به تمام سوار نظام دستور داده شد تا به جانب راست حرکت کند.	the cavalry were all ordered to turn back to the right.
در حقیقت سبکسریها و خبط و خطاهای آشکارا بیش از عیوب و خطاهای پنهان به حیثیت و شرافت زنان لطمه میزند.	open looseness and freedom do much more damage to a woman's honour than secret depravity.
با تمام احساسی که خودم نسبت به این جریان دارم.	how much I may feel on my own account.
اتومبیلی دنبالتان خواهد آمد و شما را به ییلاقات اطراف خواهد برد.	a car will be waiting to take you out to the country.
خب به نظرم پیرمرد نازنینی است.	an I think he's an old dear!
ولی ما خون پرحرارت شیران در بدنداریم و مستعد بیست نوع حماقت کردن در روز هستیم.	but it is different when you have the hot blood of a lion and are ready to get into a score of scrapes every day of your life.
کلمات برای من تا چه اندازه دشوار بود	how much it has cost me to say the first word.
این دنیای پیر چه هولناک است!	frightful old world.
خود را از جاده بیرون انداخت و در میان جنگل پنهان شد.	it did it dart to one side and disappear in the thicket.
یا این که مدام به هم فکر نکنند.	or without thinking about the other
انگار خیلی هم از تو خوشش آمده.	I dare say she was very much pleased with you.
لری گفت من باید برم خونه	I have to go home he said
پس از آن هم دیگر ادامه دادم.	I went on from that.
یشتر از یک مرتبه که نخواهیم مرد	we can die but once
شاید امشب مزا جا حالتی ندارد.	no doubt he does not feel inclined this evening
سوارکار من به منظورش دست یافت	my cavalier has attained his object
اِما از همین موضوع ترس برش داشت.	this belief produced another dread.
انسداد ناگهانی معامله توسط مقامات مسئول	a sudden block put on the whole deal by the authorities
در اصطبل دلگیر و نموک ایستاد.	stayed in the gloom of the damp stable.
من تو را به جائی خواهم رساند.	I shall make something of you.
هیچ وقت موقعیتی بدست نیاوردم.	I never seemed to get the chance.
خودم را در آب خواهم انداخت.	I should throw myself into the water.
یکی موجودی زیبا و نوزده ساله	one a beautiful creature of nineteen
آماده بود از اتاق بگریزد.	ready to run away
خیال نکنم کسی عارش بیاید با من دوست بشود.	I'm not ashamed of myself as company for anybody.
گرچه خود در بستر مرگ بودند.	though they lay dying.
هری نیز برایش دست تکان داد	who waved back, grinning.
مثل زمین حاصلخیزی که منتظر بذر باشد	dark like the fallow earth that waits for the good seed
نظرم را درباره او خواهم گفت و سپس یک راست از خانه بیرون خواهم رفت!	I'll tell her what I think of her and then walk straight out of the house!
هیچ کس نیست که در تامین بودن آیندة شما تردیدی داشته باشد.	nobody can doubt that.
متاسفم که سفرت بیهوده بود	I'm sorry you wasted the trip.
هیچ کاری جز رخت شویی بلد نیستم.	I don't know nothing but laundrying.
زحمت پاک کردنش را به خودم ندادم.	I didn't bother to swipe it away
حال دیگر خانه جدید من کام لا مرمت و مزین شده است	I have now quite settled in my new rooms .
این نجار خیلی ساده می تواند ترتیبش را بدهد.	the carpenter here can arrange it easily.
جاستین را بیشتر به طرف خود کشید.	pushed it behind his head and shifted her closer in to his side, sighing softly.
تا شش سال و نیم دی گه به اون موضوع قرار نیست فکر کنم	I'm not going to think about that for approximately six and a half more years.
دیگر تام به کلی نومید شد.	his heart broke
من تمام روز توی خانه ماتم گرفته بودم.	I've been moping in the house all day
من اصلاً به آن لیوان نزدیک نشدم.	I never went near it.
مثل غباری که رفته بود.	like the mist had done.
به نظرت خواهد رسید که در استراحتند.	it will seem to you that they are resting.
مارتین پرشورانه گفت حتماً	I will, he said passionately.
این زن اصلاً دهانش چفت و بست ندارد!	there seems no limits to the licentiousness of that woman's tongue!
به کتک زدن او پرداختند.	struck him blows.
او کاغذی را روی زمین انداخت	he cast down upon the floor a paper
اتاق پذیرایی نیز سال ون زیبایی با کف چوبین بود	the parlor itself was asalon with a polished wood floor
که ما چند فرصتی به او بدهیم.	to give him the chance.
ولی این دیگر به ابتکار خودم بود که بچگیهائی نشان دادم.	the bow and the general effrontery were of my own invention.
اگر اربابش لباسی بهش هدیه بده	if his masters present him with clothes
زیرا بیشک عطشی که ما را به ستوه آورده و رنج آن بمراتب بدتر از رنج گرسنگی است.	which beyond a doubt is more distressing than hunger.
فکرکنم ازاین پیشنهاد خوشش به یاد.	I think that's how she'd want it.
چیزهایی را که اسم برده بود یافتم و برایش آوردم.	found the articles named, and returned with them.
تنها آن دو در خانه بودند.	they were left alone.
تنها خیره به او نگاه کردم.	I stared at her.
در عرض این مدت من ترا به دوستانم معرفی خواهم کرد.	during which I will be with you to introduce you to those who are my friends.
من هر چند وقت یک بار با او معاملاتی دارم.	I do business with him from time to time.
من باید شب میان کارگرها باشم.	I have to be among the men at night.
باید مرا آدم فاسد حیله گری بدانی	you must regard me as a plotting profligate
اما این گفته تاثیری بر او نگذاشت.	but these words produced no effect on him.
دلیل آن مطلب را از او پرسیدم.	I asked the reason.
حالا رئیس نوانخانه شده بود.	was master of the workhouse.
هنوز طنین صدایش در گوشم هست	I can hear her voice now.
کشتی تقریباً در نیم میلی جنوب غربی ساحل پست شرقی جزیره از حرکت باز مانده بود.	were now lying becalmed about half a mile to the south east of the low eastern coast.
زیرا همه امید و ایمان مقدسین بدان بسته است.	for in that lies all the hope and faith of the saints.
من قول می دم که کاشف به عمل به یاد.	I reckon we'll find out SOMETHING before we get through.
حال پیدا کردن جانی با شماست.	it is your place to seek the assassin.
مشاهدهٔ او ترا به خنده خواهد افکند.	it will amuse you.
چطور شلاقش را رو من بلند کرد.	how he drags those guns about!
له وین سمت دیگری را نشان داد.	pointing her to a different direction.
تمایلی ندارد در کار آن دخالت کند.	he is not disposed to give his personal attention to the object.
نتونستم جلوی خودمو بگیرم.	I couldn't help hearing
که در این لحظه روی نمود و جلسه دادگاه را از رسمیت انداخت احساسات و تأثراتی در ما و شما آقایان ایجاد کرده است که محتاج به شرح نیست.	which disturbs the audience inspires us, like yourselves, only with a sentiment which it is unnecessary for us to express.
نمی دونم می تونم با شما حرف بزنم یا نه.	I don't know whether I can tell you about myself or not.
تا سرانجام تابوت او در مقبره خانوادگی دفن شد.	until the crypt in the family mausoleum was sealed.
من تو را مثل پسر خودم دوست دارم.	I've loved you as if you were my own son.
البته همیشه دور از چشم دیگران.	always in secret
اما این جا یه چیزیه که مثل خورشی ده.	but there's a thing that could be the sun.
به واسطه باد و تموج هوا	but which was borne upon the wind, reached hiM
زیرا نه وقت بود و نه پول که بتواند آن استعدادها را نشان دهد.	because there had been neither time nor money to bring them out.
با این حال بازم قرضش صاف نشده بود.	it still wasn't enough to cover all his debts.
من واقعا می خوام یه کمی بیشتر انسان بمو نم .	I really do want a little more time being human.
این اتاقی نیست که بشود در آن خوابید.	this is not a place to sleep in.
طوطی صاحب امتیازاتی شده بود	which afforded him privileges
حاضرم شهرتم را سر این حرف بگذارم.	I'll stake my reputation on that.
خودم خیلی دنبال این موضوع رفتم.	I went a good deal into that, at one time.
من تازه از راه رسیده بودم.	I had only just come home
که حمل کردنش خیلی سخت نبود.	which was not very difficult to carry
به زیر کاج بزرگی درکنار رودخانه پناه بردند.	to the shelter of a great oak that stood upon the river bank.
که با توجه به اهمیت شامل و جامع حیات ناخدا از لحاظ توفیق و سلامت سفر ناخدای وال گیری حق دارد	considering the paramount importance of his life to the success of the voyage
پاهایش را روی پنجره گذاشت	put his legs out of the window
دندونام رو به هم فشار دادم.	I ground my teeth together.
نه در روز تعطیل بلکه در وسط هفته.	well dressed on a week day.
این فرشته مانند کسی است که او را از دست دادم	that angel resembles the one I have lost.
دیگ راین کار استثنا بردار نیست	I make no exceptions.
کادروس گفت نه مقصود من شما نیستید	I do not allude to you my boy
که به یکی از اعضای سفارتخانهٔ من اجازه داده شود که در داخل کاخ اقامت نموده	that a member of my embassy staff be permitted to reside inside the palace
ناراحت شده بود چون فیلتر آن را مکیده و با اب دهان خیس کرده بودند.	got annoyed because they had sucked it and wet the filter with spit.
من پسربچه نسبتاً زشتی بودم.	I was rather an ugly little boy
ولی داخلش چنان زیبا بود	but inside there was a harmony of beauty
دلی تیره و روحی تهی از نور درون.	a dark heart, a spirit lacking inner light.
امشب فقط قواعد بازی رو بهت یاد می دم	I'm just going to teach you the rules this evening
من لباس رسمی فرانسویان را همراه دارم.	I have brought a spare uniform.
صدای پاهای یک دوجین آهوی کوهی که در حال فرار کردنبودند.	the soft step of a deer dozens of feet away.
به او کمک کرد تا سوار شود.	assisted her into the buggy.
حتما دارای یک ابر قدرت بودم!	I must have a superpower!
اگر پشیمان هستید هنوز وقت باقی است.	if you repent there is still time.
برداشت و با دقت نگاهش کرد.	took it up, and examined it very attentively.
آری آری هم او خودش است که مدتی است	yes, it is indeed he who has so long
اما بیم و امیدم هر دو واهی بود.	both my fear and my hope proved ill founded.
بار دیگر به شکار شبانه پناه برده بود.	he had another outbreak of his nights as a solitary hunter
همچون مردی از او لذت بردم.	as a man I found a pleasure in her
او هم به شکلی که شده تلافی کند.	she would get her own back in some way or another.
اما من هرگز جر و بحث و دعوای شما دو تا رو ندیدم	I've never seen you argue.
جایی که ملازم بیرون رفت	where the servant had gone out
با لج صدای او را خفه کردم.	I shut her out viciously.
گویی از زمین سبز شده بود.	you'd have thought he'd just popped out of the ground.
من می دونم کی بهت دستورمیده.	I know who gives your orders.
دلایلی به جهت دفاع از آن اقامه کرد	argued in the defence of it
یحتمل که باطنا اوقاتش تلخ شد	he might feel perhaps annoyed
عصبانی شدم و او ترکم کرد.	I grew angry and he left me.
شما خودتان قضاوت خواهید کرد.	you shall judge for yourself
شاید بتوان گفت که اساساً رسیدن او به سن نه سالگی تنها در اثر همین روحیه بوده است.	perhaps to this circumstance may be attributed his having any ninth birth day at all.
هیچ جایی برای رفتن نداشت.	with absolutely nowhere to go.
می دونم که از نظر شما ایرادی ندا ره	I know you haven't
در وسط دریا برگشت و غرق شد	it capsized and sank.
منظورم لذت جسمانی و شهوانی است	I mean in heartless, sensual pleasure
صفحات آن بر اثر ورق زدن زیاد و دست به دست گشتن کثیف و سائیده شده بود.	the pages were soiled and thumbed with use.
من در نخستین ده که به آهنگری برسم آن را مرمت خواهم کرد	for I will set it to rights at the first village where there is a blacksmith
در آن موقع حال من خوب بود.	I was perfectly well.
احساسشان بسیار قوی و جلوتر از واژگانشان بود	their senses are very sharp and much in advance of their vocabulary
یعنی ان قدر کشش بدیم تا دوره دادستانی می سون تم وم به شه.	if we want to until he's out of office.
بگذار از اول برایت تعریف کنم.	I'll tell you from the beginning.
به وزن اضافه شده واکنشی نشان نداد.	she didn't react to the added weight.
به هدف خودم در هایبری رسیدم.	at last I was not disappointed either in the object of my journey.
من فریاد زدم و او پوزخندی زد	I cry, and flinch as he gives a tiny half smile.
جوان جواب داد که شغل و حرفه او تحقیق در السنه و ادبیات قدی مه است	to which he replied that he was by profession a humanist
راستی من حال انتظار ترا نداشتم.	I did not expect you today
حالا شما پنج لیره بدهکارید.	now you owe me five.
عناصر بسیار زیبا و بسیار مبتذل.	beautiful and vulgar at the same time.
من هیچ حقی نداشتم که بپرسم.	I had no right to ask.
زیرا کالسکه بی چراغ ممکن بود به دست پلیس گرفتار شود.	as it would be foolish to attract the notice of the police by too many precautions
راستی تف به این قدرت و ثروت!	I wish for no virtues of that kind.
دیوار محکم پشت سرشان بسته شد.	the wall thud closed behind them
بدون اینکه نظر من را بخواهند و با من رایزنی کنند	who have not consulted me
صورتش را به دست شاهزاده آندره نزدیک کرد و آرام و ملایم آن را بوسید.	bent her face over it and began kissing it, just touching it lightly with her lips.
لبخندی با نرمی لبانش را زینت داد.	he shrugged and laughed softly.
من باید خود را بدست خود بدهم	desire most to punish with my own hands
اما توده سفیدی که زیر آفتاب بر آب شناور است	nevertheless still shows the white mass floating in the sun
بایست بروم ببینم چه خبر است.	I'm a going to see what's going on here.
مطمئن نیستم که باید چه کار کنم.	not sure what to do.
موقعیتی که در اذهان عمومی دارد	he had long held in public opinion
باید بلافاصله راه بیافتم.	I must go off at once.
کل این ماجرا از نو درمی گرفت.	all spun round another way.
از آنجا که زنی شریف و محتاط بود	as a discreet and right minded woman would be
تموم شب ناله کرد و بعد از ظهر فر داش مرد	she groaned all night, an' she died the next afternoon.