باز اِما به خودش دل خوشی داد که به هر حال کلی باعث رضایت و شادی آن دو نفر شده	she could not but flatter herself that it had been the occasion of much present enjoyment to both
چیزی روی سرش انداخته بود	her head covered
که من به جای اینکه با گلوله این دیوانه در بهداری افتاده باشم با چه کسی این گفتگوی مطبوع را دادم.	whom I have the honor of conversing so pleasantly, instead of being in the ambulance with that maniac's bullet in my body?
ولی تصمیم گرفت که این کار را نکند.	but decided not to.
یعنی من که رئیس تو نیستم.	you know, I'm not your boss.
من تا حالا توی مدرسه شلاق نخوردم.	I never was whipped in school.
موتور را خاموش کردم و پیاده شدم.	I shut off the engine and got out.
همین برای شما کافی است.	NOW are you satisfied?
خواهرت هم موافق است.	your sister thinks so as well as I.
ولی هنوز وقت گرفتن آن فرا نرسیده بود.	but he mustn't catch it yet
همیشه صبور و در حقیقت محرم بازرگان است.	always patient and in fact is the merchant's confidante.
اعلیحضرتا تا این را هم گمان ندارم	I think not sire
خیلی خوشحالم که آمدید.	I am so glad you are come.
خیلی ممنون میشم که مؤدب باشی و زبونت رو نگهداری.	I'll thank you to keep a civil tongue in your head.
فقط میخ وام اگه میشه به هم بگی.	I just want you to say if you can
جویده جویده گفت	he said vaguely.
به سوی تخت رفت	advancing to the bed's head
نگاه من به فنجان چای دوخته شده بود.	I gazed steadily at my plate.
چنان که گویی درباره آن به بحث مشغول بودند.	as if he were considering that.
خیلی از مردهای ما را فرو برده.	I have seen it very cruel to some of our men.
خیلی اتفاق افتاده که من بر سر موضوعی عصبانی شدم اما هرچه بود در همان یکی دو ساعت فراموش کردم	I lose my temper on the slightest provocation, flare up, and then it's all over.
سرش را روی کاپشنش گذاشته بود.	his head pillowed on his jacket.
به پانسیون رفت و ناهارش را خورد.	he wandered off in the direction of his room
فنجان به اندازه پوست گردوست	a cup not so big as a nut shell
نمی تونم قبول کنم	I can't possibly keep them.
زیرا که حبس مرا رام و منکسر و نابودم ساخته	captivity has subdued me
که موجب بدبختی است.	it will bring bad luck.
تو اما این تراکتور مال او نبود.	but it was not his tractor.
آمدم بگویم که باید دست بردارید.	I have come to tell you that this must end.
نرسیده فروخته می شن.	I can sell them fast as I get them.
ولی این بماند بین خودمان.	but this is quite between ourselves.
ناگهانی هار شده	maddened by a sudden attack of rabies
چون او است که علت اصلی کتک خوردن ما بوده است.	for he was the main cause of all this thrashing.
ولی باز هم بهتر است تو دخالت نکنی.	but, however, you had better not interfere.
شخص دیگری در این مسایل دخالت نکند.	that no other spiritual aid should be called in.
یک خواهش غیر قابل بیان	a wordless plea
روزی که حس کرد حالش بهتر است شارل کوشید زیر بازویش را بگیرد و او را در باغ بگرداند.	one day, when she felt better, he tried to take her, leaning on his arm, for a walk round the garden.
نخست آنکه با شخصی مثل جنابعالی آشنا شدم	the first is that I have made your acquaintance
این منم که باید شکنجه به شم نه اونها.	as he was certain of being tortured.
دو دست بر سینه نهاد	crossing her hands upon her bosom
اما اون می تونست مردم رو مثل یه کتاب بخونه	but he could read people like a book.
بر عکس باعث تشدید و تقویت محبت در قلبش شده .	on the contrary, that change can only intensify love in his heart.
بعد نو لرزانی کوپه را روشن کرد.	a shivering light filled the compartment.
به اتاق کار ورانسکی رفت تا او را از تصمیم خود بیاگاهاند.	she went into his room to announce her determination.
برگشت و پرسید کسی نخواهد آمد که راه را برایش روشن نماید.	looking round, asked if somebody would light him down the dark stairs.
زمان در هنگام غیبت او از خانه آن را بیشتر تقویت کرده بود	time had only strengthened in her absence
او را غرق شادی کند.	overwhelm her with joy
تکان هم نخورید.	do not move!
هرچند که در این مورد از راه راست کمی منحرف شده.	in spite of this one great deviation from the strict rule of right.
من به شما آرزوی خود را گفتم.	I have told you my wish
بارو نت بینوا را دنبال کرد	pursued the unfortunate baronet
من این حرف را خودم شنیدم.	I heard him say so.
آن کرکس همان موجود است که او خود آفریده است.	that vulture the very creature he creates.
در ساعت معمول هر روز از خواب برخاست	rose at his usual easy hour the next morning
باز یل اعتراف کرد که این نقشه خود را با تنی چند از دوستان جا نیش در میان نهاده بود	he confessed, it is true, that he had confided his idea to some of his friends
مگر نه این که خودش گفته بود	if he himself had said that
در همان ثانیه تسلیم نخستین تأثر و احساس خود شد و شتابان به جانب کالسکه رفت.	following his first impulse stepped instantly and rapidly toward the coach.
سپس صدای خمیازه آدمی که بین خواب و بیداری در تقلا بود بلند شد.	then an indistinct muttering, as of a man between sleep and awake.
سپس دوباره چشمانم را باز کردم	then open them again.
آخه او خاله ندا ره.	because he hadn't any aunt.
مثل آینه صاف بود.	the water was a flat calm.
داخل اطاقک را نگاه کرد.	looked into the cabin.
با وضعی بسیار احتیاط آمیز رفقای خود را عقب کشید.	drew his companions back again, with the greatest caution and circumspection.
گفت این کار را بهتر از من بلد است و بلد هم بود چون به زندگی در اردو عادت دارد.	he said he knew how better than me and he did, too, because he's used to camping.
که به او خورانده شده بود	administered to a young girl!
ریاست روحانی به مثابه یک منظومه شمشی است که در حرکت باشد.	it is a whole solar system on the march.
دیگر هرگز در این کشور مزاحم کسی نخواهد شد.	he will never trouble anyone in this country again.
صدایش در راهروی خلوت پیچید.	his voice echoing in the dark passage.
هم تو اندرون و هم در بیرونی.	inside and outside.
به جای اینکه از در خارج شود	instead of leaving the door fastened
بیمار اطاعت کرد و ساکت شد.	he obeyed her shout and was silent.
در دوباره برای کنت باز شد.	it was again opened for the count.
در اینجا ارلاندو ازاطناب کلام آن بی حوصله شده بود و گفت	but here she grew impatient with this legal verbiage, and said
اهمیت بسیاری برای آن قایل بود شنید	which he had so impatiently awaited and to which
آرزو دارم که هرگز نروی.	I wish you wouldn't.
آن سه ملاح چنان به سرعت او را به بالای سر وال رساندند	the hoisters ran him high up to the top of the head
به این نتیجه رسید که ساده بودن هدفش ضامن موفقیت اوست.	reflected that the very apparent insignificance of his aim would help him to success.
وی لفور نه گوش به حرف او داد و نه به طرف او نظری کرد	he had neither listened nor heard.
جعبه گیتارش دریک دست و انگشت شصتش دردهانش بود.	his guitar case in one hand, his free thumb in his mouth.
از ای نرو ناگزیر بودند که معاش خود را در جاهای دیگر تأمین کنند.	therefore they were under the necessity of seeking a livelihood in other places.
اگر با دو شیشه شراب کهنه به مداوای آن نپردازم	unless I doctor it with a couple of sups of the old stuff
سپس او را برای استحمام و تراشیدن موی سر به دست دو مأمور سپردند.	his name and crime entered in the books himselfassigned to two assistants, who saw to it that
همچنین به سبب خویشاوندی نزدیکش با این خانواده تصمیم گرفت	as well as his high blood relations with his family
بعد هم جستی زد و چهارنعل به طرف مزرعه تاخت.	the next moment she took to her heels and galloped away into the field.
محو تماشای او است.	I fix my gaze on it alone
تا شما سخاوت دل کریم خود را به ایشان نشان بدهید.	that you may show the generosity of your kind heart.
پلکان را با آهستگی غیرقابل تصوری پیمود	ascended the stairs with incredible softness and silence
تا پیش از آن که شب بر سر دست درآید و ما را در این بیغوله غافلگیر کند به راه خود برویم.	let us go hence ere night come on and surprise us in these wilds.
این منم که او را خواهم کشت.	I'll kill him.
حال به ببینم اگر من عقد را امضا کردم	I wish to know if, in demanding my signature
بی آنکه این مراقبت را برملا کند.	with as little appearance as possible of doing so.
نفس عمیقی کشیدم و از جایم بلند شدم	I take a deep breath and stand up.
تا نفهمم نخواهم رفت!	I won't go without finding out.
از جایم تکان نخواهم خورد.	I will not stir.
ساعاتی جهنمی را پشت سر گذاشتم.	I've had a hellish time.
چگونه ما بر سر آن کشمکش داشتیم	how we had a dispute about it.
پی وتر آلکزاندروویچ میل ندارد با من باشد و هر گاه من بروم او به طور قطع خواهد آمد.	this gentleman doesn't want to remain in my company or else he'd come at once.
صدای پای پدرش محکم و یکسان.	her father's firm and equal.
چون انصاف نیست که من بخوام تو اینجا باشی.	because it's not fair for me to want you here.
نظری به شوهر کرد که تا قعر ضمیر او را ملاحظه نمود	endeavoring to read her husband's inmost thoughts
ولی هیچ قدرت جادویی ندارن	but hasn't got any magic powers.
بدبختانه سیگار نیست.	I'm afraid there are none.
آن گونه که هیچ فردی را به جز نرهای جوان نیرومند که میان وال گیران به ورز و معروفند با خود ندارند.	those mustering none but young vigorous males, or bulls, as they are familiarly designated.
اما سیاه کفنی پشمین داشتند که برای تابستان سنگین بود	but in ablack shroud, of woollen, which was heavy in summer
زیرا بیمار بود	because she had been ill
با خم شدن روی این سوراخ تاریک خطر سرنگون شدن در آن هست.	there was the danger of falling over if you looked down into the abyss.
چه عزم جزم کرده بود	for he had made up his mind
من به او توصیه کردم.	I have advised him to do that.
تا حالا بهش دستبرد زده شده است	the ever got jacked
می شه سرشان را برید.	to get rid of them!
من میل دارم از حقیقت آگاه گردم حقیقت!	I want the truth, the truth!
مسابقه آغاز شد.	the racers started.
گلویم را صاف کردم.	I cleared my throat.
ضربه نهایی بر وقایع در دست اوست.	has the last featuring blow at events.
حال آنکه دیوانه اختیاری هر وقت که خواست از حال جنون بیرون خواهد آمد.	while he who is so of his own accord can leave off being one whenever he likes.
هر دو جوان به فکر همین موضوع افتادند.	was passed by the two young people in schemes on the subject.
همان جا که سیدنی چندی پیش ایستاده بود تا لوسی را بر سنگفرش پیاده رو در حال قدم زدن مجسم کند	where he had paused in the dark not many hours before to picture to himself on which of the rough stones of the street her feet had trodden
او پنهان شده بود تا بگیرد.	he hid himself to weep.
دروازه به شدت پشت سرش بسته شد.	the gate firmly bolted behind him.
ناگزیر دخترک وارد دریا شد تا عرق تنش را بشوید.	so she went into the water to wash off the sweat.
هیچ وقت حرف زدن او را ندیدم.	I never heard her speak
ولی سوگند یاد کرده بود که تا آخرین نفس در مقابل نفس خویش ایستادگی کند	but it appeared that something new had come to birth in his soul as though he were vowing to himself that he would bear this trial.
گرچه من از ین قیاس دور و دراز او چندان خوشم نی آمد.	although I did not much admire the conceit.
جبهه را ترک کردند	deserted from the front
حتم دارم که مست کرده بود.	I told you he would.
ثروتی را از دست داده	drawing a fortune a title
در آنجا راننده جسر در انتظارش بود تا از خندق عبورش دهد.	where a ferryman was waiting to take him across the moat.
تو این را ببند.	do you shut it.
او به انتهای راهرو آن سمت رسیده بود	he had reached the end of the farther corridor, and
از آنجا دیدم که او بر فراز پلکان پرچین برآمده و رو بس وی کشتزاری که در سمت راست است کرده است	whence I saw him at the top of the stile looking back into the next field on the right hand
پس چیزی نگفتم.	so I didn't say anything.
باید حسابی را با تو تسویه کنم.	I'll have this out with you.
بخواند که طی گذشت سی سال زندگی در بین زنان و مردان آن قدر بر قلب و ذهنش سنگینی کرده بود.	deciphering of those scored parchments which thirty years among men and women had rolled tight in his heart and brain.
او را با اتومبیل به خانه رساند.	drove her home.
البته فقط یکی دو تا از اونها رو برای تفریح راه میندازه.	I doubt if he's gotten that far yet in fact, I'm sure of it.
من هم خیلی خوشحالم.	I'm very glad.
آن طوطی را از بال و پر درخشانش باز شناختم	thought I could make out the bird by her bright plumage
مشغول حفظ کردن اشعارش شد.	went to work to get his verses
شریک او در مداوای بیماری خود باشد.	be represented as a partner in his own cure.
هیچ حالش را ندارم.	I am out of spirits.
شما آقایان هم بنشینید!	you, gentlemen, bring yourselves to!
پیرزن چون وارد اتاق شد	the old woman coming into the room
باز هم نشان بدهد خبر ندارد بکی آن جاها است.	to avoid betraying that he knew she was about.
از بس که آدم جذابی بود.	he is so very agreeable.
من خودم اینو می دونم.	I know that well!
هرگاه اطلاعات شما نشان دهنده خوبی و خوش ذاتی طفل بود	if it had been favourable to the boy.
حتی یک گوشه زیر جامه او را هم نجنبانده بود.	had not so much as altered one angle of his vest.
من خودم یک فکری دارم که کاملاً بک ره.	I've got a notion, and I think it's a sound one.
سپس دو دختر جوان	then the two young girls
آن را در جیبش گذاشت.	put them safely in his pocket
همان گذشتهٔ اندوه یاری که برایش بسیار کم با شادی همراه بود	that sad past, which had been very niggardly of joy for her
به طور کلی من به کودکان علاقه مفرطی دارم	but I am always fond of children.
مثل بادسنج روی بام	you're like the weather cock on a roof.
بر روی جاده نشست.	sat down on the trail.
راستوف پس از آن قضیه دیگر به امور مالی و اقتصادی خانواده خود مداخله نکرد.	said he to himself, and after that he did not meddle in business affairs.
سرم را با تأسف تکان دادم. نه.	I don't know,' I said
این کتاب به هم کمک می کنه	it would help me
نه از برای من بلکه از برای خودت.	so far as it will affect you.
از جا پرید و برافروخته و لرزان جلو ما ایستاد.	stood, livid and trembling, before us.
یواشکی به طرف بار مخصوص مهمان رفتم و یکی دو پیمانه سر کشیدم.	I sneaked off to the private bar to have a pint or two before dinner.
از سربالائی بالا رفت و از نظر ناپدید شد.	went up the hill and out of sight.
به محض اینکه به سلامت از اینجا دور شد بهت می گم	I'll tell you as soon as she's safely away,
حتی زمانی که موهای روی بازوانم شروع به فر خوردن کرد.	even as the hairs on my arms began to shrivel.
من نبردمش اونجا که بکشمش.	I didn't go upthere with her with any intention of killing her.
خیلی زود معلوم شدکه احساسات مشابهی دایم.	our coincidence of feeling was soon discovered,
سرم را تکان دادم.	I shook my head.
حالا به وضوح همه چیز یادم آمده بود	I can remember it vividly now
اما تعجبی که آن تعریف ایجاد کرد	but the surprise it occasioned
دست خود را روی پیشانی عرق کرده گذارد.	he put his hand up to his forehead.
هیچ خوب نیست که در چنین شبی شخص سفر دریا نماید	not a pleasant night for a dip in the sea
من ترسیدم که زیر باران زنگ بزند یا سرما بخورد	I thought it might get rusty with the rain, or catch cold
حواس خود را همه به بافتن داد.	became absorbed in it.
نهایت سعی و تلاش خودم را کردم که عین یک مدیر عامل بازاریابی آرام به نظر برسم	I'm trying very hard to look like a relaxed business class top marketing executive.
باهاش تشک درست کنند!	we'll have enough of it to stuff a sofa!
موهای بلند صورت هرمیون از بین رفته بود	all the hair had gone from her face
زیرا اصلاً کسی تا به حال او را تربیت نکرده بود.	because nobody had taught him.
بلکه برای آن که نشان دهد بوالهوسی او را در مورد وزغ به فال نیک گرفته	but in order to show that he took her levity with the toad in good part
در این جمعیت هرگز بیش از پنج مرد نبودند که یکدیگر را بشناسند.	there were never more than five men who knew each other.
که تو این قدر سنگدلی که این همه به من عذاب دادی.	you could be so hard hearted as to let me suffer so.
اکنون ساعت دوازده در شرف فرا رسیدن بود.	twelve coming on to pass away.
یک دستم را بلند کردم تا عذر خواهیش متوقف شود.	I raised one hand to halt his apology.
یکی دو آه بلند کشید	gave a long gasp or two
همین قدر تا هیجده سالگی!	when I am eighteen!
ولی برای مقام شخصیت صادقی مثل او زیاد است	there is still more due to the character of an honest man
بندهای آهنین از یک طرف تا طرف دیگرش بی گسیختگی امتداد داشتند.	the iron bandstraversed it from side to side without any break.
او را در سراسر نگه داشتند و خواستند تپانچه را از دست او بگیرند.	stopped him in the vestibule and tried to take the pistol from him.
پس از او تمنی کردم که حوصله کند تا داستان خود را بگویم	I begged his patience to hear me tell my story
چنانکه شرح آن در جای خود بیاید	after their manner, as we shall describe in its proper place
منظورم این نیست که از آن نوع مردانی هستم که به زن توجهی ندارند.	I don't set up to be one of those men that don't care about women.
اجرای سوت مانندی که فرد شور و شوق و امیدواری فراوانی در آن به کار برد.	a wheezy performance, into which he threw much ambition and an irrepressible hopefulness.
اما این دفعه همه عقب نشستند.	but this time all had come.
بسیار دقیق و کامل.	meticulously and very properly.
مردی که هرگز ندیده بود.	whom she had never seen
گفتم شاید کار مهمی داشته باشد.	I thought it might be important.
روحم تشنه یک جرعه آب زلال و خالص بود.	my soul thirsted for a pure draught.
سرش را نیز بسته بودند.	his head was bandaged with a linen cloth.
مخصوصا اگه آدم باسواد شکمش سیر با شه.	especially if the educated ones have their stomachs full.
مطمئن نبودم تو باشی.	I wasn't sure it was you.
مسی و ما بوف شمع بود اما کسی نبود.	he had been the candle and not the some one.
من باید نقایم را بردارم اگر گرمم شد.	I shall take off the veil if I get too hot.
به نظرم بهتر است نامه را همین جا تمام کنم و کمی باسلق درست کنم.	I think we'll stop now and make some fudge.
همه کامیابیش این کلام یکی از سکنه حومه بود	the whole success which he produced is contained in this remark of aninhabitant of the faubourg
من هم امیدوارم تا حدود توانایی برای رضایت و آسودگی شما بکوشم.	I hope I shall do everything to your satisfaction.
کلیدی نقره از جیب بیرون آورد	took a silver key from his pocket
هیچ وقت طلاق نخواهم گرفت.	I'll never divorce him,
اگر هم نشده باشد بزودی خواهد شد.	there will be.
مثلاً مثل مراسم رقص که برای من احمقانه بود.	like the prom, for exampleseemed silly to me.
با این همه هنوز یک روشن روانی کامل در چشمانش داشت.	still, there was a perfect lucidity of soul in his eyes.
من قصد دارم وسیله آرامش خیالت رو فراهم کنم.	I merely wanted to set your mind at ease.
یعنی به طریقی که بهتر از آن ممکن نبود دلت را از سینه بیرون آوردم	I took out your heart as well as I could
همسایگان طراوت خود را از دست داده	every face in the neighbourhood worsting
آهسته گفت که شاهزاده خواب است و شتابان در را بست.	reported in a whisper that the prince was sleeping, and hastily closed the door.
به دلیل بدنامی او به عنوان یک قمارباز و شیاد	basing his refusal on the ground that the applicant was a notorious gambler and cheat
صدای پایی شنیده شد	there was a scuffling outside
صدایش در گوش خود او مانند همه چیز طنین بی روح و ملالت انگیزی داشت.	his own voice, in his ears, was as dull and wearisome as everything else.
هیچ کس نبود که به کمکش بشتابد.	no help to be had.
در آنجا قایق کوچکی ببیند بی پارو و بادبان و دکل و سکان و با دلی جسور و بی باک خود را در میان آن قایق اندازد	finding on the beach a little bark without oars, sail, mast, or tackling of any kind, in the intrepidity of his heart flings himself into it
روی زمین مقداری خرت و پرت دیدهمی شود.	there are odds and ends upon the ground.
ما تونستیم تو خو نه زندگی کنیم.	we could live in the house.
من سر ساعت چهار از قطار پیاده میشم.	I'll be up on the four o'clock.
من نباید راجع به او به احدی چیزی بگویم.	I was to say nothing about him to anyone.
زلال تر از آب.	clearer than the water.
اما تنها این نبود.	that wasn't all
فقط پایم لغزیدم و همواره دعا کردم ای کاش بت وانم از زیر بار چنین چیزهایی ش ا نه خالی کنم.	I stumbled and wished all the time that I could bail out.
تا به وظیفه خود چنانکه شایسته است عمل کرده باشم.	he was unwilling to leave it untranslated
هایده دست کنت را بوسید	, kissing the count's hand
اگر سعادتش یاری کند و حقیقتا آقای شهردار فردا با بچه وارد شود ممکن است نجات یابد.	if good luck willed that the mayor should actually arrive tomorrow with the child
مثلاً اگر هویهمنی دو کره نر داشته باشد	as for instance, if a _Houyhnhnm_ has two males
همان طور که انسان از نور خورشید و باران سپاسگزار است.	as one was grateful for the sunshine and the rain.
اتفاقا معلوم شد که کارخانه تا خود تابستان تعطیل خواهد بود.	it had been known to stay closed until way into the summer.
اگر همچنین کاری کرده با شه باید از خودش خجالت بک شه.	I should think shed be ashamed of herself if she has.
باز مانند روحی سرگردان و مغذب آواره کوه و دشت و صحرا شوید	give over roaming mountains and valleys like a troubled spirit
بعدا به تو اطلاع خواهم داد.	I'll tell you later.
چوب و بقیه وسایل ماهیگیری را در اتاق جا گذاشتم.	I left my new rod and the rest of the fishing tackle in my bedroom.
که آرزومند است دختری چون سوندرا نظر لطفی به او کند.	obviously anxious to be taken seriously by a girl like herself, as she could see.
عاجزانه خیره شد.	he stared helplessly.
به حیرت افتادم که شاید مرا دست انداخته است.	I wondered if she was making a fool of me.
این استنباط از اینجا برایم حاصل شد که با احساسات و عواطف مادری با انگشت به من اشاره کرد تا از دیوار دلیجان بالا روم و بعد بازوانش را دور گردنم انداخت و مرا چنان بوسید که گویی پر او هستم.	I think so, because she beckoned to me to climb up, with quite a new and motherly expression in her face, and put her arm round my neck, and gave me just such a kiss as she might have given to her own boy.
در دست او النگویی بود	on her wrists she wore some glass beads
من یک شاهی پول ندارم و کاری هم ندارم بکنم.	I haven't a cent in my pockets, and nothing to do.
من از آن فرصت استقبال کردم.	I welcomed the opportunity.
به او پیشنهاد کرد که خودش به منزل او برود و به او درس خصوصی بدهد.	offered to give him typing lessons at home.
قلبش را سرانجام از کار باز خواهند داشت .	bring his heart to its final pause.
فقط می دونم هیچ کدوم از این چیزهایی رو که اتفاق افتاده دوست ندارم.	except I don't like any of the things that have been happening.
اما چشمانش متمرکز نبودند.	but his eyes were distant and unfocused
ردپای یک جانور دوپا و سم دار را دیده است.	she found the tracks of a biped with a cloven hoof.
کاری جز اشارتی به زبانی شکسته انجام ندادم.	I have no more than hinted in awkward speech.
من چاقم و قوی و سالم.	I'm fat, but I'm strong and healthy.
یا دیگران این طور خیال کنند.	or lest others should think she must.
راه و نمی تونم پیدا کنم.	I can't find the way.
آهسته از جایش برخاست	he got gingerly to his feet
تو به ایشان اطلاع بده که از اینکار دست بردارند	you tell them so, and that they must stop this
اما همین که از جایش برخاست	but as he tried to stand
آیا ممکن نیست که گاهی نجباء طراز اول ما را مدیون خود کنند و آنان را به هم نشینی با فرومایگان عادت دهند	sometimes keep our very nobles in dependence, as well as habituate them to vile companions
من که کاری به این کارها ندارم که عملشان منطقی است یا نه.	whether that consoling reflection was logical or not.
سخت سرگرم کار بود.	he was very busy.
که چه کسی در فرانسه خواهد دانست	who the devil should know
که از آنجا مانند پوشش سیاه پهناوری بر باغ افتاده بود.	which fell over the garden like an immenseblack pall.
مادام دوفارژ با فرود آوردن سر و نظر افکندن به سوی ایشان مراتب احترامشان را پذیرفت.	she acknowledged their homage by bending her head, and giving them a quick look.
در میان تالارها و تصاویر به جستجو برآمد	moody pacing down the galleries, looking for something among the pictures
یک لب خنده کم رنگ به اون مرده دستپاچه زدم	I smiled wanly at the nervous man.
من اخیرا یه کتاب خوندم	I read this really good book recently
از دور معلوم نبود.	not noticeable at a distance
ماشین را به طرف پایین تپه راندم.	I let the car run down the hill slowly.
وی پس از آنکه به سخنان من گوش داد نگاهی پرمهر و عطوفت به من افکند	I liked the way he looked at me as he listened.
امروز هستم و فردا نیستم.	I'm alive to day, but to morrow
روی هم رفته چه روز خوشی بود!	what a happy day we've had altogether.
در آن را باز کرد	unscrewed the metal cap
که حداقل برای مدتی باید از همه کناره بگیرم.	who intends for some time, at least, to retire from the world.
آبش را یکجا نوشیده بود چقدر احمق بود که همه ذخیره.	he had foolishly drunk all of his water
اما این زن او را فراموش نکرده بود.	but she had not forgotten him.
در مورد کار افراد.	about the way people work
همان طور که سه شب قبلی این کار را کرده بودند.	like they had for the last three nights.
یک دسته شمع از پیه آب شده	a pack of tallow candles
ولی حالا به شکل جای پا بودند.	but now it held the shape of footprints.
خاصه بسیار مایل است که با شما صحبت نماید.	she so delights in your conversation
آن را تجدید کند	they would be renewed
این مسافر مردی فوقالعاده جالب توجه و به دلایل گوناگون پر اهمیت بود.	as he was an extremely interesting person from various points of view, and likely to be useful.
نتیجه آن قطعاً به سود و صلاح جامعه تمام خواهد شد.	the result would infallibly terminate in the good of the public.
از شدت بی خوابی مثل یک زامبی شده بودم.	I was a zombie of sleeplessness.
لبخندی زد و به حالش تأسف خورد.	he smiled,pitying her.
آنجا آمده بود تا سری به ساحل بزند و دیداری تازه کند.	he was down there visiting it.
برای صبحانه می بی نمت.	I'll meet you for breakfast in the dining room.
تا شما را به ساحل برسانند	they will carry you ashore?
شخص باید به قدر امکان اطراف خود را ببیند	you should always strive to see clearly around you
سپس بر اثر لمس دستی بر آستینش از جا پرید.	then she shivered at the touch of a hand on her sleeve
که کنار تراش او تیز است و حدتی دارد.	to see if all the edges were perfect
از سرماخوردگی ناله و فغان کرد و اظهار داشت که به علت باز ماندن درها سرما خورده است.	that she had caught a cold with the doors being left open
ملوانان به طرف چرخ طناب دویدند.	the crew began to man the capstan bars.
لیکن او همچنان روی صندلی نشسته بود	but she sat in the chair
از میان آن عبور کردیم. دروازه با صدای بلند پشت سرمان بسته شد.	we passed through, and they clashed to behind us.
من وقتی به اینجا آمدم	when I tried it.
گذشته از این من تقریبا همیشه خوشحال بودم.	I was very happy, however, nearly all the time.
که خود را در مرکز مثلث دید.	of which he was the centre.
اما به تدریج شروع به تعریف و تمجید از پدرش نمود	but in time she began to idealize her father.
دلیلی ندارد نگران کارهای دیگران باشم.	I am not afraid of what any body can do.
قراول سر بالا کرد	the bandit raised his head.
او به خواهرش گفت که هنوز مانن سابق همیشه اشک در آستین دارد.	he told her sister was still the same crybaby as ever.
این عشق از همان روز اولی شروع شد که ما همدیگر را در سالن رستوران دیدیم!	you know, the very first time we met.
لیکن پس از آن آهی دلسوز کشید	but he soon sighed
تا قبل از رفتن به رختخواب هیچ کار خاصی نکردند	sleepy to do much before bed
کلاه خود را روی میزی انداخت.	threw his hat on the table
من کوشیدم که با ایما و اشاره به او خوب بفهمانم که برای من به کار بردن آن آلت بی مورد است	I made signs, as well as I could, that I had no occasion for such an instrument
فقط آدامس بادکنکی تمش کیش را باد کرد و ترکاند.	except to blow a loud wet raspberry.
محبوبیت زیادی هم داشت.	she was also very popular.
بلافاصله به پرواز درآمدند.	he was soaring upward.
خودم هم متاسف نیستم.	I'm sure I'm not sorry he's dead.
کس دیگری را داشتم که منتظرم بود.	I had someone else waiting for me.
صورت حساب نعل بند بود!	a farrier's bill!
بلکه نفس مزا وجه است با هر که باشد.	, but because she will marry
چند تا از دندونای اون لا تا را هم با خودش برد.	along with some of the teeth of the gang.
همراه با یک دامن شطرنجی آبی و سفید کرکی	together with a checkered blue and white flannel skirt
بالاخره کلی فکر کرده بود.	there was no want of foresight.
در تاریخ مزبور تفحص کرده و بسیار خسته شده بودم و آن روز هم غذای سنگین و ثقیلی خورده بودم که کسالتی فوق العاده در من پیدا شده بود	when tired with my constant labor at the same thing and overcome by a heavy dinner I had eaten
پسر به سوی سکوهای نه و ده حرکت کرد.	the boy, off he went.
صندلی راحتی را به رین تعارف کرد.	indicating a comfortable chair for him.
ولی پس از دقایقی اندک پرنده بازگشت.	yet after a few minutes the bird came back.
رویم را به سمت او برگرداندم.	I wheel round furiously round to face him.
چنان که گویی تصمیمش را گرفته بود	as though he had suddenly reached a decision
هرچند که دارای فضیلیتی هم باشد.	however virtuous he may be.
یک چشمش لوچ بود و چشم دیگرش هم چندان سالم نبود.	blind of one eye and not very sound in the other.
او ناخدا را زیر حباب و کف دریا دفن خواهد کرد.	he would bury him in bubbles and foam.
با اکراه موافقت نمود و دستور داد از اسب و درشکه رفع توقیف شود .	sent word to the livery stable to release the horse and buggy.
تا نگاه تمسخرآمیزی به محلول آبکی آن بیندازد	to sneer at his watery potion.
روحش شکفت .	her spirits rose.
من به آشپزخانه بازگشتم و در گوشهای نشستم تا طفلک را بخوابانم.	I went into the kitchen, and sat down to lull my little lamb to sleep.
به نزدیک آشپز کشتی رسیده بود	pretty near the cook
نگاهی هم که به هنگام گریز در چشمان زن دیده بود به همان وضع باقی بود.	its eyes were as he saw them when he stole away.
سپس ناگهان لحن سخن خود را تغییر داد	suddenly changing his tone
در شبی که در پی همان روز مشهور رسید	on the night that followed that famous day
البته که یادم میاد	I do remember.
برای همینم یه چیزایی سر هم کردم و گفتم.	so I made some stuff up.
محل روزنامه فروشی کیوسک مرمری بود با یک شبکه برنجی.	the news stand a marble kiosk with a brass grill.
به نظرم او خیلی ناراحت است و میدانم که خودم هم ناراحتم!	I think he's pretty unhappy, and I know I am!
بسیار خسته بود.	she was also very tired.
از پنجره بیرون را نگاه کردم.	I look out of the window
در آ جا دیگ و پاتیل بسیار بود.	where the pots and kettles were kept.
با هوهوی ضغیفی از هری تشک رد کرد	gave a feeble hoot of thanks
بدین طریق تمام گوشه و کنار قلب خود را به روی او گشود	he opened up the most hidden passageways of his heart
از او چای خواستم	I asked her for tea
تأثر او شدید و عمیق بود.	the poor boy was in a state of deep affliction.
رین شک داشت جاستین خود احساساتش را شناخته باشد.	he very much doubted whether she understood exactly what she felt for him.
من یه زن تاجر عالی رتبه نیستم.	I'm not a top businesswoman at all.
بقیه هم دنبالش ون رفتند.	hen the rest followed
بیا مال تو شد.	I'll give it you!
جای خودشو به مزارع سرسبز و خرم داد.	replaced by neat green fields
انتظار داشت که دست کم مقداری جواهر نفیس و گران بها در آن به بنید	expecting to see fabulous jewels at the very least
از جیب پهلو یک کیسه توتون و کاغذ سیگار بیرون کشید.	pulled a sack of tobacco and a book of papers from his side pocket.
که ناگهان صدای آهسته در عیش او را منغص کرد.	when she was disturbed by a soft tap at the room door.
دلم به تب و تاب افتاده بود.	brought my heart into my mouth
مثل این که نمی تونست به گه.	I don't think he could
همه چیز را از اجتماع گرفتید و هیچ چیز به آن ندادید.	receiving everything from society and giving nothing in return.
اما موضوعی تقریباً غیرمترقبه بود.	the circumstances were not.
بسیار جدی شده بود	she had become very serious
تنها حسی که قادر به تحملش نبود.	the only emotion she could not bear.
به قول تو خیلی خشک است.	so very dry, as you say.
دراینصورت با راه افتادن برق میتونم به کارش بندازم.	if they got me some electricity to run it.
احتیاجی نیست تو منو نجات بدی.	I won't need you to rescue me.
که مادام وی لفور هم بسیار خاطری پریشان دارد	that she had shared the grief of the family
اما چشمانش زیبا بود.	but her eyes were fine
چندان به لطف و مهر با من سخن گفت که متحیر بودم چگونه ممکنست یاهوئی آن همه مؤدب باشد .	spoke so many obliging things, that I wondered to find such civilities from a _Yahoo_.
من می تونم بهشون کمک کنم.	I can help them.
بو را خنثی و بزاق را دفع کند.	making the odour exhale, and scumming off the saliva.
راستش را میگویم.	I'll tell the truth.
من حتی از آمدنش اطلاع نداشتم.	I did not even know he had come.
بادبزن ابریشمی سیاهش را باز کرد.	snapping open her black silk fan to its widest.
که امروز من دیگر دوستی ندارم	because I have no friends now
ولی قول نمی دم همه چی رو بهتون به گم.	I'm not promisin' I'll tell yeh anythin
از هر سو فریادهای شورانگیز برخاست.	rapturous exclamations were heard from all sides.
احتمالاً این سبد که روبان صورتی دارد.	probably this basket with pink ribbon.
خدا نکند تو حتی نصف من عذاب بکشی!	I would not have you suffer half what I have done!
من از همان اول نگران بودم که مبادا مجبور شویم این راه را در پیش بگیریم.	I feared all along that we should be obliged to take this road.
من حتی یک دقیقه هم وقت ندارم	but I positively haven't another moment now.
گفتم. مرا ببخش	I'm sorry,' I said.
گمان نکنم پیش از این دیده باشمش.	I don't suppose I have ever seen her before.
پایش را توی چادر گذاشت	grandly into camp
برای اینکه من بعد از ظهر اصلاً ایشان را ندیدم.	I haven't seen him all day.
فردای آن شب دو ساعت از طلوع آفتاب گذشته بود که به دهانه غار رسیدند.	next day at two in the afternoon they arrived at the cave
حواس من با یک فشار از بیرون حفاظم پرت شد.	I was distracted by a sudden fluttering pressure against the outside of my shield.
غم و رنج عمرش را کوتاه کرد.	her life was shortened by trouble.
اما بلافاصله رویش را برگرداند تا نگاه دیگری بکند.	then he jerked his head around to look again.
پسرم این عنوان را برای خود خواهد گرفت و بکار خواهد برد.	my son shall take it and bear it.
اولین باری که دیدمش حدس زدم باید قاچاقچی مشروب با شه.	I picked him for a bootlegger the first time I saw him
دور از ما در جنگل فرو رفت.	far beyond us in the wood.
تا مادیان را نگه دارد.	pulling at the reins.
بلا را در جریان گذاشتم ظرف غذا را به طرف او برگرداندم متوجه شدم چیزی که خوردم پیتزا بوده در این فکر بودم که بهتر است چطور شروع کنم.	I pushed the plate of food back towards her pizza, I realized wondering how best to begin.
باران با خلق تنگی مضاعف بخروش آمد.	the downpour of rain, redoubled in its spite, became furious.
عجب آنکه این کشیشان پیر در تمام مدت زندگی زو سیما سکوت کرده	who had kept silent during the life of the deceased elder
پدر با نگرانی پرسید	the father asked anxiously.
آرزوی هیچ سعادتی را بجز زندگی مشترک با شما ندارم.	I can look forward to no better happiness than that which would be one with yours.
با کمک آن سربازان دفتر کارش را بازسازی نماید.	he went back to open his office under the protection of the soldiers.
خود را از بالای بام با سر به زیر اندازد	to pitch himself head foremost over the parapet
برای او بسی خوشوقتم.	I am very glad, said the prince.
اره و مره و تری شه و چوب و آثار جرم را قایم کردم و پتو را زدم سر جایش و طولی نکشید با بام وارد شد.	I got rid of the signs of my work, and dropped the blanket and hid my saw, and pretty soon pap come in.
نترس حرف بزن.	don't be afraid.
حال کلاه مرا و بالاپوش نوکرم را بده.	my servant's coat and my hat?
خود را یکه و تنها در اطاق فراخی که عرض آن میان هفتاد تا صد گز و طولش بیش از 60 گز بود یافتم غم و اندوه من شدت گرفت.	found myself alone in a vast room, between two and three hundred feet wide, and above two hundred high, lying in a bed twenty yards wide.
اما عجله کن و زن بگیر و همان کارهایی را بکن که باید کرد.	but make haste and get married, and make everything as it used to be again.
روی قالیچه جلو بخاری دیواری ایستادم	I stood upon the hearth rug
چه طرز پاسخگویی او را به هیچ رو اهانت آمیز نیافته بود.	not having felt her mode of answering him at all offensive.
او زیر میز شما چیز بدبو نگذاشته.	putting a stink bomb under your desk.
یعنی در مورد فقر و از دست دادن ثروت.	I mean the poverty, and abandoning her position.
ای مرد واقعا بلندهمت من نوکر و غلام و حقیر و مطیع شما هستم.	truly magnanimous man, your very humble and very obedient servant
مطمئن باشید که امیدواری کافی دارم.	I assure you I have.
شرایط جسمانی مناسبی داشتیم	in fairly good training
یه لحظه فکر کردم بهش خورد!	I thought she'd had it then!
در ازاء این تعارف و ادب کشتی تازه رسیده اخرین اطلاعات مربوط به صید وال را درباره میدان گشتی که قصد آن را دارد دریافت خواهد داشت و آن چیزی است که برای آن کشتی اهمیت بسیار دارد.	the outward bound ship would receive the latest whaling intelligence from the cruising ground to which she may be destined, a thing of the utmost importance to her.
آن روش این است که چون کشتی میان چند قایق از هم جدا و به خطر افتاده گیر کند همواره باید نخست عده بیشتر را نجات دهد.	that is, when placed between jeopardized but divided boats, always to pick up the majority first.
تاک و توپ از سر او هم با لا تر رفت و به زمین افتاد و غلتید و دور شد.	THOK! and it rose higher than his head and came down and rolled away.
به رختخواب برمی گردم.	I back up to the bed.
یک بچه کوچولوی خوب که روحش الآن در بهشت است.	a good little child,whose soul is now in heaven.
جدت اشاره کرد	your grandfather says
تنها هدفم از آمدن به اینجا کمک به او بوده.	I have come here with no object except to help him.
دهانم را باز کردم تا صدایش کنم	I open my mouth a couple of times to call after him
در این شکار تنها مراقب جهت وزش نسیم لطف و عنایت تزار بودند	in this pursuit watched only the weathercock of imperial favor
این فن را در آغاز جوانی آموخته بودم.	having learnt the art in my youth.
خلاصه بعد از اون دی گه مثل اولش نشد.	never been the same since.
که بشناسد دشمنی را	of discovering an enemy
بعد به فکر گوشتی که دزدیده بودند افتادند	next they thought of the stolen meat
اینم معلوم نیست چیه	that'll be tricky, too
من با دست خود چنان سخت به دکل چسبیدم	I clung with both hands
اما از طرز حرف زدنش معلوم بود که چندان متأسف نیست.	said the other, not sounding sorry at all.
هاگ رید با دیدن هری برایش دست تکان داد.	gave him the thumbs up.
اول کمی برای دزدها دلم سوخت اما نه خیلی	I felt a little bit heavy hearted about the gang
همین عدم امکان مؤید دلیلی است که من برای خود دارم.	but this impossibility only strengthens my argument.
بعد صدای انفجاری به گوش رسید.	there was a burst of green light
نشان داد که میل ندارد از اطاق بیرون برود	made no offer to leave the room
خود بیش از گذشته به او توجه نشان خواهد داد در این انگیزه نقشی داشت.	that he should pay her more attention than he had done before.
در نظرمان شایان تقدیس است.	whoever exiles himself seems worthy of veneration to us.
بنابراین تصمیم گرفتم به آن سوی بروم.	I decided to go overthere.
ولی خودش را کنترل کرد.	but she stopped herself.
رفتارتان را نسبت به خودم توجیه کنم.	your attitude to me.
زیرا ظاهراً تا به حال او را در چنین حالتی ندیده بود.	for she did not know her in this new mood.
بدانید که احساس من این جور نیست.	I assure you mine are very different.
به زودی عرض عرشه را پیمود	he trailed himself across the deck.
گویی به این نوع تعلق نداشتند	they did not seem to belong to the same species
نه حتی سعی کرد خود را از دیدن دخترک حقیقتا خوشحال نشان دهد.	or indeed do anything to demonstrate to her that he was truly delighted to see her again.
چقدر از دیدنتون خوشحالم.	I glad to see you boys
ارتش و تمام مناطق نظامی روسیه منصوب گشت.	over the armies and over the whole region occupied by them.
احساس آرامش کردم.	I was comforted.
ین شغل را یا به پسرها و دخترهای جوان داده بودند یا به پیرمردها و زنان میانه سال.	held by young men or girls or old men or middle aged women
منظور او تشویق آن عده از عمله کشتی بود	to cheer the hands at the windlass
بی آنکه حرفی بزنند از همراهی یکدیگر خشنود بودند.	not talking, each content in the company of the other.
به ازای خیانت او به گروهش به او پیشنهاد مبلغی پول و نیز خروج بی خطر از کشور را داد.	offered him a sum of money and a safe conduct out of the country for the betrayal of his band.
دوباره سرپا ایستادم	when I found my feet again
تصاویر متعددی از هفت جادوگر و ساحره با رداهای نارنجی رنگ بود	posters of seven witches and wizards, all wearing bright orange robes
بتونیم کاری به راش بکنیم.	there's anything to do
قسمت اعظم آنان عبارتند از کشف کنندگان توطئه و شهود و جاسوسان و متهم کنندگان و دادستانان و گواهی دهندگان و سوگند یاد کنندگان و بعلاوه انواع و اقسام زیردستان و آلات فعلی که دست پرورده و گوش به فرمان و مزدور وزیران و نایبان آنانند.	the bulk of the people consist in a manner wholly of discoverers, witnesses, informers, accusers, prosecutors, evidences, swearers, together with their several subservient and subaltern instruments, all under the colours, the conduct, and the pay of ministers of state, and their deputies.
آخرین جزئیات را هم از جیبم بیرون آوردم.	I took from my pocket one last detail.
من سکوت اختیار کرده	I took no notice
به فکرش نبودم.	I had not thought of that.
پس در اتاق را به روی خود بستم و به اطراف نگریستم تا تختخواب را بیابم.	I fastened my door and glanced round for the bed.
تنها من چنین نبودم	I wasn't the only one.
ناگهان روشنایی روز کم شد و رعد و برق هم شروع شد. صدای بارش شدید تر شده بود.	the day had grown dark very suddenly, and now there was thick thunder and the sound of rain had swelled.
ده سال دیگر نیز برای اتمام آن وقت لازم بود.	would not be built before another ten years.
که به او جرأت داده است برای من آشکار سازد	that could have encouraged him to reveal to me
پس به پیش راندم	I advanced forward
مانع تو نخواهم بود!	I will not hinder you.
اما از این تفصیلی که گفتی آب به دهن من آمد.	but you have made my mouth water
اجرای آنچه را باید در مورد من اعمال شود برعهده بگیرد.	without disturbing your s sensitive conscience.
اما برای کسی که خاطر مشوشی دارد	but for one who has a timid conscience
که من کمال مدافعه از خود خواهم کرد	I have a strong intention of defending my person
حداقل یک دوجین شیطان برای هر کدام از ما.	at least a dozen demons to each of us.
به گمانم بیشتر حیرت زده شده بود.	I should imagine he must have been rather startled.
بدین جهت به تصور اینکه بر روی دیو خوابیده	believing he was laying on the giant
شاید تا حالا یک بدبختی رو جای من دار زدن.	so perhaps some other poor devil has been hanged for it, long since.
با آتش هر یک که به پایان می سید	lighting one from the other to the end of the chapter
من از این تشبیه لذت بردم.	I rejoiced at his insistence
به عکس اشاره کردم.	I pointed at the picture.
پاسخ آخری را داشتم.	I could answer that last one.
صدایی از بلندگو هواپیما به گوش رسید	comes a voice over the intercom
در این مدت مانند پادشاهان از ایشان پذیرایی به عمل آمد.	by whom they were entertained and treated like kings.
سرشان را به دستشان تکیه دادند که با هم صحبت کنند.	propped themselves on their elbows to talk.
نمیخوام چیزی بشنوم.	I don't want to hear it
مالفوی بلافاصله توپ بلورین را به بالا پرتاب کرد	he shouted, and he threw the glass ball high into the air
ممکن است ساییده شود. من این طور دوست ندارم.	I don't like that way of doing things.
هر قدر زد کسی نیامد.	but though he nearly broke the cord no one answered.
اما وارد این بحث نخواهیم شد.	but we won't go into that.
بعد پنج دقیقه سکوت نمود و آنگاه دوباره آنراتکرار کرد.	then broke for five minutes, then gave it again.
تا تف کنم توی صورتت.	watch me spit in your eye!
ولی جای خوبی دارم.	but I've got a good place.
سکه را سوی او پیش برد	he held out the coin to him
هوش من با خودم نیست.	I no longer understand anything.
که بدون مشورت با او در هیچ مورد مهمی تصمیم نمیگیرند	that they never made up their minds to any important undertaking without consulting her.
نظرم همیشه همین بوده.	it was always the same.
کاملاً متوجه وزن سنگین و عظمت درامی نشده بود که خودش شخصاً آن را به وجود آورده بود.	she had never been fully conscious of the weight and size of the drama that she had provoked
وقتی کارش خاتمه پیدا کرد	when she was done with him
گفت تمومش کردم گفت در عمق صداش شادمانی وجود داشت.	I did it, she said, sounding pleased.
هیولای درونم موافقت کرد.	the monster in my head agreed.
من لب نزده بودم.	I had not eaten.
به محض روئت این یادداشت به کنه مطلب پی خواهید برد.	you will readily comprehend this when you see it.
چون برای نوشاندن آب به او سرش را بلند کرده روی بازویم نگه داشته بودم	I raised her and supported her on my arm while she drank
اگر دشمن بوده است کارهای او را خوار و بی مقدار نموده	if an enemy, to bring them to naught
پس از آمدنش به ایوان و سوال از موضوع گفتگوی آنان	at the moment when he had come onto the terrace and asked what they were talking of
باعث شد از پشت به زمین بیفتد.	which knocked him backward onto the floor.
لیکن ما از ترس این که مبادا مسلسلی در ساختمان ایستگاه کار گذاشته باشند توقف کردیم.	but we returned them, fearing a machine gun in the station buildings.
نمی تونستم تحملش کنم.	I wouldn't've been able to stand it.
باز او را به حرکت در آورد.	it incited him.
من سبد رو روی ایوان گذاشتم	I left a basket of clothes on the porch.
جلوگیری از غارت و چپاول و آرام کردن ساکنان شهر اقدام کنند.	to prevent looting, and to reassure the inhabitants.
دو سه بار جابجا شد	once or twice as she feverishly changed her position
آنگاه لب به سخن گشود	so she spoke.
میدونستم که چه حسی داره.	I knew how he felt.
که نیم چاشت را با هم صرف خواهیم کرد.	that you intend breakfasting with me
که تاریخی هم در پای آن نهاده بود.	together with a date.
او را ناراحت ساخته بود اینک در نظرش کام لا آشکار و حل شده جلوه کرد.	all that day now seemed to him quite clear and completely solved.
امیدوارم اعتراضی نداشته باشی	I hope that's okay by you
زن پدرم پاهای مرا گرفت و از دودکش بیرون کشید	my mother dragged me by the legs out of the chimney
او کشف کرد که زمان به سرعت در گذر است.	he discovered as time went by.
موهای خرمایی و صورتی کشیده و با طراوت	auburn hair, and a thin, fresh
که در رأس قشون قرار گرفته است	that he would place himself at the head of the army
هیجان و شعف این دو نفر تمامی نداشت.	consciousness and pleasure were likely to be more than momentary in them.
تا زانویش در گل فرو رفت و فقط معلوم بود	sinking to his knees in the muddy field
در افق ظاهر شد و دوباره در حاشیه باریک و دراز ابر سیاهی که برفراز آن معلق بود ناپدید گشت.	the horizon and disappeared behind a long narrow cloud that hung above it.
همین قدر که پرتوی از خورشید او به چشمان من بتابد چنان مغز و ادراکم را روشن و جان و دلم را توان و نیرو خواهد بخشید	for any beam of the sun of her beauty that reaches my eyes will give light to my reason and strength to my heart
حتی در خواب نیز آن را در اختیار داشت.	he held the mastery of them even in his sleep.
یقین دارم خیلی میل دارید خبری از او داشته باشید.	I felt sure you'd like to have the latest news of her.
تا من اتومبیل را بگذارم و مراجعت کنم.	I must go and put the car away.
می تونستم باشم.	I could have been.
باید عملش و اثرش بکار بهبود حال بشر آید.	it should have for effort and effect to ameliorate the conditionof man.
از طرف شما خواهد بود	it'll be on your side
من ترفیع مقام گرفتم.	I've been promoted
اکنون دیگر فقط صورت پیدا است.	only his face is visible now.
از پنج سالگی.	when I was five years old
آن اینکه بر فرض پادشاهی یافتیم که در جنگی درگیر باشد و دختری هم داشته باشد	for supposing we find a king who is at war and has a beautiful daughter
موهای بدنش ناپدید شد	the fur vanished
دی گه کسی حرف نزنه!	no more talking!
شهرت داشت از این جهت خود را بلد کشتی کرده بود	was one of the licensed pilots of the port
هر که خواهد کامیاب شود و به ثروت و مکنت رسد	whoever wants to flourish and become rich
اطمینان دارم که احتیاجی به رفتن من نیست.	I need not go, I am sure, I answered.
ناگزیر چنان مشتی بر مغز او کوفت	so he at once gave him a drubbing
مزدت را خواهم داد.	I'll pay you for it?
باید به شما بگویم که من وظیفه خود دانستم آ تا را منصرف کنم.	I must tell you that I thought it my duty to dissuade her.
لبخندی بر لبانش نقش بسته بود.	his lips were smiling.
شاید ثبات نشان بدهد.	she may be constant.
زیرا نگذاشت باقی ساندویچ را به دریا بی اندازد	for he stopped her throwing a sandwich into the sea and told her
من جایی نرفته بودم.	I hain't been gone anywheres.
می دونم که تو قصد کشتن کسی رو نداشتی	I don't think you meant to kill anyone.
من کاملاً در اختیار تو هستم.	can be that I am completely in your power.
هر سه بار در بیداری بود.	I was wide awake every time.
نزدیک بود عصبانی شوم و آنچه نباید بگویم بر زبان بیاورم.	I kept my temper though.
که من لوشان دادم!	it was me that blowed on them!
از نو آن را بویید.	smelled it again
همیشه روی کاغذ آوردن مطالب مهم بیشتر مایه رضایت خاطرست مخصوصاً که کاملاً به وضوح نگاشته شده باشد.	it is always more satisfactory to see important points written down, fairly committed to black and white.
یک همراه دیگرش بعد از این مهمانی سخت دوباره سرحال بیاید.	the other recover his temper and happiness when this visit of hardship were over.
اجازه خواست چند سؤال از او بکند.	begged to ask him a few questions.
کوشید آنان را به سوی تصویر دیگری بکشاند.	he tried to draw his visitors away to a third picture.
چندان ربطی به عالم واقعیت نداشتند.	had very little to do with reality.
مطلع شده بودند که اعلام سفر پاپ اعظم صرفاً دروغی ساخته دولت بود	when it was learned that the announcement of the pontifical visit had been a lie spread by the government
من می دونم این بسته رو کی فرستاده.	I think I know who that one's from
در مدت چندین صد سال	,in the slow dragging ages
خیلی هم جدی بود.	looking as serious as he could
مطمئنم که گیرم میاد.	I'll believe I'll get it.
بازوانم به بدنم خشک شده بودند.	my arms frozen to my body.
اما متوجه شد که قادر به کنترل جارو نیست.	then he realized that his broom was completely out of his control.
امیدوارم مجبور نشوم بیشتر از این جلو بروم.	I hope I shan't have to go any further.
کاش یک نفر پول و تجهیزات در اختیارم بگذارد و در عوض شریکم بشود.	I need me a grubstake.
اما اگر اصرار دارید	but, if you will persist
او به دیدن من آمد.	he came to me.
که عضلات کف دستش بیرون زده بود .	the pads of his palms bulged
پیرمرد تعادلش را از دست داد و چیزی نمانده بود که به زمین بیفتد.	as the tiny old man stumbled and almost fell.
ما خیلی از وظایف خود را فراموش کردیم.	we have neglected many things.
این کام لا حقیقت دارد!	that is wonderfully true.
مثل دیگران نیستید.	not like the other one.
به دقت ثبت به شه تا درست به تناسب کارش ون حقوق بگیرن.	accurately so that there won't be any mistakes as to their time.
فکر آقای التن کاملاً روشن است و تصمیمش را گرفته.	the state of his mind is as clear and decided
از مسیری که در سمت چپش بود	so clear was the road left for him
باز هم بین ابروهایش چین افتاده بود.	there was that little pucker between her eyes again.
انگار آن را قبلاً هزار بار انجام داده بودم	like I'd done it a thousand times before
از آنجا یک ژاندارم و یک دکتر بفرستد.	from which place, he was to despatch, a constable and doctor.
سیلی از هیجان و احساس	a flood of emotions surged up in him
من بهتون گفتم.	I told you
یا بدتر از آن مبتلا به امراضی مهلک بودند که علایم آن علایم امراض دیگری بجز آن بود.	what was worse, serious diseases with the symptoms of minor ones.
زنت اجازه نخواهد داد.	your wife won't allow it!
ناگهان آن را توی صورت تام برد.	suddenly thrust it almost into the boy's face.
به من که رسیدند وایستادند	they stopped and I stopped.
دی گه نمی تونم برگردم اون بالا خرد شدم	I don' wanna go back there no more'I'm tar'd.
سه پسر از او داشت	had had by her three sons
باید با آب درش ون بیارم .	I'm going to have to try to wash it out.
این گروه به جمع کردن سنگ پرداختند و حالت جنگی به خود گرفتند	all armed themselves with stones and formed in line
تنها خدا از این راز آگاه است.	he muttered, almost embarrassed.
نگاه نکردم تا ببینم چه کسی بود.	I didn't look to see who.
وارد سرسرای ورودی شدند.	slipped out into the entrance hall.
از دو جهت او را محاصره کرده است نبرد کند.	who would hem him in from two sides.
شاید هم جسم ما به سختی بتواند تاب آن را بیاورد.	perhaps our frames could hardly bear much of it.
اشعار من عبارتند از عمل و احساسات.	I feel them, and act them.
اگه سر جای همیشگی مون بشینیم در مسیر باد قرار نمی گیره.	she won't be downwind if we sit in our regular spot.
این کار چنان اشاعه پیدا کرده بود	that extended far and wide
غواص او را دیده است.	the diver has seen it.
زیرا امید فراوان داریم که او روزی زن برادر ما بشود.	from the hope we dare entertain of her being hereafter our sister.
هر قدر دلمان بخواهد پول خواهیم داشت.	money to eat
اکنون لازم میدانم به خواننده اطلاع دهم	I will only add now
بر خلاف مطلبی دیگر دارم.	on the contrary
شما را پا به پای خود از هستی ساقط خواهد کرد	pull you down with him.
درست و حسابی فدایی دیرم.	I am entirely devoted to the convent.
واپسین نگاهمان به زندگی همان گونه تار باشد که نخستین نگاهمان بود.	our last moment of dim earthly discerning may be like the first.
همان آرامش فکری که از نظر همسرش نشانه کفایت کامل شوهرش در زندگی کردن بود.	which she had erected in her thought for a sign of perfect competency in the business of living.
راستش تا حالا ندیده بودم کسی این قدر تعجب کند.	I do not know that I ever saw any body more surprized.
لکن مانند هر کودکی فکرم را با نهایت سادگی بیان کردم.	but as a child I expressed my idea in the naive way recorded.
من تا به حال خون آشام هایی به این بی تمدنی ندیده بودم.	I'd never met any vampires less civilized.
چندان کوچک اندام نبود	he was not diminutive
لاسش را جلو او بزند	lacerate her with the performance.
با نمایاندن و فرستادن اتفاقات و وقایع بد و وحشتناک	by presenting dreadful scenes to their view.
رفتارش مثل یک زن حسابی بود.	the composure of an older woman
ولی من عزیمت شما را ترجیح دادم.	but I wish you had.
جای کوتاهی پیدا کرد	till he found a low place
همه کارها به خودی خود درست خواهد شد.	everything else will come right of itself.
آن را با کود مرطوب و تیره کاملاً پر کرد	burying him in dark, damp compost
با سکوت حزن آلودی گوش کرد.	he listened in gloomy silence.
ولی فراموش نکنید	, but remember
در چند کلمه حقیقت امر را برایت توضیح بدهم.	I will in a few words show you the real state of the case.
آن وقت مجبور بشوند تحملت بکنند چه تملقشان را بگویی چه نگویی.	so that people must put up with you whether you flatter them or not.
حالا بگذار من خودمو ببینم دی گه.	give me a bit more time.
با یک دنیا شادمانی احساس کردم	to my great joy
او را به زمین انداخت.	brought him crashing to the floor.
در آستانه پیروزی نسبت به دو نفری که کمکش کرده بودند مهر و محبتی بی نهایت احساس میکرد نسبت به این دو جوان در آن سوی اقیانوس.	felt at the foreshadowing of success an almost boundless affection for his two helpers, for these two young people from over the sea.
این علامت حرکت من بود.	I recognized my cue.
تا تو از کرده پشیمان نشوی	so that thou repent not of what thou hast done
ولی خشم و عصبانیت بر فصاحت کلام چیره شده بود.	but anger had got the better of rhetoric.
می تونم ببینم چطوری ممکنه کار کنه.	I can see how it might work.
برق نگاهش از چشمانش پرید.	the light died from his eyes.
تا خیال پردازی کنیم	to dream on
اینم می دونم که توی اردوگاه شنلشو روی چهارتاچوب سوار کرده و زیر شنلش خوابیده.	I know for a fact he was sleeping under a cloak propped on sticks.
شما میخنده چون کمیته از اون به کمیته ابتکارات او نه.	he laughs at your committee because it's the old way and the old ways are his ways
صدایش سردرگم و ناامید و سپر انداخته بود.	in tones of bewilderment, despair, resignation.
مادرش بیرون آمده بود تا قبل از شروع مدرسه عکس بگیرد.	her mother had come outside to take it right before school started.
افزارهای خود را مرمت کند	to repair his farm implements
من از طعمش خوشم آمد.	I loved it.
بعد از این عمل البته به من اطمینان خواهید داشت و از من خاطر جمع خواهید بود	you can now have confidence in me after what I have done
معلوم شد که آمده است بگوید شام در سر ساعت معهود برقرار خواهد بود.	who had called to say that the dinner would take place as proposed.
من باهاشون میرم پیش مردمی که توی جاده سرگردون شدن.	I'm going with them.
این هم بسیار موجب تعجبش بود.	he was much surprised.
که من از خواب پریدم.	when I woke up
ولی چون دیدند که تذکرشان اثری ندارد	seeing it was no use
من عاشق گل رز هستم	I just love your roses
دیگری این پسرک است که د	the other's that cub that
دیگر کسی مرا نخواهد دید	I had nothing to fear, that I should neither be seen nor heard
چنان نظری تند و تیز به وی کرده	looking so earnestly at her father
که انسان باید از تمام مزایای طبیعت و ثروت استفاده کند	placed the summum bonum was in the gifts of nature
مرگمو هم خراب کنن!	ruining my death!
که چای حاضر کرده بودند	where tea was prepared
چون از هیچ کمکی در حق من مضایقه نشده است.	since everything that could possibly be done toaid him was already being done.
دو کلمه حرف به آقای تو دارم	I only wish to say two or three words to your master
یا بهتر بگویم همسرت به ما گفت	or rather your wife only told us
من تاجر بودم	I was a merchant
از کنار منزلش رد شدیم.	we passed her house
به امید اینکه حرفی که معروف نشده و کسی را به خاطر نرسیده خود اسباب شهرت و بازگوی او نگردد.	hoping to conceal its true cause even from his seconds
خواستم فرار کنم	I turned to run
آنگاه آن دو به اطاق تاریکی پیچیدند	they turned into a dark room they were passing
از سمت جنوب جزیره رد شدید.	keep the weather of the island.
منالان صاحب خودمم که هشتصد دلار قیمت شه.	I owns mysef, en I's wuth eight hund'd dollars.
اما انگشتان نااستوار یک دستش بی هدف تا لبانش بالا آمد	but the unsteady fingers of one of his hands strayed to his lips
من نمی دون ستم که این جوری می شه.	I didn't know it was like that.
من زدم انداخت مش.	I knocked him sprawling.
با من خداحافظی مکن.	don't say good bye
آن گاه با انگشتان بزرگش چنان دست آنا را محکم فشرد که دستبند او مچ دستش را قرمز کرد.	his big hands clutching her by the arm so violently that red marks were left from the bracelet he was squeezing
دائما به خود گفت که اگر ربرتا به آن اتاق راهش ندهد	he kept saying to himself that unless she would permit him to her room
بعد به پارو زدن مشغول شدند.	then lay on their oars.
شاید تنفرم به همین علت افزون شد.	I am afraid I liked him none the better for that
ظاهراً در بستر مرگ افتاده بود	who was apparently on his deathbed
این بار نقش یک گرگینه را بازی کرد.	this time acting a werewolf.
هاه نگاه کن این خرمن کاهه.	there's a haystack
فکر کردم شاید چیزی نصیبم شود	I might make something out of this if I handled it properly.
بگذارید از شما سو الی بکنم.	let me ask you
زیرا نزدیک بود ترا با فریاد صدا زنم.	I was nearly shouting to you,
تقریباً به خواب رفته بود	had almost dropped asleep
ساکت و آرام در کنار تختخوابم ایستاده بود	a silent presence near my bed
اصلاً به امید خدا و با زیرکی و کمی اقبال خوش ممکن بود	but that with the same shrewdness and a little more luck
فقط سعی کردم بر اعصابم مسلط به شم.	I was just ' trying to get myself together.
در این فکر بود	thinking to himself
زندگی من بی تو خیلی تلخ می شه.	my life will be bitter without you.
ابری از گرد و خاک زبانه کشید.	a cloud of dust boiled up.
مرا منتظر نگذارید	do not keep me waiting
من که نگفتم من بودم	I never said I was
به صدای من هم عادت دارد.	but then she is used to my voice.
محلی که در آن بزرگ شده بود	the very place in which she had been brought up
لیکن چون نمایشنامه به صورت کالای تجارتی درآمده	but as plays have become a salable commodity
پیوسته عده نسبتاً فراوانی کتاب در دسترس داشتم.	being always provided with a good number of books.
شاید تو هم بخواهی با من بیایی.	or I hope you will come to me.
اینکه آدم چقدر متمول است	how rich you were
نواخت و بعد به همه رقص محلی اسکاتلندی را یاد داد.	taught those who were interested how to dance his national dances
از تخت برخاست	getting off the bed.
که با گیاهان دریایی پوشیده شده بود	covered with aquatic plants
همچون من در پی بخت و اقبال آواره شوی	run the same chance that I run
همین مامان خودت!	look at yer mum!
هدفی خواهد داشت و در راه آن مبارزه خواهد کرد و در صورت لزوم جانش را در راهش از دست خواهد داد!	he would have something to fight for, something to die for, if need be!
صدای چرق خشکی شنیده شد.	a dry crackling was heard.
هرگز باور ندارم.	I do not think so.
ببین وقتی شوهری ابدا قابل اعتماد نیست پایبند هیچ اصل اخلاقی نیست و حاضر است در حق دیگران بدی بکند تا خودش ناراحتی نکشد زن چقدر باید زجر بکشد.	what it must be for a wife when she's never sure of her husband, when he hasn't got a principle in him to make him more afraid of doing the wrong thing by others than of getting his own toes pinched.
بهتون احتیاج دارم.	I shall need you.
با سیمایی بسیار زشت و خشن.	very plain and rough in his exterior
بدبختی بزرگی است برای مهمانخانة ما!	what a disgrace upon the house!
اکنون پیغام بر و هاتف غیب گوی ایشان شده بود	was now their oracle
یک حرکت هم نکرده بود.	he had not moved.
به اطراف ان اپارتمان کوچک نگریست	looked around the small apartment
در کناری را باز کن.	unbolt the side passage door
که به گناه اینکه عضو شما و وابسته به شما هستم دایم در پی اذیت و آزار منند.	that persecute me as a creature and limb of your worship
امّا ترجیح داد فقط کمی تند تر راه برود.	but she walked on as rapidly as she could.
من نمی دون ستم چطوری به شما اطلاع بدم.	I didn't know how to reach you.
البته با عینک.	with the help of spectacles.
حالا با احساس اندوه عجیبی متوجه شدم که در طول این همه ساعت که در اطاق را به روی خود بسته بودم	with a strange pang, I now reflected that, long as I had been shut up here,
دعا کن تا اخلاقت بهتر شود.	pray to be better!
جای تعجب هم ندارد.	I don't wonder at it.
بنابراین همه چیز مرتب خواهد بود.	so everything will be all right.
باز هر روز دم دست نبود.	was much beyond her daily reach
اما این کار ممکن بود عواقب بسیار جدی و و خی می در پی داشته باشد.	but it could have led to very serious consequences.
پیش افتادم و او را به اطاق نشیمن بردم و خواهش کردم بنشیند.	I led the way into my sitting room and asked him to sit down.
من هنوز چهاردهمین بهار زندگی را تمام نکرده بودم	I wanted to run away when I was fourteen years old
با انگشتانم روی صفحه کلید ضربه زدم.	I stroked my fingers across the keys again.
دست راستش گیاهان انباشته بر نرده چوبین را به کنار راند.	his right hand pushed the herbs away.
مانند مرغی زیبا او را نگاه کرد.	looked at my aunt like an amiable bird.
متأسفانه همه نتایج منفی بوده است.	the results have, I fear, been negative.
چند ثانیه بعد با کت فراک برگشت.	was back again in a few seconds in a frock coat.
رو به تکالیفم اخم کردم.	I frowned at my homework.
هر بیست و چهار ساعت به قدر یک قاشق	a spoonful once in four and twenty hours.
چون که برای جزئیات بیشتر هیچ سو الی از من نکرد.	because he didn't ask me for any more details.
باید دماغی تازه کنم.	for I am getting rusty here.
چون تو را برای کمک دارم.	since I have you to help me.
کوسه یک کلمه است.	shark is only one syllable.
برو وسایلت را جمع کن.	so you'd better get packed.
به این نحو که اجزاء مرکبه آن را از هم جدا سازد	by separating the several parts
مغزم خوش ندارد روی یک موضوع متمرکز بشود.	my mind is too fond of wandering on its own way.
اما هرچه گشتم نیافتم.	I could not find one.
اما خودش دلایلی برای این کار داشت.	but had her reasons.
من به همان یک آزمایش راضی خواهم بود	with this mere attempt I shall rest satisfied
دیگر هم نگاهم نکن.	but keep your eyes off me,
عین خیالمان نباشد که به نظر مردم خارج از این چهار دیواری حقیقت چقدر تلخ است.	we don't mind how hard the truth is for the neighbors outside our walls.
باید جای دیگری دنبال یک متحد بگردم.	I'll have to look elsewhere for allies.
عد خودتان قضاوت کنید که آیا من حق نداشتم پیمان ازدواجم را با او بشکنم و محبت کسی را جلب کنم که دست کم یک انسان است.	judge whether or not I had a right to break the compact, and seek sympathy with something at least human.
اما متاسفانه چیزی برای فهمیدن وجود ندارد	I'm afraid there is nothing to find out.
او دخترش را روی زانو نشاند	took her daughter onto her lap
داروساز پاره کاغذ را خواند و سوتی کشید.	the chemist whistled softly, as he read it.
ولی ناگهان صدایش فرو افتاد.	then his face fell.
ولی بعد به نرمی هوهو کرد تا به او اطمینان خاطر بدهد.	but hooted softly in a reassuring sort of way all the same.
ناخنکی عشق از هر که.	a bit of love from someone!
حرکات متناوب ترازوی اسرارآمیز نور و ظلمت را به دقت نگریست.	he considered the alternatives, the mysterious balance of light and darkness.
سگ تربیت شده و خوبیه.	he is extremely well trained.
کرسی را زمین نهاد و در رویش نشست گویی فی الواقع دیوانه شده است	dropping the stool and sitting on it as if he were in reality mad
ببینیم و تعریف کنیم.	I'd like to see you try it.
آبله هم نمیخوایم بگیریم.	hang it, we don't want the small pox, you see.
در جبینش به جستجو پرداختم تا شاید خطی که حاکی از فرو نشستن التهابی باشد بیابم.	I scanned her brow for any passing line that might indicate a settling emotion.
من از رنگ آلبالویی متنفرم.	I hate maroon
من پسرش هستم.	I am his son.
زیرا که از خطر گریزی نیست.	for the danger was imminent.
ظلمت او چنین بود	such was her darkness
روزی اگر شما را زنده بگذارم	one day, if I allow you to live
من دریچهٔ قلبم را کام لا بروی تو خواهم گشود.	I'll open the other side of my heart to you.
ای کاش سقوط نکرده بود.	I wish he hadn't.
آهسته نفس کشید.	soundlessly let go her breath.
اکنون آشفتگی او حیرت آور شده بود.	her agitation now was amazing.
اما به روی خود نیاوردم.	but I took no notice.
از من خواهش کرد که به شرح سفرهای خود بپردازم.	desired I would give him a relation of my travels.
از شب پیش تا آندم فقط این یک قدم را برداشته بود.	this step he had taken since the preceding evening.
آن کلیسای کوچک پیش از آن روز آن قدر جمعیت به خود دیده باشد.	the little church had been so full before.
خودم حاضرم که فردا حرکت کنیم.	I shall be ready to go tomorrow,' he said.
با فروتنی و افتادگی پاسخ دادم که من بنده ارباب خویشم.	humbly answered that I was my master's slave.
نفسی به آسودگی برآورد	she heaved a deep sigh of relief
که زیاد از همدیگر فاصله بگیرند تا مساحت زیادی از سطح آب را میان خود تقسیم کنند.	to spread themselves widely, so as to cover a large expanse of water.
که گویی خبر داشت در جای امنی است.	as if it knew it was perfectly safe.
در بحبوحه خلسه این حقیقت را کام لا دریافت	he knew and felt it suddenly at the very moment of his ecstasy.
او او به من هم توهین کرد.	he he insulted me.
از آرایشگاه مردانه گذشتم.	I passed the barber's shop.
یک پایشان را در حال انتظار روی کناره اقیقها نهاده بودند.	while one foot was expectantly poised on the gunwale.
امروز با خوردنش مشکل دارم.	I have such trouble about it.
شاید بهتر باشد که به عنوان کارآموز شرکت من باشی	perhaps you'd consider becoming an apprentice with the company
بلکه به این دلیل که معتقد بود روزی مادربزرگش سینه خیز به سویش میاید	but because she was determined that one day her grandmother was going to come crawling to her.
همه کس را در آغوش گیرم	I want to embrace.
من می تونم در این مرد خدمتی به شما بکنم	I might be able to be of some service.
آن وقت سؤالات و تفتیشات به میان آمده.	this would cause inquiries
بعد از اینکه توانسته بود از اطاق هیئت مدیره بیرون آمده و اندکی هواخوری کند	after having delivered himself of some profound sentiments in the board room.
یک شخصیت مهم است.	a most important personage!
که پدرم وثوق زیادی به او داشت.	whom he reposed great confidence
همهمه و صدای پایی چند در حیاط پیچید.	a loud noise of feet and voices came pouring into the courtyard.
چنان خشمگین کرد	objections till at last
مگر آنکه دیدگان خود او اکنون دوستش را در هیئت و حالت مالوف خویش در برابر خود نشسته	for, did not his eyes show him his friend before him in his accustomed clothing and aspect
من خود به خود بزرگ شدم.	I'm raising myself.
استخوانهاشان به مثابه سنگ شده است.	theirbones have turned to stone.
در جناح ین آتشباری قرار دهد که مأمور تیر اندازی به استحکامات چپ است.	on the flanks of the battery that is to bombard the entrenchment on the left
من اخراج شدم.	I've been relieved.
دستم را به سختی فشار داد	he tightened his grasp upon my hand
همین حالا شما را مورد آزمایش قرارمیدهم.	I will put you to the proof, and this very moment.
این دفعه از هر دفعه عمیق تر بود.	it cut deeper than ever, this time.
تحقیقات ما بی فایده است.	there is an end of our investigation.
هفتصد روبل نقد و دو هزار و سیصد روبل فردا بامداد در شهر.	seven hundred roubles down, and the remaining two thousand three hundred to be paid next day in the town.
اما به فکرم نرسیده بود.	but I didn't think.
به سفارش او دو سال پیش در آن به باغبانی گماشته شده بود.	had been admitted on his recommendation two years previously.
آنجا در حالی که اربابم به نیزه خود تکیه زده بود	there, my master leaning on his lance
ابتدا با یک چاقوی کوچک جراحی آن را مانند یک جراح با احتیاط و دقت تمام قاچ قاچ برید.	weighing the pieces on a pharmacist's scale, and calculating its breadth with a gunsmith's calipers.
همچون درخت میوه آفت زده به خود لرزید و آخرین سیب سوخته خود را بر خاک افکند.	like a blighted fruit tree he shook, and cast his last, cindered apple to the soil.
انتظار داشتم که سخت باشد.	I'd been expecting it to be difficult.
اکنون چنان به غایت با مادران غم زده و دختران شکوفندهء حاضر در مکان مغایر بودند	looked so extravagantly coarse contrasted with sorrowing mothers and blooming daughters who were there
من که بسیار آرام و خوشبختم.	I am so tranquil and happy now.
برای اجرای طرح جدیدش برخلاف گذشته از دور تا کمک خواسته بود.	had associated her quite newly in carrying out his plan.
ولی قول داده بود که همان شب برگردد.	but she had given her word that she would return that same evening.
من هم چندان مایل نبودم از او اجازه رفتن بگیرم.	I hardly liked to ask to go by.
بلافاصله با سرعت هرچه زیادتر دنبال آن دو جوان به راه افتادند.	they set off immediately as fast as they could walk, in pursuit of the two young men.
آرام نگاهش را برمی گرداند.	rolling his eyes slightly.
که همان سرد کل کشتی وال گیری در دریا باشد.	that of a whale ship at sea.
من باید سختگیر باشم.	I'm like to look sharpish.
مردان انگلیسی در پارک دنده عقب اتومبیل شخص دیگر %۸۲ دقت داشتند.	men in the UK averaged 82% accuracy in reverse parking someone else's car close to the kerb
من به بیشتر از پنج تا نیازمند هستم.	I need more than five.
آنچه در حرارت خشم گفته شود خود به خود ناگفته است.	what is said in heat, that thing unsays itself.
دیگر جو موجود بین ما برایم ناراحت کننده نبود.	but the atmosphere between us isn't remotely awkward any more.
درست مثل آن شبی که سریوژا به پای مادر در غلتید و آنا او را غلغلک داد	just as he had one evening lain on her lap while she tickled him
باشد من دیگر وعظ نخواهم کرد و خیلی دوست دارم که اخبارت را بشنوم.	I won't preach any more, and I'd like to hear the news immensely.
شانزده ساله بشود	will reach the age of sixteen
اگه توی این جشن شرکت کنی	if you would attend.
مرد چاقی از آن بیرون جست	out of which there jumped a fat gentleman
کوچک و پیش پا افتاده بود	it was trivial
همواره از موضوع دیگری هم سخت واهمه داشت	there was always the other great dread
ما شش نفر بودیم.	six of us
یک طرح دارم که باید یه طبقه پایین بری.	I've got some copy for you to run downstairs.
من حس کردم چیزی بین ما هست.	I felt there was something between us.
من به او گفتم که به شما علاقمندم	I told her my heart belongs to you
به او خواهم گفت که دنیا چه خبر است.	I can tell him!
گفت که اگر اطلاعات بیشتری به او بدهم خشنود خواهد شد.	professing he would be glad to receive further information.
بدون سوگند هم از آنان مراقبت خواهم کرد.	I shall look after them without that.
هرگز دخترمو تو کوچه ننداخته بودن.	I never had my family stuck out on the road.
در راهرو ایستاد.	he stopped short.
نباید من انتقامم را گرفته باشم تا وقتی شرف همسرم احیا شود	but I should not be avenged, nor the honour of my husband vindicated
شیروانی زیر پا لغزان بود.	the roof was slippery.
صبورانه منتظر بود که فرانک او را پیدا کند.	waited patiently for him to spy her.
حتی شکر گذار هم باشیم.	nay, must even thank him.
اما دوباره دفع تا از حرکت بازایستاد.	but as suddenly stopped
چنانکه ملاحظه خواهید کرد او خود نه سخن گفتن را دوست دارد و نه از رموز سخن گفتن آگاه است.	but he does not like talking himself and can't do it, as you will see.
چندان مهم نیست!	that's as bad to bear.
اگه من جای تو بودم	if it was me
که غرق خون بوده	covered with blood
ناخداها را بر آن دارد که اندکی به ما رحم کنند.	he would move the captains to take some pity on us.
راستی که موژیک است!	lout that you are a real peasant
کمی دورتر چند تا چادر هس	there's some tents ahead.
البته و عجز و لابه خواهم کرد.	I will fall at his feet and beseech him.
نامه را با یک دست باز کرد و نگاهی به آن انداخت.	shaking the letter open with one hand and glancing at it.
از دیدن دو مرد که شبیه سربازها بودند و اونیفورم تیره به تن داشتند تعجب کردم	I was surprised to observe that by the gate there stood two soldierly men in dark uniforms
اونوقت یکهو. دستش را در هوا چرخاند و بشکن خشکی زد.	now here you are and here I am, and it all happened just like that.
جسد ناخدای کشتی را دیده	he had seen the body of the commander
به زودی به زمین صلب و سخت رسیدم	soon got upon firm ground
سرم را درد آوردی!	you are beating on my brain
سخت کوشی و مراقبت بود.	were steadiness and diligence.
من کاملاً حالم خوب است.	I'm quite comfortable.
اما بدانید که زندگی من آن قدرها قیمت ندارد که زحمت دفاع برای آن لازم باشد.	but my life is not worth the trouble of defending it.
نباید خواهش کنم .	I mustn't beg.
این مرد را نجات بده	make this man to recover
باید برایش زن پیدا کنم.	I must look about for a wife for him.
ردای بزرگ را پوشید.	pulled on the spare ones
دختر چنان کار کشته بود که و ین ستون هراسی کمتر از معمول به خود راه داد.	the girl was so evidently experienced that he was less frightened than he would normally have been.
که خامه ترشیده	because it was sour
با سرعتی باور نکردنی	with incredible accuracy and nimbleness
از کجا گرفتی	where did you get it
نقد و نقد منظورم همین است	cash, and cash down, I mean?
ولی هزینه یافتن کار ۲۵ دلار بود	but the fee was twenty five bucks.
من کسی نیستم که در اهمیّت و بزرگ جلوه دادن اشعارم غلو کنم.	I do not attach any exaggerated importance to my poetical works.
نه مسی و حالم خوش نیست.	I am too ill
از این بابت مطمئنم.	I'm sure of it.
ولی جواب مورد نظرش را دریافت نکرد	but he never received the response he longed for
در را دوباره بستم.	I shut the door again.
تنها درخواست من این است که گاهی طرف مشورت قرار گیرم.	I only want to be consulted sometimes.
چنان بزرگ بود که تمام فضای راهرو را تا سقف پر کرده بود.	a dog that filled the whole space between ceiling and floor.
اطمینان دارم که این دعوت مرا رد نخواهید کرد.	so I am sure that you will not refuse me.
لکن متأسفانه در آنجا چراگاهی نبود.	though, to my sorrow, there was no grazing here
چشم دیدنشان را نداشت و هیچ کاری هم از دست هیچ کس ساخته نبود.	she couldn't stand them no way you could fix it
باید به موقع بیائی و مرا از اینجا ببری.	so you just must come and take me away.
یه جایی دیشت باهاش آشنا شدم.	I met her somewhere last night.
این را گفت و با عجله رفت.	with these words she broke away and hurried off.
همسر جوان یکی از مردان سالخورده ثروتمند در این جا.	the young wife of an elderly man of fortune here.
با شرش به طرف ولیعهد و دوک اشاره کرد	he wagged his head towards the king and the duke.
صدای خروپفش به هوا رفت.	he began to snore.
من نه به شانس عقیده دارم نه به اینکه ممکنه کسی باعث بدبختی دیگرون به شه	I don't think they's luck or bad luck.
لذا اغلب در فکر او و شوهرش بود.	so he was thinking about her and her husband.
با نوک پا به سوی اطاق او راه افتادم.	walked on tiptoes to his room.
گرچه تنها وجه مشترکی که داشتند فقط همان شطرنج بود.	despite the fact that the only affinity between the two was their addiction to chess
روزهای طاقت فرسایی را با او داشتم.	I had weary days of it.
این بود که این امتیاز زیاد ارزش نداشت.	so that cheapened the distinction too much.
در حالی که عش قاو رو به زوال است و علت شکاف و اختلاف ما همین است.	while his is waning and waning, and that's why we're drifting apart.
اما در گذشته هرگز با ارزشش آشنا نشده بودم.	but I never knew its significance before.
جواهراتی از گل آن را زینت داده بود.	jeweled with flowers.
یکی از کشوها را باز کرد	opened a drawer
به هوشش آورد	made him the more diligent
آن را بست	made it fast
ناخواسته تصور میکند که این غوامض و دشواریهای حل آنها خاص خود اوست	cannot help imagining that the complexity of these conditions, and the difficulty of making them clear, is something exceptional and personal, peculiar to himself,
گفتم که من با این وضع و این بچه نمی تونم	how I was going to have this baby
جایی است که باید باشد.	its where he ought to be
باید این راه را فراموش کنم.	I should forget about it.
منالان این یاتاقان و جاش میذارم	I'm takin' up this here bearing now.
اما روزی که دیگر دیر است.	when it was too late.
اما ناگهان حرف خود را قطع کرده و سراپا گوش شدند.	but they paused to listen.
علامتش را پاک کرده بودند	with the sign burnt off with a plumber's blowflame
افسار را تکان داد.	flapped the reins.
عاشقش هستم و عشق خیلی شیرین است	I love him, and love is very sweet.
در آنجا به انتظار دستور ایستادند.	there stopped, awaiting instructions.
از پوشاندن تن خود با چیزی که بر دوش یاهوئی بوده است سخت نفرت داشتم.	abhorring to cover myself with any thing that had been on the back of a _Yahoo_.
از برای پسرش هم قراری با من گذاشت.	he has opened an account with my house for his son
او تا آخرن لحظه با دلداری مقاومت کرد و عملا در محلا نگهبانی خود مرد.	but valiantly facing everything out to the last, literally died at his post.
چم و خم کار هم دستم آمده.	I've caught the secret.
سعی کرد خشم را به کمک بهواند.	trying to summon anger to her aid
چون بنا بود برای شرکت کردن در مراسم عزاداری به خانه بروم .	for I was going home to the funeral.
اطمینان زیادی را که من به تو دارم	the great confidence I repose in thee!
به حکم تقدیر درست به همان عده نفرات که زیر دست استیل کی لت بودند احتیاج داشتند.	were providentially in want of precisely that number of men which the sailor headed.
اسبش را سوار شد و تاخت.	mounted his horse
انگار برات مهم نیست.	you don't seem to care much.
زیرا هوا خیلی سرد است.	for it is bitter cold.
این کار و بیشتر توی دریا یاد گرفتم.	I learned that much at sea.
سر به زیر و ساکت شده بود.	keeping her head down and working in silence.
رون با دیدن این صحنه شور و شوقش را برای این کار از دست داد.	he lost his enthusiasm for the idea.
به رسم تشکر کمر خم کرد.	bending her body as a sign that she returned thanks.
حتی اگر شده با اعمال جبر و زور.	even if it had to use force for the purpose.
ثانیا از هوساری خود متأسف بود که در آن هنگام در خانه حضور نداشت.	secondly, from his hussar point of view
پیام نفهته در زیبایی الفاظ	the message hidden in the beauty of words.
از این بابت تا حدی شبیه لباس مشهور قدیمی بود	in that respect like the coat
اما در آن سکوت هیچ صدایی نبود.	but no sound disturbed the quiet.
من درست اظهارات او را درک نکردم.	I didn't quite hear.
طفل من باید آنجا باشد.	my child is there!
تسلط مطلق او بر زنش از این راه بود.	hence the absolute empireof the man over that woman.
نگاهی دقیقی به سراپای من انداخت و بعد برگشته به ماکزیم گفت.	looking me straight in the eyes, and then turned toMaxim.
چه اعتراف بکند و چه نکند.	whether he admitted it or not.
دستکش را از دست سفید و زیبا بیرون آورد	he drew the glove from his shapely white hand
اما مثل اغلب تذکراتش همه را ناراحت ساخت.	but, like most of her observations
من به دادگاه احضار نخواهم شد.	I'm not going to be tried.
که شما در شب تولد من به آنجا آمدید و مادرم را ملاقات کردید.	on the night when I was born, and saw my dear mama.
درهای بهشت به رویش گشوده شده بودند.	the doors of heaven opened to her.
بلکه از میان لوله آهنینی عبور کرده بوده است که آن جوان در پهلوی خود تعبیه کرده	but through a hollow iron tube full of blood, which he had adroitly fixed at the place
تو باز هم شایسته محبت کشورت بودی.	you would have deserved well of your country,
با صدایی خشن گفت	he said in a tough voice.
نگهبان کامیون او را گرفت	the guard guy of the truck rabbed him
امروز دولت رس ما منو خریده.	I'm bought by the government for to day.
فکر این کار هم خیلی او را گرفته بود.	the theatrical gorgeousness of the thing appealed strongly to his nature, too
خشک و خشمناک بود.	was stunned and outraged
امشب خیلی به هم خوش گذشت.	I had a good time tonight.
فهمیدم چه باید بکنم.	I know what I'll do.
سه پنجره در سمت راست و سه پنجره در سمت چپ و یکی بالای در ورودی اصلی.	three left, three right, and one above the main entrance.
خیلی سرم نمی شه.	I don't know nothing much about it.
ممکن بود اتفاق بدی بیفتد.	when anything might have happened to her!
این خاطره در این دقیقه مخصوصا برای او مطبوع بود.	the recollection was particularly pleasant at that moment.
برای همین این خانه زیاد به دلمان ننشست.	so we took a gray view of the place.
هوا تاریک بود.	it was very dark.
هیچ وقت آماده نمی شم .	I'll never be ready.
طنین زنگوله پس از صدای ناقوس بزرگ را داشت.	it seemed a gay little chime after the great bell.
ولی سال ۶۶ قهرمان باشگاهم ون بودم و دوباره سال ۶۹ این عنوان رو بدست آوردم و تاسال ۷۶ تیراندازیم خوب بود ولی عالی نبود.	but I was club champion back in '76 and again in '79, and still pretty good in '86.
من بهش گفتم با هم جامو برداریم.	I told him to take the cup with me
باید از آن کشور بیرون رود.	he must depart from the country.
پشتش گویی از سرما مورمور شد.	like a shiver running down his spine.
من کارد را از زیر گوشم بیرون کشیدم	i pulling it out
دیگری چیزی ننوشید.	he drank no more.
هرگز اشتباه خود را تکرار نخواهد کرد.	he would never make that mistake again.
اراده خود را دایر به گذراندن شب را در آنجا اعلام کرد.	graciously announced his intention of putting up there, for the night.
تا به حال چیزی شبیه او نو ندیدم.	I've never seen anything to equal her.
باز فوری یاد فرانک چرچیل افتادم.	thinking of him directly.
اداهای مبتذلش را کنار گذاشت	she left her vulgar teasing
پنداشت که چیزی نمانده بود تا با این خوشحالی نیمه کافرانه به خودش خیانت کند.	uncomfortable feeling that she had been betrayed into a half pagan ecstasy.
خیال کردی دروغ می گم. باور کن غذاش رو دست نداشت.	as I look back on'tnow, it musta been pretty good.
که ممکن است در اثنای صحبت کسی آمده و صحبت ما را ناتمام بگذارند	we might be interrupted in the most interesting part of my story which would be a pity
این یک لباس امپراتور پوشیده است	that the emperor
در میان خیل ساکنان این منطقه شمالی او نیز از جنایتی	he wasone who, out of many in this northern region, had been touched
دو تا اسب میخواد.	it would require two horses.
وارد اتاق شد.	she hurried into the room alone
که توپمان را دربیاوریم.	to get our cannon out.
ضم نا به من توصیه کردند که نرم اونجا. گفتند به وجود من احتیاج ندارند.	besides, they advised me not to come that they did not need me.
این قصبه از پیشرفت تمدن عقب افتاده بود	left behind by the advance of civilisation
اما اگه دیدی	but if you find
سرتاسر آن سال موجی از شورش تمام آن نواحی را فرا گرفت.	throughout that year a wave of rebelliousness ran through the countryside.
حاضر شده بودم در دریا از گرسنگی بمیرم و در چنان جای خطرناکی پیاده نشوم.	I felt willing rather to starve at sea than to confront such perils.
پس باید مطمئن به شم که زنده می مونی.	so I guess I better make sure you're not going to die on his hands.
معتقدم آن قدر تجربه دارم که از این لحاظ مرتکب اشتباه نشوم.	I believe I have lived single long enough not to make a mistake in that line.
اما به طریق خاص خود.	but in her own fashion.
بعد بدون آن که عینکش را از چشم بردارد	without even removing his glasses
در این موقع چون مدتی از ساعت یک بعد از نیمه شب گذشته بود آماده شدم او را ترک کنم.	now, as it was long past one, I prepared to leave him.
سپس صدا کرد	then the square cracked
عینک خود را روی پیشانی بالا زد	pushed her eyeglasses up onto her forehead, a
خاصه همین مشروب که دکتر ساخته است	for a draught of the beverage prepared by the doctor
دی گه به زندگی خصوصی ادم که نباید کار داشته باشین.	I like a healthy breeze round my privates, thanks.
پیش از هر چیز دو چشم درشت و زرد دید.	found himself gazing into a pair of lamp like yellow eyes.
یک فرزند داشت یعنی همین مردک	had one child, this fellow
بدون این که حتی مطمئن باشد که واقعاً او بوده است.	or if she was the one he was looking for
با سختی صندلیی به او تعارف کرد.	he stiffly indicated a chair.
اما با وجود این خوشحال بود.	even in her despair, she was glad.
1830 انقلابی بود که نیمه کاره باز ماند.	1830 is a revolution arrested midway.
بنابراین من می تونم شر ببندم که نزدیک محدوده خودش ون میمونن	I'd bet he's keeping it close to home.
خانم وی زلی گلدان را جلوی او نگه داشت.	she offered him the flowerpot.
بیشتر رموز کار را خود فراگرفته بود	had been chiefly his own teacher
در حالی که به زحمت به یاد میآورد کجا بوده و به کجا خواهد رفت.	with difficulty remembering where he was, and where he ought to walk or drive.
با نامشان آشنا شده بود طبق این خبر در آن مجلس حضور داشتند.	she was becoming most familiar were recorded as present.
فکر کرد بهتر است کاری نکند که دامنه صحبت به مسایل ناراحت کننده برسد و چیزهایی که از نظر او هوناک بود مطرح شود.	casting about quickly in her mind for some topic of conversation that would put off the bad moment when the subject she feared would come up for discussion.
باید بگویم این موضوع سبب تعجب من شده.	I must say this comes as something of a surprise.
من که حالم داره بد می شه.	I think I'm gonna be sick.
قدمی به جلو برداشتم.	I took a step forward.
صفحه را روی ذهنم اسکن کردم.	I scanned the screen in my peripheral vision.
لاغر بود و کمی خمیده	was lean and stooped somewhat
مگر اینکه از آن یک فیل که فرمودید سر کلاف را پیدا کنیم.	unless by that clue there's in it, one may draw out the ball of the whole matter.
کلاهم را برداشته بودم	I had raised my hat
اما راضی نیستم	but I will no
این کار و بر خلاف میلیشون انجام ندادم.	I didn't do it against their will.
زیرا در حقیقت هر گاه آنان نخواهند سخنان تو را گوش کنند گناه بر تو است.	for in truth you are to blame for their not wanting to hear you.
اندکی عقب رفتم تا آن را بهتر ببینم	I moved a little to see it better
در را باز کرد و ادامه داد	as he threw open the door.
طوفان آن قدر شدید بود	but the storm had been so violent
فراموش نکنید که پاسی از ساعت نه گذشته است.	please remember that it is after nine o'clock.
لیکن ناخدا آن را کافی ندانست	but not enough for the captain's fancy
بی شک پسر بزرگ دوک نیز مرا دوست داشت	for though the elder was attached to me
زنش مرده بود	he was a widower
ولی از لرزش او لذت برد.	but he enjoyed the way she cringed.
