امیدوار بودم به قدری ناراضی نباشد که از خیر سوا لاتی که منتظرشان بودم بگذرد.	I hoped she wasn't so dissatisfied that she would skip the questions I was waiting for.
اما من دویدم و به تنه درختی پناه بردم	but I ran to the body of a tree
بر سنگ قبر کشیشی که چندین سال پیش درگذشته و بر اثر زهد و تقوی شهرت فراوان کسب نموده بود نشسته است	itting on the tombstone of a monk who had been famous long ago for his saintliness.
اگر خواننده تمام هوش خود را یک جا به ما بدهد	if the reader puts all his intelligence at our service
حی علی الفلاح.	come to security.
به او علاقه بسیار پیدا کرد.	took great interest in him.
بابتش پنجاه دلار پول داده بود.	it cost fifty.
از بالای دیوار دشت سمنتی گسترده و یکدست را مشاهده کرد.	peered over the wall to the broad smooth plain of cement.
تا اینکه تقریباً با تأخیر چهل ساله به اهمیت ساده زیستن پی ببرد.	in order to discover the privileges of simplicity almost forty years late.
اما زنگ ساعت خبر خوشی برای ما بود.	but the news was good
من چشم بسته راه میرم.	I could shut my eyes an' walk right there.
بارها و بارها دیدمش.	I see him from time to time.
ما در کشتی کهنه فلینت که وال رس نام داشت مانده بودیم	us standing off and on in the old WALRUS.
استیرفورث هم اطاعت کرد و روی صندلی نشست و پشتش را به میز چسباند.	who, accordingly, sat himself down, with his back to the table
مردی با صورت اصلاح نشده و کثیف با شمشیر و نیز صلیبی کوچک که با نخ سفید به سینه چپ اونیفرم ستوانی اش دوخته شده بود	some unshaven, dirty man, girt with a sword and with a tiny cross embroidered in white cotton on the left breast of a lieutenant's uniform
کریستف دل تنگ بود که چرا اینک که آن دیگری مرده رو زا همچنان زندهاست.	he hated her for being alive while the other was dead.
اما به نظرم میاد که این جور ادما بدون خرد کردن افراد دی گه نمی تونن به جایی بر سن.	but it seems to me these guys don't get to the top without trampling over a few people on the way.
من گفتم نه.	I said no
این خنده طنین دار وزیر و رجل سیاسی تأثیر عجیبی در وی کرد.	this ringing, high pitched laughter from a statesman made a strange impression on him.
تمام شب را به میگساری پرداخت و آنقدر در صرف نوشابه افراط کرد تا به دست خود رشته حیاتش را برید!	he has spent the night in drinking himself to death deliberately!
چشمش به دو رشته گیس زرد افتاد	he saw two long tails of yellow hair
اما چون وکیل پادشاهی غایب است مکتوب رسیده به کاتب اسرار ایشان که اذن باز کردن مکاتیب را دارد	but that gentleman being absent his secretary by his orders opened his letters
من وقتی دیدم	when I heard
که نزدیک یک ربع ساعت در کالسکه نشسته بود.	who had been seated a quarter of an hour on his box
آنا وقتی او را دید تلوتلو خوران جلو آمد و خود را در آغوش او انداخت.	as she saw him, she staggered forward, and half fell into his outstretched arms.
پس از حمله فقط هیجده نفر باقیمانده بود.	only eighteen were left after the charge.
عاشق دریا و عاشق عشق بود.	he loved the sea and love
جزوه کش را در بغل خود محکم کرده و خفت.	placing his pocketbook under his pillow.
خیلی دوست دارم.	I do like it so very much.
من توانستم اطراف آن را که با چندین سلسله راهرو و پلکان محاط شده بود و در فواصل معین ممکن بود که از یکی به دیگری فرود آمد بنگرم.	I could see the sides of it encompassed with several gradations of galleries, and stairs, at certain intervals, to descend from one to the other.
یادآوری اندوه گناه نیست.	it is no sin to remember a grief.
دوتاشون زوار دررفته	two layers of fabric worn through.
کورمال به طرف اطاق رفت	went in the darkness
بلافاصله به عنوان یک اشراف زاده منفور به من حمله کردند	I was set upon at once as a hated aristocrat
زیرا با اینکه پتو مانع دیدن بود	for though it was covered up
کشته خواهد شد.	that man's dead.
شما دو تا باید بدوئید	you two need to run.
ولی من اجازه نمی دم از این کارها به کن ین.	but I won't have you do this sort of thing.
حتما خود او این تقویم را روی دیوار کنده است.	it was he, without doubt, who scratched a calendar on this stone.
قلب پلاگه شروع کرد بآرامتر زدن.	her heart began to beat more lightly.
به ساختمان خانه خیره مانده بود	his eyes fixed on the house.
12 نسبت به درماندگان بسیار مهربان و دلسوز است	12. he is kind and compassionate to the poor and weak persons
کاری کن که از این وصلت راضی باشد.	incline him to be satisfied with the match.
می دونم خانم	I know, ma'am.
شعله جلویی را روشن کردوقهوه را روی آن گذاشت.	lit the front gas ring, and put on the coffee.
از صمیم قلب دوستتان دارم.	I love you dearly.
در این قایق هیچ جای ترس نیست.	there is no room for fear on this lighter.
نوبت بدبختی فرارسید.	then unhappiness came.
زیرا رفیقش هنوز بیهوش بر زمین افتاده بود	for the carrier still lay senseless
با تعداد صفحاتی که شب قبل پس از مرخص شدن از نزد او موفق شده بود بنویسد.	as many pages as he had written since his farewell to her.
پس شاید تمهید شر و فسادی درباره شما کرده باشند.	it was, perhaps, some plot against you.
نیز نوعی نا آسودگی خاطر در عشق هست.	it has in it a certain diffidence.
که این حرفه را انتخاب کردهاند و تصدیق میکنید که هر شغلی جنبههای منفی هم دارد.	who have chosen that career, and one must allow that every calling has its disagreeable side.
این یک قهرمان بزرگ است!	he is a hero!
به طرفش رفتم و کنارش زانو زدم.	I went and knelt beside him.
این رنگش را ندیده بودیم!	but this beats everything.
این بار واقعا از ناراحتی به گریه افتاد.	she cried in real anxiety and burst into tears.
کشف کردم که از چه چیز ساخته شده است.	I discovered what it was really made of.
شمارو می گم!	that you are not!
آنقدر بزرگ شده بودم که لذت تنها بودن را احساس کنم.	I was just old enough to know that it's good to be alone occasionally.
از حل این مشکل که شعر چیست و حقیقت چیست نومید شد و در افسردگی ژرف فرو رفت.	he despaired of being able to solve the problem of what poetry is and what truth is and fell into a deep dejection.
من قبل از ناهار این اتاق را با دقت گشته بودم.	I searched this room carefully before lunch.
خانه آتش گرفت و از بین رفت.	the house had burned down
موجب جذب بهترین مواد غذایی از سراسر آن مناطق گردید.	attracted the best qualified gluttons from all along the coast.
بستگی او را با خود تایید کرد.	has acknowledged the relationship.
که او در حال حرکت بود	who was directing his steps
ناچار بود ردایش را بالا جمع کند.	he had to hoist up his robes
که معمولی و گذرا نباشد.	but what was very moderate and very transient.
او بارها با زبان رسا ثروت و صاحبان ثروت را محکوم کرد	who again and again, in the most explicit language, denounced wealth and the holding of wealth
چوب زیر بغلش را انداخت	threw over his crutch
چه عرض کنم!	I'm ignorant of it!
گرچه از روی احتیاط آن را زیر پیراهن خود پنهان نموده بود.	but he was careful to hide it under his shirt.
هری پاتر باید بیدار به شه!	he must wake up!
تا نگاهی بیندازم.	so I entered to see.
به راستی هم چنین بود.	so indeed it was
توی قطار هاگوارتز خونده بودمش.	I read it on the train coming here
منم هیچی ندیدم	I didn't see anything either
در آن به صراحت اعلام کرده بودند	had stated quite clearly that
باید کمکشان کرد.	we ought to support our cossacks
اوه ماکزیم! این طور حرف نزن!	I think that's very unfair,' I said.
شاید آن ماجرای بزرگ خودش هم خوابی بوده.	the great adventure itself must be a dream!
بی آنکه مدلی انتخاب کند یا درباره آن جر و بحثی بکند.	without choosing or discussing anything.
حتم داشته باشند جامهاشان تهی نباشد.	make certain that their glasses were full.
کسانی هم در زندان بودند که حاصل یک لحظه خشم و عصبانیت زود گذر بود.	others were in prison because they had committed crimes of passion or succumbed to a momentary temptation
حسابی قاطی کرده بودم.	I completely messed up
مادیانش را با اشاره چشم به او نشان داد	pointing to his mare
سال بعد و که ازت نگرفتن	next year 'll do.
در حقیقت پای سیاست گاه است.	at the foot of the scaffold
ناگهان عظمت خطر را دریافتم.	of a sudden, I began to comprehend.
تو وقتی از شکم مادرت بیرون آمدی حاکم نبودی	you came out of your mother's womb without a government
عروسک حسابی به خود ندیده بود قابل تحسین نباشد.	who hadnever had a doll in her life, a real doll
حیف که پاک شد!	the more's the pity!
از آنان خواهش کردم که ورود مرا به یکی از منشیان دربار خبر دهند	desired them to signify my arrival to one of the secretaries
نخستین قسمت عمرش یکسره صرف دنیاداری و زن دوستی شده بود.	the whole of the first portion of his life had been devoted to the world and to gallantry.
که طبیب مخصوص مادر من هم هست.	who attends my mother
اون وقت جارو جنجال راه میندازن و خیال میکنن کشته شده	then they raise hell an' figger he been killed.
هر چند شک نیست که نام همچو چیزی را هم هرگز نشنیده بود.	though no doubt he had never heard there was such a thing as that.
تازه همه چیز بسیار شفاف بود	NEWEverything was so clear.
کاغذها و این چیزها شو اون مینویسه.	writes the warden's letters and stuff like that.
نفس شوم خود را در کلاس شلوغ و خوابگاه آن دمید	breathed typhus through its crowded schoolroom and dormitory
آخر خیابان بند آمده بود.	for the street was blocked.
من او را دیدم.	I saw him
کاش می تونسم حالا بهتون نگم	I wisht I could wait an' not tell you.
من ممکنه سرما بخورم	I might get cold.
با دیوارهای بزرگ و زرد و سفید صومعه های متروکه اش پشت ردیفهای سروهای سبز تیره که ماهیتی بسیار مدرن دارند	with the great yellowy white walls of abandoned convents behind the rows of sombre green cypresses, that fact very modern in its spirit
خوش داشت که حساب مرا چنین بنامد.	as he was pleased to call it.
باز چند ثانیه گذشت.	a few more seconds went by.
دست یکدیگر را گرفتیم	lay hold of each other
حرارت خشم من تو را بر افروخته و گداخته کرده!	my heat has melted thee to anger glow.
گاه چند تکه نقره شش تا در ته تور است.	sometimes there's an inch of silver six words in the bottom of the net.
امیدوارم به کارهای غیرقانونی متوسل نشده باشین	I hope that you didn't do anything illegal
به هم می گه باید بذارمشون راحت با شن و خودم برم	I got a feelin' I oughta go away an' let 'em be.
از آن پسرک واکسی هم چیزی دستگیرم نشد.	I could get no sense out of the chap who cleans them.
این معجون باید خوب بجو شه.	this potion needs to stew before it can be drunk
وقتی که بتواند دوباره از او جویا شود	when he should again interrogate her
عینکش را تا روی پیشانی بالا زد	he pushed his spectacles up on his forehead
باید یواش قدم بردارند	they must go softly
جبهه به امن احتیاج دارد.	I am needed.
هم ون طور که خودت گفتی.	just like you said!
او محبوب و مخدوم پهلوانی چون شخص حضرتعالی است.	she is loved and served by such a knight as your worship seems to be.
آیا انتظاری غیر از این داشتند.	whether they expected to.
به نظر من ناقابل تر از این هستید که از افتخارات وطنتان دفاع کنید.	a man who does not even know how to carry his breeding.
اما چون دیده که جسد طفلی است	, but, perceiving his error
شوخی خطرناکی که با زندگی و همه چیز من بستگی داشت.	the best of them all.
شاهدی احضار شد تا متهم را شناسایی کند	a witness was called to identify him
مال خود شه.	it belongs to him.
در واقع در آن حد که مربوط به یکی دو خاصیت عجیب و بسیار جالب توجه در عادات وال سر زا باشد	indeed, as indirectly touching one or two very interesting and curious particulars in the habits of sperm whales, the foregoing chapter, in its earlier part
اگر من هر شش تن را بر زمین نزدم	if I do not knock them head over heels
کار خیاطی را که دستش بود از سر گرفت.	resuming her work
ناشناس نیز سخت برآشفته و غضباناک بود.	that the latter was in a state of considerable irritation.
موهایش مثل سایه یا مثل ابر بی فروغی بود که توفان یا نیروی شدید آذرخش آن را از هم گسسته باشد.	the hair streamed shadowy, like a beamless cloud torn by storm or by electric travail.
آنگاه او یک مرتبه به سوی چپ ساحل رودخانه پیچید.	then turned suddenly down a bank upon the left.
دوباره امتحان کردم.	I tried again.
دهانش مانند فنری فشرده بسته شد.	her mouth tightened like an overwound spring.
کتش را درآورد و از طرف چرمش روی زمین انداخت تا بتوانند رویش بنشینند.	taking off his coat and spreading it lining side up on the ground so they could sit on it.
سی ساله شده بودم.	I was thirty.
امکانش هست پیش شما بیایم و ببین متان	I wonder if I could come and see you?
که جرئت نداشت برای خود تفسیرشان کند.	that she did not dare to decipher.
لبخند آبنبات فروش هم شبیه لبخند پادشاه پیر بود.	that smile had also been like the old king's smile.
برای ایشان باید مثال های ملموس و آسان	but must have examples that are palpable, easy,
اندیشید که شاید سرما خورده باشد.	reflected that he might have a cold.
در این موقع دو زن و مردی که کلاهی سفید به سر داشت از طرف خانه اربابی به سوی افسران آمدند.	two women and a man in a white hat were seen coming toward the officers.
اون توی جنگله.	he's in the forest
که نفوذی علیه من به کار نبرید.	as to urge no influence against me.
البته این در موقعی بود که دیگر اوقاتش به وضع توصیف ناپذیری تلخ شده بود.	but this was carrying out his virtuous precepts to an unusual extent.
به دور و برم نگاه کردم	I look around
آنگاه ماجرایی وحشتناک و دور از عقل و خرد بر سر دن کیشوت آمد که شرح آن خواهد آمد.	to whom there fell a terrific and desperate adventure.
ولی حال به همان منوال نماند	but not for long
پس اگر او را کشتم	if I am victorious
من عقیده داشتم	I had quite made up my mind
تصور بسیار نامشخصی داشت	he had a very indefinite notion of what it consisted in
اگر من هم متقابلاً احترام خودم را به شما بدهم دیگر مدیون هم نخواهیم بود.	if I give you mine in return, that debt will be quit.
در این در!	take this door!
بی آنکه لکه بر جامعه نظامی او برسد	without some stain of infamy or blood to soil the uniform of the soldier, or the gown of the magistrate
بهترین پیشنهادی که به ذهن کلاید رسید آن بود	the best he could suggest was that both were to try
. از نارنجک دستی که به کمربند او آویخته بود	where a hand grenade was fastened to the belt
موجب شود که بتوانند نقایص کار مرا جبران کنند.	will be curious and able enough to supply my defects.
قصدم همین بود.	I wanted to,
با صدایی زیر و گوش خراش فریاد زد	crying in a hoarse sort of screech
بار دیگر به آن چیزی فکر کرد که همسرش از آن واهمه داشت.	he began to think again about what she had feared.
گویی سعی داشت مطلبی را به خاطر بیاورد.	as though he were going to pick something up.
اگر اشتباه نکنم یک نامه برای یکی از افسرهای تو دارم.	here is a letter for one of thy officers, if I mistake not.
سعی داشت آسودگیش را در دل نگه دارد	trying to smother his relief.
فکر کردم اون مرده که عینکش شکسته و عقاید عجیب داره به طرفم میاد.	I thought you were probably the man with the broken glasses and the queer philosophy.
به سمت من نگاه کرد.	glanced towards me.
بازمانده آن بناهای عالی که به سالیان دراز برافراشته بودند از ویرانی برکنار ماند.	the rest of that noble pile, which had cost so many ages in erecting, preserved from destruction.
بعد پایین آمدم .	I came down again.
ولی اگر شما نتوانید بر خودتان مسلط باشید و در هم بشکنید ما میتوانیم ضرر	but if you can't keep up your end, we will stand our loss, of course,
ولی مادرم او را از این کار بازداشت و بر سر میز نشاند.	but my mother wouldn't let her do it, and made her dine with us.
وود منتظر جواب هری نماند.	then, without waiting for an answer
احساسات و رنج و شرمساری و پشیمانی او را درک کرد.	he understood her feelings, her sufferings, shame, and remorse.
پنهان داشتن نام واقعیش تنها شرط پدر او برای ازدواج ایشان بوده است	his concealment from herself of the name he had relinquished,was the one condition'fully intelligible now'that her father had attached to their betrothal
من محصل فقیری هستم و با ید در فکر تهیه پول وزندگی باشم.	but I am a poor student, and I have my way to make.
از آن به بعد من با خودم عهد کردم که حالا که همچی شد دیگر دست به پوست مار نزنم.	I made up my mind I wouldn't ever take a holt of a snake skin again with my hands, now that I see what had come of it.
به این ترتیب سیر و سلوک خود را در خانه آغاز کرد	so began a perambulation of the house
جانش در خطر بود.	was in danger
سعی کردم لبخندی زورکی بزنم اما نتوانستم.	I try to smile, but my face won't quite do it.
شرمندگی مورد نداشت.	there was nothing shameful.
برای ابد از نظر ناپدید شده بود.	or anywhere else ever again.
با این همه خود را محکم به تنه درخت چسباندم و از آن بلا جان به در بردم.	however, I escaped pretty well by sticking close to the stem of the tree
دردمند و وامانده بود.	most of it grief and pain and hunger.
چون دوستش در پی افسانه ی شخصی خودش به این سفر آمده بود	his friend was in pursuit of his destiny.
تا برای آخرین بار خانه را تماشا کند.	for a last look at the house.
قانون قانون است.	law is law.
به چرخاندن آن ادامه داد.	continued to turn it.
تردید نیست که در گفتار خویش صادق بود.	I have no doubt she did.
به زودی برای من روشن شد که	indeed, it was soon plain to me that
خیال داشت این کار را ولو اینکه موجب خفه شدن او گردد انجام داده	at the risk of being stifled
چون کلاه خود پهلوان را که به ضرب چوب خرد شده بود از سرش برداشت	relieving him of the visor, already battered to pieces by blows
پیر مرد عصای خیزران خود را به دست گرفته	fumbling about him for his cane
من همه موارد ممکن را بررسی کردم.	I checked them all out.
خیلی شانس بیارم چند دقیقه دی گه زنده می مو نم و نه بیشتر.	I'll last a few more minutes with luck, but not much longer.
بعد باز به طرف من آمد و شروع کرد به تحقیق و فحش دادن.	then he turned to me, scolding and questioning me.
من دیگر جگرگوشة زیبایم را نخواهم دید.	I never shall see my pretty darling again.
روح یک سرباز هنگام یکه یک ارتش دارد	or as if the soul of the warrior, when he has an army
تا موقعی که این کار انجام نگیرد	until that was done
لحن صدایم را آهسته و ملایم نگه داشتم	I kept my voice light.
مسیو نوارتیر خادم را پایید تا بیرون رفت	MNoirtier looked after the servant until the door was closed
من در این باب فکری خواهم کرد.	I will reflect.
این نکات هر چند ممکنست که در نظر عوام کالانعام سخیف آید	however insignificant they may appear to groveling vulgar minds
اما من گنج را پیدا کردم.	I found the treasure.
آینده جز بر شکست دلالت نداشت.	we had nothing before us
ای کاش می تونستم اون ابله گنده پشمالو رو موقع دفاع از خودش ببینم که می گه	I really wish I could hear that great hairy moron trying to defend himself
بلوزها را نیمی در اندازه بزرگ و نیمی در اندازهٔ متوسط بگیر.	get the blouses half in large size, half in medium.
این بود که هنوز چیزی نگذشته به کلی لخت شدند	so it was not long before they were stripped
تا اینجا آمده باشد و باز گردد!	should he retreat after going so far?
چقدر ناپسند است.	it's very unbecoming.
که به جای کلاه کوچک یا شاپو دو شاخ عظیم برسردارد.	that, instead of a cap or hat, he has two immense horns on hishead.
من قابلیت این کار را ندارم.	I am incapable of doing so, he said.
خودش نیز از جرئت و جسارت خودش تعجب کرده بود.	horror struck by his own daring
اما با بسیاری از همنوعان خود در سفیدی و نرمی پوست خود تفاوتی عظیم دارم.	but that I differed very much from the rest of my species in the softness, whiteness, and smoothness of my skin
شاید عملا نوعی ضعف بر او مسلط شده بود.	perhaps some faintness actually attacked her.
سفر دریائی من پانزده روز ادامه داشت	spent fifteen days in the voyage.
فقط از آن جهت است که فهرستی خسته کننده است	it is only that the catalogue is tedious
طوری نیست که سرما بخورم.	it is not the sort of thing that gives me cold.
چون سه چهار بار گفته بود که اگر باهاش عروسی نکنم خودشو میکشه.	because shehad said three or four times that if I didn't she would kill her self.
دکتر لاریویر با وجودی که به این قبیل مناظر دردناک عادت داشت نتوانست از افتادن قطره اشکی روی تور پیراهنش جلوگیری کند.	this man, accustomed as he was to the sight of pain, could not keep back a tear that fell on his shirt frill.
باورم نمی شه بازی شب پیش رو از دست دادی فقط واسه اینکه خوابیدن یه نفر رو نگاه کنی.	I can't believe you missed the game last night just to watch somebody sleep
مطمئن باش که شد.	I assure you she did.
همه مجبور شدند منتظر من بمانند.	I made us all late
دکتر گلن حالت روحی ربرتا را در آن هنگام که به مطب او رفته بود شرح داد	to describe the state of mind in which she hadapproached him
با تعجب و تاسف دیدگان او را لبریز از اشک یافت.	she was surprised and saddened to see that there were tears in his eyes.
ما مو ندیم و بقیه رفتن.	we stayed behind
در مواقع ضرورت با صاحب نظران و مردان کار مشورت کند	consulting experienced theoreticians and practical men where necessary
از روی مطالب مختلفی یادداشت برداشتم	various subjects for annotation have presented themselves
راننده ماشین راننده شخصی نبود بلکه پاسبانی بود که با غرور تمام اونیفورم به تن داشت.	driver not achauffeur but a policeman proud in uniform
با حالت خشکی گفت	he said coldly
که با من سابقه آشنایی دارد	e, who is under some obligation to me
معمولا من روزی ده تا ایمیل داشتم	I normally get about ten emails every morning, if that.
سوای جنگ دو خاطره داشت	out of the war he carried two memories.
زن جوان خیلی جذابی است.	a very pleasing young woman.
اما به کاری دست نبرد.	but, no more was done.
تا پیشنهاد رفع اختلافی را بدهد که در یک مسأله بسیار مهم فلسفی بین آن دو پیدا شده بود.	to clear up a difference that had arisen between them on a very important philosophical question.
اما هیچ یک از ما آن را در غالب کلمات پیش نکشید.	but neither of us put words to it.
نفس در سینه نگاه دارد	hold our breath
پاکتی چرکین و نگشوده را پیش روی او گذاشت	laying a soiled and unopened letter before him
پیرمرد انگشت بر لب نهاد	he laid his finger on his lip
من یک هفت تیر در دستم هست!	I old a pistol in my hand!
صفحه و همه چیز دارن.	have pages and everything.
وقتی گفتم خودم را نشناختم.	I didn't recognize my voice when I answered.
او به یک جست از روی قربوس زین پریده و بر پشت مادیان جا گرفته است	she cleared the back of the saddle in one jump
در را باز کنید.	open the door!
ناگزیر تصمیم گرفتند که آرام بگیرند	so they thought it best to allow themselves to be pacified
من هم دوست نداشتم.	I didn't like it, either.
کتابهائی را می خونم که ممنوعه.	I am reading forbidden books.
البته با مغز سالم.	with a sound mind.
برای انجام مأموریت جدیدم به راه افتادم.	drove off upon my new quest.
من هم پسری دارم	I have a son too
این خوشی است	that is joy
شعورش فقط به اندازه یک مرغه.	for she hasn't the sense of a guinea hen.
عظمت این سپر انداختن خود را در حالت نشستن او نمایاند.	the enormity of her relief showing in the way she sat
حال باید بیهوده در میان دشت بایستیم.	now here we stand in the middle of a field without rhyme or reason.
تا این که یک روز در رستوران هتل میز مجاور ما. برای اولین مرتبه پس از سه روز خالی بودن. اشغال شد	I saw that the table next to ours, left vacant for three days, was to be occupied once more.
که رنگش پریده	, during which his face became pale
لابد دلتان برایش خیلی تنگ شده!	how you must miss her!
له و بی دل و دماغ یواش	crushed and crestfallen.
به قفس خود برگرد.	shut yourself up again.
که عقدنامه را امضا کند	to sign the contract
این بار دیگر آواز نبود	not this time singing
از اتاق بیرون آمدم و در را بستم.	I was and shut the door behind me.
چشمان را با دست گرفته بود	shading his face with his hand.
کسی چیزی از تو نخواست.	I don't want you to do anything
مصمم بود که هیچ محلی به پشیمانی باطنی خاله جانش نگذارد.	he was morosely gratified by the consciousness of it.
ولی دنیا پراز چاقوئه و خیلی راحت یکی دیگه میتونه پیدا کنه.	but the world is full of knives just lying around waiting to be picked up.
اما این مرگ مرا تکان داد.	but her death shocked me terribly.
هنوز خون پدرم در پیشانی تو نمایان است.	you have still on your brow your master's blood!
گرچه نباید از تو نزد خودت شکایت کنم و باید شکایت تو را نزد شوهرت ببرم.	as it is of no use complaining to you. I mean to complain to your husband.
بذارین فکرها شو بکنم.	I'll think the thing over
صرفا اینکه طرف نامه او را دریافت داشته است و خواهد آمد.	that he has received the letter, and will come.
یک بانوی بزرگ بود.	was a very great lady.
سر خم کرد و لب لب را یافت.	he bent his head, groped with his mouth for hers, found it.
خیلی کثیف بود!	it was nasty!
سعی کردم قلبم را حس کنم. سعی کردم پیدایش کنم.	I tried to feel my heart, to find it
زودتر برو مشغول شو.	you can go and get on with it
همه نشتند و مشغول شدند	they were all seated and busy
در تمام مدت ناهار بیش از پیش به هیجان آمده بود.	that all through dinner she was more agitated than ever.
به بیچارگی ایشان نظر کنند نه به اعمال بدشان.	having regard to their sufferings and not to their rascalities.
سمت آشپزی داشتم	I was cook in.
شما خود تفحص مستحق ین نمایید	, but you have only to search for yourself
آن وقت از وحشت موهای تنم سیخ شد.	then my blood crept cold through my veins.
تویی که هم مهربان به طایفه بشری	, thou art indeed man's father in heaven
خرج گزافی نبود.	are not too much
دوباره آن صدا را شنید	when he heard it yet again.
کهنه حرامزاده محکوم خواهد شد.	the old scamp will be condemned.
چشم به خاطر خواهم آورد.	I will remember it, said the young man
پیچید و دوباره به سوی شرق پیش رفت.	turned and went due east again.
او بیدار نشد.	didn't wake up.
این استان را در ماتم و اندوه فرو برده است.	has cast a gloom over the county.
لذا به دیدار دیوانه رفت و بیش از یک ساعت با او حرف زد.	obtaining access to the madman conversed with him for an hour or more
ولو پانزده هزار میل یا بیشتر تا جایی که کشتی دنبال وال خواهد گشت فاصله باشد.	even though she may have fifteen thousand miles, and more, to sail ere reaching her proper cruising ground.
من یک ماه صبر کردم	I waited a month
خیلی امید داشت که به شه اونها رو رام کرد	he was hopeful that they could be tamed.
اما یک کلمه از سخنان همدیگر را نفهمیدیم.	but neither of us could understand a syllable.
فکر بکری به ذهنم رسید.	I have a totally brilliant idea.
من می دونم که دوستت دارم.	I know I love you.
از خاک بیرون بیایند	coming out of the earth
همه بوی مرغ را شنیده بودند	all of them smelling chicken.
البته اگر بخواهی او را ببینی.	if you ever want to see him at all.
من شماره دیروز را دریافت داشتم و بی درنگ آن را مطالعه کردم.	I got the paper and read it yesterday.
راننده حرکت کرد.	the chauffeur drove on.
ما از آن به بعد دیگر هرگز او را ندیدیم	after that we saw him no more
گذاشتم غرایز طبیعی کار خودشو نو بکنن تالیا هم همین احساس و داشته با شه.	I let the practical instincts take over, letting her feel that, too.
اما آن استاد ما را مطمئن کرد که اگر این عمل با زبردستی انجام گیرد بهبود و شفای آن دو تن قطعی است.	but the professor assured us, that if it were dexterously performed, the cure would be infallible.
چون معشوقش دچار توهم شده و عقل خود را از دست داده است.	her bedazzled sweetheart must have lost his mind.
طبیعیدان را دیدم که جلو در یک اتاقک انباری در گوشة باغ میوه ایستاد.	I saw the naturalist pause at the door of an out house in the corner of the orchard.
می خوام بدونم چرا باید به خاطر تو دروغ به گم	I want to know why I'm lying for you.
گفت حرف خوبی زده است	declared he had said a very good thing.
کسی جرأت نداشت که به آنجا نزدیک شود.	no one ever dared go inside
سپس تصمیم گرفتم که هرچه زودتر فرار کنم.	I decided that I must escape at once, if ever.
کارم خیلی زیاد بود.	I had to work.
بعلاوه پنجاه درصد 14400 دلار کمتر از آن بود که به خاطرش ناپدید شوند.	besides, 50 per cent of $14,400 was too small a sum to disappear for.
این خود او بود.	but it was she.
من جرأت ندارم اصرار کنم.	I dare not insist,
هر سلاحی را که فرا چنگشان بود برمی گرفتند	caught up what arms they had
پلنگی ماده یافت که زخمی شده بود.	he found a wounded panther
ولی من اجازه نخواهم داد این جا توسط زندانیان اداره بشود.	but I can't allow the inmates to run this prison.
که گفتی قصد دارد مغز آن را از هم بپاشد.	as if she knocked its brains out
یا به نحوی شگفتی انگیز از وال گیر مجربی تعلیم گرفته است.	or else marvellously tutored by some experienced whaleman.
این موضوع را به وضوح میدانست.	she felt that clearly.
اما دقیقا یادم نم یاد.	I don't really remember.
مطمئنم که من و تو می تونیم با همدیگه راه بیائیم.	I know we're going to getalong.
ناخدا لختی خاموش ماند	a flea in his ear, as the saying is.
یعنی محیط آن تقریباً شش فرسنگ و نیم است	about twelve miles in circumference
به خانه بازگشتم	I returned home
این برای من مسلم است.	I am perfectly aware of it.
ناخودآگاه کنجکاویم را بر زبان آورده بودم و حالا برای پس گرفتن آن حرف دیر شده بود.	I voiced my curiosity impulsively, and then the words were out, and it was too late to recall them.
به همین یک دلیل اکتفا نداشته و تا محقق نکند از اتاق بیرون نشد.	to be convinced by a single proof.
اسب را به حرکت آورد تا بار دیگر در طول خط زنجیر هوسارهای خود گشتی بزند.	touched up his horse to ride once more round his hussars.
من نمی دونم.	I don't know.
بنابراین وقت یا جرات نکرده که بیشتر و واضح تر از این بنویسد.	so that he had no time or did not dare to write anything longer or plainer.
بعد همه با هم با دادوفریاد و سرو صدا راه افتادند و هرچه طناف رخت پهن کنی سر راهشان دیدند پاره کردند و همراه بردند که یارو را با آن دار بزنند.	so away they went, mad and yelling, and snatching down every clothes line they come to to do the hanging with.
که برای ناهار نتوانستم به منزل بیایم.	that I didn't come home to dinner.
مچ ظریف او را برای یافتن نبض در دست فشرد.	taking the frail wrist between his fingers, feeling for a pulse.
نزدیک قطار در حال عبور ایستاد .	stopped quite near the approaching train.
نشاط خاصی به او داده و سبب شده بود که آن شب شنگول و تر دماغ به سوی خانه بشتابد.	cheered him and caused him to step along most briskly and gayly.
واقعة بهجت اثری که پیش آمده بود ناگهان به یادشان آمد و جملگی به صوی چراگاه دویدند.	suddenly remembering the glorious thing that had happened, they all raced out into the pasture together.
چه وقار و هیبتی!	a most worthy old man, and what dignity!
اما حال دیگر او این دو ایالت زیبا را نخواهد دید.	now he won't have those splendid provinces.
که کنار قبره.	that's on the edge of the grave.
منتظر اوامر او ماند.	awaited his directions.
با اکلیل آراسته شده بودند	beaded round with gilt
نفس عمیقی کشیدم تا کمی خودم را آرام کنم.	I took a deep breath, willing myself into composure.
شب سوم برای این که مجبور نباشد نزد من بماند از درد سر شکایت کرد و به اطاق خودش رفت.	on the third from recovering my company she complained of a headache, and left me.
دی گه تم وم شده	now it's done.
گویی مرد محبوب خود را از دست داده یا فریب او را خورده است.	like a girl who has either lost the man she loved or been cruelly deceived by him.
باید تمام حقیقت را بت و بگویم	I must tell you the truth.
بلکه اصلاً روحشان خبر ندارد که باید چه چیزی ابراز کنند.	haven't the faintest idea what there is for them to express their will about.
با آتش ترساندمشف و ذره ذره داستان واقعی را با یک عالمه غرغر و گریه و زاری از او بیرون کشیدم.	I put the fear of fire on him, and wrung the true story out of him, bit by bit, together with much snivelling and snarling.
ابروهایش را تا آخرین حد ممکن کشید	his brows contracted to their utmost limits.
مانند غاری که بخواهد از زیر در بگذرد خود را خم کردم.	I bent down to go in, like a goose under a gate
لبه تخت را گرفت و شکمش را تو کشید.	bracing herself and catching firm hold of one of the bedposts.
با من حرف زد.	he was, spoke.
از این گذشته اطمینان داشته باشید که من از این به بعد جز برای تکریم شما ارباب واقعی و طبیعی خود لب از لب نخواهم گشود	but you may be sure I will not open my lips henceforward to make light of anything of your worship's
انتظار دارم که شما هم گاهی در فکر من باشید.	I should like you to think sometimes of me.
حتی اگر تنها برای دو دقیقه باشد.	even if it was only for two minutes.
اما خبری نشد.	but nothing happened.
از راه همان عادات و حرکات به صورت دیکتاتوری غیرقابل مقاومتی درآمد.	through those forms that same sultanism became incarnate in an irresistible dictatorship.
ما با هم خواهیم ماند.	we will stay together.
از همان جا برگشتم به طرف مرداب.	I struck through the woods and made for the swamp.
وقتی هم تمومش کرد دی گه نمیخواد این ور اون ور آویزونش کنه.	when he's through,he don't want no pig hanging around.
دیگه خطری مارو تهدید نخواهد کرد	I'll be safe
اکنون غرق در گل و شکوفه بودند	now flourished thick with flowers.
ولی همیشه اوضاع به همین منوال بوده است.	but they have been that way always.
ولی نه صورتش و نه من افسر کونیگ هستم.	but neither his name nor his face looked particularly familiar to me.
چنانش تنگ در بغل فشرد	he clasped him in his arms so closely
زیرا به آرامی در کنجی خزید	for he coiled himself up in a corner very quietly
از تصادف با هم وطن خود بسیار خرسندم.	I am delighted to meet a compatriot.
تا اینکه نوبت به ارباب من رسیده بود و او تدبیری را که به خاطرش رسیده بود به مجلس پیشنهاد کرده بود	when my master proposed an expedient to the assembly
ولی چنین کاری نخواهم کرد.	I will never do that.
رنده را پاک کرد و آن را در کیسه چرمی کنار ماشین انداخت و نزدیک میز رفت و دخترش را به حضور طلبید.	dropped it into a leather pouch attached to the lathe, and, approaching the table, summoned his daughter.
به محض شنیدن تکان مخصوصی که به در ورودی باغ داده شد	hearing the well known shaking at the garden gate.
علامات به کلی مخالف در دو تلگراف	for wrong signals to be made as they were in the last two telegrams
سرمای آن سکوت ناگهانی و آزاردهنده.	the chill of that sudden, hurt silence.
از آنجا که به کار بستن روش نخستین بوسیله هر دولتی عین ستمکاریست	as it was tyranny in any government to require the first
اصلا خوشم نمی یاد با هم جر و بحث و دعوا کن ین.	I don't like to see you quarrelling.
بیایید به ایشان بپیوندیم و سرهای خود را پهلوی هم بگذاریم.	let us join them, and lay together our own.
من به این دلیل این کار را انتخاب کردم چون تنها فرصت و وسیله رفتن به شهربود.	I just took that because it was the only chance I saw of getting up to town.
سخن مرا قطع نکنید!	don't interrupt me
وقتی آن را برداشتم	as I held them up
این نامه در او اثر عجیبی بخشید.	which letter put her into the greatest good humour.
کسانیکه لایق و شایسته شنیدن آن بودند ناچار باید نزد کنتس که نامه را از دست رها کرد بروند.	those who were considered worthy to hear it had to come to the countess, for she did not let it out of her hands.
رفته رفته دریافتن این نکته شروع شده است	if there can be force in a boiler
هیچ تاثیر بدی روی زندگی تو نگذاشتم.	I shall not have made any difference to you.
روز اول اشتباه ناجوری کردم.	I made an awful mistake the first day.
بایستی زنده بمانم	should be alive
به انتظار بخشش بنشینم.	therefore I shall confess and await forgiveness.
به این دلیل تمام لوازم خود را در آن زورق گذاشت.	he took all of his belongings with him in that boat.
با صدایی ملیح و ضمن ادای احترام.	in her most civil tones, and dropping a curtsey as she spoke.
گفت که لابد مردمی پرخاشجوئیم	that certainly we must be a quarrelsome people
مادر رو به او کرد.	the woman turned her head
شخص پدر که به قدر کفایت جزع و ناله خود را کرده	the father has mourned sufficiently
ده سر اضافه هم غنیمت است.	ten more heads are worth having.
دوستان بی شمار و فرزندان نیکو و بسیار داشته باشد.	in those of fortune, in having many friends, and many and good children.
باید یه چیزی رو برات ون تعریف کنم.	you wait 'til you hear this
شیشه را به لب خویش نزدیک ساخت.	held the vessel to his lips
بسیار زود به ناتوانی او در حفظ منافع مالی خود پی برده	she had very early made up her mind to his incapacity of minding his own interests
واسه اینکه کاری نکرده بودم.	seeing that there was nothing against me
هنوز برای قضاوت زو ده ولی میتونیم جمع بشیم و دوباره امتحان کنیم.	it very much remains to be seen but at least we can get together and try.
درست قبل از باز شدن در اتاق خود را روی تختخوابش انداخت.	just as the door handle turned.
چون از روی اسم ناخداهایشان میدانست که باید سوابق مشکوکی داشته باشند.	because he knew from the names of their skippers they must have suspect backgrounds.
رینگ رونگ دی لو!	ring a dong dillo!
آن بازگشت به زندگی	that sudden flare
همه افراد به سر کار خود بازگشتند	all hands were turned to
ناچار بودند تندتند راه بروند تا عقب نم آنند.	jogging to keep up with their enormous strides.
آقای کازوبن از من و مادرم خوب مواظبت کرد.	my mother and I were well taken care of.
جمعیت به فریاد خود ادامه داد تا رفته رفته به خواست خود خاموش شد.	until they left off, of their own will.
دوباره شماره را گرفتم.	I dial it again.
چه قدر تکرار هر صحنه موذیانه است	so insidious is the repetition of any scene
بلکه از او تضمینی کافی خواهد خواست	he must have solid guarantees of some sort.
سوزنش به قدری در دستش کشیده شد که کم مانده بود نخ از سوزن بیرون آید.	with her needle drawn out to its thread's length.
زیرا که مشارالیه رأی درست دارد.	you know he always has wise advice to give.
برای تنبیه کردن همیشه وقت خواهد بود و این کار بسته به اوست.	it rested with him to punish them and there would always be time for that.
من جا خورده بودم.	I was startled.
حال به مرخصی شما اکنون که شما را دیدم و از تندرستی شما مطمئن شدم و دانستم که احتیاج به چیزی ندارید	now I have seen you and know you are well and have all you require
عاقبت به گذرگاهی رسیدم که پر بود از رد پای انسان و چندین جای پای گاو	I fell into a beaten road, where I saw many tracts of human feet, and some of cows
چهارمین دولت ظرف شش سال	the fourth in six years
من و او دایه خانه را ترک گفتیم.	she and I left the nursery.
وضعیت این یکی و طرز حرف زدن آن یکی اصلا طوری نبود که هیچ زن با حجب و حیایی بتواند اجرا کند.	the situation of one, and the language of the other, so unfit to be expressed by any woman of modesty,
صدای غمگینی آهسته سلام گفت.	a strange little voice said hello.
حدس زدم که باید 65 سال داشته باشد.	I suppose he would be about sixty five
حتی نفوذ ملانی هم دیگر قادر نبود این رشته گسسته را دوباره پیوند بزند .	bound her to the old days, to old friends.
او جوان پاکی است.	that the fellow is innocent
کشتی چرخید و دوباره جهشی کرد	she filled on the port tack and was off again
در این موقع صداهایی شنیدم	we heard voices already
تمام اعضاء و اندام ما به هم شبیه بود بجز اختلافی که از حیث پرموئی و رنگ داشتیم به شرحی که گفتم.	the same in every part of our bodies except as to hairiness and colour, which I have already described.
لیکن اکنون بفرمایید که چه کسی اول بار در دنیا پرش کرد و در هوا معلق زد.	but now tell me, who was the first tumbler in the world?
من تو را بدبخت دیدم بدبختی تو به من اثر کرد دلم به حال تو سوخت خواستم بلکه کاری در حقت نمایم	I saw you were unhappy and your unhappiness interested me
به هیچ وجه گناه از جانب او نباشد	nor be to blame
شک داشتم توضیح مناسبی برای این یکی به ذهنم برسد.	I doubted I could come up with the appropriate analogy to explain this one.
بگذار او در بوسه پیش قدم شود.	let her want to be kissed, first.
استهزاء تلخ و جانگزای موی خاکستری!	bitter, biting mockery of grey hairs
رالف توانست خوب براندازش کند	he could gaze down upon her whole person
حرکات سالیانه و روزانه خورشید و زمین را با جریانات اتفاقی باد تلفیق کند و تطبیق دهد.	by adjusting the annual and diurnal motions of the earth and sun, so as to answer and coincide with all accidental turnings of the wind.
مطیعانه چشمش را به زیر انداخته از اتاق بیرون رفت.	went out of the room with meekly downcast eyes.
با تأیید ناظران به طبع رسیده	with the approbation of those to whom they have been submitted
قبلا اینو دسته بندی کرده بودم.	I'd already catalogued this one.
به گمانم که بشود ولی دیرتر از آن نه.	I think that will do but it must not be any later.
زیرا انسان سالم آدم خاکی است	because he is above all a man of this earth and is bound
موضوع خاصی نیست.	I have nothing particular.
این یکی از نکات اساسی است که اثر مو لف را ناقص نموده است.	for it is one of the serious omissions of the work.
سپس چند بار دیگر دسته را بالا آورده و فشار دادم ولی باز هم عمل نکرد.	I sawed it up and down four times.
سرانجام هم منفجر شد.	at last he exploded.
من دوست ندارم اشیاء این همه در مقابلم تند و تیز باشند.	I do not like the outlines of things to be too sharp.
ولی فوراً او را شناخت.	she recognized him immediately.
چون به طور غیر متعارف کلفت و پر بار بود	being uncommonly shaggy and thick
من شما را بسیار دوست دارم.	I love you.
مگر اینکه کسی به او کمک کند	unless some one helped him.
اینکه هم اکنون ترتیب ازدواج من را بدهید.	marry me now.
مخصوصا خود من.	I for one love it.
نزدیک دم قاطر قشنگش مینشست	he sat near the tail of his own smart mule
از وی خواهش کردم که فرمان دهد چند چوب به ارتفاع ده گره و به قطر یک نی معمول آماده کنند.	I desired he would order several sticks of two feet high, and the thickness of an ordinary cane, to be brought me.
این مفید است.	I am quite content.
او برگشته بود.	he had come home.
از من خواسته بودند آن خانم را بدرقه کنم.	I was asked to see her off.
برای همین مردم با آن مخالفند.	that is why people object to it.
پس از آنکه مسافتی را در جهت باد بر آب پیمود به توسط کشتی وال گیر دومی گرفته شود	drifting far away to leeward, be retaken by a second whaler
پنهانی از تن دردادن به آن سرباز زده بود.	had secretly disobeyed it.
زمان درازی لازم بود.	it was a long time.
اسم رمزها رو گم کردم!	I've lost the passwords!
زیرا وقتی تماشاگر به تماشای یک کمدی منطبق با اصول فن و ابتکاری رفته باشد	for after listening to an artistic and properly constructed play
از خوردن آش روسی خواهند ترکید و از خوردن سوپ روسی خفه خواهند شد.	burst with our buckwheat porridge, and choke themselves with cabbage soup.
دستانش در هم گره خورده بودند.	his hands were tied.
او را متقاعد ساخت که آرام بگیرد و به تدارک وسایل سفر بپردازد.	soothing her and trying to persuade her to prepare for her journey.
احساس ناخشنودی خود را به کمبود معنویت نسبت داد.	she felt to her own want of spirituality.
من فهمیدم که ما باید از اتاق خارج شویم تا مسافر بخوابد. هر دو رفتیم بالا.	I understood that we must retire, in order to allow this traveller to go to sleep, and we both went up stairs.
بعد تقریباً به یک حرکت تمام اهل کلیسا از جا بلند شدند	then almost with one impulse the congregation rose
گفتی تمامی کلیسا با صدای سرش ماس هم نفس شده بود.	breathe with the voice of the head deacon.
تا اینکه سگ و اسب نگهداری کند و فقط روی زمین چهارنعل برود.	than in keeping dogs and horses only to gallop over it.
ولی ایشان بدون اینکه توضیحی در این باره بدهند او را به اطاق مجاور بردند	but that gentleman prevented his offering any remark thereupon, by leading him at once into an adjoining room
وی کناری ایستاد و منتظر چیزی بود.	was standing on one side, apparently waiting for something.
من اعمال رابمنزله وسیله میدانم و فقط مقصودم را در مد نظر دارم.	I look on all actions as means to an end, and the end is all that I look at.
با حیرت به من نگاه کرد.	he looked at me astonished.
که همه موانع را به کنار بگذارید.	as to set aside all impediments
ولی خرافات چنان در اهالی ریشه کراده بود	but they were so rooted in local superstition
برای اینکه دوباره بتوانم صدای او را بشنوم گفتم.	I said to restart the conversation so that I could hear her voice again.
ولی دوستم مشتاق است هر طور شده آن را بدست بیاورد.	but he's anxious to have the stone.
مگر آلات و اسباب نداری	but I suppose you had no tools to aid you
من هم با ترس او را دنبال کردم.	I was timidly following her
ولی همه همچنان برجا بود.	but they continued to exist.
اینست که یک نقشه نظامی برای انجام حمله طرح کرده و آن را تا انتها به اجرا درآورید.	is a plan in military terms to mount the attack and carry it through.
این بود که چرخید و روی میز کناری کتابی جستجو کرد.	so she turned and felt on the table beside her for a book.
گویی صرف اشارهء میس پراس به از این سو به آن سو قدم زدن باعث این انعکاس شده است.	it seemed as though the very mention of that weary pacing to and fro had set it going.
اگه میخواین بهتون کمک کنم	I'll help ya if ya want,
متاسفم که منتظرت گذاشتم	I am so sorry to have kept you waiting
بنابراین هرچند رنج و مرارت سرباز بیشتر است پاداش او به مراتب کمتر است.	so that though the soldier has more to endure, his reward is much less.
چیزهای لازم را بر آن افزود	his remarks upon it
ولی او نا تقریبا هر شب تا ساعت ده و نیم یازده از اتاق نشیمن استفاده میکنن.	but then they use their sitting room every night nearly until ten thirty or eleven.
بلکه زن مصممی شده بود.	but a determined woman.
غرض تابستان 1778 یعنی در حدود بیست و سه سال پیش است.	the summer of 1778, that is nearly twenty three years ago.
به جزء جزء نقشه با دقت نگاهی انداخت.	looked closely at every detail of the plans
به شادی از کار دو اسقف به کار دو وکیل پرداخت	passed gayly from the two bishops to the two lawyers
نمیدونن که چه گرم و آرامش به شه.	how dear and comforting they could be
دور تا روی هم رفته اشتباهی در آفرینش بود	she was altogether a mistake
یک شکم سیر گریه کرد.	had a good cry.
دعای خیرم را برای او ببر.	I send it to her by you.
هر دو به شهر موطنم رسیدیم	we arrived at my city
اعتراف کند که اشتباه فاحشی مرتکب شده و تمام تصوراتش خطا بوده.	acknowledge herself grossly mistaken and mis judging in all her ideas on one subject
به یاد آورد که چگونه این حلقه به انگشتش رفت.	how he had looked when he slipped it on her finger.
با وجود این لازم بود خودش را نشان بدهد.	but he felt it necessary to assert himself.
تصمیم گرفته بودم جشن حسابی بگیرم.	I'd made up my mind to do things well.
من هنوز یک دنیا کار دارم که انجام دهم.	I have a night's work to do yet.
بالاخره عزم من جزم شده است.	I am in earnest at last
دنبال بیل و کلنگشان آمده بودند.	they had come for their tools.
سرش را با تأسف تکان داد	as he shook his head.
در طی این مدت امپراطور فرمان داد که برای من تشکی آماده سازند.	during which time, the emperor gave orders to have a bed prepared for me.
به خاطر شما این یک کار را خواهم کرد.	I'll do that for you.
جلو میز توالت در کنار پنجره ایستادند	but stood at the toilet table near the window
پیش از آنکه مسافتی دراز از دریا دور شده باشم	before I could get far enough into the sea
ولی ماهی با آخرین نیروی خود بار دیگر به آب فرورفت.	but with its last strength the carp again plunged into the depths.
دست در یک تله موش به دام افتاده بود.	here was a snap, and the hand was trapped in a mousetrap.
تا آنجا هم را ملاقات کنند	who had said she would receive them there.
درباره این دخترها مخصوصا درباره چند تن از آنان	was inclined to think of them certain girls in particular
آن پیشنهاد شرم آور به یادش آمد.	remembered how she asked him if he was proposing to her
شاید هم تا حالا در چند مورد خرابکاری کرده باشه	maybe he's even had to indulge in a purge of the fainthearted.
سوی نیروی واقعی اشیاء که یگانه قدرت عمومی شده باشد.	to the force of things become the sole public force
حرف زیادی در این مورد نداشتم.	I had not very much to say.
او عقیده دارد که زن و شوهر جوان را باید تنها گذاشت.	he says that young people ought to be left alone for a while at first.
یک زن الف باریک اندام با لباس سفید ساده که صدای مهربانش لطیف و اندوهگین بود.	a slender elf woman, clad in simple white, whose gentle voice was soft and sad.
اگه فقط پونصدتا ابوطیاره داشتم.	I wisht I had five hundred jalopies.
او در خیال صدای زنگ بزها را هنگام عبور شنید	she fancied she heard goat bells ringing in their passes
مثل ای نه که متکای پر قو زیر سرمه.	I seem to have feathers under my head.
شب از نیمه می گذشا و میخانه بسته بود.	which was closed for it was midnight
من احساس عجیبی دارم.	I can't, I feel so queer!
ولی به دختر پررویی خیلی کمک کرده است.	but is very generous to one quite impertinent girl
تا آخرین لحظه شکیبائی کردم.	I put it off to the last.
هر فکر که جز این داشت محو شد و جز یک شادی مجهول و شگرف برایش نماند.	every other thought was effaced, and he felt only a profound and unheard of joy.
یک عالم بدبخت خواهم شد.	I should be very unhappy.
در همان خانه نیز بیش از آن رنج برده بود که بتواند منظره تغییر وضع را در پیش خود مجسم نماید.	had suffered too much where he was, to bewail the prospect of change very severely.
باید شخصیتی در خود ایجاد کنید که گرما و محبت و اعتماد و اطمینان را از خود به نمایش بگذارد.	you owe it to yourself to develop the kind of personality that radiates warmth and confidence, and which attracts people to you wherever you go.
او را با کمال دقت در آغوش کشیدم.	I took it very carefully in my arms.
به تو گفتم که چرا این پیشنهاد رو کردم.	I've told you why I'm talking of them.
او نا از توی چوب دستی ولد مورت بیرون اوم دن.	they came out of his wand
سیم خاکستری رو تو دستام فشار دادم	I wadded the gray cord up in the palm of my hand.
من حتی یک کلمه هم نشنیدم.	I haven't heard a word.
آنگاه چنان فشاری به بازویم داد	with that he gave me a twitch
اندوه و رنگ پریدگی چهره پیرمرد	the pallor and anguish expressed on his countenance
که صاحبان توتین در آن موقع در ده	that the raftsmen were all down at the village
دستش را بوسیدم.	kissed his hand.
اما ناگزیر بودم که با دشواری هرچه بیشتر عبور کنم.	but was forced to move with extreme difficulty.
به شرطی که منو تو دسته راه بدین.	if you'll let me b'long to the gang
هوشش به خواب رفت	his energetic mind slumbered
در آنجا به امید اینکه یکی از خدمتکاران بیرون بیاید در را کوبیدم.	at which I took the liberty of knocking, in hopes some more civil servant might show himself.
با وحشت بسیار شرحی درهم و برهم از آنچه دیده بود بر او بیان کرده بود	in a great fright gave him a very confused account of what he had seen.
نیروی شهوانی تحت کنترل عشق معنوی.	sensuous force controlled by spiritual passion.
تا کار صبحش را شروع کند.	to begin the morning's work.
اما دستش را گرفته بود.	but he held her hand.
که وسایل این کار را دارد	that he had means
که من هیچ گاه از آن نصیب نبردم	I can never enjoy.
فقط به سه نخ سیگار سوار قایق شدم و راهی این جزیره شدم.	three cigars in my pocket to help me spend the day on this island.
چون دست به زبر آورد	as it dropped
ولی از همان جا با ایمان متزلزلی به خانه بازگشتم	but I went home with my faith shaken
کلاهش کج شده بود	her bonnet askew
بعد به عیب و ایرادهایش پی بردم.	the second was criticism.
من تردیدی نداشتم که	I could not doubt that
کت و شلوار آ بیش بیش از اندازه کلفت بود	the blue suit was too hot
گرده یخ زده دریا ما را در پوشش یخی پوشانده بود.	whose freezing spray cased us in ice, as in polished armor.
اتاق در خاموشی فرو رفت.	it left me in darkness.
با قلب خودم مقایسه ش کردم ولی به نظر مقیاس خوبی نیامد.	I paced it against my own heartbeat, but I wasn't sure if that was any measure.
به خواهر شوهرش نگاهی انداخت.	looking at her sister in law
ولی حاصل کار فقط سردرگمی بود.	but it was all confusion.
اکنون بر زمین افتاده بود	now lay in agony
چشمان آ بیش سرشار از محبت بود	his blue eyes very kind
من دی گه حرفی نزدم	I didn't say any more
از آنجا به طرف چپ پیچ خوردند	thence turned to the left
اما من حاضر به قبول آن نبودم.	but I would have nothing to do with it.
ولی با وجود دفع حمله مزبور هنگش بیش از نصف افراد خود را از دست داده است.	though the attack had been repulsed, he had lost more than half his men.
من فقط می تونم به گم مردن دی گه چاکار کردن.	I only know what other men have done.
با این همه در این حال و هوا شنیدن این سخنان برایش لذت بخش بود.	still it was pleasant to him to hear this now.
اما اسم این خانه را که در آن هستیم به من بگو.	tell me the name of the house where we are.
انگار تمام قوایش را گردآورده بود که فریاد نزند.	as if within herself she was marshaling every resource she possessed not to scream.
با صبری تلخ به انتظار آن مرد ماندم.	waited with sombre patience for the coming of its tenant.
خودشو نو درگیر جادو جن بل کردن و هیچ تعجبی ندا ره که زندگیشون پایان دل خراشی داشت.	getting mixed up with these wizarding types ' just what I expected, always knew they'd come to a sticky end
در اینجا چیزی بدتر از آواز خواندن در مصیبت نیست.	for there is nothing worse than singing under suffering.
زیرا همه کس با این احساس پرچ مدار که برای نخستین بار زیر باران گلوله آمده بود آشنایی داشت.	for everyone knew the sensation which the cadet under fire for the first time had experienced.
که از شر خود نامه خلاص شده است.	she had been able to escape the letter itself.
اما دیگر نتوانست چیزی بگوید	but couldn't say much more
یقین داشتند که جانب عدل و انصاف را فرو نخواهند گذاشت.	convinced that they could pass fairly and impartially on thefacts presented to them.
آخر این کار پرزحمت داشت.	it would have been too much trouble.
موفق نشده بود جلوی خود را بگیرد.	he had been obliged to give in.
مورل دیگر فرصت نداده	MMorrel did not wait for a second invitation
به همین علت به سوی آشپزخانه راه افتاد.	so into the kitchen he went.
من همان وقت گفتم که بالاتنه را باید بلندتر و از دو تخته برید.	I said at the time that the bodice should be cut longer, and made of two widths.
از انتخاب اثاثیه گران قیمت سرباز زد	he refused anything except the least expensive
من خود نیز زندانی طبیبانم.	I also am a prisoner of the healers.
به اسلاید نگاهی انداختم.	I glanced at the slide.
با دماغی پر از باد و نظری متکبر و رفتاری با کمال غرور.	with a proud look and insolent demeanor
من باید یک کاری بکنم.	I must do something.
با چاقوی خود اندکی ته آن را شکاف داد تا نامه را در آن جای دهد و بدان طریق آن را به قایق برساند	with his knife slightly split the end, to insert the letter there, and in that way, hand it to the boat
که از چین و شکن موها سنگین گشته بود	, at the heavy knot of hair
هیچ کس حرف نزد	nobody said anything
شاید هم روباه بود.	possibly a fox.
مطمئن نیست که بتواند در اینجا و در هرجای دیگر کارگر قابلی از آب درآید.	highly uncertain as to whether she would prove of service here or anywhere.
چند عدد قاشق و کارد و چنگال نمکدان و فلفل دان که ربرتا	some spoons andforks and knives and salt and pepper sets
لئون به خیال اینکه از چشمانش حالت گستاخی و جسارتی خوانده شده است سر برگرداند.	he turned away, thinking perhaps there had been an impertinent look in his eyes.
می خوام بدونم که چند وقت لازمه که اینجا بمو نم	I want to know how long I'm gonna have to be here.
بیست و پنج سال دیر کرده بودند.	twenty five years too late.
بار کافه هم با چشم خودم دیدم که پر از پلیس بود.	the bar of the ken I went up there and see it with my own eyes is filled with traps.
این دختر فقط خواهرزاده زنش است و خیلی هم متکبر	this young woman is only her niece, and very proud.
نمی دون ستم می تونی بهش چیزی نگی. چه قول داده باشی چه نداده باشی.	I didn't know if you'd be able to keep it from her, promise or not.
من اونجا رو انباری کردم.	I've been storing things back there
بلکه هر کسی که در هر جای خانه بود	but all through the house
من متاسفم که شما ما رو در این حالت دیدید.	I'm sorry you see us in that way.
ژنرال فعلا مشغول صحبت با یک سرهنگ است و پس از او نوبت دبیر شرکت است.	the general is busy now, but the secretary is sure to come out.
مدت زیادی از آن دور بودم.	I'd been away from it too long.
آن شخص موی سر او را گرفته	, his adversary seized him by the hair
برای اولین بار تمایلی نداشت.	for once he didn't seem keen
اما او مشغول انجام دادن کارهای بانکی زنی بود	but he was engaged with a woman
نزدیک بود قید کارمو بزنم.	I coulda chucked my job
خانه و ملک در شهرهای بزرگ.	houses and buildings in the major cities.
به نظر تغذیه خوبی هم داشتند و اونیفرم هایشان هم کامل بود.	they looked well fed, too, and had whole uniforms.
گفتم که چمدانی در منزلی واقع در همان خیابان دارم.	I told him mine, which was down that street there
ازیان که با او تنها بود کمی شوریده بود.	he was a little uneasy at being alone with her.
شاید بهتره تو هم با ما بیای	perhaps you'd better come, too
حق هم دارند.	right they are
خودمان شش تا اسب داریم.	I've had the care of our own six horses.
به عنوان یک پزشک به خودم حق دادم برگردم.	I am come back in my quality of doctor, he said.
لااقل به نظر من خیلی خوب است.	at least she thought so.
این فرمان کتبی را که فرمانده کل سابق	gave directions for the order to be written out which the former commander in chief
چنانکه گویی همانا پیش از آنکه نقشه جهان تنظیم شود قلم زده شده بوده است.	as if verily mapped out before the world itself was charted.
قادر نبود تعادل خود را حفظ کند	he became disoriented
قایقی که من در آن نشسته بودم اندکی جلوتر بود	but the boat I was in, having some start
باید بروم و حتماً خواهم رفت.	I must and shall!
زن یک کشیش حقیر شدم	married a poor clergyman
شصت هزار جریب زمین و نصف گوسفندها از دستم رفت.	I lost sixty thoosand of ma acres, and half ma wee sheep.
در فکر بودم که قوری دیگری چای بیاورند.	I was beginning to think wed have to send for a fresh pot.
ضعف بر جانش مستولی شد.	his arms about her made her shake with helpless hate and fury.
کشمکش و تکاپوی جانانه محاکمه سبب شده بود	because of the very vigor and strife of the trial
روت فریادکنان گفت دوستت دارم! عاشقت هستم!	I do! I do! she cried.
ابته محض خالی نبودن عریضه همواره همان جنگ نبود.	though strictly speaking it had not always been the same war.
مردم آن را فراموش خواهند کرد و نام او بدون لکه باقی خواهد ماند.	that everyone would forget about it, and his name would remain unsullied.
همین قصد را دارم.	I intend to try.
من یقین دارم که نیمی از این حال مالیخولیایی تو مربوط به این منزل است.	I am sure it's quite half through your lodging you have become so melancholy.
در حالی که سرخ شده بود	whose pale cheeks became slightly flushed
سخنان خود را توأم با دلایل مسلم و با حرکات و اطوار علمی مربوط به این فن گفت	with such conclusive arguments, and such figures and mathematical proofs
که با بع خودگوریو خیلی تفاوت داشت.	was the very opposite of his own.
پشت پاتیلش کزکرده بود.	was cowering by his cauldron.
برایم مهم نیست.	I dont care.
در حالی که سرگرم اون هستید	while you're at it
لبخند بی رمقی زدم.	I smiled ruefully.
طنابی را که زندانی را از میان شکم به تیر بسته و به زیر میز گره خورده بود گشود.	he untied the rope which fastened the prisoner across the middle of the body, and the knot of which was under the table.
من قادر نیستم هیچ چیز مشخصی بگویم	I cannot say anything definite
تا اندک اندک غروب به شب گرایید.	while the evening slowly deepened into night.
به خصوص در حال فعلی!. .	with very especial care.
اگرچه او به عنصر خود پیوسته است.	though he was in his own element.
چه با باد و چه بی باد.	wind or no wind.
با اینکه مثل سابق نمی تونستم دوستش داشته باشم حاضر بودم باهاش ازدواج کنم.	that I would marry hereven if I couldn't love her any more as I once did.
ولی برای اینکه مداد بهتری شوی به آن نیاز داری	but you'll need it to become a better pencil.
با عجله از درمانگاه بیرون رفت.	strode quickly from the room.
با اینکه درست از لطف آن سردرنیاورده بود	though he by no means knew what it was.
منهم یه خورده گشت زدم	I had something to do.
ولی هرچه لطف خدا بیشتر تو دل زنی جا به گیره	the more grace a girl got in her
خودش نتواند هیچ کاری بکند.	he can't do anything about it.
بعدش خیلی راحت مرا پیدا خواهی کرد.	then you may easily find me out.
من به طور حتم مدرکم را خواهم آورد.	I'll get my proof for you all right.
جایی که کسی دعوتشان نکرده بود.	no one had promised them.
هر جا میری	wherever you go
چو بندازین که	you running away with the idea that
اما قدر مسلم این است که کشف قوانین تاریخی تنها از این راه امکان دارد	but it is evident that only along that path does the possibility of discovering the laws of history lie
با ترشرویی پرسید	he asked sullenly.
باید با شما صحبت کنم.	I must talk to you.
جلو مردم خودمو بخارونم.	nor scratch, before folks
تا این که قطار به یک سو پیچید	until the train turned a corner
در عوض از وضع جیب خودش خبر دارد.	but he does know his own pocket.
بعد به کلی از میان رفت.	presently died wholly away.
که در اخر کار جاشو ان دسته جمعی نزد ناخدا رفتند و به او گفتند ژ	that at last in a body they went to the captain and told him
وام پا این را گرفت و از دخمه بیرون رفت.	as he left the cell.
هوای داخل خندق انگار که همه ناگهان تخلیه شد.	as if most of the air had suddenly been pushed out of the gully the flash flood had cut.
این فکر اوراکلافه کرده بود.	entirely poleaxed by the idea.
یک توافق بدون احتیاج به گفتن	a wordless ongoing agreement.
قدی بلندتر از معمول	above the average in height
خیلی خوشحالم که آن قدر زود شروع کردید و امیدوارم که همان طور ادامه بدهید.	I'm glad you began at once, and hope you will keep on.
اگه چند وقت روی اون بنشینم	if I was to set on it long enough.
لزوم زناشوییی از بین رفت.	the necessity of marriage avoided.
دفترچه را ورق زد.	flicked through the blank pages
تمام حواسش از پی تجارت گندم و آرد بود.	but on commercial speculations.
زیرا هنگام حمله به یک محل حفاظت شده وجود افراد فنی ضرورت دارد.	whilst attacking a garrisoned place.
تخم طلایی که هنوز خیس بود از دستش لیز خورد و افتاد.	the golden egg, still damp from the bath, slipped from under his arm.
عفیفانه در دورترین لب هی تشک قرار گرفته بود.	chastely perched on the farthest edge of the mattress
ولی احمق نیست.	but he is not stupid.
همه دار و ندارش همین است.	that's all I hear of his making.
همه جا سبز و خرم گشته	the grass as green as showers and sun could make it
دور تا دور تخت از دید محفوظ بود	but it had been blocked from view
چون در ازدواج قبلی هم عشقی وجود نداشت.	I don't recall that love was prominent in your other two ventures.
شاهدی در بین نبود.	there were no witnesses.
البته اگه زحمت نیست.	that is, if you want me to.
یک گزارشگر تلویزیون آمده بود تا از زندگی او گزارش تهیه کند.	they had sent out a TV reporter to do a story on her.
زیرا ژان میشل دیگر در سن و سالی بود که زن گرفتن و کانون خانوادگی تازه بنیاد نهادن کار بس مشکلی بود.	which had come to him at an age when it is difficult to start life again and to make a new home.
آماده هستند که هر عملی را برای ارباب خود انجام دهند	cunning way, are ready to render any sort of service to their master
من خیال دارم او را برگردانم.	I'm going to get him back.
نه از برای هوس گذرای جوانی.	not because of a juvenile way station along her road.
اخیرا کمی درد داشتم	I have had a few aches and pains lately
تازیانه را انداخت و آن را لگدمال کرد.	dropped her riding habit, and stumbled over it.
آن را از سرش برداشت.	pulled it off.
ولی دو سه روز گذشته روی زمین سفت تر از این خوابیده بود.	but in the last three years or so he had lain on harder.
همگی دست به دست هم دادند	all joined hands
بار دیگر چند ضربه به در خورد.	there was another loud rap on the door.
مطمئنم که از ته دل همدیگه رو دوست دار ین.	I'm sure you are fond of each other ' er ' very deep down.
خیلی علاقه دارد که با شما آشنا شود.	would so like to meet you.
او را با اجتماع آشنا کرد	introduced him into society
خودم به اندازهٔ کافی بدبخت هستم!	I am unhappy enough as it is!
حال اگر مسلم است که سلاح نیز مانند علم نیاز به همکاری فکر دارد	since, therefore, arms have need of the mind, as much as letters
نسبت به وجود پسرانش بیگانه بود	was alien to the existence of his sons
خورشید از آن شمار است.	the sun is one of them.
با هر کس دیگری که دوست داری.	with anyone you like.
از مترو پیاده شدم و به سمت خیابان به راه افتادم.	I make my way slowly back from the tube station to our street.
سر صحبت را با او در این باره باز کنم و بپرسم که او هم به تو علاقه دارد یا نه.	to enter on the subject as you wish me to do, will be asking her to tell me whether she returns it.
که رفته رفته در صدد بهبود بخشیدن به کار او برآیند	as to conceive the idea of improving on his method
استواری که سابقا در سوار نظام بود اندکی کنار کشتگان توقف کرد	an old trooper on the flank, a noncommissioned officer who had stopped beside the dead men
دچار هیجان شدیدتر از دفعه اول شد.	fell into another ectasy, more boisterous than the first
متوجه تغییر شکل رد پاها بعد از آن نقطه شدم.	I remarked the change in the shape of the prints after that point
بط رز درهم برهمی که محتاج توصیف نیست	but all in a somewhat decayed condition
دیگر نخواه مش دید.	I shall never see her again!
ولی تعداد کمی در آنجا مرده بودند.	but not many had died there.
معلومه که حاضرم	I sure will.
ساعت نوزده و سی دقیقه قرار دارم.	I'm due back at nineteen thirty.
درست موقعیکه اونجارو ترک کردیم تعدادم ون به ۱۹ نفر رسید.	we picked up another three just as we were leaving.
دوباره سرسره سورتمه جلو از روی برآمدگی جستن کرد	went the first sleigh over a cradle hole in the snow of the road
بالاخره خودم را به بالای دیوار رساندم.	at last I gained the summit.
مثل باز کردن دری که کلیدش گم شده بود	such as forcing locks or
جای تعجب بود که جزو اسباب و وسایل آن خانه باشد.	yet that it should be anything else in that house was a circumstance to raise no common degree of astonishment.
ولی من که پول ندارم.	I haven't got any money
هیچ چیز به هم بر نمی خوره.مگر مشتی که تو پوزم به خوره	I don't take no offense 'cept a bust in the nose.
من در خانهٔ او به صورت تو دقیق شدم.	I was looking at your face just now.
او فیلم را از بین زا نواهایش نگاه کرد.	she watched from between her knees.
تو فقط وقتی این موضوع را به ما گفتی	you only told us
در تاریکی راه مقعر دنبال خود بر زمین می کشاند.	orat least the unconscious, man, through the shadows of hollow road.
اخه رفته شکار و هنوز نیومده.	she's off hunting at the moment.
با آستینش غبار رویش را پاک کرد.	wiped the dust off with the sleeve of her shirt.
ولی سدر یک دررفت.	he only just got away.
او را شناخته بودم.	I knew him
به جز او چیزی را دوست نداشتم	I loved only her.
این بود که از طرف عقب اومدم.	so I come down the back way.
اما به هیچ وجه توقع خشم و وحشت را نداشت.	but certainly not angry and scared.
تا چه حد مجبور شده بود بار سنگین نومیدی را به دوش بکشد.	that he had been overwhelmed by the burden of disillusion.
یا دست کم فقط از کمک مادرهای خود برخوردار باشند.	at least, with only the maternal help.
به هر حال از این مقوله بگذریم و آشتی کنیم.	let us keep the feast in peace, and not throw the rope after the bucket.
اکثر دانش آموزان مدرسه در زیر آن گرد آمده بودند.	most of the school seemed to be packed beneath it
خوبست شمع را هم در پلکان بگذاریم.	we'll set the candle on the stairs.
که تنها برای خدمت به تو خویشتن را با این همه خطر در انداخته است	who of his own free will hath exposed himself to so great perils, and all to serve thee?
اگر شخص مورد نظر شما رنج کشیده و خطا کرده بگذارید برای نیرو گرفتن و تسلی یافتن به منظور اصلاح و شفای خودش به چیزی بالاتر از همنوعات متوسل شود.	if any one you know has suffered and erred, let him look higher than his equals for strength to amend and solace to heal.
پس از آن به تندی سرپایین انداخت.	then dropped his headquickly.
کارفرمای خود را با قلبی مصدم و مجروح ترک گفته بودم.	I had injured wounded left my master.
هر جا برم باید گشنگی بخورم.	I couldn't do half as well anywhere else.
تا مبادا آشنایی را دامنه بدهند و به خاطر پا از گلیم درازتر کردن مشتی به سینه ایشان فرود آید.	lest if they pursued the acquaintance further, they might receive a summary thump for their presumption.
آقای بروک از او دعوت کرد هفته آینده برای شام بیاید و شب را همان جا بماند.	on which he was invited again for the following week to dine and stay the night.
این مسلم است.	that is evident.
هرچند مطمئنم به تو اینجا بد نگذشته باشد.	I trust, however, that the time here has not been passed unpleasantly to you.
به خود اجازه داد با احتیاط تمام پیشنهاد کند	cautiously ventured to suggest
من میدانم کی هستم	I ought to know who I am
گوئی که با خواب مرگ در پیکار بود.	he seemed to struggle against the mortal sleep.
امیدوارم روزتان با خوشی بگذرد	I wish you a good day.
با لحنی که متعارف او نبود و کنت تا به حال ندیده بود	with an authoritative tone the count had never observed before
سعی دارم کاری انجام بدهم یا چیزی بگویم.	I try thinking of a follow up line.
حال دیگر برایم تردیدی نماند که جرام به چه کاری مشغول بود.	when the young man entered, I am sure I knew what he had been doing.
اگر بگویم که اولیور به تدریج و آرام آرام خوابش برد.	to say, that gradually and by slow degrees, he fell asleep.
با دست آزادم به صورتش سیلی زدم.	as he jerked back around toward me.
فردا خیلی کار داریم.	we've got lots ter do tomorrow,
من دوستت دارم چیز دیگری برایم اهمیت ندارد.	I love you, and I don't care for anything,
لکن نگاهش پرمحبت و سرور انگیز بود.	but his face was full of tender and happy feeling.
امروز صبح من این قربانی تازه را دیدم که شاد شاد بود.	I met the victim this morning in high spirits.
گویی پشیمان بود که عنان اختیارش را از کف داده بود	as if he regretted his outburst
بعد او نیز رفت.	then he too left.
به قدری از اینکه جوان تر از آن هستم که خود میل دارم متاثر شدم	I was so sensitively aware, indeed, of being younger than I could have wished
اگر چه چنین نبود.	though it wasn't.
من مجلس آرایی بلد نیستم.	I have no parlour tricks.
بالای آن چند چراغ و شمعدان نصب کرده بودند.	bearing on its wide top several lamps and a long row of candles in candlesticks.
کالسکه خود را دید	he perceived his carriage
در حالی که دنده مربوط به این قسمت اندکی از هشت قدم بلندتر بود.	whereas, the corresponding rib measured but little more than eight feet.
کاری که ضمن آن تمام فداکاریها برای احیا کردن کشوری که او عاشقش بود حفظ و ثبت میشدند تا آیندگان در اوج احترام و تحسین از آن یاد کنند.	wherein all the devotions to the regeneration of the country he loved would be enshrined for the reverent worship of posterity,
پوست سفید و روشن بود.	the skin was white and clear.
لذا موافقت کردم که این ریسک را به اجر ادرآوریم.	I agreed to risk it.
من کمی ترسیدم.	steals over me again
با خواست و اراده خودم	by my free will
که برای خوابیدن نیز اندرون آن مهیا شده بود	which was admirably arranged for sleeping in
من هم ون مردی هستم که دو تا سیگار زیر لب شه.	I'll be the man smoking two cigarettes.
اِما چشم و گوشش را به کار انداخت تا زود بفهمد فرانک چرچیل چه احساساتی دارد و خودش چه رفتاری باید در پیش بگیرد.	she could then exercise all her quick observation, and speedily determine how he was influenced, and how she must act.
ظاهرا یک صندوق محتوی دو بازوکا بود	one apparently contained the two bazookas
لیکن چیزی نگذشت که عواقب ناگوار آن راز را حس کردم	whereof I soon felt the unhappy effect
شات گانی در دستش بود.	shotgun in his hands.
من آن کسی بودم که به او بله گفت.	I was the one she said yes to.
اما از ترس تیر خوردم نتوانستم این کار را چنان که باید و شاید درست انجام دهم.	but scarcely cared enough to do it well.
شما را خبر خواهم کرد.	I'll send for you.
پشت به بخاری ایستاده بود	now going up to the fire stood with his back towards it
یا کشتی را ترک گفته بودند.	or had deserted her
که او ژنی دلخور و خسته شده	that the young girl had been overcome
به طور خودکار به طرف صدا برگشتم امروز خیلی به آن صدا گوش داده بودم.	I looked automatically toward the unintentional call, realizing as my eyes found their destination that I recognized the voice I'd been listening to it so much today.
آدم تو دل برویی بود.	her person pleasing
پسر او در اینجا بر همه چیز نظارت و ریاست دارد.	whose son overlooks and directs everything here.
به روپوش من هم توجه نشان داد.	he took notice of my gown.
خیلی مشتاق دیدن توست.	she does so want to see you.
رخساری خصمانه و یخ بسته.	his expression was icy and hostile.
در مورد عزیزانمان آن قدر در ترس و امید هستم و حواسم پرت است	I am so distracted with fear and hope for our precious creatures
برای دیدار مجدد تو بی قرارم.	I can't wait.
بدنش زخمی و خراشیده شده است. اما آسیب دیگری ندیده است.	scratched and bruised but otherwise unharmed.
چهار بشقاب روی میز قرار داشت.	four had been provided
اما دید که توانایی ندارد	but finding it impossible
در اعماق قلبش ترسی هولناک بود.	there was in the depths of her heart an awful fear.
از طبایع شاهان و وزیران چیزها شنیده و خوانده و بر آن نیک آگاه شده بودم	I had indeed heard and read enough of the dispositions of great princes and ministers
ماجرای دیگری بود که وقتی به هتل برگشتیم اتفاق افتاد.	that was something else that happened when we got back to the hotel.
تا به او نزدیک شدم به تاخت گریخت و به اعماق تاریک جنگل فرو رفت.	when I went near him he made off into the thickest part of the forest.
منظورم این است که جسد او هرگز در تابوت نبود.	I mean that he warn't never in it.
بعد از آن خود را مستولی ساخت بر کراهتی که آشکار و ظاهر بود از سیمای او به یاد کردن این قسم.	then, overcoming his manifest repugnance
بعد مکثی کرد.	then he paused
در را فشار داد و داخل شد.	pushed open the front door.
با دقت نگریست و دانست که این دو ستاره دو چراغ یک درشکه است.	he looked and recognized the fact that these two stars were the lanterns of a carriage.
سه دانه که سرهای پیکان داری داشت در خاک افتاد	three of the spearhead seeds stuck in the ground.
در مدتی که تام و دی زی منتظر اتومبیلشان بودند با ایشان روی پلکان ورودی نشستم.	I sat on the front steps with them while they waited for their car.
دیر از خواب بیدار شدم و	I got up late.
کار دیگری نداشت جز آنکه کنجکاو باشد.	he had nothing else to do than to indulge his curiosity.
که او را درست مثل یک بشر دوست داشت	whom he loved as if he were a human being
اما حال دیگر تاب و توان ادامه این تلاش را نداشت.	but now he felt incapable of keeping up the unequal struggle.
او نا فکر می کردن که استعداد جادوگری من چندان تعریفی ندا ره.	they thought I might not be magic enough to come, you see.
ولی وی بلافاصله روی زمین به زانو درآمد	but suddenly composing himself, he fell on his knees
به عنوان سرباز سوار.	I'm going as a trooper.
اما از هر جهت به مرد جوانی شبیه بود تا شاگرد مدرسه.	but in every other way he looked more like a young man than a schoolboy.
اما از حیث مصیبت همانند بودند به تندی متحد کرد و با قدرت مقاومت ناپذیرش دستشان را در دست هم نهاد.	power these two uprooted existences, differing in age, alike in sorrow.
دختر جوان فریاد کرد	cried the young girl
اما اصلاً به فکرم نگذشت که شاید تو باشی.	but it never entered my head that it was you,
نسبت به ایشان هر دو عطوفتی دارد.	who has a great affection for them both, I have spoken.
آتش زیر بوته را روشن کردند	lighting the water pipe
به جز اینکه کله شق بود.	except that she was so headstrong.
من جدا معتقدم باید صبر کنیم.	I do think it would be better to wait, said the latter.
قبل از تاریک شدن هوا	before the morning were over
که یونس آن فرمان را دشوار یافته بود	which he found a hard command.
کیف پولم را از جیب شلوار جینم بیرون آوردم	I pulled my wallet from my jeans pocket
تمام پایتخت را اگر مردم آن بخواهند درباره قدرت مطلقه او چون و چرا کنند ویران خواهد کرد.	destroy the whole metropolis, if ever it should pretend to dispute his absolute commands.
البته با روش خودم و در موقعی که خودم مناسب بدانم.	in my own time and way.
خورشید آسمانش بود.	the new sun in her firmament.
بلکه هم بدتر!	or perhaps worse!
در غیر این صورت خودت و خدایت نابود خواهید شد	or we will kill you and your gods!
ملحق شدن دو ماهیت این احساس رابه اومیداد.	of two things merging into one.
من از گریه تو شرم دارم.	I'm ashamed of you for crying.
من چنین چیزی نگفتم.	I did not positively say so.
بلکه عشقی بود حقیقی به زندگی پر فراز و نشیبش در روزهای جوانی اش پیش از آن که برای همیشه به آن سقف گالی پوش خانه مادری اش در دل بیشه ها پشت کند.	but a genuine love of that wild life which he had led in his young days before he turned his back for ever on the thatched roof of the parental tolderia in the woods.
یکان یکان آزادی خود را بازخرید کردند یا از خانه ارباب خود گریختند	bought their freedom one by one or ran away
بعد از این کار خوشحال شدند که قدری هم سرخ پوست شده بودند	behold, they were glad they had gone into savagery
گفت آری آنجا هم بودم اما برگشتم	I was but am now back again
اما پیدا بود که از کازنی شف و گروه او متنفر است	but it was evident that he hated him and all his party
حالا اگر واقعاً از من بدت آمده است ممکن است خداحافظی کنی و برای همیشه از دست من راحت شوی.	if you choose, you may say good bye
آن را به فاصله دو گز از انتهای زنجیری که پای مرا بدان بسته بودند تا آنجا که ممکنست آهسته بر زمین بیفکنم.	cast it on the ground as gently as I could, about six feet from the end of my chain.
خدم دیدمش .	I've seen him.
در حال حاضر حتی این مصیبت هم از خاطرم رفته است.	for the moment I lose sight,'
اما نمیخوام بهش به گم	but I won't tell him.
او صدای اسمردیاکف را که صدائی مخصوص و عجیب بود لیکن او کام لا با آن آشنائی داشت شنید.	she heard his scream the strange, peculiar scream, long familiar to her
این روزها دیگر اختیارم دست خودم نیست.	I just don't seem to be able tocontrol myself these days like I once could.
من نیز مانند شما بشری بیش نیستم.	I too am a man like the rest of you.
تا شاید لیوان آبی پیدا کند.	in case there was a glass of water somewhere
سپس حالت تخیلش را بازگرفت و باز بی حرکت ماند.	then he resumed his thoughtful attitude, and became motionless once more.
او بسیار بدبخت است!	he is very unfortunate
جز آنکه با التماس و الحاح در نرم کردن دل کلاید بکوشد کار دیگ ری از دستش ساخته نبود.	she could not do other than deal tenderly and pleadingly with him.
لباس سیاهی پوشیده	dressed in black
سبد نان را به سمت او کشیدم.	I pushed the basket of bread toward her.
حالا دیگر وقتش است که بروم.	it is time for me to go.
خودش را پوشاند و لب باز نکرد.	wrapped herself up, without opening her lips.
گویی قرار بود خانم رمزی فردا برگردد.	as if she expected to come back tomorrow.
در یک خوابگاه خفته بودند	sleeping in one bed
که تا سر چشمه برود	to get back to the spring
اما وقتی به سومی ضربه زد متوجه شد که آن یکی پر است	but the third which he tried was, from the dull sound it gave out, evidently full.
مطمئن بود که دیر یا زود از این خط عبور خواهد کرد.	he knew that sooner or later he would step across it
خودم می دونم که وضع	I know I look
تحمل شنیدنش را ندارم.	I can't bear to hear about it.
ذهن محقق باید مدام بین خط افق همه بشریت و خط افق عدسی شیئی در حال انبساط و انقباض باشد.	that a man's mind must be continually expanding and shrinking between the whole human horizon and the horizon of an object glass.
اهل خوردن ترشی هم نیست.	not a pickle eater.
بیشتر به خاطر اینکه مغزش قبل از این روی چیز دیگری بود.	mostly because her brain was already on to something else.
ولی برای جوانی که این همه به تنوع احتیاج دارد به دک هم نیست.	but it will be something for a young man so much in want of a change.
یک ملاقات معمولی است.	a regular meeting.
وقتی که نخستین موجودات تک سلولی پیدا شدند.	when the first single celled organisms appeared.
تو هم اگر بخواهی یک خانم واقعی خواهی شد.	if yer like, yer shall be a lady.
ولی احتمال قضیه که منتفی نیست.	but they might have been in it, for all that.
من حداقل بیست دختر داشتم.	I had at least twenty girls.
با تام دست به یکی کرد.	being uncommitted as yet
مردی که حال لیوان به دست شعار ساده صداقت آرامش و صلح احترام به قانون خیرخواهی سیاسی در عرصه داخلی و خارجی سر داده بود در کنار پیشقراولان شرافت ملی نشست.	glass in hand, his simple watchwords of honesty, peace, respect for law, political good faith abroad and at home the safeguards of national honour.
آنجا مهمان دارم.	I've a lot of friends there
ولی کامیون جا داشت و زنده بود	but this truck was the active thing, the living principle.
طفلک بیچاره خود را گم خواهد کرد	the girl won't know where she is
الان نمی تونم تصمیم بگیرم.	I just don't know.
اما هرگز بدان توجهی نداشته بود	but she had never particularly remarked it
شناخت باطن هر یک از ایشان برای ذهن آن دو تای دیگر تا همان پایه در پوشش ابهام فرو پیچیده بود که تشخیص چهره ظاهرش برای چشم.	each was hidden under almost as many wrappers from the eyes of the mind, as from the eyes of the body, of his two companions.
اوم دن ما اشتباه نبود	I knew it wasn't a mistake to come!
مار سیاه از پا درآمد.	the black serpent foundered.
شراب جز افسون سفید نیست.	wine is only white magic.
ولی در حال حاضر متوجه نیستم پای چه چیزی در میان است.	but at present I do not see what there is to question.
من خیلی از دست او عصبانی شدم.	I was fairly mad at him.
صدا و لحن کلام مادربزرگ کام لا تغییر کرده بود.	even then I could detect in the old lady's tone and manner a great change.
در این کار توفیق یافته بود و خرسند بود.	she had succeeded, she was satisfied.
مثل سگی که موشی رو بجنونه خو نه رو لرز وند.	give her a shake like a dog shakes a rat.
ذاتا خشن و تیزهوش بود و به علاوه با زنان مشهوری رابطه پیدا کرده بود و در این مورد خبره بود.	he was of brutal temperament and intelligent perspicacity, having, moreover, had much to do with women, and knowing them well.
باید فوری برای تمرین نمایش بروم.	I must run to rehearsal.
گفت برای یک لحظه فکر کردم آیا راهی وجود دارد که بدون بروز دادن ترسم دست او را بگیرم.	I wondered if there was a way to take his hand without admitting my fear.
بلافاصله با تمام نیرویی که داشتم سریعاً خود را به اینجا رسانیدم.	I've run here all the way.
منظورم ای نه که اگه فرصتی دی گه به من بدی تا خودم رو نشون بدم من بهتر خواهم بود	I mean, it would have been fine, if ' what I mean is, if you give me another chance, I'll do better.
که توانست حتی یک بازرس را تحت تأثیر قرار دهد	as showing that even a beadle
فهمیدم از پشت درست.	I knew it came from behind the panels.
فرصت تماشای پیرامون خود را یافت و با شعف به منظره چشم دوخت.	having now the leisure to look around, let her eyes roam in delight.
دی گه طاقت صبر کردن ندارم.	I can't stand waiting anymore.
حتی اگه اینجا توی قبر خوابیده باشیم.	even if we are buried down here in the country.
حالا بذارین ببینم چی کار کردین.	let's check how yeh've done!
من نظر دیگری دارم.	I've got a better idea.
اما وقتی رفتند پشت میز چای نشستند	but when they were seated at tea
دو نفر اول به بستن و محکم کردن طناب به دور کمر دن کیشوت پرداختند.	the first two immediately tied the latter very firmly with the ropes
ولی قابل فهم نبود.	but it was unintelligible.
سفقی در کار نبود.	was no roof at all.
پولی بیشتر از درآمد کاریت.	a half years than the sugar has.
چنین بود شادی بازیابی آزادی گم شده	such is the delight of recovering lost liberty.
اطمینان است که در ظرف یک ساعت یا ده دقیقه یا نیم دقیقه و شاید هم یک لحظه دیگر	but the certain knowledge that in an hour, then in ten minutes, then in half a minute, then now this very INSTANT
به بافتن ادامه داد.	took up her knitting.
نعم المطلوب این نشانی است که گمان ندارم	this cross seems to me
نگین آن کمی برجسته بود	the joint was swollen rather
بعد لبش را بالا گرفت	then lifted his lip
می دونم. می دونم.	I know, I know.
رئیس دانشگاه با لطف بسیار مرا پذیرفت	I was received very kindly by the warden
از خسته کنندگی و یکنواختی محیط خانواده عصبانی بود	fretting about the dulness of the house
چون دید که نزدیک است مدهوش شوم مرا به اطاق مخصوص خود برد	observing I was ready to faint, took me into his cabin
دخترهایم خواهند آمد!	they will come!
این کارها خود در حدود بیست دقیقه به طول انجامید.	which took up ten good minutes more.
من باید تنها در خانه بمانم اوه!	I shall remain entirely alone!
همه به تاجرها قرض دار شدن.	everybody got bills at the grocery.
از کنار بارانداز به سمت شهر راه افتادم و خود را با جریان آب به ته شهر رساندم.	I started across to the town from a little below the ferry landing, and the drift of the current fetched me in at the bottom of the town.
سرآنجام به این نتیجه رسیدند که بهتر است او روی صندلی بنشیند و بقیه دورش بایستند.	eventually she had to sit while everyone else stood around her.
اما خودم خبر دارم که دخترها دوستش ندارن.	I know a lotta girls dont like him.
کاش یک نفر دیگر هم بیاید.	I hope there is some one else.
چیزی آنجا راه بر او گرفته بود	something stood athwart the road
دخترم هم گویا به او تقریبا قول ازدواج داده.	she has given him a sort of promise according to what he turns out.
بعد با هر صحبتی که هنری تیلنی کرد حالش بهتر شد.	capable, as heretofore, of continual improvement by anything he said.
برای تو شایسته نیست.	it's unseemly for you.
این حرف و بارور کنم.	to believe that
عمل اتفاق است.	doubtless it is chance
ضمن ورق زدن کتاب مداد و کاغذی به دست گرفتم	I got hold of a piece of paper and a pencil.
من فردا خواهم آمد.	I'll come tomorrow.
قبلا به شما به گم که اگه بفرمایین سواد نوشتن ندارین زیر بار نخواهم رفت.	I warn you that I shall not admit that you don't know how to write.
اما بعد از اون کار گند	after that fool of a job.
منظورشان نزد شما بود	that is to you.
از آنجا گذشتم و دوباره زنده بیرون آمدم!	I passed through, and I came out again alive!
آن هم شجاعت بود.	that was courage.
چندی بیش نبود که از نگاه سبعانهء سرهایی خلاص شده بود	were but newly released from the horror of being ogled through the windows
من بخشی از علت آن بودم	I was part of the reason.
از اشپزخانه بیرون امدم.	I come out of the kitchen
وقتی منو دید فهمید که من سگ نیستم	when he met me, he knew I was no dog.
چقدر طول میکشه که یکی ازمابخواد که صندلی الکتریکی رو دوباره راه بند ازیم.	how long before someone asks him to rig up an electric chair?
شماره افسران کم بود	there being only a few officers
چشمش به در سمت راست آن افتاد.	he located the right door
این خود چقدر بجا خواهد بود که من تاج پادشاهی یکی از آن کشورها را بر سر تو بگذارم.	which will be just the thing to enable thee to be crowned king of one of them.
یعنی به کشوری که او آنجا بود مراجعت نکردم.	I never returned to the country where she lived
من ازش نخواستم این کار و بک نه	I didn't ask her to do that.
معمولاً برنده هم می شن.	so they nearly always win.
اما به شرط اینکه مثل آن روز که جنگ دو لشکر بود	if it is not shot with a sling as they were in the battle of the two armies
اگر تو بخوریش	if you eat it
اما او در اشتباه بود	but he was wrong
به طوری که سرش در اثر انباشت عقاید متضاد و متناقض دوار گرفته بود.	so that his head would be whirling with the conflict and contradiction of ideas.
خانم با اشاره سر از او تشکر کرد و به بوییدن دسته گل خود پرداخت.	she thanked him with an inclination of the head, and began smelling her bouquet.
فوری تصمیم دیگری گرفتم.	I make a snap decision.
اما بسیار میل دارم که برای تبرئه خودم نیز باشد با او ارتباط داشته باشم.	I wish I were, if only for the sake of justifying myself in her eyes.
خوانند باید توجه کند که این کارها را نخستین بار جد امپراطور کنونی بنیان نهاد	the reader is to observe, that they were first introduced by the grandfather of the emperor now reigning
کارش بک جا رسیده است!	reduced to such shifts!
من از او قول گرفتم از آن پس هیچ گاه شانه به سری را با تیر نزند او هم به قولش وفا کرد.	I made him promise he'd never shoot a lapwing after that, and he didn't.
من هیچ جا نخواهم رفت.	I am not going anywhere,
آن الماس گران بها را بین سندان و چکش بگذاری	in thee to desire to take that diamond and place it between an anvil and a hammer
مزاجش عادت به زهر کرده و آنچه به او زهر خوران یدند کارگر نشد.	neutralized the effects of the poison?
اما حال وقت این کار را ندارم	but now I have no time.
بلافاصله انگار آب سرد روی هری ریخته باشند از آن فضای رویایی خارج شد.	the dream state was lifted as suddenly as though cold water had been thrown over him
بر خود غلبه کند و قیودی را بر خود قرار دهد	by conquering and putting a constraint upon himself
شاهزاده خانم پیر با این اندیشه سوار کالسکه شد و رفت.	she thought as she got into her carriage.
بلکه به سبب انجماد رهگذران نگون بختی بود که در همان جا به سنگ بدل شده بودند.	but to the solidification of unfortunate wayfarers who had been turned literally to stone where they stood.
مصونیت هم مثل ضربه پذیری میتونه ارثی با شه ولی نمیشه روش زیاد حساب کرد.	in some cases immunities can be passed on from mother to child just as susceptibilities can.
در پرتو ماه چهار یا پنج سوار روی تپه پیدا شدند	four or five riders came in sight in the moonlight
تا دیگر آزاد نباشد و خود را تسلیم دیو کند.	to make them cease to be so and descend to the level of the beasts.
که با وجود شدت عاطفه و احساس باز هم توانسته بود لباسی بپوشد که با نقشی که به عقیدها و مناسب وضعش بود توافق داشته باشد.	that notwithstanding a real emotion she was able to dress the part she had to play according to her notions of seemliness.
برای اینکه تو سطحی و آماتور هستی.	that is because you are dilettantish and amateurish.
بذار بهت بخندن.	get laughed at.
آخرین شک و شبهة حیوانات هم برطرف شد و غم از دست دادن رفیقشان با این فکر که لااقل وقت مردن خوشحال بوده و از بین رفت.	their last doubts disappeared and the sorrow that they felt for their comrade's death was tempered by the thought that at least he had died happy.
سپس با چرخ فنری پایین آمد و باز گرد سر اهب به چرخیدن مشغول شد.	then spiralized downwards, and went eddying again round his head.
آنگاه خواهرش را که دستش را به دور کمر او حلقه کرد بوسید	then kissed her sister, whose arms encircled her
بهتره پیش از ای مزاحم نشیم.	I'm afraid I don't see any point in troubling them further.
مراکز تنبلی برای نقاطی که مراکز عمل لازم دارند.	centres of idleness wherecentres of labor should exist.
اتمام عروسی در املاک او صورت گیرد.	her daughter should be married there
که چه شگلی بودند	what they were like
زیرا این کار در حدود بیست دقیقه طول کشید	occupying, as it did, some twenty minutes in the telling
روزی خواهد رسید که دیگر سهمی نخواهند داشت	that a time is coming when they will not be afraid any more.
کسی را ندیده	he never saw anybody
سراپایش گر گرفته بود.	glaring at him through a haze of brilliant red.
اعلام کرد که وقت رفتن فرا رسیده است.	declared it was time to go.
بنابراین شاید این یکی را انتخاب کنم .	I should choose this if I might,
یا برادرانه با آغوش بازش خواهد پذیرفت.	or would receive him with a warm heart.
گفتم که با تمرین درست می شه	I told you that it was all about practice.
با حالتی سردرگم دستی به صورتم کشیدم	I rub my face confusedly.
یعنی میان جنون زن و جنون مرد.	between the madness of women andthe madness of men.
عیششان را به هم نزنیم!	I won't disturb their happiness.
حال دی گه هیچ قدرتی زیر این آسم ون نمیتونه وادارت کنه که باز هم دروغ بگی	no power under heaven could make you tell another lie here, of course
با نگاه استهزاء آمیزی به صورت پسرش دوخت.	rested on her sons face ironically.
تو هم اگه داشتی	if you had one.
او شروع کرد به کنترل خودش.	she began to control herself.
چکش را در چند گرهی صورت او جنباند و با خشم امر کرد دستور او را اجرا کند.	shook the hammer within a few inches of his face, furiously commanding him to do his bidding.
حرارتی ده هزار بار بیش از حرارت آهن تفته کسب خواهد کرد	it will receive a degree of heat ten thousand times more intense than that of red hot glowing iron
به ستارگان اسمان پهناور لایتناهی خیره شد.	looking up at the wheeling stars in the vast sky.
خرسند و از پا درآمده در تاریکی پشت آن افتادند.	fell grateful and exhausted in the sheltering shadows beyond.
اگر طغیان کنی بازوانم زندانت خواهد بود نه بند و زنجیر.	if you raved, my arms should confine you, and not a strait waistcoat
به داستان این عشق شکست خورده	to this tale of wounded self love and defeated ambition
از طلوع آفتاب تا غروب.	sunrise to sunset.
چند هیکل سیاه که صورتشان در تاریکی قابل تشخیص نبود از گاری پیاده شدند.	while indistinguishable figures descended from a wagon.
ولی او شیر را نخورد و من فهمیدم که مرده است.	but it didn't stir, and I knew it was dead.
