یقیناً یک چیزی هست که خاطرت را پریشان کرده.	I am sure there is something the matter.
فکر کردم شاید نخواهید کسی مزاحمتان بشود.	I thought perhaps you didn't want to be spoken to.
بنابراین در ابتدا من خیلی مطمئن نبودم.	so that at first I was not quite sure
من یاتاقان و واکردم	I got this here bearin' loose.
اما غذا عالی بود و شرابی عالی نیز در دسترس بود.	but the food was good, and there was good wine
از آن پیاده شد و به راه افتاد.	climbed out, and started walking.
قرا ره به رام یه چوب دستی نو بخرن.	they're going to buy me a new wand for next year.
البته کاری نکردم.	but it didn't work anyway.
در متن پیش زمینه یک سر غول آسا به طرف کوه یخ خم شده و بر آن آرمیده بود.	in the foreground, a head, a colossal head, inclined towards the iceberg,and resting against it.
اما باید این را به تو بگویم	but this much I will say
باید باهم باشد.	it shall be together.
از انتظار اواخر ماه	of the end of the month
بوی خوشی ازت نمیآد.	you don't smell good.
فعلا وقت ندارم با تو حرف بزنم.	I havent any time to talk to you now.
از زیر آن نگاه کرد.	looked out under them.
امّا با تب استخوان شکنی که داشتم قابل مقایسه نیست	but it doesn't compare with break bone fever.
ولی خیلی درد داره	but it will be painful
به سرعت از سرسره سنگی بالا رفت.	then started to climb, fast as he could
اما به قانون و حفظش احترام می ذاشت.	but he respected the law and its need to be upheld.
نشان به آن نشان که پنیرش هم گوسفندی بود.	more by token it was sheep's milk cheese.
به جستجوی او پرداختند.	so they began looking for him
هیجانی که بر اثر آن ایجاد شد آن قدر عمیق بود	so profound was the sensation that
از اینکه آینده خود را بر بنای مستحکمی و استوار بگذارد.	from preparing for the future
فرصت حرف زدن هم نبود	not talking to each other.
کمی به جلو خم شدم و عمیقاً به چشمان ریز و کم عمق قهوه ای او نگاه کردم.	I leaned forward, meeting her gaze as if I were staring deeply into her depthless, small brown eyes.
بنابراین واضح است که کلی با آن راه رفته است.	so it is evident that he has done a great amount of walking with it.
نخستین درس خود را با دقت و توجه بسیار گوش داد.	very attentively he took his first lesson.
پیش از رفتن به پای چوبه دار چنین با رنج آراسته شود.	to be so painstakingly decorated before being led to the gallows.
که اتفاقی بیفتد	that something would happen
همگی در سن و سال این خواستگاری هستند	at an age where they deserve it
بعد به جای دیگر نگاه کرد.	then looked away
بیا کنارم بنشین	come and sit aside of me
با این همه ارزشش را داشت.	it was worth it.
من باید به استودیو برگردم.	I have to get back to the studio.
آنان به هوا برخاستند	once more flying
افکار و احساسات و رؤیاهای عاشقانه خود را با یکدیگر در میان نهند.	their respective dreams without injury to each other.
وقتی به او نگاه کردم	I set eyes on him
روت گفت من چنین تصوری از او ندارم	I don't read him that way, she said.
زیرا جوانان همسایه همگی به او پیشنهاد ازدواج داده بودند	for she had received proposals from nearly all the young men in the neighborhood
قابل تحمل نخواهد بود!	it won't be borne!
حالت هیچ خوب نیست.	you ain't well a bit
فوری از این فکر او استقبال	I hastened to comply with his friendly suggestion
طوری که در آن لحظه برای اِما واقعاً جای شکرش باقی بود.	as must appear with particular advantage at that moment to her friend.
حتی بحث نمکنم.	I don't even dispute it.
اعلی حضرت که بر آن بود تا در صورت امکان بر جان تو ببخشد	his majesty resolving, if possible, to spare your life
ولی هنوز کنت درباره جهیزیه ورا تصمیم نگرفته و با همسرش در این باب گفتگویی نکرده بود.	but the count had not yet decided in his own mind the question of the dowry, nor spoken to his wife about it.
وقت کافی هست!	there's time enough!
آن همه پنجره انگار چندین و چند چشم بودند که از پشت پرده به آدم خیره شده بودند.	made one think of too many eyes behind the curtains.
توی محوطه بی درخت اون پشته.	it's in that clearing back there.
جامعه چه گفته و چه کرده	what had society said or done
اما قربانیان باید افراد ساده لوحی باشند.	but the victims had to be gullible.
که او خاطرجمع است این رفتار برای او مفید واقع خواهد شد.	because he is satisfied that it is for a certain person's benefit.
فقط سایبانی چوبی داشت.	in its place was only a wooden shelter
ولی تنها هنگامی که بخت کام لا به ما لبخند میزند.	but only when all goes well with him.
بعضی از درها اصلاً در نبودند	doors that weren't really doors at all
یاهارجام یزوس لریووکسا.	ehT sertanrvdA fo eisuS lerriuqS.
من میخوام با یکی در بی افتم که	I wish somebody mess
باکی ندارم اما منتظر تو بودم که آمده	but I was impatiently waiting for your arrival
واقعاً هم برای حالم بسیار خوب است.	it did me good!
اما از این ارام ناراحت شده بود	but the necessity irritated him
میس پراس را به حال خود گذاشت تا طبق قرار به او بپیوندد.	left her by herself to follow as she had proposed.
هیچ وقت صورتشو نمیتونم ببینم ولی میتونم چشمهاشو ببینم.	I can never see his face, but I can see his eyes.
با یک دنیا خوشنودی و شادمانی با خود حساب کردم که اکنون در برابر خود بیش از چهارده دشمن نداریم.	with glee that we had only fourteen enemies to deal with.
آخر روی سکه آفتاب هست این حتما آتش پرست است.	there is a sun on the coin fire worshipper, depend upon it.
بعدها شنیدم که به چند تن از آنان که از پهلوهای من بر روی زمین جهیده بودند آسیب رسیده بود.	some of them, as I was afterwards told, were hurt with the falls they got by leaping from my sides upon the ground.
چرا خود را در مملکت مایه عبرت مردم کرده است	for setting so ill an example to the kingdom
تا عاقبت باربر وحشت زده جوابش را داد و مرد در آن سوی دروازه حیاط از دیده پنهان شد.	till an answer came from the scared porter, and he disappeared under the gate.
با خونت او نو امضا کنی.	sign it with blood.
اما یک بازپرس بجای ایشان هست.	but there is an inspector who takes his place.
روی پرچین فرود آمد.	landed with a thud in the field over the hedge.
فصول نسبتاً زیادی از این کتاب به شرح رویدادهای اولین ده سال زندگیم اختصاص داده شد.	to the first ten years of my life I have given almost as many chapters.
قسمت آخر جمله را به زحمت ادا کرد.	he added, with difficulty articulating the words.
که به شما بگویم	, I would add that
مگر آنکه نخست این گونه هاج و واج شود	without first wandering in this manner
پاورچین پاورچین و بی سر و صدا وارد شدم.	I stole in on tiptoe.
او با ملایمت دستی روی موهایم کشید	he strokes my hair gently.
پس بادبان برکشیدم	I set up my sail
فرانک رو برنگرداند.	he crushed his impulse to turn away.
گفت من درس هم ون چیزی که بود برات ون گفتم	I tried to tell you folks, he said.
در آن هنگام کشور پرتقال با مملکت من در صلح و صفا بود.	their country and ours were at peace.
لذا ترس برش داشت و با دلهره واماند که چگونه فرار نماید	fear, and the bewildered anxiety to flee
دو تا ماهی سیاه	a couple of sun perch
غرور زود رنجش او را از پیش کشیدن این مطلب بازداشته بود.	he had shrunk with proud sensitiveness from ever recurring to the subject.
فکر کنم او و مادرت مدت زیادی هست که با هم رابطه ندارند	I think he and your mother have not had sex in a long time
اما به یاد قولی که داده بودم افتادم.	when I remember the promise I made.
هیچ خبر نداشتم بیماری	I had no idea you were ill.
به گمانم راه آهن بی آن که خودش را بفروشد با دستانش خیلی خوب رفتار کرده.	I think the railway has done pretty well by its friends without compromising itself hopelessly.
اما بجز تنفس نشان دیگری از حیات وجود نداشت.	but, except the breathing, there was no sign of life.
چه تصویر بزرگی از آن در خاطرم مانده!	what an enormous perspective I make of it!
من روزی جوان بودم تو روزی پیر خواهی شد.	I have been young, you will be old.
دهانم خشک شده است.	my mouth dry.
همانا عبارتست از اخلاق و تاریخ و شعر و ریاضی.	consisting only in morality, history, poetry, and mathematics.
اگر نه حکم قضا و قدر بود حالا شارل بیچاره در میانه ما بود.	had it not been for an adverse destiny, that beloved monarch would this day have been among us.
که منو به اسم ولگرد حبس کرد	that jugged me for a vagrant.
هنوز خودکارش را روی کاغذ نگذاشته بود.	she still didn't put pen to paper.
اما هیچ یادم نیست چه وقت.	but when I did it I can't in the least remember.
داخل دکان کوچکی شدم	went into a little shop
با دقت زیاد از آن سوی خیابان بر او خیره شده است.	was now surveying him most earnestly from the opposite side of the way.
با وجود درد بازوهایش لخت از هم گشوده شدند.	let his arms float wide and limp in spite of the pain.
در عوض یک صندلی جلوی دیوار بود	an empty chair stood against the wall
تا مثل کنه به این خانواده والامقام بچسبد.	fixing himself on this very superior family.
هنوز اون جوری احساس جی گر بودن به من دست نداده	I just don't know if I feel like a darling .
بدون آن که سر خود را به عقب برگرداند چنان او را در نظر مجسم کرده بود که انگار روبرویش نشسته است.	he did not need to turn around to see her in his imagination.
زیرا درون آب مارها مشغول شنا بودند و یا در دهانه چاه به خود پیچیده و خوابیده بودند.	for there were snakes swimming in the pools or clustering in knots around their brinks.
زیرا بیشتر کار خواهم کرد.	I will work harder.
دست لرزانش ظرف سوسیس را از او گرفت.	took the platter of sausages with trembling hands.
متاسف است که چرا اصلا با من روبه رو شده .	is sorry he had anything to do with me.
فقط قلبم را باقی بگذارید.	leave me nothing but my heart.
پشت در پنهان بشویم	get behind the door
دست چپم را درون دستش گذاشتم.	I put my left hand in his
امیدوارم نسبت به من آن قدر حسن نیت در خود حس رده باشید	I hope you may be able to think so well of me
سپس بار دیگر کشوی خالی را قفل کردم.	I relocking the vacant drawer.
سوگند خوردند که هر سه دستخط به یک شخص واحد تعلق دارند.	sworn to as being identically the same hand writing.
همین که پرستار من مرا به زمین نهاد	my nurse having set me down
چنانکه این مطلب را پس از چندی به خود من گفت	as he afterwards told me
اما این گیسوان سیاه مقبول	but that beautiful black hair
آخه یه مار کنار صندلیش بود.	there was a snake beside his chair.
من خیلی تشنه بودم.	I was too thirsty.
شاهدخت وارث تاج و تخت شود	the princess inherits
ولی بعد مجبور شد به این وضع خاتمه بدهد	but was really obliged to put an end to it
فقط سه روز هم بیشتر به فکرش نبودند.	only thought of about three days.
پایین ایوان گذاشت.	set it on the porch.
با سر در آب فرو رفت.	plunged head first into the water.
سم گفت انگشتم را به حالت اتهام به سمتش گرفتم.	I stopped in my tracks, spinning to face him.
به شمایل چسباند و دوباره چنان تعظیم کرد که دستش به زمین رسید.	again bowed till he touched the ground with his hand.
همه چیز راجع به گذشته مثل رویایی طلایی بود.	just one big heavy blast from the past, a great big golden gasser.
اما مزد خوبی به او پیشنهاد کردم.	but I offered him good wages.
اما مطمئن بود که زیاده از اندازه باده ننوشیده است	but he felt certain he was not drunk
من هیچ تصوری از این جور چیزها ندارم.	I have no idea of that sort of thing.
که قدر پهلوانان سرگردان را باید دانست یا نه!	whether knights errant deserve to be held in estimation,
افسردگی در صدایم رسوخ کرده بود.پرسیدم	I asked, darkness seeping into my voice.
روی زانویش گذاشت و باز کرد.	balancing it on his knee, let it fall open.
اما شما حال بگویید	but, first tell me
تصمیم گرفت هشت روز غیبت کند	he resolved to absent himself from his house for eight days
لحن شاد او قلبم را آرام ساخت.	the gay tones set my heart at ease.
کنت سرش را تکان داد	said the count, bowing
چون هنوز 4 به 1 هستید	because you are still four against one
طبعاً بدون آن که حرفی با هم رد و بدل کنند.	without speaking to him, of course
اما از برای اینکه شخص به این تفصیل از واقعه مطلع باشد لازم است که خود حضور داشته باشد	but in order to have known everything so well you must have been an eye witness
به نظر من که نباید افراد متفرقه رو توی هاگوارتز راه بدن.	I really don't think they should let the other sort in, do you?
حالا دی گه من اصلاً نمی تونم تکونش بدم	now I cain't get her a movin' a tall.
لیکن تذکرات و نظرات او تأثیری در فکر و عقیده کشیش نکرد و او را از تصمیم خود باز نداشت.	but all his cautions and warnings were unavailing to dissuade the chaplain from taking him away.
از ای نرو در تشخیص چیزهائی که در دورترین جاهای دریا قرار داشت به قدر ما که این همه با دریا آشنا هستیم مهارت نداشت.	so he could not be as expert in distinguishing remote objects at sea, as we who so much converse in that element.
امیدوارم که حال سرکار خوب باشد	hoping you find yourself well, sir!
من هم یک شب رفتم آنجا رقصیدم.	I danced there one evening.
این بود که به خانه امن رفتم و تو را پیدا کردم.	I went to the safe house and found you.
سرگذشت خود را هرچه زودتر بازگفتم	I had soon told my story
که توی دو سه تا از کلیساهای این شهر سخنرانی کنم و فریاد تو رو به گوش مردم بر سونم.	see if shecould not secure a church, or two, or three, in which to speak andplead his cause.
مشاهده سرخی این صورت سیل دار و پیر معتاد به الکل بسیار عجیب بود	it was strange to see the color rise in that shaggy, bibulous, time worn face
به عقیده من برای این که موفق باشی	it is my philosophy that in order to be successful
دچار اضطراب شدیدی شدم.	my spirits were depressed.
ربطی کامل به این فقره حاضر ما دارد.	is connected with the person of whom we were speaking
یه چیزی زیر بغل اونها بود	with something under their arm
صدای پایی از راهرو به گوش رسید	I come to a halt as I hear a sound.
من از چوب دستی استفاده نکرد!	I isn't using wands
به امید این که چیزی از آب در بیاید که شاید قابل چاپ باشد.	hoping to make something good enough to print.
هیچ وقت چنین قصدی را ندارم.	I never mean to.
قوطی شیر خشک هم که دیگر شاهکار واقعی بود.	but the milk can was a perfect masterpiece.
به ویژه برای آنکه عقیدهٔ خود را بدون اعتماد کامل اظهار داشته بود	grieving the more since he had put forward his own opinion with little confidence
سعی داشتند او را روی آجرها بنشانند.	jerks at her skirt to make the old lady sit down on the brick wall.
اما این حرف و به کسی نزن.	you needn't tell that.
در را باز کرد	he opened the door
آسمان چه رنگ زیبای درخشانی دارد.	how sparklingly blue was the sky.
اما گفتگوی دیگری نکنید.	but make no treaty you understand me?
سرش به موهای واقعی مزین و چشمانش از مینا بود.	ears on her head, which had real hair and enamel eyes.
من هیچی نمی گم	I won't say anything
هنگامی که ملوانان یک صدا خواندند	when the sailors began chanting
اما پرت و پل ای محض است.	but it's rotten nonsense.
که این خود نیکوکاری دیگری است.	which is only another sort of benevolence.
باید مراقب بود که مسئله به ابتذال کشانده نشود و تنها حقوق صرف مطرح نباشد.	there was the more need for scrupulous watching lest the office should be perverted into a mere question of salary.
ناگهان احساس ناراحتی کردم.	I felt a pang of unease.
اگر تو خواهرزاده بلافصل من یعنی دختر خواهر تنی من نبودی	if thou wert not my full niece, being daughter of my own sister
این عمل احمقانه است.	I say, this is folly!
ولی دستگاه روحی همچنان بیمار بود.	but his moral machinery was still out of gear.
من حاضرم منظور ترا برآورم.	for I will satisfy thee and answer all thou requirest.
پچ پچ کنان به خودم گفتم دلم برای کامیونتم تنگ شده	I miss my truck, I whimpered to myself.
چنانکه پنداشتی آماده گریستن است اما این وضع مدت مدیدی طول نکشید	he seemed about to cry, but this did not last long.
اصلا خجالت نکشیدم.	I wasn't embarrassed.
ولی هیچ کس حرفی نزد.	but nobody spoke.
فردا صبح عازم آنجا خواهم شد.	I'll leave in the morning.
توده دراز و خمیده و وزین و سیاه چیزی بود که در وسط تصویر روی سه خط آبی تیره عمود در کف درهم و آمیخته نامعلومی خیمه زده بود.	limber, portentous, black mass of something hovering in the centre of the picture over three blue, dim, perpendicular lines floating in a nameless yeast.
در جاستین نمایان شد و رنگ باخت.	turned in upon itself, and totally disappeared.
تصویر زندگی سعادتمند خود را با او برای چندین مرتبه در نظر مجسم ساخت	the scenes of happiness with him she had so often repeated in her imagination
اما در اینجا نیز سکوت غیرقابل تحملی حکمفرما بود.	but here too was the same intolerable silence.
من آنجا بودم.	I was there.
نومیدانه از خود پرسید	he said to himself in despair
این آخرین بنایی بود که در انتهای خیابانی قرار داشت	but it was the last house at the bottom of a narrow street
اما شوهرش همراهش نبوده است. و شوهر با هواپیما یا قایق به جزیره نیامده است.	but her husband wasn't with her, and he didn't come in by plane or ferry.
حقوق و کلی از این چیزها میدونه.	reads law and all stuff like that.
با توجه به محل خراشیدگی فکر کردم حتماً زمین خورده است.	I considered the location, and decided she must have tripped.
تکان جانکاهی تمام بدنش را بحر کت درآورد.	he shuddered all over with a cold shiver.
قریب به یک فرسنگ در داخل روستا راندیم.	went about three miles into the country
طی راه با ماجراهای بسیاری روبه رو شدند	met with a variety of adventures
انگار که تماس با او گزنده است.	as if the contact stung.
گفتگویشان همان قدر از نقطه آغازش تفاوت داشت که مشاجره لفظی آقای بولست رود و برادرانش در یکی از جلسات کلیسا در چند روز پیش از این.	the conversation ended at a point as far from the beginning as some recent sparring between the brothers in law at a vestry meeting.
به گمونم از این بیشتر نخ وندم.	I guess that's all.
آن وقت تا آخر عمر مدیونت خواهم بود.	I'll owe you more than ever I can hope to pay.
سیگاری از جاسیگاری برداشت و آتش زد	then she lit a cigarette
به همین دلیل برای او دامی درست کردند.	so they built a waiter trap
دعوت کرده بود آقای مارتین برای ناهار بماند.	he asked him to stay to dinner.
چون تفتیش کامل به عمل آورد کلید را در قفل فرو برد.	his inspection finished, he placed the key in the lock.
اما همین کافی نبود.	but it was enough.
کمی وارد این راهرو شدند که هم طولش بیشتر بود و هم عرضش.	shortly entered one on the same plan, but superior in length and breadth.
مثلا یک مرغ پخته	cold chicken maybe
من سوپ کلم و کاشا را بیشتر از هر چیز دوست دارم	I should like cabbage soup and porridge better than anything
تا اینکه خلاصی یابد از نگهبانی	as a means of ridding her of a guardianship which
اما ملت را به فرزندی پذیرفت.	but he adopted the people.
با این همه آنچه را که طرح ریخته بود انجام داد.	yet she did not abandon what she had planned to do.
چند بار در عالم خواب دریان را صدا کردم	I called in my dream to the lodge keeper
این کار حتماً بده.	I reckon it's wrong
ولی من که یک شاهی پول ندارم.	I have not a penny.
دو مرد قدم پیش نهادند تا پدر و دختر را از زمین بلند کنند.	they came forward to raise the father and daughter from the ground.
اما مایل نبود سه پایه را ترک کند	yet could hardly leave her easel
طبق معمول شاگردان را به ییلاق ببرم و مراقبت کنم که در آنجا مستقر شوند.	I shall have to take the pupils into the hills, as usual, and see them settled there.
آخرین صدایی که از او شنیدم	the last sound I heard of him
دست چپم را به او دادم.	I gave him the other
مطمئنم که تقصیر اون نبود.	I am sure it was not his fault.
ولی تو چت شده.	but what's got into your head?
روی حالت به لافم تمرکز کردم.	I focused on my poker face.
حاکی از شرارت یا بلاهتند نداشت.	which signifymalice or stupidity.
پس به عالی جناب اطمینان دادم که قانون علمی است که من چندان با آن سروکار ندارم	I assured his honour, that the law was a science in which I had not much conversed
نور ضعیف چوبدستیش روی موجود عجیبی افتاده	his beam of wandlight hit an extraordinary creature
با دقت به او نگریست و یکباره حالتی بسیار موقر	looked attentively at her and assumed an extremely dignified
من فکر کنم ۵ سال دی گه دووم بیارم.	I think I'm going to last at least five years longer.
شاید برای این است که من به اینجا آمدم.	maybe that's why I'm here for terms.
وسایل کهنه و میخ دار از سقف آویزان بودند.	rusty, spiked instruments hung from the ceiling.
بنابراین او را هم گیر انداختند	so they took him too.
سپس حرفش را قطع کرد.	he with that broke off
در نهایت فلج و زمین گیر شده و برای همیشه ناپدید گردید.	he finally disappeared, extinguished by paralysis.
با او نگاه کردم.	I looked with him.
دخترک با او همگام شد و با حالتی گرم و مهرآمیز به بازویش آویخت.	she took his arm in a clinging, snuggling embrace and measured her stride to his.
به پائین حمل گردید و به حیاط پشتی برده شد.	were carried down and dumped in the courtyard at the back.
سوسوی چندی است میان تودهٔ عناصر در هم ریخته.	a glimmering of light in chaos.
تنها من شاهد این منظره بودم و کسی ملتفت نشد.	no one else was looking.
ولی هیرتن با خشم و عصبانیت کتاب را به سویی پرتاب کرد و گفت اگر دست از سرش برندارد گردن وی را خرد خواهد کرد.	he flung it off, and muttered, if she did not give over, he would break her neck.
زیرا ثروتمندان مردمی فاسدند لیکن گناه آن بیشتر ناشی از غفلت و بی قیدی ماست.	for the rich among them are for the most part corrupted already, and much of that is due to our carelessness and indifference.
وقتی ایشان را دید	on seeing which
مثل یک خفّاش جهنمی خودمو انداختم توی غوغای این زندگی .	I've gone through life like a bat out of hell
او را تا منزل همراهی کرد.	he saw her home
من قبلاً فرد مسئولی بودم.	I used to be the responsible one.
میرم طبلم رو بیارم.	I'll run get my drum.
آرزوی قلبی من ای نه که دنیا از بدی و پلیدی پاک به شه	my secret ambition is to rid the world of evil
هنگام ادای این جمله اشک از چشمانش سرازیر شد.	tears came as he spoke.
ممکن بود برات خطرناک با شه.	when you might have fainted and had a miscarriage.
یا به جریان کلی جنگ ارتباط داشت و یا به اوضاع خانوادگی مربوط بود.	or it might relate to public affairs, or possibly to family concerns.
آنگاه هر بار دیگر که از زیر آب بیرون بیاید بدون یک دقیقه کم و زیاد همان هفتاد بار نفس خواهد کشید.	then whenever he rises again, he will be sure to have his seventy breaths over again, to a minute.
کلاغه برایم خبر آورده که ممکن است تو بخواهی آن را بازی کنی.	a tiny little dicky bird told me you just might want it.
البته در نهایت به شادمانی منتهی شد.	had triumphed in the end.
این هوا را از سرت بیرون کن که غیر از ازدواج راه دیگری وجود دارد.	get it out of your head entirely that this can be settled in any way but marriage.
من دی گه عصبانی نیستم	I'm not angry anymore.
این حقیقت داشت!	that was the state of the case!
دیگر وجودش ضرورت نداشت.	he will not be wanted any more.
برویم شاممان را بخوریم.	let us go to dinner.
باری ما هر دو بر اثر سوء ظن بیک دیگر اشتباه کردیم	therefore we should have been mutually guilty in any case.
ادبیات بد وجود دارد!	there is bad literature
پس اگر چیزی به گوش او برسد که در خور تقلید باشد بسیار مایه خوشنودی او خواهد شد.	he should be glad to hear of any thing that might deserve imitation.
من این اظهارنظر خیلی مث به عقیده بتیه.	I'd call that a pretty strong recommendation.
همین که تو قدری بهتر شدی من درست و حسابی به فکر افتادم که او را با کمال صفا ببال ین تو بکشانم	I have had an idea, ever since you have been better, of simply planting her at your bedside
مثلا به اون در باریکی که از پنجره زندان پیداست!	stairs which before this he had seen from the jail!
اما کوشش بسیار کرده بود تا صدایش بازآید.	but it required quite an effort for him to find his voice.
شاید برای همیشه.	for ever maybe.
در یک لحظه آن زمانی را در نظر مجسم ساخت که برای تسلی ناتاشا به وی گفته بود	the day when, trying to comfort her, he had said that if he were not himself
اما محبتم به شما همان است.	but in my love that was I.
دیروز چل و دو تا ماشین قراضه مثل ماشین شما از اینجا رد شد	I seen forty two cars a you fellas go by yesterday.
من فقط بیست و دو سال دارم	I am only two and twenty
پرستار و یک کلفت	its nurse, and her maid
آدم باید برود توی سر سرا و با فریاد او را صدا بزند.	you went out in the hall and shouted for her.
ضربة سختی به در مهمانخانه خورد	it struck sharp on the inn door
استارت آن عیب پیدا کرده بود.	something had happened to the ignition.
خوب به خاطر ندارم که آن روز را چگونه به سر آوردیم.	I scarcely know how we got through that day.
چیزی نماند که روی یخدان بیفتد.	he all but fell over on to the chest
بر اثر دودستگی به جان هم افتادند	embroiled by factions among themselves.
باز چیزی از حرف تو نفهمیدم.	I understand thee still less now
آتشی که در پی آن برپا شد	the fire which followed
بدون این که وی را برای این کارهای بی فایده سرزنش کند.	without reproaching him
در همان بار اول که خطای او برملا شود جانش را بر سر این کار خواهد گذاشت	that will take her life the first time he detects her in an impropriety?
قیمت این فلز صعود خواهد کرد.	the price would be nice, very nice indeed.
راستی که او توانسته بود از مانعی عظیم پرش کند.	which was indeed a prodigious leap.
که انتقام من فایده عظیمی برای اینجا دارد!	that my vengeance will fetch a great premium here
من ازت خواستم که بری بیرون	I asked you to get out.
بر شیطان لعنت	shiver my timbers
تقریباً گذاشت اتومبیل بایستد.	letting the car come almost to a standstill.
او با این افکار دوباره احساس کرد که دیو زشت غضب در جانش به جنبش آمد.	he thought, and again he felt something terrible and monstrous rising in his soul.
من هم کودکان را دوست دارم	but I am awfully fond of children, too.
البته تمام تقصیرها را من به گردن سرنوشت خود افکندم	I, of course, threw it all on my destiny
چون حقیقتاً قدرت انجام کارهای بزرگ را ندارند.	being indeed equipped for no other.
لذا از جا کنده شد و به طرف دهی که بنا بود نمایش در آنجا داده شود پا به فرار گذاشت و مقلد همچنان بر پشت او سوار بود.	made him fly across the fields towards the village where they were going to hold their festival.
آن جا در شمال خلیج.	over there on the north side of the gulf.
من ذاتم این جور نیست.	it is not my nature.
کلاه خود را برداشت و چنین وانمود کرد که قصد رفتن دارد.	took up his hat, as if to go.
به خدمتکاران و یک دو تن از دوستان که در خانه بودند به حقارت نگریستم	I looked down upon the servants, and one or two friends who were in the house
همین جا نشست.	she sat down
اما وقتی با دستش پی کبریت گشت روولور خیلی بزرگی را که به کمرش بسته بود دیدم.	but when he put his hand back to reach for the matches I saw an enormous revolver strapped to his waist.
تا وقتی که زنگ خورد.	till the bell rang.
من موقع خرید ماهی حتی جنسیت ان را در نظر نگرفته بودم.	I didn't even check if I got the right sex.
به او دهن کجی کرد	made a mouth at him
دیگر منتظر نشدم.	but I didn't wait to hear any more.
چگونه گذارش به چنین مکان متروک و دور از زادگاهش افتاده است.	how she had managed to reach a place so far removed from her own home
به یاد چهره شما افتادم که از دوران نوزادی نشان از هوشمندی و فراست داشت.	I thought of your face, which from your infancy had the stamp of intelligence
بعد به انبار رفت و یک صندوق چوبی کهنه و یک قوطی رنگ پیدا کرد.	then went into the shed and found an old crate and a can of paint.
از آنجا بیرون آمدم.	I started out
به او یادآوری کردم	I reminded him.
من نه فرصت آزمودن شش لول دیگرم را داشتم	I had no time to try my other pistol
خورشید تازه برآمده بود	the sun still low
من در را فشار دادم و باز کردم	I pushed the door open
یک مقدار کافی از آب سرد	a sufficiency of cold water
آن آقائی که تازه رسیده بود پاکت را بازمی کرد	the man, who had entered but a moment before me, and was still unpacking his parcels
ولی بزودی شاهد مرگ من خواهند بود در اتاق مهمانخانه منتظر منند.	who shall be the witnesses of my death before they witness my betrothal.
شمشیرش را تا نیمه از غلاف کشید	easing his sword in the scabbard
به من قول داد که اگر به قمار بروم برایم توضیح بدهد.	she promised to explain matters, and I departed.
او دستی به پشت صندلی نهاده و	with one hand leaning on the back of the chair
زیاد حرف زدم و سرتان را درد آوردم.	asking your pardon.
این را گفت و کالسکه را راه انداخت و یارو را مات و مبهوت تو جاده گذاشت.	and with that he drove on andleft the fellow standing there in the road like a bump on a log!
فکر دیگری به سراغم آمد	another thought struck me.
خودت به قدر کافی خبر داری.	you have seen enough of it.
همزمان سخنان ریشخند آمیز و تندی بر لب آورد.	the equally unseasonable impulse to burst into scornful invective.
سرش را به سمت صداهای دیگری برگرداند.	his head inclined in the direction of new noises.
او حتی قادر بود کلاه گیس نسب تا خوبی درست کند.	she could even make a passably good periwig
طوری که طفل از جای جستنی کرد	so harshly that the child started up from the floor
چشم به زمین دوخته بود.	stared at the ground.
اما قبل از دیدن ژنرال تصمیم داشت به ملاقات شخصی برود	whereas there was one visit he was most anxious to make without delay.
جوان بود و منتزع از این عوالم و به همین جهت سنگدل.	he was young, abstract, and therefore cruel
نوک چوبدستیش را روی فهرست گذاشت	jabbing his wand at the list
ولی در آن لحظه به نظرش رسید که درونش ناگهان خالی شده است.	but suddenly he didn't seem to have any insides at all.
من که علاقه به دانستن نظر کسی ندارم	I am not particularly interested in anyone's opinion,
به یادشان خواهد ماند.	they would remember him.
پشت به او کرد تا سمت خانه برود.	turned to walk to the house.
بنابراین تصمیم گرفت که همان جا بایستد و اگر بتواند صدایی شبیه سلام از خود دربیاورد!	so she resolved to stay and get out of the scrape as she could.
اندکی خم شد.	he leaned over her.
آرزو دارم بتوانم جبران این محبت شما را بنمایم .	I only wish I could thank you for it.
برای که نامه بنویسم	I had no one to write to.
صدای بنگ دیگری به گوش رسید	there was another loud BANG
مردان هنوز مو دب و نرم بودند	the men were courteous and tender
چنین خیال کرده بود که مرا بکشد	he wanted to kill me
اصلاً منتقد نیست	he's not a critic at all.
که به مجلس بیایید.	to join this assembly
با لبه پهن آن ضربتی محکم بر او زدم	gave him a good blow with the flat side of it
منتظر بود تا سرما او را به قالب دیگری تبدیل کند.	waiting for the cold to shake her into another form.
خودم یادت می دم.	I'll learn you.
خواب راحت و خوشی داشته باشیم.	he paused, than to have a good sleep.
از بعدازظهر دی گه ندید مش.	I haven't seen it all afternoon.
بچه آن روز حالا باید مردی باشد.	he must be a man by this time.
درد حدود نیمی از آن از دریا بیرون بود به طوری که ممکن بود باز هم قسمت بیشتر آن به واسطه عنصر که از آن تشکیل یافته بود روی آب قرار بگیرد.	about half way out of the sea, so that it might yet in great part be buoyed up by its native element.
سعی من این است که از حلقه بیرون بمانم.	I'm trying to stay outside the loop.
ولی تاثیری ندا ره.	I don't think I could stand it.
تا چه اندازه در معرض وسوسه نفس قرار گیرد.	to what temptations he will be exposed!
خودم را با صورت روی زمین انداختم.	I flung myself on my face.
گیرم که طوری دیگری شهادت داده باشد.	the searing, destroying power of such a thought as that
حالا دیگر دست مجروح و فکر خودکشی را از یاد برده بود.	his wounded arm forgotten, thoughts of suicide forgotten.
سپس آن اسب نزد ارباب رفته بود	after which he went to my master
احساسی شبیه بیزاری او را در برگرفته بود.	a feeling akin to remorse fretted him.
اندیشیدم اندکی به کشتی بنشینم و آن قسمت جهان را که آب گرفته به تماشا گیرم	I thought I would sail about a little and see the watery part of the world.
اما من نمیرم	but I won't go.
احتمالا او ما راندیده بود.	probably without seeing us.
من هم اگر از این داستان خبر نداشتم بعید بود اهمیت بدهم.	I don't suppose I should have done so had I not known this legend.
بیست و سه سال پیش	twenty three years ago
تبم بالا رفته.	I'm running a fever.
اما بالاخره چون شنید که کاردینال از وی دیدن خواهد کرد خوشحال و مسرور شد.	but when he heard that the cardinal was going to pay him a visit this very evening
خواهش کرد که به حرف خود ادامه دهد.	begged her to proceed.
صندلی خود را کنار میز به جای اول گذاشتم و آمادة رفتن شدم.	I had put my chair away, and was going out of the room
عجولانه از دکان بیرون رفت.	flounced out of the shop.
مخصوصا همان داستانی را که تو فراموش کرده بودی نقل کردم تا تو بتوانی کام لا به من ایمان آوری.	on purpose, so as to destroy your faith in me completely.
تداوم را دوست داشت	he liked continuity
ولی من باید بروم دست شویی.	I want to go to the bathroom.
تا اینکه شبی پایان کار فرارسید.	until at last, one night, came the end.
من خواهان مرگ او بودم.	I wanted him dead.
من به شما نگفتم	I do not say
بفرمایید بنشیند روی صندلی.	I hope you find a chair.
من اونقدرا قوهی تخیلم قوی نیست	I don't have that much imagination.
مری کار سن دور او چرخید و سر فرصت اندامش را برانداز کرد.	while she toured all the way around him, taking her time and looking.
قبل از اینکه صلح تبدیل به دعوا شود	making peace before it could turn into a fight.
بلکه با وی مانند خدمت گذار وفادار خود و کسانی	but as a man now fully devoted to him
که شاید بیش از دو هزار تا باشند	of which there may be more than two thousand
به هر حال باید تعجیل در این کار کرد	I must hurry you, so that
معلوم است که آدم باید بیاید و تشکر کند.	of course, one has to say thank you.
حالا کار دارم.	I'm busy now.
ولی حالا میدانست چه باید بکند.	but now sure of what she must do.
من مردی خشنم ولی نه چندان که ندانم با انسان و حیوان چگونه باید رفتار کرد.	I am a clown, but not so much of one but that I know how to behave to men and to beasts.
اشک چشمانش را پر کرد	her eyes filling with tears
خواهم نوشت آنچه را که دوست دارم بنویسم	I will write, what I enjoy writing
ولی نباید از یک هم چین دختری توقع ادب داشته باشید.	but you can't expect me to have any manners
چه قدرتی داشتم.	the power I had.
اما گویی همه چیز متوقف شده بود.	but things seemed to have stopped.
خیلی سعی کرده بود	he had tried
تا هر دو متفقاً از جواهری که آنسلم در آزمایش شرافت زنش یافته بود به هم تبریک بگویند.	with him give vent to his joy over the precious pearl he had gained in having established his wife's purity
در غیراینصورت لگد خواهی خورد.	I'll kick you!
خودشان به اندازه کافی سردرگم هستند.	they're wavering enough already.
اما این صداها او را متعجب نساخت	but these did not impress him.
بچه برای تغذیه خود به شیر گاو احتیاج داشت	course of treachery and deception
خدا کند رفته باشد	I hope to heaven that he has gone
که انگار خیلی بد و زشت بود	it must've been really bad
به طرف در رفته	he staggered towards the door
ابدا نمی دونم که امتحان خوبی پس می ده یا نه.	I haven't the faintest idea whether he would make good ornot.
حتی به پسرهای معقول هم گاهی باید تذکر داد.	even decent boys need reminding sometimes.
کاملاً سالم و قبراق بود.	to enjoy excellent health herself.
با پنجه به سر برآمده و پاهای متحرکش زد و او را زخمی کرد.	struck at its straining head and slashed at its moving feet.
نمی دونم .	I don't know.
سربازان و فرماندهان حقوق یکسان دریافت خواهند کرد!	the officers and men would be paid the same.
تحملش را نداشت.	she could not stand it.
احتیاج خواهد بود که به اینجا بیائید	you will then need to come here
اما ورانسکی او را نگه داشت.	but he held her back.
دیگر به اوج افتخار رسیدند.	the very summit of glory was reached.
بدان مناسبت مسأله آرامش و نظم پایتخت و حفظ روح وطن پرستی اهالی مسکو نه فقط در عداد مسائل درجه دوم و فرعی قرار گرفت	which treated the tranquillity of the capital and its patriotic fervor as not merely secondary
در اتاقِ رو به رو بانوی سالخورده صاف به او خیره شده بود!	in the room opposite the old lady stared straight at her!
آنگاه با زبانی الکن به تقریر یک قانون اساسی پرداخت.	it returned to the stammer of acharter.
از همان روزهای نخست کوشیده بود	from the earliest days of the revolt he had careully worked
او در ظرف مدتی بالغ بر شش هفته تمام داستان را به شرحی که در این کتاب آمده است برای من ترجمه کرد.	where in little more than a month and a half he translated the whole just as it is set down here.
شام و خمیر پخته.	dumplings for supper!
بعد از مدت زیادی هر دو از حال نیمه بیهوش و خواب به خود آمدند	after what seemed a mighty stretch of time, both awoke out of a dead stupor of sleep
او با لحن اعتراض آمیزی پرسید	she asked defiantly.
تا جائی که ممکن بود صادقانه به تو خدمت کردم.	I think I have served you faithfully.
اما در آن موقع چون آمادگی برای ترسیدن داشتم و افکارم خیلی آشفته بودند	but then, prepared as my mind was for horror, shaken as my nerves were by agitation
او احتیاجات سادة مرا برایم فراهم کرده است	he has seen after my simple wants
خوب می دونم چه حالی داری.	I know just exactly how you feel.
بعد آن را درآورد	then took it out
اما کافی بود.	but it was enough.
این رنجی الیم نیست!	isn't that suffering!
از روی کشتی در دریا افتاده بود.	that was trailing overboard across the stern bulwarks.
اما صدایش آن با حالت بدی در سرسرا پیچید و آن دو نیز فورا ساکت شدند.	but the sound echoed dismally into the silence, and they stopped fairly quickly.
که در هیچ مکانی توقف نکنم	not to stop till
او از شدت ضربه به خود پیچید و روی زمین غلتید.	sending him reeling backward onto the grass.
کاترین هراسان شد و لولای قاب را شکست	she broke the hinges and divided the case
تنها سلاحش را از دست داده بود.	he had lost his only weapon.
در این هنگام به پنجره نزدیک شدم و به خارج خم شدم .	I went up to the window and leaned right out of it.
کاترین به شتاب خود را کنار کشید	she hastily disengaged herself
بلافاصله هر سه نفر با وحدت نظر کاملی برگشتند	upon which, they all three faced about
در این مورد اطمینان داشتم.	I was sure of that.
بدتر از یک گرگ دن سرکش	more effectively than a rampaging rhino.
باری چنانکه در این تاریخ آمده است همین که مهتران اندکی از اربابان خود دور شدند	it says that, withdrawing a little from the others
اما هرگز جرات جلو رفتن از او را به خود نداد.	but never daring to go beyond her.
یه سوراخ روی پیرهنتون دار ین.	you have a hole in your shirt.
من دستیار تو نیستم و نخواهم بود.	I'm not your assistant and I never will be.
مجبور بود روز مهمانی در شهر باشد.	must be absent on the very day.
یک پهلو از آب بیرون جهیدم و از دماغ آب را بیرون ریختم و یک کمی این طرف آن طرف فوت کردم.	I popped out to my armpits and blowed the water out of my nose, and puffed a bit.
چون شش هفته تمام لباس کذایی قانونی را در بر داشته	that, in consequence of having worn the regimentals for six weeks past
من واقعاً از تو توقع چنین کاری رو نداشتم.	I'm very disappointed in you.
چون بیش از حد مبهوت و هیجان زده و گیج و ذوق زده بودم.	I was too amazed and excited and bewildered and happy.
پس خیلی زشت است که خانم جوانی خواب آقایی را به بنید	it must be very improper that a young lady should dream of a gentleman
اما اثبات اشتباه او به معنی دامن زدن به خشم وی و افزودن بر پهنا و ژرفای شکاف حاصل بود.	but to prove her wrong would mean irritating her still more and making the rupture greater that was the cause of all his suffering.
چهار خروس و بیش از چهل مرغ داشت.	held four roosters and upward of forty hens.
از برای اینکه سعادتمند شوی	live to be happy yourself
تلفن همراهم را توی کیف گذاشتم	I put the phone away in my bag
زیرا پس از آنکه وی چند کلمه سخن گفت آمدند که غله کشتزاری را که من در آن دراز کشیده بودم به در وند.	for, upon some words he spoke, they went to reap the corn in the field where I lay.
حالا فرض کنیم از من بخواهند نماز بخوانم.	I only hope they won't make me!
این شخص با کمال ادب گفت	asked the visitor
به شما اعتماد داریم	puts faith in you
اما نزدیک نانوایی با گروه دیگری از این افراد مواجه شد.	until he passed a group of them next to the bakers.
در حالی که تنها زانوی خود را در فرو رف تگی نیم دایره جای پا قرار داده بود	with his solitary knee fixed in the semi circular depression in the cleat
اونها هم به جاهایی که بهشون نیاز دارن میرن.	I'll bet he's got the trains running on time and all his ducks in a row.
به نظرم خودم بدانم چه شده.	I think I know what it is.
به زودی اینجا خواهد بود	but he'll be here soon
جای ما از همه به ورزشگاه نزدیک تره.	we're as close as we could be.
به اتاق خود خزید و با افکار خویش تنها ماند.	she went to her room and remained alone with her own thoughts.
هر جا بخواهی بروی پیاده خواهی رفت.	for what journeys you take, your own feet will serve you.
یک تابلو هم تا به حال نفروخته.	I don't think he's ever sold a picture.
گذشته از این من یقین دارم	for sure I dare say
کاش دلت آزاد بود.	I wish your heart were independent.
هیچ کنترلی روی کارم ندارم.	I have no control over myself.
دوان دوان و جست و خیز کنان	jumping, ducking, and breaking through
آن پسر جوان سال گذشته شاگرد خود او بود.	the boy had been one of his students last year.
سرش به سنگ خورد	striking his head against a stone
ناگهان احساس کردم انگار به خاندان سلطنتی یا مشابه ان تعلق دارم.	I feel like I've suddenly become part of the royal family or something.
سپس با سرعتی سرسام انگیز به پیش راندند.	then borne forward with prodigious speed.
فردا هم شاید بگوییم و بشنویم.	may not be said and heard again to morrow.
پیک واقعی که به دنبال او آمده بود	the real express sent after him
تو زنی داری به حق سرمشق و افتخار تمام زنان شرافتمند.	are that thou dost possess a wife that is worthy to be the pattern and crown of all good wives.
اما پیاده گردش نماییم.	but let us walk
دکتر که لحن صدایش عوض شده بود سخنم را برید	the doctor interrupted, and his voice was quite changed
خیس از عرق بود.	he broke out into a sweat.
یه سورپریز کوچولو برای همتون	surprise for you all
من یقین کردم	for I was sure
یک چیزی توی ناهار بوده	something they ate at dinner
زیر پاهایش در اثر ورم از شکل افتاده	because swelling had disfigured her legs
راجع به روزهای قدیم .	about the old days.
ولی من سقفی روی سرم دارم و غذا و لباسی.	but I have a roof over my head, and food and some clothes.
من خیلی زود متوجه شدم که بیش از آن نخواهم توانست کاترین را نزد خود نگه دارم.	I speedily found it would be impracticable to retain my charge beside me, as heretofore.
این را خوب به خاطر داشته باش!	you may lay to that.
سرانجام تقاضا کرد پنج لیره بوی قرض بدهد.	at last he asked him for five pounds.
مگر اینکه با قدرت اون مقابله کنی.	if n you don't fight off his power
من تنها از راه سادگی و پاک دلی در این خصوص سخن گفتم.	I only told you that in the goodness of my heart.
من قدرت بزرگی داشتم.	I had a great power.
منظور او پولی است که به من داده و موضوع نجات من است.	that I bowed down to the ground for that money!
من آرزوی دیدن اقیانوس را داشتم	I longed to see the ocean
اما صورتش هنوز ریش نداشت	but his face was beardless
چشمانش با صداقت وحشتناکی نگاهم را نگه داشتند.	eyes holding mine with such terrible honesty.
کاملاً مطمئن نبودم.	not quite certain.
امیدوارم که این مسافرت موجب بهبود او شود.	I hope it will cure him.
من هیچ به مرگ تو راضی نیستم.	let the hen live
در آن لحظه به ورانسکی نظر افکند.	then she looked at him
زمانی را به یاد آوردم که به خاطر من از حالت گرگ بودنش خارج شد.	I remembered him forcing himself out of wolf form for me.
بدون آن که بتوانم حتی یک کلمه با او حرف بزنم!	I might not even speak to him.
نبادا به رام دعا کن ین.	fear you get praying over me.
ناگهان زنگ در صدا کرد	when the garden bell rang.
وگرنه به زبان دیگری با تو حرف خواهم زد.	or I'll be having another kind of talk with you.
بلکه قلمی را که رو به او گرفته شده به دست گرفت	but taking the offered pen, copied upon the paper, in the proper place
صحن حیاط پر از کالسکه بود	the courtyard was full of carriages
من یک تل آهن پاره ته باغ دارم.	I have myheap of old iron at the bottom of the garden.
اما محلی نگذاشت.	but made no sign.
آمادگی هر کاری را خواهم داشت.	I shall be ready for anything.
در حالی که پیشانیش له شده فرو رفته بود.	with his forehead crushed in.
حالا این یکی قوز بالای قوز را ببین که دم گاو مرا برداشته	then, all because of him, came the other gentleman and carried off my tail
دوباره از پنجره به بیرون نگاه کرد.	then gazed out of the window again.
آنگاه درباره زیبایی شگرف آن روز سخنانی بر زبان آورد.	proceeding to remark on the rare beauty of the day.
بنابراین وجدانم راحت است. به حضور والاحضرت رفتم.	so my conscience was at ease. I came forward. .
به فاصله سه گز از چشمان خود نگاه داشت.	brought me within three yards of his eyes.
چشمان خویش را چنان به من دوخته بود که گویی خیال سوزاندن مرا دارد.	bent his eyes upon me, as if he would have burnt me up with them.
پشت سر خود به رختخوابی که آن را ترک گفته بودم نگاه کردم.	I looked back at the bed I had left.
به طوری که قهوه از فنجان لب پر زد و ریخت.	so that he spilled his coffee.
شمع را فوت کردم و میان بستر جستم و خودم را به توجه الهی سپردم.	then blowing out the light tumbled into bed, and commended myself to the care of heaven.
اما به محض اینکه از در خارج شدم قهقههٔ خنده را سر دادم.	but I went away and roared with laughter.
من سرم را تکان دادم و چرخیدم تا از او دور شوم.	I shook my head and turned away.
سپس برخاست و با شتاب راه خود گرفت.	then got up and hurried away.
اکنون بی آنکه فکر دیگری به ذهنش برسد مات و مبهوت خشکش زده بود.	now stood thereunable for the moment to think of anything more to say.
سپس شروع به گاز گرفتن و دریدن دیگران کرده	then fell to biting and tearing the rest
بعد آن را زیر پیراهن پشمی ملوانی خود پنهان کرد	then, hastily concealing it in the bosom of his jacket
امشب برای کشتن وقت مشغول خواندن کتابی شدم	I was reading a book to night, to wile the time away
از آن حتی یک حرف به گوش دختر جوان نرسیده بود.	not a word of it had reached the young lady's ears.
با این غنیمت به عجله راه بازگشت را در پیش گرفتم.	with this booty I made a hasty retreat.
بدون سر و صدا فوراً از در ورودی به طرف راست پیچید	at once slipped unnoticed through the door on the right
با کمک کس دیگری بار را روی زمین گذارد.	with the help of another man laid his burden down.
از اینکه در محضر آسمان جاه شماست با حالی پریشان و منقلب رنگ از رخش پریده و نفسش بند آمده است به نظر عنایت و مرحمت بنگرید و او را با مهر و شفقت به حضور بپذیرید.	quite stupefied and benumbed at finding himself in your magnificent presence.
تصمیم داشت جریان را برای شما تعریف کند ولی در ماند رلی نبودید.	then when she came down that night she was going to have told you all about it.
برای نخستین بار روحیات او را پیش خود مجسم کرد.	but for the first time picturing to himself her soul.
با دلبری تمام او را مغلوب ناشده به در برد.	gallantly taking her way unvanquished.
از فرصت برای تجسس در قیافه و ظاهر او استقبال کردم.	I welcomed the opportunity to examine him at my ease.
که او در آن شب مورد وثوق و اطمینان شوهرش بوده است.	that she was in his confidence that night.
ولی تا حد اشک ریختن از آن به ستوه بود.	but she made him weep with exasperation.
ولی ان جی او راباجدیت و صلابت ازکنارپنجره دورکرد.	but she drew him quickly and firmly away.
در حالی که دستم را روی دهانم گرفته بودم خود را از او عقب کشیدم.	I lurched away from him, my hand tight over my mouth.
اما همه آن فروتنی ملالت بار سیمایش را ترک گفته بود.	but all the weary submission had gone out of his face.
شاهزاده این بگفت و بط رف سالن روان گردید.	said the prince, and entered the drawing room
آنگاه کمربند خود را مرتب کرد و وارد حیاط شد.	then, adjust ing his belt, he went into the churchyard.
با وحشت و هراسی آمیخته به مهر به آن مرد نگریستم	I looked with sympathetic awe and fearfulness upon the man
به زحمت بسیار روی تختخوابش بلند شد	he had risen from bed with great difficulty
به او گفتم که چون از بخت بد یا نیک زورقی نصیب من شده است برآنم که دل به دریا زنم	I told him, that since fortune, whether good or evil, had thrown a vessel in my way
بعد بدون یک کلمه حرف مرا تنها گذاشت.	then left me without a word.
یاد حرکت دیروزش در موقع رفتن افتادم و یک مرتبه نگران شدم که مبادا واقعاً تعادل عصبی خود را از دست داده باشد.	I recalled his singular conduct of yesterday, and really I began to fear his wits were touched.
در این موقع بر اثر تغییری که در احساسات او بو جود آمد احساس تشنگی کرد.	then the revulsion of feeling made him thirsty.
هیجان عمیقی داشت که برایش قابل فهم نبود.	feeling a deep excitement that he couldn't explain.
چشمان من در زیر اثر محبتی شدید و آتشین سیاهی رفته است.	with eyes that turned blind with their eagerness and deep affection.
با سر و صدای زیاد و تبختری فراوان از شهر خارج شد.	rattled out of the town right gallantly.
چشمانم را از او برگرداندم و به آتش بخاری خیره شدم	I turned my eyes from him, fixed them on the fire
حالا که ما تا اینجا به همراه او آمدیم	now that we have accompanied him so far on his road home
با حرکت منفی سر و دست از این عمل امتناع ورزید.	made a gesture of refusal with his head and hand and by that gesture
چشمان خویش را به زمین دوخته و همچنان ساکت نشسته بود.	but sat severely silent, with his eyes fixed on the ground.
آنچه بر من از آغاز فرود آمدنم به خانه پدرش تا آن هنگام گذشته بود تصدیق کرد.	being admitted, confirmed all that had passed from my arrival at her father's house.
با گفتن این راز هنوز چیزی در من به جا مانده که شایستهء دلسوزی و ترحم شما باشد.	that there was something left in me at this time which you could deplore and pity.
همچنان که او نیز همهٔ هستی خود را به دست او سپرده است.	the friend whose life was delivered into his!
با این همه مشاهده کردم او اصلاح نشدنی است و به مین جهت وی را به حال خود گذاشتم.	I thought I spat on the ground and left him in disgust.
حاضر نبودم که افکار و عقاید خود را بیهوده به دور افکنم.	I hesitated to throw my mind frivolously away.
از ترس اضطراب به طرف در نگاه کردم تا ببینم کسی متوجه من بوده یا نه.	I glanced hurriedly at the door, like a guilty child.
ولی ترجیح دادم که مستقیماً به خانه برگردم.	I wanted to come straight back to you.
سپس از اینجا خارج شده و مبادرت به قتل کرده است.	and then went away and immediately did the murder.
رفت و خود را روی صندلی کنار میز انداخت.	then plumped down in a chair by the table.
باز انتظار کشیدم و باز آن حیوان از بیرون آمدن امتناع ورزید و دوباره در قفس دراز کشید.	that I still waited for him, and that still he did not come out, and lay down again.
از فرط بی تابی پایش را به زمین کوبید.	stamped his feet in his impatience.
گویی توانایی ایجاد ارتباط میان مکان و صوت را از دست داده است.	as if he had lost the habit of associating place with sound
او میل دارد من هر چه زودتر پایم به گور برسد تا آسوده شود.	he would not relent a moment to keep me out of the grave.
خب در واقع اون بود که آبجی مو وادار کرد رو من جاسوسی کنه.	well, it was him put her up to narking me.
چون به انتظار ایستاده بود با خود گفت	waiting there, she thought
پس از اینکه کار خود را عملی کردند و فرار نمودند	after having exhausted the ideal
گوشش به التماس و درخواست او بدهکار نبود.	turned a deaf ear to her pleas
وقتی صندلی را به او تعارف کرد تا بنشیند	when he showed him the chair so that he could sit down
تا این که احساس کرد نگاه یک مرد سفید پوست رویش سنگینیمی کند.	until he felt the eyes of a white man upon him.
در تاریکی شب کورمال کورمال به در نزدیک شد	he groped his way to the door
اما به زحمت چشمان خود را باز نگه داشت.	but he had to make an effort to keep his eyes shut.
هنگامی که صدای بند آمدن نفس اطرافیانش را شنید	as the people above him gasped
اما حضور او را احساس کرد و خوشحال شد.	but everything told him that she felt his presence and was glad of it.
به اجبار این حقیقت تلخ را پذیرفته بودند	had to submit to the realities of a new time
گرچه هر گاه و بیگاه نگاهی خیره به من انداخت.	though now and again he remembered my existence and flung me a remark at hazard.
افق دیدش را بگستراند تا جایی که با افق دید خودش یکی شود.	of widening his horizon until it was identified with hers.
چون وجدان ناراحت و وحشی که داشت برایش مسلم کرده بود که	for his troubled conscience and fears almost persuaded him that
او به جستجوی بیل خود که سر شب جا گذاشته بود	he came to fetch his spade, that he had forgotten.
توجه به این نکته که تمام لذات آن روز پایان پذیرفته است اندوهناک بود.	knowing that all the enjoyment of that day was over.
وادارش کرد تا صورتش را در آن اندام شگفت فرو برد	made him bury his face in that astonishing composition
لذا من تصمیم گرفتم که به آنجا رفته و واقعه را با چشم خود از نزدیک ببینم.	I determined to go up and see for myself.
زیرا آنچه دیده و شنیده بودم خاطرم را سخت برآشفته بود.	for I was troubled in my mind with what I had heard and seen.
پدر از خانه خارج شده و پی کار خود رفته بود.	he had already gone to his business.
ولی چون به خاطر آورد که اگر بخواهد درصدد رد کردن آن برآید	but as he recollected that, in the event of his refusal
دست یکدیگر را گرفتند و صورت یکدیگر را بوسیدند	seized each other's hands, kissing them and pulling them away
همچنانکه حرف می زد شمعی را افروخت و رو به من گرفت تا من پیش بیفتم	so saying he lighted a candle and held it towards me, offering to lead the way.
با اینکه واقعاً اعمال او شایسته چنین سرانجامی بود باز از اینکه به دست خودش او را گرفتار سازد وحشت داشت.	richly as he merited such a fate by her hand.
این لرزش بیشتر ناشی از هیجانی بود که برای شنیدن داستان همسایگان عارضم گشته بود.	moreover, I was excited, almost to a pitch of foolishness, through my nerves and brain.
بعد از جیب کت. دستمال سپیدش را درآورد و به روی دامنم انداخت.	then he threw his handkerchief on my lap
سپس شرحی مختصر از سفر دریائی خود بیان کردم.	I gave him a very short relation of my voyage
طوری که تقریباً به صورت یکی از قدیسین درآمده است.	was on his way to becoming a saint.
درست به موقع متوجه قصد و نیت او شدم و خودم را محکم نگه داشتم.	I saw his intent in time to brace myself.
رویاهایی به نظرش آمد و به کلی خل شد	it got on his mind and turned his brain
وظیفهٔ فعال بودن و زیبائی آن را بر او آشکار کرده بود.	he had revealed to her duty and the beauty of action.
که از خرد شدن و خفه شدن مصونش داشته بودند.	in such a manner as to preserve him from being crushed.
ترس مرا گرفت و تازه دریافتم که از شب باید خیلی گذشته باشد.	that I had a lazy apprehension of the great deep rising in the night.
لیکن دیمیتری اصرار ورزید که من به او خدمت کنم	but he pitched on me to be his servant.
بن ابر این تصمیم گرفت برای پر کردن ساعات فراغت خود به دنبال چیزی دیگر بگردد.	had to seek other pastimes for his idle hours.
او مجبور شد که حواسش به همه جا باشد	caused her to look round.
ولی همین که پدرش در پشت درختان باغ از نظر ناپدید شد	but the moment he was concealed by the trees of the garden
اظهار داشت که بله چنین افتخاری نصیب او شده است.	said that he had had that honour.
زیرا آن را امر کام لا طبیعی میدانست.	but that seemed to him quite natural.
من هم بی سرو صدا به سمت محلی خزیدم که دوستانم در آنجا منتظر بودند	I crept quietly back to where my companions were waiting
مطمئن بود که صدای جیغ او را شنیده است.	who had screamed.
به اتاق جلو برگشتم که درش را باز گذاشته بودم.	I turned back to the front door, which I'd left open
شنلش را روی آن به تن کرد که سردش نشود.	pulled on his cloak for warmth
اما مضطرب بود و دل و دماغ آن را نداشت.	but he was troubled and fell in no mood for it.
میل داشت بدون مقصد به قدم زدن پردازد.	he felt that he must go away somewhere, anywhere.
چون چیز دیگری در دلش ریشه دوانده بود.	for something very profound had changed in his heart
اما همین که دست لرزانش را دراز کرد	but as soon as her trembling arm left the bed
خودم را روی آرنج بالا کشیدم تا بتوانم صورتش را بهتر بتوانم ببینم.	I pulled myself up on my elbow so that I could see his face better.
اما برای یک بار هم که شده جورج به اطراف نگاه نکرد و چشمانش را از الکساندرا برنداشت.	but not once did he look around or take his eyes from her.
آنگاه آلات و ادوات خود را بیرون آوردم.	I then took my tackling.
بدون از دست دادن وقت بس وی بام خانه رفت.	hurried up to the house top.
در حالی که زبانش از دهانش کمی بیرون مانده بود	with his tongue poking out
همان تجاوز طبیعت به گوشه و کنار این فضای بیکران بود.	even as the woods had done.
به علاوه به مرحله اعلای تقدس ناهنجارش رسیده بود.	then, she had reached herfierce stage of devotion.
لینتون با لحنی آمیخته با گریه و زاری فریاد برآورد	he rather shrieked than said.
به دلیل اینکه من آنچه لازمه این کار بود به عمل آورده بودم	my precautions were taken.
در کمال هوشمندی بازویش را در اختیار او گذاشت تا دوستش به آن چیزی که به شدت نیازمندش بود برسد	managed very cleverly to give him the support of her arm he really needed.
دردی که احساس کرد از آخرین حد امکان بیرون بود.	the grief which he felt surpassed the bounds of possibility.
بلکه چیزی شبیه ترس سراپای وجودش را فرا گرفت.	however, but quite another feeling akin to terror had overtaken him.
که در صورتش هیچ چیز خوشایندی نداشت.	with nothing very pleasant in his face.
آغوش باز کرد و او را در آغوش گرفت	but flew to him with open arms.
در برابر تمام رنج و عذاب بشری زانون زدم.	I bowed down to all the suffering of humanity,
در طی این مدت فقط چند بار ناخوشی و کسالت کاترین کوچولو موجب ناراحتی و نگرانی خاطرم گردید.	my greatest troubles in their passage rose from our little lady's trifling illnesses
در موقع عبور کردن از شهر به قدری احساس محبت و صمیمیت در من تقویت شده بود	I was so softened and forgiving, going through the town
عادت داشت در خانه بماند و در همان جا بخوابد.	was accustomed to sleeping in the house.
اما در نگاه اول به نظرش رسید که صندوق خالی است.	but at first he thought it was empty.
احساس کردم که کلمات تسلی و دلداری سودی ندارد	I felt that no words of condolence availed
دوباره کوشیدم که خویشتن را از بند رها کنم.	then striving again to get loose.
همدیگر را در آغوش کشیده و به گریه افتادند.	held each other close, rejoicing with hearts too full for words.
درست مثل راهنمایی یک مرد کور در خیابان.	as if he were a blind beggar on the street
آنگاه بسته را به زیر بازوانش لغزاند.	slipped the bundle under his arm.
ولی هنوز کلید کاملاً به دست دخترک نیفتاده بود	but, ere she had well secured it
همچنانکه شب پیش پیشانیش را بوسیده بود.	just as he had kissed his brow on the preceding evening.
اونقدر مفلوکن که آدم نمیتونه برای کسی در دل کنه.	which he dared not even describe accurately here.
ناگهان صدایی شنیدم که آرامش و شادی بزرگی به دلم بخشید.	my heart was suddenly and greatly lightened.
دخترک همان طور که میدوید و نزدیک میشد مرا صدا میکرد.	calling me as she ran.
لیکن همین که به پشت دیوار حیاط که چندان بلند نبود رسید	but as soon as he came to the wall of the yard, which was not very high
بی شک از تصادف نامیمونی سرچشمه گرفته است	it was all to beattributed to an unfortunate accident
زیرا به ارباب من این اندرز شوم را داد که مرا به شهر مجاور که تا آنجا سواره نیم ساعت راه بود و تا خانه ما پنج فرسنگ و نیمی فاصله داشت ببرد و در هفته بازار به معرض نمایش بگذارد.	by the cursed advice he gave my master, to show me as a sight upon a market day in the next town, which was half an hour's riding, about two and twenty miles from our house.
خواست خطوطی چند بر این تصویر بی افزاید.	he wanted to touch that figure
خودش به سرعت پایین رفت و به محوطه برگشت.	streaked back toward the ground.
اما او کوشید که این افکار را از خود دور کند.	but he made haste to drive it away.
سپس در ضمن که با یک دست نور فانوس را رو به دریای پایین گرفته بود	then, with one hand dropping his light low over the sea
وای به حالش اگر چنین خیالی را به سرش راه دهد.	I detested him just then.
پشتش را به درخت فشرده و کمی به پایین خزید.	settled lower against the tree.
پس از پایان این غذا دعای شامگاهم را خواندم. و بعد بستر خواب را آماده کردم!	I said my evening prayers at its conclusion, and then chose my couch.
لکن ابراز عصبانیت خود را به بعد موکول ساخت	but he resolved to be quiet for the time and show his resentment later.
به اتاق نشیمن رفت و چراغ را روشن کرد	went to the living room and lit the lamp
به صورت او با نگاهی غضبناک خیره شد.	looked him full in the face.
به تصویری از درد و وحشت بدل شده بود.	had deepened into one of pain and horror.
چنانکه چشم چپش چهره او را دید آرام گرفت چند لحظه چشم از وی برنداشت.	that his left eye could see her face he calmed down, not taking his eyes off her for some seconds.
ناگهان دریافت چه چیزی ترسانده بودش	suddenly she knew very well what had frightened her
بعد یک مرتبه پایش را بلند کرد و روی نقشه شاشید و رفت و لام تا کام هم حرف نزد.	then suddenly he lifted his leg, urinated over the plans, and walked out without uttering a word.
پس از آن با شتاب وارد خلنگ زار شدم	then I struck off across the moor
به خاطر حادثه وحشتناکی که اتفاق افتاده	with the terrible excitement of the evening
این چه رؤیایی بود که خون را در عروقش منجمد ساخته	what was that, which sent the blood tingling to his heart
آنگاه با افسردگی تمام به یکدیگر نگاه کردند.	looked uneasily at each other.
از ای نرو گله گاو و گوسفند را از جیب خود بیرون آوردم.	whereupon I took my black cattle and sheep out of my pocket.
یا اینکه بوسیله شما دربارهٔ او اطلاعی بدست آورم.	or to learn from you where he is now.
از شرم نتوانستم سرم را بلند کنم و در چشم او نگاه کنم.	I felt ashamed to look him in the face.
من توی یک چشم به هم زدن کشو رو باز کردم و اینو از توش برداشتم.	I whipped the drawer open, and grabbed ' his.
پای آینه رفت تا ببیند به راستی موهایش را آراسته است یا نه.	went up to the pier glass to see whether she really had done her hair.
قصد داشت که ماشین خود را به کار اندازد.	for he was going to set his engine at work.
زیرا کریستف برای گردش به یک رفیق همراه احتیاج داشت.	for he always wanted a companion in his walks.
گفتم که برایم امکان نداشت در خانه بمانم	how I had found it impossible to remain behind
راهش را وسط شلوغیِ کنارِ در باز کرد.	made her way through the throng of men by the door
زیرا که بسیار عجله و شتاب به دیدار شما داشتم	I was most anxious to see you
فکری که از آغاز سفر بازگشت آرام و قرارش را سلب کرده بود.	that had given him no peace since the beginning of the voyage home.
جدایی از وی برایش امکان پذیر نیست	that he could not break away from her
چون او ذاتا آدم آرام و مبادی آدابی بود و به رضایت دوستانش پایبند بود.	for he was timid and fond of the approbation of his friends.
بعد با صدای گرفته به حرف درآمد و چیزهایی راجع به تصمیم خودش گفت	began to blubber out something about
زن و دختر خود را بعد از خود به او سپرده بود.	, that on his death bed he resigned his favorite mistress and her daughter to my care
پشت در اتاقش به گوش دادن ایستاده بود ببیند.	had listened at his door, as he passed.
اما با تمام وجود خود ناگهان احساس کرد که او دیگر نه آزادی تفکر دارد و نه آزادی عمل	but he felt suddenly in his whole being that he had no more freedom of thought, no will,
زیرا من آنچه که برای شما حکایت کردم به چشم خود دیدم و به دست خود لمس کردم.	for everything that I have told you I saw with my own eyes, and touched with my own hands.
روی شکم خوابید و سوسک را میان دو دست گرفت	subsided to his stomach with the beetle between his paws
با حاتی بسیار نجیبانه آن را کنار کشید.	flung it away from her with a gesture that was noble in the extreme.
چون که راه هر روزی هم طولانی و هم سرد بود	for the walk was long and bleak.
ولی من حاضر بودم دنیا را بدهم تا ساکت و آرام سر جایم بنشینم.	but I would have given the world to sit still.
لیکن پس از آن که دو ساعت در آن بیشه به جستجوی مارسل همه جا را گشتند و نشانی از او نیافتند	after having wandered for more than two hours in all directions in search of her without finding her
بی آنکه یک لحظه در نتیجه آن یا لااقل در تجاربی که قبلا در این راه حاصل کرده بود بیندیشد.	without reflecting for an instant on the result, nor on the experiences which he had already gone through.
با این گفته به چابکی راهش را کشید و رفت.	with that she walked on in the direction in which she had been going
با سرو وضع مرتب و خوشایندی در برابرش ظاهر شده بود.	was that he had presented a neat and pleasing appearance.
از روی نوع دوستی به او توصیه کردند که به نزد شوهرش برگردد.	now, in a burst ofhumanity, advised her to return to her husband.
فقط در یک لحظه توانست خود را نجات دهد.	only saved himself by the skin of his teeth.
درروشنایی صبح لری دوباره همان لری قدیمی بود	in the light of day he seemed to be his old self again
منتها وحشت داشتند پا به درون آن بگذارند.	but they were frightened to go inside.
اما به قدری از این موضوع به هیجان آمده بود که بقیه را کاملاً فراموش کرده بود.	but she was altogether too excited to let the matter rest.
چنان او را میان جمعیت فشار دادند که ناگهان پرده تاریکی پیش چشمش افتاد و بیهوش شد.	was squeezed so hard that suddenly everything grew dim before his eyes and he lost consciousness.
من قادر نبودم حدس بزنم که برنامة عملیات او به چه صورت خواهد بود.	I could only surmise what his course of action would be.
مثل یک آدم ترسو از اطاق بیرون رفتم.	I went out of the room like the coward
آرزو کرد کاش از اول همچو راهی نرفته بود.	wished she hadn't carried it so far.
حالا مثل گوسفندی نبودم که زیر چاقوی قصابی افتاده باشد.	now, a mere fleeing sheep before this butcher.
نکند احساسات ربرتا را زیاد از طاقتش به بازی گرفته و تحقیر کرده باشد.	caused him to suffer from a sense of having misused and demeaned her not a little.
آقای سردبیر که هم علاقمند و هم متأثر شده بود با احترام و دلسوزی به پیشنهاد خانم گریفیث گوش فرا داد.	who was as much interested as he wasimpressed and who listened to her with respect and sympathy.
تصمیم گرفت که به درمان معمولی خود متوسل شود	he thought himself of having recourse to his usual remedy
اما این صحبت در کوچه اتفاق افتاده بود.	but this conversation had taken place in the street.
نباید! به قوت بنرده چسبید و صبر نمود .	I mustn't! and holding on to the rails firmly, she waited.
که به هر صورت اختیار با خود او است.	that he was master of it.
آن قدر با او زندگی کرده بود که فکرش را بخواند.	he had been with him now long enough to know how his mind worked.
آن را باز کرد و آمادهٔ کمک خواستن شد.	held himself in readiness to call for help, if necessary.
تا آن که به خانه برگردد و خانه را ندیده برود.	as come back and leave the house unvisited.
این کار چه از نظر جسمی و چه از نظر روحی کام لا ً لازم بود تا اِما بر گردد به آن حال خوشی که غروب روز قبل داشت.	literally and figuratively, was quite necessary to reinstate her in a proper share of the happiness of the evening before.
از پیش نگران بودم که مبادا این الوارها به شما بخورند.	I was afraid it hit you.
بیش از اندازه سر به هوا و گیج شده بود و عادت کرده بود که با خودش حرف بزند.	for he grew extremely absent minded, and took to talking to himself.
این کلمه واترلو را با ادراک نفحات عالم بالا پیدا کرد.	under the visitation of a breath from onhigh.
صندلی خود را رو به روی من در آن طرف میز قرار داد و نشست و آنگاه در حالی که روی میز به طرف من خم شده بود	he then came and brought his chair to the other side of my table, leaning over it
سپس سر خود را برگرداند و دیگر هیچ توجهی با و نکرد.	then turned away and paid no more attention to him or his costume.
که پهلوی هم در چند ذرعی قبر درآمده بود	that grew in a bunch within a few feet of the grave.
آنگاه مارتین با شکیبایی آغوشش را گشود و او را در بر گرفت.	then he put his arms about her in large tolerance and stooped.
اما من خودداری نتوانستم و از ته دل خندیدم.	at which I could not forbear laughing very heartily.
بازوهایش را چنان تند و سخت روی سینه درهم انداخت	folding his arms with such violence thathis clenched
از روی کمال ادب به سلامتی علیا مخدره نوشیدم.	in a most respectful manner drank to her ladyship's health.
پرستار کوچک من دوید و به داد من رسید	my little nurse ran to my relief
اما در کمال شگفتی خنده بر لبانش خشکید.	but the laugh on his lips froze in wonder.
با جناب عالی در بلیه ای که موجب آمدنتان به این مکان شده است ابراز همدردی کنم.	of condoling with you on the calamity that has brought you among us.
زیرا بر حیله گری و احتیاط متهم دلالت داشت.	as showing the prisoner to be artful in his precautions.
در حالیکه فیلسوفی و تغافل را به یاری خود طلبیده	calling to his assistance all his philosophy and dissimulation
در حالی که موی بلند و قهوه ای رنگش بر گرد چهره پریشان بود.	with his long brown hair, all untrimmed, hanging loose about him.
با این حال این بار هم نسبت به او دچار هیجان شد.	once more, though, she felt an electric response to his person
برای همین چمدان سنگین را برداشت تا به اتاق مهمانشان ببرد	so he began to heave the case upstairs into the spare bedroom
آخرین چیزهایی که در صندوق بودند در برابر ما قرار گرفتند	there lay before us, the last things in the chest
یا راستش را بگوییم تام بم وقع به خانه رسید	at least he was there in time
که آویز آن روی پیشانیش افتاده بود.	that hung on her forehead
مرا پس از آنکه بیش از یک پیمانه سرشیر بلعیده بودم از کاسه درآورد.	took me out, after I had swallowed above a quart of cream.
در صفوف چهار نفری روی پل حرکت کرد و از مخرج پل گذشت.	spread across the bridge and began to emerge on his side of it.
به حال من دل سوزاندن را از او آموخته بودند.	had been taught to pity me.
پیر به قدری فریاد کرد که ترسیدند و دست برداشتند	but the old man resisted and cried so that they were actually frightened
آهی کشید که به نظر من نشانة آسوده شدن خیالش بود.	he gave a sigh which I took to indicate his relief.
از بخت بد آنکه این وضع ترسناک درست	this terrible situation arising now
بدون برداشتن زنجیر پشت آن نگاهی به خارج افکند	with the chain up, and peeping out
من از اطاق خارج نشدم. گذشته از این او فرصت برای نشان دادن نامه نداشت.	I was there all the while she had no time to do it!
اما گفته بودند که او این بار از زمزه میهمانان افتخاری آنان است.	but had been told that for this time he was a guest of honour.
گاریچی پس از این که مدتی معطل شد تا به نوازش حیوان پرداخت	the man to whom he belonged, having lingered for a minute or two 'to bear him up
با افتادن غول صدای مهیبی در دست شویی پیچید و زمین به لرزه درآمد.	with a thud that made the whole room tremble.
دختر کوچکش را که پرستار من بود بر ترک زین نشاند.	took along with him his little daughter, my nurse, upon a pillion behind him.
چیزی را محکم در دستش نگه داشته بود	something clutched in his hand.
مرا در مقابل دیدگان خود ایستاده نگه داشت.	holding me standing before him
اما قبل از ورود به اتاق بچه فرصت شکل دادن به آن را نیافت.	but he had not time to formulate it to himself before he went into the nursery.
اما در صورت مگ چیزی بود که لوک بر آن شد دم نزند.	but something in her face made him decide not to.
دیگر آنکه برادرش یک دختر کوچک دارد که با خود خواه دش آورد.	that his brother had a littledaughter whom he would bring with him
بر وی بانگ زد که یا تسلیم شو یا سرت را از تن جدا خواهم کرد.	bade him surrender, or he would cut his head off.
ناگاه از گوشهء چشم دامن لباس دخترک را دید.	when his eyes caught the skirt of her dress.
برای این که لرزش پاهایش قطع شود ناچار شد به دیوار تکیه بدهد.	had to lean against the wall to stop his knees from trembling.
ناچار بر اربابش بانگ زد که به انتظارش بماند.	he was forced to call to his master to wait for him.
هر چند این کار را با اکراه و اندوه انجام داد	however reluctantly and gloomily
کلاید هم بی درنگ پیشنهاد بیوه زن را پذیرفت.	which he took at once.
ما به زحمت توانستیم از کف جیب که در آنجا ایستاده بودیم برفراز آن صعود کنیم.	we could not, without difficulty, reach the top of them, as we stood at the bottom of his pocket.
اما توجه و نگاه داری من تنها به او واگذار شد.	but the care of me was wholly appropriated to herself.
به طرف پنجره رفت تا پرده را کنار بکشد.	went to draw the curtains at his window.
این فتوحات را دیگر بار به حرف زنده کنند.	achieving them again in gossip.
هردو رویشان را برگرداندند تا پرسی متوجه خندیدنشان نشود.	they both turned away to hide their laughter
من خواهم رفت قبلا نیز تصمیم خودم را در این خصوص گرفته بودم.	I shall escape, that was settled apart from you
به نحوی که پدر دیگر جرئت نکرد به تلاش خود ادامه دهد	that he did not dare to challenge her.
به منظور آن بود که زنگ را به صدا درآورد	conveyed an injunction to ring the bell.
والانتین تصمیم گرفت از تمام عالم دست بردارد و چشم بپوشد	nevertheless, make up her mind to renounce the world, sir
در سینه او احساسات و تأثرات شریفی به ودیعه گذاشته که مردانی شش برابر او هم باید بر آن غبطه بخورند!	has planted in his breast affections and feelings which would do honour to many who have numbered his days six times over.
ولی در این کار موفق نشدم و کاترین هر چه را در آن باره از پدرش شنیده بود با آب و تاب برای لینتون تعریف کرد.	I couldn't succeed till everything she knew was out.
زیرا سر را بن شانه مخالفت تکان داد.	for he shook his head by way of disapprobation.
سرم رو به جلو و عقب بردم و چشمهامو بستم.	I let my head roll back around toward the fresh air and closed my eyes.
گفتی خویشتن را چندان به پتک کوبیده که خود به فلزی گران بها بدل شده و جمله مراجعان را نیز به همین عقوبت دچار خواهد کرد.	as if he had beaten himself precious, and menaced a similar conversion of all visitors.
تعجب کردم که ارباب چه فکری کرد وقتی تو را در سالن غذاخوری پشت میز غذاخوری برای اولین بار دید.	I wonder what he thought when he saw you sitting at the dining room table for the first time.
تصمیم گرفتم به جای آنکه بالا به اتاق دست شویی بروم و دست خود را بشویم همان پایین از دست شویی اتاق گل استفاده کنم.	I went into the flower room and washed my hands in the basin to save going upstairs.
زیرا همین که لباس پوشیدم و برای عرض مراتب احترام و ادب نزد او رفتم	for, going as soon as I was dressed to pay my attendance upon his honour
هرچه در آن دوزخ به چشم دیده است برای ایشان حکایت کند.	tell them what he had seen in that hell down there.
اعلام کرد که این شرایط با وضع او سازگار است	said he thought that would suit him.
تا اینکه بالخره یک روز بردنش وسط می دون و یک مخزن بزرگ نشونش دادن و گفتن بپر توش.	finally they led him out of his cell onto the square and there was a long horse trough
منتها اینبار نوبت به خودش رسیده بود.	only now, for the first time, he wasliving it for himself.
که با نفس حبس شده در سینه منتظر شنیدن حکم فلیچ بود.	who waited with bated breath for his sentence to fall.
سرا را جلو بردم تا آن محلی را ببینم که از آفتاب سوزان به سایة آن پناه برده و منتظر وصول کردن پول کت بودم.	I stretched my neck eagerly to look for the place where I had sat, in the sun and in the shade, waiting for my money.
یا اگر قراول این عمل را دیده و گلوله به طرف او خالی کرد حسابش پاک است	should you have been fortunate enough to have escaped the fire of the sentinels
که او نیز برخاسته بود برود کرد و بیرون رفت.	who had already risen to take her leave, and went out.
خوب به یاد ندارم چه حالی داشتم. ظاهرا رنگ خود را کام لا باخته بودم.	I don't remember now, but I must have stood pale, facing him.
که پس از وقوع این حادثه زندگی خود را چگونه ترتیب خواهد داد.	how she would order her life now, after that.
با نهایت تعجب خویشتن را نیرومند یافت	he was surprised to feel himself extraordinarily vigorous.
نگران بود و ناگاه بیش از پیش ترسیده بود.	worried and suddenly more frightened than before.
دیوانه سازها از اتاق خارج شدند	glided back out of the room.
ایشان نیز با دست انداختن و آزردن او قصاصش کرده بودند.	they had retaliated by teasing him.
نمی دونم چرا تا حالا شمارو اینجا نیاورده بود.	I wondered why he didnt bring you around here before.
سپس رویش را برگرداند و خاموش به قدم زدن پرداخت.	silently continued to walk to and fro.
از شکاف دری که بسی نزدیک بژان وال ژان بود مراقبش باشد.	through acrack in the door, which was directly opposite him.
دیدم که مادرم روی تخت نشسته و سر را روی من خم کرده است.	I found my mother sitting on the coverlet, and leaning over me.
من کوشش خواهم نمود که خانم پیر را تشویق کنم	I shall attempt to persuade the old lady
بعد از پانزده دقیقه سکوت به من هشدار داد	he warned me after fifteen minutes of silence.
پاس راستش را که آویخته بود تکان داد و با وضعی چون حالت تخیل وحشیان چشم به کوره آتش دوخت.	but swung his right foot, which hung down, and stared at the brazier with an air of savage revery.
بر کیسة پر چروک صورت فرسودة پیرش بوسة ترحم را احساس کند.	to feel on the creased pouch of her worn old face the kiss of pity.
در پایان تاریکی آن شب و سفر دریایی روز بعد به وقوع پیوست.	it seemed, was, after a night's darkness and a day's sail, within touch.
خوشبختانه صحبت صحبت ایتالیا ناراحتی ماکزیم را برطرف کرد.	the conversation drawing away happily from his health
افتادم داخل یک گودال و سرم ضربه خورد	I fell down a hole and hit my head
بعد امر بری را با اشاره دست به نزد خود خواند و کاغذ را همراه با مقداری پول و دستورالعمل لازم به پسرک امر بر داد.	waving to apress boy who was near gave it to him together with the money.
نزدیک بود به دستم بزند و سینی را بیندازد.	he almost knocked the tray from my hands.
چون شیری شر زه جرج را با خشم بسیار برانداز کرد	he roared and looked about him positively like a lion.
تصمیم گرفته بقیهٔ روز را تعطیل کند.	decided to take the rest of the day off.
وقتی که ملاحان من برعلیه من توطئه کردند	when my crew conspired against me
یک گام اشتباه بارها موجب شد تا بالای زانو در آن باتلاق تیره و لرزان فرو برویم	a false step plunged us more than once thigh deep into the dark, quivering mire
بی آنکه کسی ایشان را ببیند یک شب از ده بیرون آمدند	they sallied forth unseen by anybody from the village one night
موژیک مستی که لبخند سعادتمندی بر لب داشت	roared the tipsy peasant with a beatific smile as
در طبقه پایین همه آنقدر سرشان شلوغ بود که به فکر ما نبودند.	every one downstairs was too much engaged to think of us.
به او اشاره کردیم ما را دید و به طرف ما رانده و ما را به کشتی خود گرفت	we made signals of distress she perceived us made for us and took us all on board
من فکر کردم که تو را غمگین کردم مادر.	I thought I'd grieved you.
بیرون را نگاه کردم و خیالم کمی راحت شد.	I stare out of the window
ناگهان خود را غرق در تاریکی و تنهایی جاده دید	plunged into the solitude and darkness of the road
وقتی از پنجره نگاه کردم میدونستم تویی.	I knew it was you when I looked out the window.
من سعی کردم جلوی وی را بگیرم و نگذارم در آن باره چیزی بگوید	I endeavoured to stop her thoughtless tongue.
با خندهٔ درشت و انبوه خود همهٔ صداها را خاموش کرد.	what the laughter was about, drowned all the rest with his heavy roar.
پیرزن به هنگام ادای این کلمات از ته دل خنده را سر داد.	said the old lady, laughing
گویی از نگریستن به صورت او بیمناک بود.	as though to avoid meeting her eyes.
زیرا مرا در اطاق خود محبوس کرده و سخت مراقب من بودند	being kept a close prisoner in my cabin
بیهوده نباید سخنان یک پیشخدمت زن زرد چهره حقیر را به دل بگیرد	it was absurd to care what an anaemic little waitress said to him
آسوده و بدون مانع به جانب بنا خرامیدم.	I walked enchanted, and nothing held me back.
اکنون میل نیرومندی داشتم که تمام آن زجرها را فراموش کنم و ببخشم با او آشتی کنم و دست دوستی بدهم.	a strong yearning to forget and forgive all injuries to be reconciled and clasp hands in amity.
او را در حالی یافت که بر صورتش افتاده بود	found him lying on his face
سپس با شتاب هر چه بیشتر در آب راه رفتم	I waded with what haste I could
دستش را از آن پایین کشید تا جایی که فقط انتهای آن را بین انگشتانش گرفت.	running a hand down it until he caught just the ends of it between his fingers.
این داستان نیز با دقتی تمام مورد توجه حضار قرار گرفته بود	his bearers listened with breathless interest.
تمام دستورات دریافتی را با دقت تمام اجرا کرد	punctually followed the directions he had received
بلند کرد. از تماشاخانه بیرون رفت و به میهمان خانه بازگشت.	went out in the middle of a solo and drove home.
که دختران توانسته بودند آن را بشناسند و تشخیص دهند.	which they had come to know and todistinguish.
با یک نگاه به چهره رنگ پریده و چشمان مصمم مصاحبم متوجه شدم که به هیچ وجه قصد نداشت مرا غافلگیر کند.	a glance at the placid face and steadfast eyes of my companion showed that no surprise was intended.
در این موقع تمام دادگاه دچار خنده هیجان آمیزی گشت.	here the court was convulsed
او هم دست مادرم را در دست گرفت. مثل اینکه نگاهی هم به من کرد.	as he met it with his own, she glanced, I thought, at me.
اما مثل دفعه قبل انداخت و آهی کشید.	but then let it drop like before and sighed.
خود را در آینه دید و با شعف متوجه شد آن روز یکی از روزهای خوش اوست و خود بهترین حال را دارد.	she noticed with joy that it was one of her good days, and that she was in complete possession of all her forces
باید قبل از اینکه بروند به او قول بدهد.	he must promise before they left.
بهش خیره شدم و به پایین اشاره کردم.	I stared him down.
او را نشناخته مثل دشمنی رفتار نمود.	was unconsciously acting as his enemy
احساس کردم یک جور لرزه به پشتم افتاد.	I felt a sort of shiver down my back.
بدان گونه وقتی بار دیگر دست پیش برده بود مرد سرخ پوست به همان طریق صحیح قدیم یعنی از سر پیش آمده بود.	so that with the next trial, he came forth in the good old way head foremost.
با همدیگر به آن کوره راه پیچیدیم.	we turned together down the path.
دانست که یک وهم یا خیال وحشتناکی بر او مستولی شده و اکنون روحاً و جسماً دستخوش آن است.	she realized that some frightful fancy or hallucination had seized upon him, and that, for the moment, he was at its mercy, body and soul.
من به او گفتم که وقتی از او سیر بشوم باید برود	I told her that when I'd had enough of her she'd have to go
فقط همین برایم مانده که مقام و موقعیتم را درشان یک خانم متشخص حفظ کنم	with hardly enough to support me in the rank of a gentlewoman,
اما چون همه تهیه فرار دیده شده و اسباب حاضر بود گمان کردم که فرصت نداده و خود را خلاص خواهی کرد	but knowing that all was ready for flight I thought you might have made your escape
مثل این بود که ناگهان زیر پای انسان تهی شود	in which suddenly something gives way beneath you
او را به درون اتاق نشیمن بسیار وسیع مجللی دعوت کرد.	invited him into the very large living room, which was very impressive.
متحیر بودم که آیا زن اسقف اثری را که به سرعت صاعقه. در اثر بردن این نام. در صورت من نمایان شده بود مشاهده کرده است یا نه.	I wondered if the bishop's wife saw the flush on my face
آه! آری بیم آن دارم که که در دادگاه از آرامش قلب خود پس از خرج چهار هزار و پانصد روبل بحث کند.	I am afraid, oh, I am afraid she will tell how she bowed to the ground after that four thousand.
اما نتوانست غذا بخورد چون اشتهای خود را به کلی از دست داده بود.	but could not eat anything.
ناگهان به مانع بزرگ و سختی برخورد کند	he walked into something very large and solid
مچ دستش را محکم نگه داشته بود لنگ لنگان راه افتاد.	clutching his wrist
دوست نداشتم تنها و در مکان جادویی باهاش روبرو به شم.	I did not care to face him alone in a place of magic.
وقتی ایب متوجه شد که او در شرف سقوط است	seeing him fail a little.
مخصوصاً با در نظر گرفتن آنچه به شما مدیونم	seeing as I know what I owes you.
نیمه دوم من و بهترین دوست من در این عالم باشی.	to be my second self, and best earthly companion.
با کنجکاوی از لای شکاف در شروع به دید زدن کردند.	but they kept on watching the room.
همواره در دلم بود که انتقام پدرم را بگیرم.	I have always sought to revenge my illustrious father
دیگر من آن زن خجول و بی دست و پا نبودم که حتی از مستخدمین خانه خجالت بکشم.	I was not going to be nervous and shy with the servants any more.
ضمناً به گفته افزود که خر بسیار خوبی هم دارد و بهتر است آن را با خود بیاورد	that he meant to take also a very good ass he had
منتظر ماند تا سالن عمومی خالی شود.	waiting for the room to clear.
این کشف موجب شادمانی ایشان شده بود.	the discovery that he did so delighted them.
باید به خاطری مطمئن و ضمیری آسوده قدم به میدان مبارزت نهاده	I must meet him with a heart at ease, and that quiet conscience
زیرا که از همین یک نظر چقدر مطالب به مرس ده مکشوف گردید.	so much was expressed in that one look
ظاهرا صفوف نخستین به مانع برخورد بود.	apparently obstructed by something in front.
چیزهای خوبی که خورده بود یا دوست داشت بخورد.	the good things he had eaten or would like to eat.
با موهایی که با عشق ژولیده شده بودند.	his hair in an uproar of love
گویی از تجربه شب گذشته خویش عبرت گرفته بود و بیم داشت مبادا آن را گم کند.	for, after the previous night's experience, he was afraid of losing it.
پس از یک تکاپوی سخت موفق شده بود که درد خود را مانند یک پوستهٔ خالی از تن به در آورد.	he had succeeded after a hard struggle in throwing off his sorrow like an empty shell.
لبخندی غمگنانه بر سیمای اسکار لت نشست.	smiling in spite of her sorrow.
چرا که تا واپسین دم اجازه خارج کردنش را نداشت.	must never be withdrawn as long as he lived.
حاضرم اگر ثابت شود در تابوت بوده گردنم را بزنند.	I'll have my head took off, if he was ever in it.
اولین تصمیمش هم این بود که به همین قصد وسط روز به سالنِ آب برود.	almost her first resolution, to seek her for that purpose, in the pump room at noon.
مطمئن از اینکه امشب همه چیز در زندگی من در جای درست قرار داشت.	my certainty that everything in my life was in the right place tonight.
زیرا تشنگی به شکنجه و آزارم آغاز کرده بود.	for I now began to be tortured with thirst.
این زن اصرار کرد و من خیلی دلم به حالش سوخت.	she asked for the truth
ولی در واقع دیگر خیال بازگشت نداشت.	but her determination was not to return.
لکن او شروع به فحاشی کرد و آشوبی بپا ساخت تا پلیس را به آنجا بکشاند.	but he cursed and made a disturbance to attract a policeman
گویی انتظار داشت که شاهزاده آندره به او تعظیم کند یا راه را برای او بگشاید.	evidently expecting him to bow or to step out of his way.
از کسانی که باکی از آزار دادن شما ندارند	who have no remorse to disturb you.
همه چیز را فراموش کرده بودند و فرار عجولانه او را از یاد برده بودند	forgot her flighty conduct and their disapproval of it
توجهی به او نداشت و چیزی نمانده بود	not looking where she was going
چگونه بزرگ خواهی شد و فیس خواهی کرد و کوری چشم بانوان نجیب زادگان ولایت در کلیسا بر فرش خواهی نشست و بر بالش تکیه خواهی زد.	sitting in church on a fine carpet and cushions and draperies, in spite and in defiance of all the born ladies of the town?
بجای ایستادن صدای عجیب غریبی از ته گلویش بیرون زد و به هوا اشاره کرد.	instead of standing up made a guttural interrogative sound and pointed up in the air.
در پرتو نور ضعیف آتش بخاری مشغول خواندن آن است.	which she read by the dim glare of the embers.
بلکه مقدار زیادی اسکناس برایش باقی ماند.	but had some banknotes left over in her wallet.
من دوست دارم این قصه را خودم تعریف کنم.	I love telling that story.
چون بسیار از مسیر آن دور نبودم خواستم به آن نزدیک شوم	being not much out of his course
به او هشدار داده بودند که این طور خواهد شد.	they had warned her what would happen.
باز همه موافقت کردیم که در آنجا توقف کنیم.	when we agreed to camp again in the valley bed.
یهودی چشمان خود را بالا گرفت تا قیافه او را نبیند	straining his eyes to catch a glimpse of her face.
حتم داشت که عاقبت با او به صلح و صفا خواهد رسید.	he was confident that he would make his peace with her.
ولی هیچ کدام جرأت نداشتند تکانی بخورند.	but no one dared to stir.
این بدبختی جدید که ناچار بود در این ساعت شب فرار کند	this fresh misfortune of beingforced to flee by night
نیز مایل بود او روابط میان خودش و آقای رمزی را درک کند.	yet should understand how things stood between them.
زیرا مجال نشده که شرفیاب خدمت ایشان گردم.	, not having yet had the honor of doing so
طناب دار به خصوص به هوشش آورده است.	especially since he tried to hang himself.
من در میان دشمنان یکه و تنها ماندم	so I found myself alone in the midst of my enemies
اونوقت خودش میتونه تصمیم به گیره که آیا دلش میخواد با من ازدواج کنه یا نه.	that she was going to be able todecide for herself whether she wanted me to marry her or not.
تا ساعت سه بعدازظهر منتظر صاف شدن هوا ماند	at three in the afternoon he was still waiting for it to clear.
ولی بنا بود به زودی به شهر ما بازگردد دل سپرده بود	who was at that time away at the front, though she was expecting him soon to return.
از ساکن شدن روی یک صندلی خوشحال بودم.	I was glad to settle down into one of the chairs.
دستمالی از جیب درآورد و اشکهایش را با آن پاک کرد.	she was very stealthily, drew out her pocket handkerchief and applied it to her eyes
بدین ترتیب تمام بعدازظهر هم سپری شد بی آنکه فرصتی به کلاید دست دهد.	so the entire afternoon went by without a single opportunity.
که بهترین وسایل از برای زایل ساختن این قسم صور خیالیه نوشیدن است.	that the best method of dispelling such illusions was to drink
در میان سورتمه خود ایستاد و مهاری اسب را به دست گرفت.	stood in the middle of the sleigh, reins in hand.
بنابراین انتظار دارد که ناستازی کرامت کند و این ازدواج را تسهیل نماید	in a word, he confided his all to her generosity of heart.
لیکن یقین و اطمینان داشتم که پیش از پایان هفته خلق و خویش بهتر خواهد شد و سکه ی نقره را در کف دستم خواهد نهاد	but before the week was out he was sure to think better of it, bring me my four penny piece,
او از دیدن این آقایان اسیر خرسند خواهد شد.	it will please him to see these gentlemen prisoners
هرگز او و مادرش را سعادتمند نساخته بود	which had never prospered either in his hands or in those of his mother
برخی از ایشان در وضعی به جبهه رفته بودند	others had gone to the front
بعد از آنکه به او پیشنهاد کردم که خویشتن را از دارایی خویش محروم نسازد	after urging him not to strip himself of his property
دست خود را از پنجره دراز کرد تا بر آن بوسه زنم.	gave me out of the window her hand to kiss.
البته این موضوع بدان جهت بود که وی به سختی و درد خو گرفته بود نه آنکه ذاتاً بچه آرام و بی دردسری باشد.	though hardness, not gentleness, made him give little trouble.
اطلاع یافت که عصر همان روز نبرد بزرگی در گرفته است.	he learned that there had been a great battle that evening.
دستش رو رها کردم تا بتونیم با هم مسابقه بذاریم	I pulled my hand free so that we could race back.
اِما مطمئن شده بود که بار دیگر در دل آقای نای تلی جا باز کرده.	it was all done to assure her that she had fully recovered his good opinion.
حس کنجکاوی مرا بر انگیخت که به طریقی خاص تحقیق کنم	I had the curiosity to inquire in a particular manner
به صورت او خیره شدم و سعی کردم به راهی بیندیشم که آینده را تحمل پذیر کند.	I stared at her face and tried to think of some way to make the future bearable.
آن بعدازظهر دوردستی را به یاد آورد که پدرش او را برای یافتن یخ برده بود.	remember that distant afternoon when his father took him to discover ice.
من دیدم که او در خانه ما مانند دیگران شاد و خرم است	I observed, she behaved herself at our house as cheerfully as the rest
می تونستم بفهمم که این موضوع واقعاً او نو ترسو نده بود.	I could see that she was afraid, though.
ولی بار دیگر یک چیز غیرعادی توجهش را جلب کرد.	again she was roused as usual by something incongruous.
همان طور که از مادرتان استفاده کرد.	the same way he used your mother.
اینک مسحور از این همه اشتیاق صرفا به او زل زد.	now gazed at him, fascinated by his enthusiasms.
وقتی تمامی این امور در او به نظر رسید	when all this was observed in him
آرنجش را روی شمشیرش تکیه داد و با پا به آهنگ رقص ضرب گرفت.	leaning on his saber and beating time with his foot
مبنی بر اینکه هرچه هم پیش بیاید هرگز لب به شکوه باز نکنند و خرده نگیرند	of never complaining, never criticising, no matter what happened
در آنجا او را تک و تنها گذاشتند.	left him there alone.
خیلی هم معقول افسوس بخورد که چرا این قدر دیر آمده.	regret, in a reasonable way, that he should be so late.
برای نخستین بار به طرزی توصیف ناپذیر از تعداد خدمتکاران خود و شکوه میزش شرمنده شد.	for the first time, unaccountably ashamed of the number of his servants and of the splendour of his table.
از نگاه به چشمان من پرهیز کرد.	he shunned my eye.
بعد لگد سختی که فقط از پای بازرسی ممکن است صادر شود بر آن وارد آورد.	then bestowed upon it a kick which could have emanated from no leg but a beadle's.
اصولاً بدون داشتن قلبی که سرشار از احساسات بشری و محبت باشد	without strong affection and humanity of heart
باز هم با اصرار زیاد از من خواست که اصلاً فکر رفتن با برادرش را از سر خود بیرون کنم.	again she earnestly conjured me to give up all thoughts of going out with her brother.
اگر این مبالغ کافی نباشد کافی است به او خبر بدهیم	if it were not enough we were to let her know
به شما گفته بودم که خیلی معمولی است.	I told you he was plain.
به موج شکن تکیه داد و نگاهی نرم به اطرافیان افکند	leaning against the bulwarks, and mildly eyeing those around him
از تصور سقوط و فرورفتن در چنان گردابی به لرزه افتاد.	it shuddered at the thought of tottering, and plunging amid that chaos.
ابتدا چند لحظه ایستاد و بعد روی صندلی نشست.	he first stood and then seated himself
پیش از آنکه دفاعیات ما تمام شود شما به صحت این نکته پی خواهید برد.	before we are through you shall see for your selves.
اما قبل از آن که واکنشی از خود نشان دهد	but before he could do anything else
سپس خواستم دلاوری هم وطنان خود را شرح دهم	to set forth the valour of my own dear countrymen
همچنین به او گفتم که چون در سایر چیزها مرد وحشی بسیار باهوش صاحب فهمی است	I told him, too, that he being in other things such an extremely sensible and sagacious savage
اما در همان حال معلوم بود که دلش لبریز از مهر است.	putting out her hand behind her, held mine in it, until we came near to where he was standing in the garden, where she let mine go, and drew hers through his arm.
ناگهان در خود احساس غربت و نومیدی وصف ناشدنی کردم.	my late anguish was swallowed in a paroxysm of despair.
اما دست مادام دوفارژ در برابر آن هیچ گونه واکنشی نشان نداد و سرد و سنگین بافتن از سر گرفت.	but the hand made no response'dropped cold and heavy, and took to its knitting again.
از رسیدن به جاودانگی بی قید و شرط محروم شدم.	I was not to be assured immortal life.
تا سرانجام به خوابی عمیق فرو رویم.	till we fell into a profound sleep
ساکت و صامت سر جایش میخکوب شده بود.	the eyes round and bright and she was sitting there speechless
اِما تصمیم گرفت فکر بد به سرش راه ندهد.	she endeavoured not to be uneasy
پیشنهاد کرده بود که به دیدار مادربزرگ برویم.	suggested the plan of going over to see the grandmother.
تمام ثروت و مقام خود را در پای شما بریزم	I was to lay whatever of station or fortune I might possess at your feet
اما همچنان با نگاه پایین افت ده گفت	but with eyes still cast down, soon went on.
من در طرف چپ شاه خواهم بود شما طرف چپ کالسکه را داشته باشید.	I shall be on the king's left and as I am the chief person threatened, remain at the coach door to the left.
لکن قربانی قیافه ساکت و متعجب خود گردید.	but this attitude of silent and open eyed attention had marked him out for a victim.
این مرد ممکن است احساسات خود را برای شما تشریح کند.	perhaps such men may have been able to relate their feelings afterwards.
جای آن تا دم مرگ در تنم باقی خواهد ماند.	I shall carry the mark to my grave.
تفنگ را به روی جنازه انداخت و به خانه رفت.	tossed the rifle onto the corpse, and walked home.
حس کردم موی سرم و بازویم را گرفته.	I felt him grasp my hair and my shoulder
به طور یقین شما او را خشمگین ساخته بودید.	I suppose you angered him somehow?
ولو اینکه من از شادی قالب تهی کنم.	then let me die.
تا وادارش کند که یک بار دیگر سر بردارد.	in order to force him to raise his head a secondtime.
کافی بود دست دراز کند و قلم بردارد	he had only to reach out his hand to take his pen
فهمید اتفاقی افتاده و کسی دسته گلی به آب داده بود.	that something had happened, some one had blundered.
این عمل را با خوشحالی و چالاکی انجام داد.	which she did with great cheerfulness and quickness.
که ناگهان در باز شد و این آقا نمایان گردید.	when my door suddenly opened and this gentleman walked in.
آنچه به خاطر تهدید ما گفته بود تکرار کرد	he repeated his threatenings
تا آن روز و در این نوجوان مشرف به مرگ.	until I saw it in the dying boy.
بعد نگاهی از تفاهم و تحسین به ویل انداخت.	then she looked at him with a new understanding and some amazement.
از درب ورودی بالا رفت تا گل را از نزدیک ببیند	climbed over the gate with the intention of discovering whether it were not sweetbriar.
او شروع به سر به سر گذاشتن باکت کرد.	he used to tease the life out of her about it.
آثار این اضطراب در چشمان او ظاهر بود.	r, was in despair at his utter inability
یا در وسط خیابان چاله آبی وجود دارد	that there was a puddle in the middle of the street
اما او اصرار کرده بود که با بل انش حرف بزند.	but he insisted on speaking to her.
توجهم به داستان آن که عنوان یک هشدار مخصوص را داشت جلب شده بود.	, to which narrative my attention had been pointed as to an appropriate warning.
به تأمل دربارة خاطرات گذشته واداشت.	dwell upon memories of the past.
چنان است که از ملاحظه ساده وال وقتی بار آخر دیده شده است	that from the simple observation of a whale when last descried
وحشت من از این بود که مبادا سرهنگ متوجه دست لرزان من شود.	I was afraid he would notice that my hand was shaking.
از اینکه او هم چین قدرتی بر من داشت متنفر بودم.	I hated that she had this unconscious power over me.
اما افسر دیگری به سرعت خودش را به او رساند.	but another officer was by her side quickly.
در حالی که به نظر من اصلاً لیاقت این احساس تو را نداشت.	a preference which I never believed him to deserve.
کریستف امیدوار بود که دلدارش در خم هر خیابانی ظاهر گردد	he expected to see her appear at all the corners of the paths
سپس بر سر و تن خود گذاشتم و بدین گونه نشان دادم که آزادی خویشتن را خواهانم.	then to my own head and body, to signify that I desired my liberty.
بدینسان با گذشت زمان خود را بار دیگر در ما من خویش به دست پریان کاکائویی خود سپرد	so in due course of time got himself shut up in his sanctuary by the chocolate sprites
اما حاضر نیستند تکالیف اجتماعی این آزادی را هم به موقع خود بپذیرند	but so ready to refuse the social obligations which went with them
دلش قرار گرفته و به وجد و نشاط آمده بود	he presently recovered his spirits and good humour
اکنون چنان با محیط خو گرفته بودند که توصیفشان از مناظر دلنشین بود.	so inured by now to the landscape that he derived great amusement from their comments.
تا فکری بخشنده داشته باشد تا به میل خود اجازه دهد	to show a generous mind
قایق پارویی کوچک را روی آب شناور گذاشتم.	I left the dinghy on the buoy
دانتس اکنون سعی داشت که بفهمد در خواب است یا بیدار	was he awake or was it but a dream
ورانسکی احساس کرد به کلی از قید قسمتی از ادبار خود آزاد شده است.	he felt that he was completely free from one part of his misery.
ولی دلیلش این بود که به مادرش گفته شده بود که به وجود او نیازی نیست.	but that was because his mother hadbeen notified that she was not needed.
غذایی رو که روی پاهاش بود رو بررسی کردم.	I examined the food in his lap.
با چهره گل انداخته و خندان بر زمین نشست.	flushed and smiling, plumped down on the floor.
بالاخره توانست همین جمله را بگوید.	he finally managed to say.
چند قطره بیشتر از حد لزوم در گیلاس چکید.	he poured too many drops into the glass.
با ترس و لرز توی خانه سرک کشیدند.	took a trembling peep.
شیر را به سرسرای خانه برده بود	then carried the milk into the porch
سپس با غم و اندوه رویم را برگرداندم.	then force myself to turn around
یه لحظه با خودم در مورد رفتن فکر کردم.	I thought about ducking out
به گمان اینکه مرده است و بقیه قاتل او هستند	he concluded that he was dead and that those in the room were his murderers
بنابراین سعی کرد تا شایستة این مقام شود.	he haughtily determined to be worthy of his station.
تمام این کارها فقط تا ساعت دو طول کشید.	that was only till two o'clock.
از دل ربودن از کسی است که از تو نفرت دارد.	than to lead one to love thee who abhors thee now.
ولی صورتش همچنان سادگی بچگانه را داشت.	but with a simpering boy's face
سپس کاترین را با خود به طبقه پایین برد.	they went away.
سر مادیان را بالا آورد و اجازه داد که با آهنگ خود به پیش رود.	lifting the mare's head and letting it go in time with her paces.
هارولد این را احساس کرد و بابی میلی دستش را پس کشید.	he seemed to sense it, and pulled his hand reluctantly away.
به او گفتم تو مجبوری مدرسه را ترک کنی.	i told him as I should have to take you away.
اما ناگهان همه کلاه از سر برداشتند.	but suddenly all heads were bared
برای آزار رساندن آقا معلم فروگذار	to do the master a mischief.
اما در صدایش چیزی بود که مرا متعجب کرد.	but there was something in his voice that surprised me.
این پرسش را به من فهماند که آیا همان شب نیز باید از نو هم بستر شویم.	he made out to ask me whether we were again to be bedfellows.
