فقط مجبور بودم که بر خودم چیره شوم.	I just had to get over myself.
در حال خواب و بیداری است و سرش را به شانه آن داماد کامروا تکیه داده است.	her head on the shoulder of her satiated husband.
کارتن در نگاه او نخست تردیدی ناگهانی و سپس حیرتی عمیق یافت.	he saw a sudden doubt in them, and then astonishment.
تمام ملازمان رکاب او نیز دچار همان حیرت شدند.	all his attendants were in the same state of amazement.
شاید بتوانم کشتی را به ناخدای خود بازگردانم!	I might return the vessel to her captain.
اما چون هیچ گمان نداشتم که شما را در اینجا ملاقات خواهم کرد از دیدار ناگهانی شما قدری مضطرب شدم	but I so little expected your visit that it has somewhat overcome me
به شکلی معجزه آسا مار روی زمین ولو شد.	miraculously the snake slumped to the floor
مادرش دوباره او را از زندان بیرون آورد	his mother helped him out twice
اما بعد از قدری تفکر با خود گفت	when suddenly the idea occurred to him
اما او ضعیف تر و بیرمقتر از آن بود که بتواند از جایش تکان بخورد.	but she was too weak to move.
سنگینی آن سه خود بیش از ظرفیت قایق بود	was already more than she was meant to carry.
صلاح خود را در این دیده بود که حرفی نزدند و عجالتا همه چیز را انکار کند.	he thought it best to say nothing and so for the timebeing had denied everything
باید همچو فرصتی را که به رایگان یافته است و با اغتنام آن ممکنست بر آزادی و جان و مال ملت خود حاکم مطلق شود از دست بدهد.	let slip an opportunity put into his hands that would have made him absolute master of the lives, the liberties, and the fortunes of his people!
دوست داشتم بدانم چه احساسی باید داشته باشم.	I wished I knew what I was supposed to be feeling.
مظورم همین آقایی است که الان رفتند انگار بیش از حد شوخ طبع است	that is, the gentleman who has just gone appears to have an immoderate sense of humour.
همة این مطالب را ضمن راه برایم تعریف کرد.	all of which he explained to me as we went along.
اگر فورا به توالت نرود لباسش را کثیف خواهد کرد.	if she didn't get there soon she was going to stain her dress.
از این رو بدون آنکه نسبت به رفتار نامناسب کاظم عکس العملی نشان دهد به همسر او گفت که لازم نیست خودش را نگران کند	therefore told her, without any reflection upon her husband's unhandsome behaviour, that she need not frighten herself,
سرم را تکان دادم و از لرزیدن به خاطر فکر به آنکه چقدر نزدیک بود امروز دیر برسم را سرکوب کنم.	I shook my head and repressed a shudder at the thought of how close I had been to being too late today.
اما من من بدون تو نمی توانستم این وضع را تحمل کنم.	I I just couldn't have gone through all this without you.
انگار قدرت تفکر را از وی سلب کرده بودند.	she was as though deprived of the power to think.
پیژامهٔ زیبائی با سینهٔ باز بتن داشت.	in a fascinating but decorous d'shabill'.
در صدایش این وعده نهفته بود که از او مراقبت خواهد کرد	his voice promised that he would take care of her
ملاحان آن هیچ انسانی را به جز ملاحان نظیر خود ندیده باشند.	her crew having seen no man but floating seamen like themselves.
طناب فولاد ین لنگر چون زه کمانی کشیده و سخت شده بود.	the current so strong she pulled upon her anchor.
که انگار ده آشپز ماهر در انتظار دستورات او ایستاده بودند.	implying that a dozen chefs awaited her orders there.
با همه فکر و احساسی که در وجودش داشت به دوست داشتن او پرداخت.	all her sentient and thinking powers loved this kindman.
مادرم که حواسش به من بود متوجه شد و با ناراحتی گوش به زنگ شد.	which my mother, being on the watch, heard distinctly, and was sadly alarmed at.
من حاضر بودم که به دیدنش بروم و همه جا همراهش باشم.	I'd have gone to see her and gone about with her everywhere.
که ناگهان چند ضربه متوالی به در ورودی نواخته شد	when suddenly was heard a hurried knocking at the door below.
لکن همان طوری که سر به سینه پدر نهاده بود سری حرکت داد که اقرار بود	but she made an affirmative sign with her head as she lay on her father's breast
خونسردی و آرامش خویش را کام لا بازیافته بود.	his face was quite composed.
زیرا خون او به زمین اثر کاملاً واضحی باقی گذاشته بود.	for there was traces of blood
مطلب مهمی هسته باید برایت توضیح بدهم.	I have something to tell you.
به نزد او برود و خود را در اختیارش بگذارد تا هر طور که دلخواه او است از وی کامیاب شود.	she would come in search of him and meet his wishes unreservedly.
با چشمانی که به طور دقیق بر این کله ثابت مانده بود به دسته بیل تکیه کرد.	so stood leaning over with eyes attentively fixed on this head.
اما چند گامی آن سوتر مکث کرد	but lingered at a little distance
مخصوصا با این کلمات و فقط با این کلمات قابل بیان است	that these words and they alone expressed what he wanted to say
اما امیدوارم که مادام در زیر این خاکستر مشتی طلا برای شما مانده باشد	let us hope you have found some gold among the ashes.
وقتی برای بار دوم اتاق را ترک گفتم وی چفت پشت در را انداخت و به حال قهر و تعرض به بستر رفت.	I then quitted her again, and she drew the bolt in one of her worst, most peevish humours.
این کتاب همواره در آن اتاق و روی میز کوچکی قرار داشت	which was always there, upon a little table
چوبدستیش را درآورد که با افسونی در را قفل کند.	took out his wand to magically lock it.
به اینکه خواهرش به کجا رفته و در کجاست.	as to where she had gone or was now.
از نقصی که در تهیگاهش به وجود آمده بود قادر نبود قد راست کند.	so bent was he by the wound in his hip.
من اون کسیم که به طرز وحشتناکی بی ملاحظه بود.	I'm the one who was horribly careless.
اما بیشترین فضا هنوز به عذاب کشیدن من اختصاص داشت.	with still endless room left over to suffer in.
اما به کلی فراموش کرده بود که در روزگار گذشته تاثیر آن بر وی چگونه بود.	but he had completely forgotten the impression it had made on him in old days.
اما بی درنگ منصرف شد و دوباره به اتاق رفت تا اشیاء خویش را ببندد.	but soon gave it up and went to her room to pack her own things.
در این فکر بود که چه قدر سخت است که پدر و مادر کسی زنده باشند اما او را نشناسند.	he imagined how it must feel to have parents still living but unable to recognize you.
با احترام و احساس در آمیخته بود.	was tempered with respect and affection.
به او خبر داد که پدرش با همیاری مردم به دنبال شوهرش رفته است.	told her that her father was assisted by the people, and gone in search of her husband.
پنداری مه غلیظی او را در خود گرفت و تنهایی دشوار و خلاصی ناپذیری بر او چیره شد.	it was as though a fog had fallen upon him and wrapped him in a dreary solitude from which there was no escape.
وقتی دیدند که دن کیشوت غرق در گمراهی و شیفته آوارگی و سرگردانی است	when they saw how wedded he was to his crazy ideas
مثل کسی بود که به حرف زدن عادت ندارد .	as one unaccustomed to speaking
گفت قطعاً دیدن این منظره حیرت انگیز بوده	would certainly have been a most astonishing object
از روزی که گرگم را لمس کرده بودم شخصاً او را ندیده بودم.	I hadn't seen my wolf in person since that day I'd touched him
سپس رو به محکوم سوم کرد و از او نیز همان را پرسید که از دیگران پرسیده بود.	then passing on to the third he asked him what he had asked the others
گفتم فقط بدونی از چه مسیری می خواد جلو بره.	I just thought you should know the direction he's headed.
اطلاع داشت که این دانشجو را تیرباران کرده بودند.	knew that the student had been shot.
حرکات دکتر چنان مؤدبانه بود که زن حس کرد خیلی طبیعی است که لباس از تن درآورد و پیراهن خوب بپوشد.	that he began his first caresses with so much care that his suggestion that she put on her nightdress seemed natural to her.
چون آن را دلچسب یافته بود حرفی نزد.	she let it pass because it was pleasing to her.
تا جاییکه در قصر مارکی دعوت آن زن و شوهر جوان را به مهمانی نه عملی خارج از حدود آداب دانی تلقی کردند و نه خطایی ناشیانه دانستند.	so that he did not think he was going beyond the bounds of condescension, nor, on the other hand, making a mistake, in inviting the young couple.
بعد خود را در صندلی جابجا کرد	falling back in his chair
اما وقتی دستش را دور او حلقه کرد احساسی در او یافت که دیگران فاقدش بودند.	yet when she put her arms around him she could sense a faint echo of some intensity quite missing in the others.
همه انگشتانش به میگرن دچار شده بودند و روشنایی روز به رنگ طلایی خاصی درآمده بود	each of her fingers had a migraine headache and the daylight had begun to take on
که ناگهان ضربه تیزی به پشتم خو در و چون روی گرداندم	when I felt a sudden sharp poke in my rear, and turning round
ما بی آن که دمی را بیهوده تلف کنیم از کشتی دور شدیم.	we had shoved off and given way.
حتماً وقت فرود هواپیما تنم کبود شده.	I must have bruised my ribs when the plane came in.
که اگر صحبت را به همین زمینه طول بدهد	that if he continued the conversation in the same tone in which he had begun it
در حالی که در دو طرفم بودند از دشت رد شدم.	I crossed the field with them flanking me.
به محض دیدن حالت او برگشته و در دهلیز فریاد کرده و به یاری طلبیدند.	they flew into the passage crying for help.
منتظرم خودش مسائل را در ذهنش حلاجی کند تا بتواند با اصطلاحات ساده برای من هم شرح دهد.	waiting for him to get it clear in his head, so he can explain it to me in simple terms.
همیشه گوش خود را بر سخنان همه باز نگه داشته بود .	always lent them a sympathetic ear.
اندک راهنمایی نداشتمکه قوه تخیلم را همراه بدرارد و بکار اندازد.	I had not the smallest indication on which to let my imagination work.
اشخاصی مختلف الجنس از هر نوع و قسم در آنجا جمع شدند.	who sympathized but little in the event
نظرم را راجع به روزهای بدی که در پیش رو داریم.	the kind of vision I'd had of the bad time that's coming
با چنان نیرویی آن را فشار داد که چیزی نمانده بود فریاد بزنم.	with a grip that almost made me cry out
روی صندلی پشت میز تحریرش نشست.	sinking into his desk chair
دو تا پسرها پشت یک کپه هیزم که جلوی درخت من بود قایم شدند و دوباره به سوارها مسلط شدند.	they got to the woodpile that was in front of my tree, and slipped in behind it, and so they had the bulge on the men again.
فقط برای این که اون توی چادرش ون نمو نده بود و فرار کرده بود اخراجش کرد.	he sacked her, just because she hadn't stayed in her tent and let herself get trampled
مخصوصا بگوید که فرمانده کل مایل است	that the commander in chief wished
آرزو داشت که مو لف در کتاب خود اشاره صریح به وفاداری او نسبت به معشوق کرده	he would have had him set forth the fidelity and respect he had always observed towards her
ناگهان هیرتن از پس درختی در وسط جاده ظاهر شد	he suddenly issued from the shadow of the road side
در وقتی که تو کارد خود را به سینه من زدی که اگر جوشنی در زیر نداشتم ک	when you had just broken your knife against the coat of mail
از من با یک بوسه مهرآمیز و فشردن دست استقبال کرد.	was received with an affable kiss and shake of the hand.
زیرا او نیاز به استراحت داشت	he needed to sleep, he had to
حال بی آنکه کینه و رنجشی از من به دل نگاه داری	tell me now, dismissing anger and irritation
محتاطانه به دوروبر نگاه کرد تا ببیند آیا کسی تصادفا او را دیده است یا نه.	paused to note if by any chance any one had observed her, now looked cautiously about
بلکه صرفاً صدایی بوده که در گوشه معده او پیچیده شده است.	but to die away in the innermost recesses of his stomach.
شاهد بودند که او را به دورن زندان بردند.	saw them admitted by the porter.
شاید تا حالا قایق و کلاه من و روسری ربرتا رو پیدا کرده با شن!	maybe, who knows, the upturned boat with hishat and her veil discovered!
او که نتوانست از لبخند زدن خودداری کند	though he couldn't suppress a thin lipped smile.
همان روز مطالبی را به زبان آورد.	told me things.
تا ستاره آویخته بر گردن و زانوبندش را پنهان کند.	to hide the star at his neck and the garter at his knee.
سپس فریادی از درد برآورد و به جلو تلوتلو خورد و دستهایش را به سوی وی باز کرد.	then, with a cry of anguish, she tottered forward, stretching out her arms to him.
جایی که بار دیگر جشن و سرور پرهیاهو و پرخوری نامحدودش را از سر گرفت.	where he revived his noisy revelry and unlimited gourmandizing.
انگار توپی به طرفم پرتاب شده و وارد بدنم شد.	that it was as if a cannon ball had hit me and got stuck inside.
هر چی راز توی زندگیم بود به راش گفتم	I told him all my secrets.
امده ام اینجا تا از تو به خاطر ان که جان پدرم و نجات دادی تشکر کنم	I came to thank you for saving my father's life.
مثل این بود که مرگ را دعوت کنند	it was to invite death
قهوه و نان برشته را مثل هرروز دردست داشت.	carrying her coffee and her toast with her as she did every day
که ریسمان کشیده شده با سایش به زیر کشتی از آن رد شده	as the strained line, scraping beneath the ship
همین باعث شد که کار به این دوئل بکشد.	now, my dear, we have the duel.
تنش همچون حیوان گریزانی بود که تعاقبش کرده باشند.	his body was like a hunted animal fleeing before its captors.
من بهش رسیدم و قدرت رو ازش دزدیدم.	I reached in and stole power from him.
ببیند که آیا آن را درست فهمیده است یا نه.	see if there wasanything wrong in his understanding of it.
قرار بود دوران زناشوییش را در این خانه بگذراند	this was to be the home of her wifehood
انزوا که برای هر دو واقعیت چیزها بود.	that loneliness which was for both of them the truth about things.
در حساب سعادت خود فراموش کرده بودند که چنین روز بدبختی را ببینند	had forgotten in their prosperity that an evil genius
محض از برای این بود که جای شبهه و تردید برای کسی نماند.	, that there might be no mistake in the person
آن وقت تمام پیامدهای رؤیای پراشدتیاق و شاید بر خطایش	then all the results of her yearning, but possibly mistaken, dreams would
شاید هم این کار تو مرا دچار مرگ و نیستی سازد.	perhaps be my death.
به عنوان یک مطرود زندگیش را اغاز کند.	begin his life as an outcast.
ناله و شیونی حزین و ممتد بر جسد کامی آغاز کرد	he began to utter profuse and doleful lamentations over her body
گوئی اصلاً در خانه خود روی صندلی راحت نشسته است.	as hard as if he were in his elbow chair, in his own study.
دوان دوان به سوی کالسکه حرکت کرد.	came running at the carriage
آئورلیانوی سوم با لحن معترضی وسط حرف او دوید	her husband countered.
قسمتی از آن را هم ندانسته به زمین ریخته بود	some of it had gone the wrong way.
زیرا که باک در موضوع چماق هشیار شده بود.	for he was become wise in the way of clubs.
به اندازه کافی نزدیک بود که گرمای نفسش را روی ل بهایم احساس کنم.	close enough that I felt the heat of her breath on my lips.
آخر به خانه آن شخص فقیر رسیدیم	until we came to the poor person's house
من او را از یک فاحشه خانه بیرون کشیدم.	I took her out of a bad house
گرچه بیش از آن مؤدب بود که بخواهد فاش بگوید	though he was too courteous to speak openly
در آن لحظه از جابرخاست و به بهانه اینکه صبح روز بعد باید زود از خواب برخیزد شروع به خداحافظی کرد.	he arose saying that he must go, that he had to get up early in the morning.
آن هم تازه وقتی معلمه برگشت انداختیم و زدیم به چاک.	then the teacher charged in, and made us drop everything and cut.
این خبر را دیروز پدر رزاموند به من داد.	I had the intelligence from her father yesterday.
که زنش را به ضرب چنگک باغبانی بکشد.	but impaled his wife on a pitchfork
بعد تصمیم گرفتم تا موقع ناهار خودم را با کشیدن چند طرح کوتاه نقاشی برای تعلیم او مشغول کنم.	I then proposed to occupy myself till dinner time in drawing some little sketches for her use.
اگر روزی غزل شوالیه فقیر را برای شما خواندم منظورم این بود که از شما ستایش کنم	if when I read you all that about the 'poor knight,' I wished to to praise you for one thing
این نکته را هم به او فهمانده بود.	a fact which she had impressed upon him.
هر دو به بستر رفتیم و دور از هم و واژگونه غلتیدیم و خیلی زود خوابمان برد.	we rolled over from each other, this way and that, and very soon were sleeping.
اما قبل از اینکه از دسترسش دور شویم. توانست چند ضربه جانانه بزند.	but he got in some good swipes before we were out of his reach.
اما اوضاع از آن هنگام تغییر کرده بود.	but it was so no longer.
پذیرش نصیحت خوبی که به او پیشنهاد شده بود	acceptance of the good advice that had been offered to him
با و پیشنهاد کردم که تا مدتی به وطن خود بازگردد.	I suggested that he should go home for a while.
منفعل از این که او را در حالتی چنین دیدند.	half ashamed of being surprised in such a paroxysm of grief.
گرمای اتاق باعث شده بود او در افکارش غرق شود و چرت بزند.	he had been almost dozing off, lost in the heat and his thoughts.
به تندی فرمان داد تا آن را له کند.	swerved to hit it.
به دنبالم راه افتاد تا مرا به درون عمارت ببرد.	he accompanied me in the office of watchdog
ان قدر بزرگ نبودم که فقط به یک نگاه او را بترسانم.	I wasn't big enough to frighten by looks alone.
بخشی از عشق مادر بزرگ را که به او تعلق دارد ربوده است از خواهرش نفرت داشت.	stealing the part of her grandmother's love that belonged to her.
س برگشت و به طرف بارواس نظری افکند	her second glance was at the dying man
من مطلوب خود را با او در میان نهادم و کتاب را به دستش دادم.	I told him what I wanted and put the book into his hands
شوهری که مرده بود یا زنی که زنده رها شده بود.	the man who had died or the woman he had left behind.
شکمش چون آبشاری روی لبه کمر شلوار لی تنگش آویزان بود. مصمم بود که چیزی را فراموش نکند و همه چیز را به شایستگی انجام دهد.	his belly cascading over the waistband of his tight bluejeans, determined to not miss a bet, to do all the right things.
لباس این یکی پر مندرس بود و با تمام افتادگی که جوان داشت باز وضع و رفتار او با لباسش هماهنگی نداشت.	he was so very badly dressed, and in spite of his humiliating position, his bearing was by no means in keeping with his clothes.
اما دوباره هجوم آنان به پیشروی تجدید شد.	but then it made another rush forward.
شما باید براهتون ادامه بدید.	that you were to go on.
وقتی مطالب خود را به پایان رسانید	when he had concluded.
بلکه حس رقت و ترحم به ضعف زنانه و کودکانه وی و ترس از اخلاص و صمیمیت و اعتماد او و معرفت به وظیفه دشوار بود	but there was pity for her feminine and childish weakness, fear at her devotion and trustfulness
من قصرم را رها کرده و پهلوی پیرمرد مهربان عزیز که آن قدر به من احتیاج دارد خواهم ماند.	I'll let my castle go, and stay with the dear old gentleman while he needs me
ناخدای آن به تدریج نگران خواهد شد.	that her captain begins to feel a little anxious.
که تقریبا باری من غیرممکن بود در آغاز معذرت بخواهم	that to act in that way would have been almost impossible
شگفت آنکه عامل طرح دوباره این مسئله دختری بود	that strangely enough by the one girl of this upper level
آن هم نزدیک مردی که اما ده بود بالای قبر همیشه کنده شده ملاحان پین کی بخورد	nigh to the man who was apt to doze over the grave always ready dug to the seaman's hand
در حالی که مجذوب شده بودم به جواب دختر گوش کردم.	I listened, too engrossed, to the girl's response.
انگار چیزی در درونم به جنبش و هیجان درآمد.	something kind of moved inside me.
ارباب سوسک را از پنجره بیرون انداخت	he flung it out of the window
فقط من توانایی این را نداشتم که اجازه دهم او برود.	I just wasn't capable of letting her go.
امیدوار بود که نگاه مری به چشمانش بیفتد	hoping that they would meet hers
وبا وقار دست خود را در دست زمخت پیرمرد گذاشت.	with dignity put his hand into the old man's hairy palm.
من خودم را خواهم کشت ولی نخست سگ را به لاکت خواهیم رسانید	I shall kill myself, but first of all that cur.
این اشارات گاه چندان زنده و جاندار بود	these allusions of his were at times so vivid and life like
با این همه بازپرسی از کاترینا را خوب به یاد دارم.	I only remember how they began examining the witness.
لذا با شتاب تمام دن کیشوت را به دنبال خود راه انداخت و او را از آبادی بیرون کشید	so he hastened their departure, which they took at once
همچنان مگی را در آغوش گرفت و چون کودکی تکانش داد.	held her and rocked her as if she were a baby.
که کنایاتی که مبین احساسات و عواطف باشد وجود داشته باشد	subtle allusions to the tender passion were absolutely necessary
مطمئن بودم که گرگم آنجا بوده است.	I was so sure that my wolf had been there.
لیکن این خوشحالی خالی از غم و غصه نبود	yet my gladness was not without admixture.
برای خواباندن با صدایی شیرین بخوان دن پرداخت.	sang to it softly, to lull it to sleep.
متعجب به نظر رسید و مثل این بود که یه خورده دو دل موند.	he seemed surprised and hesitated for an instant
آ به هم او را تا دم در مشایعت کرد	, and the abbe accompanied him to the door
مایل بود در این اتاق کوچک آینه بنشیند و تماشا کند	had liked sitting in this room to watch the ladies who
این احساس دشمنی به طور مبهم در او باقی ماند	the feeling of hostility persisted dimly and obscurely.
اما همه مطالب را به شیوه خود دریافته بود از پشت صفوف با صدای گریان	though he had heard hardly anything, understood everything in his own way.
ممکن است یکی از زارعین نیز برای اینکه تنها نباشد نزد وی منزل کند.	perhaps, a lad to keep him company.
تا عمر خود را به توبه و انابه بگذارند.	, weeping and praying
هوای خشکی به مزاجش سازگار نیست	had lost his health ashore
ناگهان چنان این لغت و طرز ادای جک به نظرم خنده دار آمد که نتوانستم جلوی خنده خودم رو بگیرم	suddenly seems the funniest thing in the world, and before I know it, I've started laughing.
راسکلنیکف این کلمات را با ملال و اصرار خاصی تکرار کرد	he repeated with gloomy insistence.
یک روز بعدازظهر مادرش به نزد او آمد و درخواست عجیبی کرد.	his mother came to him one afternoon with a very peculiar proposition for her.
ولی تاکنون هرگز آن را مانند امروز ندیده بود.	but he had never yet seen it as it was to day.
زیرا ممکن بود گروچنکا غافلگیر شده و قصد قرار داشته باشد.	for that she should be frightened and run away.
باز خود را در همان وضع که بود و روی همان قطعه سنگ کناره پل مشاهده کرد.	found himself again in the same attitude on the same paving stone of the parapet.
آن سر و صدایی را که در موقع بهتری ممکن بود راه بیندازد راه نینداخت.	not as clamorous and effusive as it might have been under happier circumstances.
من امیدوارم که تو همچنان مثل همیشه یک پسر قابل احترام باقی بمانی و به همان دوستان خودت راضی و قانع باشی .	I did hope you'd stay respectable and be a satisfaction to your friends,
ذات و طینت واقعی پسرتان را برای او تشریح کنید.	explain your son's character.
پنداری تمام اعتماد به نفس جمع حاضر یک آن با یک ضربه کاری در هم پاشیده بود.	as if the self confidence of the gathering had been staggered by a blow.
از لحن عبارات آن حتی خود من هم فهمیدم که برای پدرم ممکن نیست از درخواستی که در آن نامه از او شده است سرپیچی کند.	which was couched in terms so flattering that even I myself felt it would be wrong in my father not to comply with the request the duke made in it
ولی مخصوصا از این جهت رنجیده بود که دیگران توجه نداشتند	but was mortified because no one would understand
پاورچین پاورچین تا انتهای آن راه باریک رفتم	I tiptoed down the path
تصمیم گرفتم بذارم تو زنده بمانی و نکشمت	I've decided to let you live.
خانوم این آقا خواب بعدازظهرشو بامرد دیگری میگذرونه	that his woman who I also won't name was spending her afternoon sack time with a third party
دوشیزه هانی آخرین تلاش خود را کرد و گفت	she said, trying once again
تو همسر بهتری برایش در نظر گرفته بودی.خیلی بهتر از این زنی است که خودش گرفته. ..	you would have chosen for him better than he has chosen for himself.
از روی غریزه تا نزدیک آن نیز آمدم.	I came straight to it, by instinct, I suppose.
که به قول مردم ناکام مانده و با جاری شدن حمام خون به پایان رسیده بود.	which was betrayed and, as people expressed it, drowned in blood.
امان آنان با یکدیگر دوستی کاملی را پی افکنده بودند.	somehow it all came together as a nearly perfect friendship
برای شرکت در پیروزیش هنوز دیگرانی بودند.	there were other people on hand to share her triumph.
ناله دردناک وی شنیده شد و همین فریاد سبب نابودی او گشت	he uttered a plaintive cry of pain, and that cry was fatal.
مردم چندان متلون مزاج و مشتاق انتقام جویی بودند	the people were so passionately revengeful and fitful
منتظر بودیم که خانه دار ناهار را سرو کند.	waiting for his housekeeper to serve lunch.
شروع کردم به نه گریستن یا نالیدن. شروع کردم به بیرون آوردن لباس عروسی.	proceeded not to weep, not to mourn, but mechanically to take off the wedding dress
به علاوه نگهداری او هم زحمتی نداشت	for he was a quiet inoffensive prisoner happy in his folly and required no watching
ولی من گفتم شاید در این لحظه شما اینجا نباشید.	but I thought you mightn't be in the way just then.
اندکی آشفته و زیبا مثل همیشه ممکنه کنار جاده غش.	delicately frazzled and beautiful as usual.
آن اسب مرا به خانه بازگرداند	for he led me back into the house
در همان لحظه یک نفر شروع به صحبت کرد و باعث شد هری از جایش بپرد و تخم طلا از دستش به زمین بیفتد.	then, making him jump so badly that he dropped the egg, someone spoke.
سپس پاورچین پاورچین به سمت در جلویی اپارتمان رفتم.	then quickly tiptoe back towards the front door.
من همه چیز را راجع به خودم به او گفته بودم	I told him everything about myself.
من باید به فکر زندگی خودم باشم	I got to think what happens to me.
بلکه به خاطر عدم رعایت احترام پیرمردی که ضررش به هیچ فردی نرسیده است.	but for his lack of respect for an old man who had not done anyone any harm.
یک تاریکی عالی و آشفته دشات که مانند نقابی از هر طرفش آویخته بود.	there was a magnificent, dishevelled obscurity falling like a veil over all.
به من گفت که ترتیبی داده است که زنش اطاق خصوصی داشته باشد	he told me that he had arranged for his wife to have a private room
این طور بیان اینجا موی دما آدم به شن!	to come and upset us in this manner!
چون ات به حال چند بار تجربه شده بود من هم مطمئن بودم.	, she assures me
حتی سعی کرد با باقیمانده رنگی که نقاشان به جا گذاشته بودند انبار را رنگ کند.	he even tried to do up the attic with some paint which had been left behind by the painters.
بیم داشت مبادا دختران متوجه شوند که او ایشان را دیده است.	unwilling to let them see that they had been observed.
جسدم را زیر تل دیگری از علف چال خواهند کرد.	I shall be laid under some other heap of poor grass.
مادر شما دیگر از زندگی جلف قاره اروپا زده شده	your mother, wholly given up to continental frivolities
حتی بدون این که به خود زحمت پاره کردنش را بدهد.	without even taking the trouble to tear it up.
که خشم و عطش انتقام جویی من تا چه اندازه برای من ناگوار بود	that my wrath and revengeful feelings were extremely repugnant to my own nature
این عمل را با کمال صمیمیت انجام دادم.	which I did most cordially.
از شنیدن ماجرای او بسیار متعجب شد	he was now filled with amazement at what he heard from the goatherd
آن عبارت است از سلطنت آدمی نسبت به خویشتن.	the sovereignty of man over himself.
بهتر است نگذاریم که گرفتار این قصورها بشویم.	let us remember this, in time.
ممکنه صدای پارس بلند حیوان همه را بیدار کند	he might wake everyone at the castle with his deep, booming barks
بعد از آن متوجه شدم که تدارک مقدمات اقامتم در آنجا هر چند مشکل است اما غیر ممکن نیست به او گفتم که خواهم ماند.	finding that arrangements to that effect, though difficult, would not be impossible, I informed her I should stay.
توی مسافرخانه نرفت و از آن هم بیرون نیامد.	entered or left the tavern door.
خواهش دارم برای یک بار هم که شده به من نگاه کنید.	you must look once.
به چشم بیاید و از او تعریف و تمجید بکنند.	to be noticed and admired.
می دونم که خان وم محترمی مث شما نباید با من حرف بز نه	I know I shouldn't speak to you
چند گام از ملتزمین رکابش که مؤدبانه در انتظار وی ماندند دور شد	moving a few steps away from his suite, which waited respectfully
بجز ولخرجی و عادت به تنبلی فایده دیگری به حالش نداشته است.	has succeeded in nothing but in giving him extravagant idle habits.
اما کوپر مطمئن بود که کار تریسی عمدی بوده است.	but he was certain it had been done deliberately.
که چنین محبتی حقیقتا پابرجا بود چه تضمینی وجود داشت	if it was really continuinghad she in the face of such incidents as these
از این حرف او پیرمرد خنده بلندی را سر داد	upon which the old gentleman laughed heartily
کمروئی را به حد حماقت رسانده بود.	for he was shy to the pitch of imbecility
طبیعتا حواسم هست که به وضع تو هم رسیدگی بشود و مشکلی در امرار معاش نداشته باشد.	naturally, I'll see that you're taken care of.
دو چشم درشت و سبز را دید که در تاریکی به او زل زده بود.	saw something with very large, round, green eyes staring back at him in the darkness
هنوز چند قدم پیش نرفته مجبور به توقف گشت.	moved a few steps, and again stopped.
آنهم اشتباهاتی که ناشی از جهالت فطری عموم افراد بشرست	which I had fallen into through the common imbecility of human nature
دکتر که با کمال وثوقی که به شما دارم	to be the most conscientious man in the world
فریاد جگر خراش سربازان در هنگام عمل دیگر واقعاً او را از پا انداخته بود.	the horror of hearing the screams from the operating ward where amputations were going on!
دیدیم که هیچ نشانی از جراحت وجود ندارد	we saw that there was no sign of a wound
من هم ناگزیر او را گدا خطاب کردم.	then I called him a beggar.
او را خوابی بسیار سنگین گرفت	he fell into such a deep sleep
او را به اتاقی که برای خود او ترتیب داده بودند دعوت کرد.	asked him into the room that had been assigned him.
اگر پهلوان واقعاً مصمم به دخول در آن غار است	adding, that if he was bent upon entering it
اما چیزی نگفته و فقط آن قدر لاری را تحسین کرد که پسرک غرق خجالت شد و آخر سر پدربزرگش مجبور شد که به نجات او بیاید.	but she did not say so, only praised him till he was quite abashed, and his grandfather came to his rescue.
زیرا سابقاً در دیوان صدارت عظمی دعوائی داشتم و تا صدور حکم محکمه این کار چنان برایم گران تمام شد که تقریباً از هستی افتادم.	having been formerly almost ruined by a long suit in chancery, which was decreed for me with costs.
پس از سعی بسیار با صدای آرام خود توانست سر و صدا را فرو نشاند .	somehow made her usually soft voice heard above the tumult.
کراهت داشتم! و رو به دریا گرداندم تا عظمت آن را بستایم که هیچ نظیر ندارد.	turned me to admire the magnanimity of the sea which will permit no records.
وقتی هردو برای قدم زدن آماده شدند گفت	she said when they were ready
که اگر به وی اجازه ندهند به خدمت نظام وارد شود از خانه خواهد گریخت.	that if he was not allowed to enter the service he would run away.
پس از اینکه مطمئن شد کسی مراقب ایشان نیست	to make sure that he was unobserved
یک حادثهٔ ناچیز این امر را بر او ثابت کرد.	as was shown by a trifling incident.
عضلاتم از تصور واکنش او منقبض شد.	I cringed internally at her imagined reaction.
لابد چند دقیقه پس از رفتن به اتاقش مرده بود	must have died within minutes of retiring
ولی شهامت نداشت فکرش را به زبان بیاورد.	but she did not dare to speak of it.
در گوش همه گوش خراش و غیرعادی بود	sounded shrill and unnatural
که رد روباهی پیدا شده است و تمم گروه درهم آمیختند	that a fox had been found, and the whole pack, joining together
هر چند به او گفتند که خوابیده است.	though he had been informed, to begin with, that she had already gone to bed.
تا حافظ و نگهبان عظمت تاج و تخت و موجب فخر و سربلندی شخص پادشاه باشند.	to set off the dignity of the prince, and for the greater glory of the king's majesty.
لکن مفاد سخنانم عینا همین بود که گفتم.	but the idea was as I say.
دریافت که هنوز جان نداده است.	found he had not yet ceased to breathe.
در ته دل بیمناک بود که مبادا ندانسته دست به بازی با آتش زده	hers for him was that she was indeed trifling with fire
دیگر جرئت نخواهم کرد به اینجا باز گردم.	I dare not come again.
یک دم نیز در خصوص کاری که میبایست انجام دهد دچار تردید نشده بود.	had never had a moment's hesitation about doing what he ought to do.
دستی سنگین بر سینهء آقای لاری بگذارد	laying a brawny hand upon his chest
بله کاری به سرشان خواهم آور که چشمهاشان چهار تا بشود.	well, he'd hand 'em something that would surprise 'em.
من هم از برای خودم تحصیل روشنایی کردم	I furnished myself with a light
که کسانی بودند که با او به قدری صمیمی بودند	who were already on sufficiently intimate terms with him
شلاق بلند را از روی میخ برداشت.	took the long horsewhip from its nail.
پوست تبریزی را با عجله توی جیبش گذاشت.	he put the bark hastily in his pocket.
زیرا آن شب مذاکرات به طور عمومی صورت گرفته بود.	from other accounts of it, that the conversation that evening was general.
انحراف آن به سویی دیگر غیرقابل تحمل بود.	to bend them the wrong way was intolerable.
شاید یک جسد در اتاق خواب دراز کشیده باشد.	maybe there was a corpse lying upstairs in the empty house.
او مهارت کاملی در مشغول ساختن خاطر مشوش دارد	he is admirably adapted to revive one's spirits
در صدایش اثری ناپیدا از تردید وجود داشت.	the slightest trace of doubt in her tone.
او را در اتاق تنها گذاشت و رفت.	left him there, alone
نگاهی به درهای بسته درون سرسرا انداخت	pursued the fellow, surveying the range of closed doors.
آن قطعه نان را برداشت و بدقت پاره کرد.	he took up the piece of bread and carefully crumbled it away.
اما این قصه هولناک شما مرا به کلی منقلب ساخت.	but all your frightful stories have so upset me
تا این که دید آقای نای تلی دستش را گرفته و روی قلب خودش گذاشته.	till she found her arm drawn within his, and pressed against his heart
واگذاری روستائیان زرخرید خود و هرگونه فداکاری دیگر مضایقه نخواهد کرد	his serfs, or himself, only one ought to
سرانجام نیز با رفتن من موافقت کرد.	at length permitted me to go.
چیزی نگفتم و کوشیدم که فکری هم نکنم.	I said nothing, and tried to think nothing.
در خیال تلف کردن او شدند و چون او را نتوانستند.در خیال اتلاف شما شدند	that is why you, in your turn, are to die
به نظر او ما حیواناتی هستیم که بر حسب اتفاقی که از حدس آن عاجزست اندکی عقل و شعور نصیب ما شده است	that he looked upon us as a sort of animals, to whose share, by what accident he could not conjecture, some small pittance of reason had fallen
خودم باید به دیدگانم از حقایق آگاه کردم.	I shall see, now, with my own eyes. I shall see all.
پدرشان سعی کرد تا آن دو را از این تصمیم منصرف نماید.	their father tried to dissuade them.
وقتی جغدها پروازکنان جلو آمدند و بسته را روی پای او انداختند بسیار متعجب شد.	was amazed when the owls soared down and dropped it right in front of him
اما اینک از آن خط گذشتند و نه تنها واقعه وحشتناکی به وقوع نپیوست	now he had crossed that line and not only was there nothing terrible
بدون این که از این علاقه آگاه باشد.	without even knowing she loved it
گلویی صاف کردم و گفتم قصه ای نوشته ام .	I cleared it and told him I'd written a story.
من تلاش متمرکزی کردم تا تمرکز کنم.	I made a concerted effort to focus.
کلیدم را بیرون آوردم و از بالای سرش دستم را دراز کردم تا در را باز کنم.	I pulled out my keys and reached over the top of him to open the back door.
خصوصاً به این دلیل که او یک دست خود را به هوا بلند کرد و هماهنگ با حرکت گاری به چپ و راست تکان داد	especially because her raised hand of an archangelic messenger was moving with the swaying of the cart.
سخنش را تمام کرد و دستش را روی سینه برجسته و زیبای خود گذاشت و به آسمان نگاه کرد.	she concluded, laying her hand on her beautiful, fully expanded bosom and looking up to heaven.
ولی خون مقداری از موهایش را در جهت مخالف خشک کرده بود.	but the blood had dried just one lock into a stiff cowlick.
بیش از همیشه مهربان بود و حتی طرب انگیز تر.	was tenderer than usual and even more delightful.
او باید از دادن احوال خودش چشم پوشی کرده .	he should have neglected to give any intelligence about himself
شگفت زده به گوشه و کنار آشپزخانه چشم انداخت	gazed about wondering at the wealth
بدون او هیچ کار نمی تونستم بکنم	I couldn't do without her.
دوباره سرم را از روی تکالیفم بلند کردم	I looked back up from my homework'comforting
چیزی نبود که به آن فکر بکند یا از آن ناراحت بشود.	she could have nothing to explore or to suffer
اگر برای کاری که در پیش رو داشتند نگران نبودند	if they hadn't been so worried about what they had to do.
یکی را فرستاد که بلکه مرا پس بگیرد	she sent a man over to try to get hold of me.
فاج هنوز ناراحت بود که تمام روز بیهوده با علم اشاره حرف زده بود.	who was still looking very disgruntled that he'd been using sign language all day for nothing.
به سرعت به طرف در رفت که به چشم خودش ببیند.	he dashing to the door to make sure.
با این فکر نگرانی دوباره بازگشت.	she thought and desperation came back to her.
اگر هم باشد من حاضر به پیروی از آن نیستم.	I don't mean to obey it
من نیز نگاه کوتاهی به جمعیت ناراضی و ناراحت انداختم.	I glanced at the angry mob, too
تنها یک بار برحسب اشارت گفت که در میان تمامی عواطف بشری فقط عشق و ایمان تسلی بخش است	only once she said in passing that in all human sorrows nothing gives comfort but love and faith,
فقط من برای بقیه باید کلیاتش را بگویم.	I shall only just mention the circumstance to the others in a common way.
هنوز دو گاز نزده بود که اشکش سراپر شد و دیگر نتوانست بخورد.	she could scarcely swallow two mouthfuls before tears interrupted her
باور کن اگر لازم باشد حاضرم تو را بکشم.	even if I have to kill you.
او چوبدستیش را بالا گرفت و لنگ لنگان وارد جنگل شد.	he pulled out his wand and limped off into the forest.
از روی عجز و بیچارگی زوزه کشیده بود	there miserably howled
که فرشتگان او را در هوا خواهند گرفت و خواهند برد و به زمین نخواهد افتاد و خرد نخواهد شد	the angels shall hold him up lest he fall and bruise himself
آیا در خارج به انتظار ما ایستاده و یا به طرف لندن حرکت کرده است.	when we came out to the car again I saw his car had been drawn up outside a cafe on the opposite side of the road.
برای این خلق شده بود که اعتمادش به علل غایی از آن جمله مناسب بودن زنان زیبای جوان برای مردان مجرد صورت سرخ را از بین ببرد.	calculated to shock his trust in final causes, including the adaptation of fine young women to purplefaced bachelors.
ولی برای اینکه کاملاً شما را از اشتباه بیرون بیاورم	however, entirely to relieve you of it
یک بار دیگر برگشت و نگاهی به درشکه انداخت.	her jaw dropping as she looked after the carriage with passionate curiosity.
همان هوس نیز اکنون مرا برانگیخته است تا از اینجا بروم.	or else an idle whim is going to spirit me away.
از میان جمعیت راهی برای خود گشود	at that moment made his way through the crowd
این دود خوش مهرآمیز که از یک چپق کشیدیم به زودی آن یخ را ذوب کرد و ما را دوست نزدیک ساخت.	this pleasant, genial smoke we had, soon thawed it out, and left us cronies.
معتقد بود اگر زنی به طور اجبار این مسایل را آموخته است اصلا نباید دانش خود را افشا کند.	he believed that, should a woman be so unfortunate as to have such unladylike comprehension, she should pretend not to.
که فریاد احتضار مردی در فضای جزیره طنین انداخت.	when there came ringing over the island the cry of a man at the point of death.
ولی در وقت خواب از من پرسید که آیا این کتاب را دارم!	but when I was going to bed at night, asked me if I had got that book?
تقریباً چهار ساله بودم که متوجه شدم سگ داریم.	when I was nearly four that I suddenly realized that we owned a dog.
او در این اندیشه بود که به مارتین کمک کند تا دنیا را همچون او ببیند. افق دیدش را بگستراند تا جایی که با افق دید خودش یکی شود.	she dreamed of helping him to see as she saw, of widening his horizon until it was identified with hers.
چیزی نگذشت که هردومان به خواب رفتیم.	we both soon slumbered.
دهانش را باز کرد ولی فوری آن را بست.	opens her mouth, closes it again
لطافتی در خود احساس کرده بود.	he had felt a stirring of tenderness.
من باید تجهیزات و ساز و برگ و کشتی داشته باشم تا بتوان آن گنجینه را به سطح آب بیاورم.	I must outfit a ship to bring the treasure to the surface.
حتی برای یک بار هم موفق نشدم شما را ببینم.	I never saw you for an instant.
بیم داشت به او بنگرد اما در عین حال	was afraid of looking at her, and yet felt an irresistible desire to do so.
اما نسبت به زنان همان احساسی را نداشت که به روباه و قرقاول.	he had some other feelings towards women than towards grouse and foxes
من راه تحصیل علم را در پیش گرفتم	I followed that of letters
او را با توجهات خود به ستوه آورد	pestered him with her attentions
آن روز صبح تصادفاً فقط همین یک نامه رسیده بود	that morning, as it chanced, there was only this one letter
اصلا چرا از اول به من نگفتی این زوبین انداز جهنمی آدمی خوار است.	why didn't you tell me that that infernal harpooneer was a cannibal?
یا آن که تقسیم سه عبارت هوشمندانه که طی هجده هزار و دویست و پنجاه شب دوام آورد	or that the fraction of three witty sayings lasted eighteen thousand two hundred and fifty nights
با این حال هری مجبور شد سرش را بدزدد	but he still had to duck
ولی پیرمرد با نگاهی تنفرآمیز او را برانداز کرد	but, the old gentleman, eyeing him with an expression of dislike
شما آقای محترمی هستید.این نامه را بسوزانید	as you are a gentleman, burn this letter
بدین طریق او را پنج روز تمام در بستر خواباند	she made her stay in bed for five days and
من دوباره مثل قبل ضعیف و ناتوان شدم.	I was left as weak as ever I had been
من پای خود را بلند کردم و آن سوتر دروازه بزرگ باختری نهادم.	I stepped over the great western gate.
اصلاً در انتخاب کردن محل کار هم برایت سوء تفاهمی حاصل شده است.	that you've been in a wrong position altogether
من پاسخ بسیاری از معماها را میدانم.	I know the answer to many riddles.
فردای آن روز بر دقایق نکات و ظرایف امور پروندهء خویش احاطهء کامل داشت.	he always had his points at his fingers' ends in the morning.
طوری که همه تمام صحبتش را درست بفهمند	so that none of them could miss a word
در اثنای قرائت این نامه طولانی	while he read this long and painful letter
خیلی متأاسفم. من متوجه این نکته نشدم.	I did not come this way,' I said.
گویی پیشگویی شومی برای سفر او بود.	as if it boded ill omen to his venture.
بی آنکه هنگام بازگشت از جایی اندک تغییری در نگاه آرام چشمان تیزبینش یا چهره گلگونش ببینید.	without any scene from which she did not return with the same unperturbed keenness of eye and the same high natural color.
در این خصوص هم من مدارک مثبتی بدست دارم.	I can even say definitely that it was a marriage of affection.
در راه ایستگاه قطار برای خود یک جفت کفش کتانی خرید.	bought herself a pair of espadrilles on the way to the train.
از آن فراموش شدگی پس از مرگ که برایش آشنا بود.	because it was the forgetfulness of death.
سایه کسی که هرگز ملاقاتش نکرده بود.	the shadow of someone she had never met.
از جا برخاست و پیش از آنکه پایین برود به اتاق شمایل رفت	before going down she went into the room where the icons hung
به یاد خونسردی و تسلط بر نفس ورانسکی افتاد و احساس خشم نسبت به او وادارش کرد که کاغذ را پاره کند.	she recalled his composure, and a feeling of anger against him impelled her to tear the sheet with the phrase she had written into tiny bits.
معلوم شد که با این تظاهرات نتوانستم بودم او را فریب بدهم.	I had not deceived him, though, not for a moment.
درست مثل این که مرگ او به تصمیم خودش ربطی ندارد	as if his death had been not his own decision
من متوجه نشدم که کسی دستم را نگه داشته است تا زمانی که هر کسی که بود با آرامی آن را فشرد.	I didn't realize someone was holding my hand until whoever it was squeezed it lightly.
حال از بابت رنجیده و مشوش شده بود.	more than anything else, it troubled and irritated him.
من هم کمی احساس بهتری پیدا کردم.	I felt a tiny bit better, too.
برای تسلیم شدن خود عذر موجهی تراشید.	to invent an easy justification for his surrender.
دگرگون شده و به پوشاندن رازهای عفیفانه اختصاص یافته بود.	it had been transformed and become fitted to shelter chaste mysteries.
ولی پیش خود آن را نپذیرفتم و باور نکردم.	but I decided that was nonsense.
در این حال دست چپش را به حالت توجه برانگیز و مرموزی روی ران گذاشته بود.	slapped her left hand on its biceps in a fascinating
بدون این که در ضمن راه به مانعی برخورد کند	meeting with any interruption by the way.
لکن در همان لحظه مرد چراغ را بلند کرد و صورتش روشن شد.	but at the same instant the man raised his light, which flashed in his face
بدتر از آن اینکه بعد از آن همه زحمات و مخارجی که دوستان متحمل شدند تا بر او دست یافتند دوباره قصد فرار داشته است.	still more, in endeavouring to escape from them after so much trouble and expense had been incurred in his recovery.
هرچه زر بود در کف دست او ریختم	poured all the gold into his palm
اما دیگر به انجام این عمل قادر نبود.	but he could no longer do it.
دقت داشتم طوری از شکاف پرده بیرون را نگاه کنم که خودم دیده نشوم.	taking care to stand on one side, so that, screened by the curtain, I could see without being seen.
این ضربه را با شهامت تحمل کرد.	he took the blow bravely
در نتیجه یک لوحه اسکناس صد دلاری حکاکی کرد که قرار بود بعد از استفاده آن را از بین ببرد.	so he smuggled out some hundred dollar plates that were supposed to have been destroyed
اما همین که مراسم عروسی پایان پذیرفت	but when the wedding days were over
همواره هم در همان حول وحوش بود.	still lingered about the same spot.
که قلب همه در یک لحظه فرو ریخت.	as for a moment their hearts sank in.
ولی حتی یک بار به فکر خطری که در پیش بود نیفتاد.	, but not once of the impending danger.
اما چشمانش چیزی یکسره متفاوت میگفت.	but her eyes spoke quite differently.
عجیب شور و شوقی برای رسیدگی به این جا پیدا کرده.	he has become intensely interested in looking after it.
چیزی که به هر حال نگذاشته بود متوجه گذشت زمان بشود.	but which had protected him from an awareness of his age.
چون هردو لبخند جلفی بر لب داشتند.	for both were idly smiling.
اما حالا معلوم نبود که او در آن اطاق باشد.	the woman, who may not have been there.
تا این که کاملاً ضایع شد و به صورت یک سراب درآمد.	evasions until it turned into nothing but an illusion.
به او نیشخند زدم و به پیشانیم دست کشیدم.	I grinned at her and touched my forehead.
اما اندوه بار و عاری از نرمخویی.	but sadder, without his gentleness.
به من بگویید که کیستید و چه چیز باعث شده است که در این نقاط خلوت همچون درندگان بسر برید و با مرگ دست به گریبان باشید	to tell me who you are and the cause that has brought you to live or die in these solitudes like a brute beast,
که هنوز این تصور است و صورت وقوعی در خارج ندارد.	it is a fancy you have taken in your head
تمام کشتگان را همان روز پخته و خورده بودند.	all cooked and eaten that very evening.
که اگر ما او را از چنگ وی بیرون نکشیده بودیم آن بیچاره را با مشت و گاز کشته بود.	that if we had not dragged him off him, he would have beaten or bitten him to death
این اقدام را بم نزلهٔ افتخاری بزرگ برای خود میدانست.	a high and holy person like that looked on it as an honour!
یا امیدی که هرگز در زندگی تیره و تار خودشان ندرخشیده است.	to bright hopes that never shone upon their own sombre lives.
زیرا همین که این فکر به مغز ترز راه یافت	when she sets herself to press a point
در سکوت کامل کنار همسرش ایستاده بود	she had stood by her husband's side perfectly silent
چنین اتفاقی نباید با جبران کردن این وضع نامطلوب با وضع مطلوبی بی اثر شود.	the incident ought not to be neutralised by replacing with something more delicate the comfort lost
که به اولین کشتی که برخورد بکنیم	to speak the first ship I sight
آخه مجبور نبودم غذا بپزم و کارهای خو نه رو بکنم.	not having to cook.
توانسته است پدرش را متنبه سازد و	he had upset his father, and that the old man
در حالیکه چراغ را پیش صورت خود گرفت	putting the light near his face
با خنده اشاره به تفاوت وضع فعلی او با وضع زمان تحصیلش کردم.	I remarked laughingly on the change in his present circumstances from those when we had both been medical students.
طبق دستور عزراییل شروع به بافتن موهایش کرد	she braided her long hair
فکر کردم به من کمک خواهد کرد	I thought he would help me.
سپس نگهبان بازویش را لمس کرد و او برگشت و رفت تا تار خرد کردن سنگ را ادامه دهد.	then the keeper touched him on the arm, and he turned and went back to breaking stone.
پس کاملاً امر او را اطاعت کردم.	I obeyed him to the letter.
صدای بریده شدن نفس کسی را شنیدم و بالا را نگاه کردم.	I heard a little gasp and I looked up.
به او گواهی داده بود که آن مرد باید برادرش باشد.	telling him somehow that this was his brother
به این امید عبث که هر که بود راهش را بکشد و برود.	in the futile hope that whoever it was might go away after a single attempt.
از شروع عصرانه تا حالا خیلی کم خوردید.	you have scarcely tasted since you began tea.
رضایت خالی از ترحم کسی را در خود منعکس کرده بود که انتقام خویش را گرفته باشد.	bore a cruel look of being avenged, which they would henceforth bear for ever.
در این عالمی که غیر از گریه کاری ندارم	for if you are killed I shall be alone in the world
لکن در عین حال خود گرفتار نگرانی و تشتت افکار شدیدی بود.	growing confused, and constantly losing the thread of his ideas.
جوانک میل دارد زی دست من کار کند و کسب و کار یاد بگیرد.	the lad would like to be under me and give his mind to business.
ما توجه خود را به سفر دریایی معطوف ساختیم	we turned our attention to our voyage
با شمشیر ضربتی محکم بر گردنش فرود آوردم و کار او را ساختم.	with a strong slash across the neck, I thoroughly despatched it.
فردا بامداد اندکی پس از ساعت نه از صدای در بیدار شدم.	but I awoke next morning after nine o'clock when they knocked at my door.
اما بینوایی یک پیرمرد را هیچ کس مهم نمیشمارد.	the wretchedness of an old man interests no one.
به سراغ اشیائی رفتند که قرار بود در شب حمله بکار برند.	each turned his attention to the weapon he would be using on the night of the strike.
لکن چون به آنجا رسید توقف و منتظر عفو شاهزاده گردید.	having gained which strategic position, however, he stopped and looked back to see if he might hope for pardon.
بی شک تلگراف درباره مادربزرگ بود.	for the matter concerned his mother.
دیدمشان که از تپه پایین رفتند و پشت دیواری ناپدید شدند.	I watched them walk down the hill and disappear behind a wall.
مطابق میل دکتر همگی بازگشتند.	in obedience to the doctor's impulse, home they went.
قدرتی به من بدهد تا خود را شایسته محبتی کنم که قبل از احراز آن شایستگی در حق من روا داشته بود.	the power of meriting the kindness which seemed so frankly offered me before it was earned.
دوربینش را برداشت. به طرف پنجره رفت.	snatched up a pair of binoculars, and stepped to the window.
چنین به نظرش رسید که حقیقت را بیان کرده است.	it seemed to himthat what he had just said was really true.
در فاصله اندک بر فراز میدان کارزار معلق بود.	hung low over the field of battle on the horizon.
چنان که دیگر هیچ کس اطمینان نداشت حقیقت امر چه بوده است.	that nobody was quite sure what the truth was anymore.
در ضمن امیدوار بود که دختر قدری دیگر رفتنش را به تأخیر اندازد.	hoping she would tarry yet awhile longer.
ولی چشمانش را از روی کتاب اصلاً بلند نکرد و سؤال هم ننمود.	never lifted her eyes from her book, or asked a single question.
تصمیم راسخی که درباره کارگرهای زیردستش گرفته بود	in spite of the fact that he had made such drastic resolutions in regard to
اما حقیقت را به شما بگویم ف ان چه امشب در دفترم رخ داد از ترس زهره ترکم کرد.	but to tell you the truth, what happened back at the office scared the wits out of me.
از ای نرو با فروتنی و شکسته نفسی بر آن عالی جناب به سبب لطف و مرحمتی که در حق من نموده بود سپاس گزاردم.	I made my humble acknowledgments to his highness for so great a favour.
در واقع نتوانست وجود خاک را در دهانش تحمل نماید.	in fact, she could not bear the earth in her mouth.
تصمیم گرفت درخواست بلناپ را رد کند.	he decided to deny themotion.
برای نخستین بار بالاخره آنچه را که به انجام آن قادر هستم نشان بدهم.	that for the first time I shall have to show all I can do.
زوبین انداز در مدخل مسافرخانه منتظر من نباشد تا از پا درم بیاورد.	the harpooneer might be standing in the entry, all ready to knock me down!
گفت به این زودی انتظارتونو نداشتم	I never expected you so soon, he said.
من به دنبال او از اطاق بیرون آمدم.	I followed her from the room.
در و دیوار و کف زمین را خیس کرده بود.	that had left both walls and floor soaking wet.
مخصوصاً یک وجب دورتر نشانه گرفت تا به او نخورد و آسیبی نرساند!	aimed it a yard on one side on purpose, for fear of hurting him.
بهتر این است که سهمش را از بدنه کشتی بگیرد و به خانه ببرد.	he had best cut away his part of the hull and tow it home.
پس لازم بود که عجله کند و پیش از بسته شدن در به خانه رسد.	it was important, therefore, that he should make haste.
در برابر این جوان که آشکارا معلومات و تحصیلات بسیار بیشتری از او داشت	before a youth of obviously so much more training and schooling than he possessed
ولی احساس روانی او این بود که انگار درمعرض دید همه قرار داشت.	but the psychological feeling was still one of utter exposure.
به من قسم داد که از این کاغذ مطلقا در هیچ جای ذکری از آن نکنم	he made me promise several times never to speak of that letter to any one
انگشتانش در زمین فرو رفته بود	his fingers dug into the ground
ماری تورن به طیب خاطر حاجت او را اجابت کرد	which she did with right good will
به او اشاره کرد که به زمین فرود آمید.	gesturing him to the ground.
به کمک همان السنه خواهد توانست خود به خود بر اوج ادبیات بشری صعود کند	with their help he will by his own exertions reach the summit of polite literature
پس من ناچار بودم که ساکت باشم.	I was therefore forced to hold my peace.
پیش از آنکه حال و حوصله بیرون آمدن از آن را پیدا کنم مدتی بود که روز فرا رسیده بود.	before I could get spirits enough to creep out of my cave, the day was far advanced.
ما روستاییان نیز توانسته بودیم دریابیم.	even to our rusticity his gentle bearing sufficed to make it plain.
اما نتوانست چنان کند که مرد غریب نبین دش.	he could not prevent the man seeing him.
هیچ حاجت نداشت که گرد او را چیزهای زیبا گرفته باشد.	he had no need to be surrounded by beautiful things.
بنابراین فقط خواستم یک خرده برای تنها چیز زیبایی که داشتم گریه کنم.	so I just made a little private moan for my one beauty.
فانتین دانست که حکم صادر شده است.	she understood that her fate was sealed.
اما مانند هر زن با احساسی نیاز داشت با شاد کردن روح انسان دیگری بر او خیرخواهانه حکومت کند.	but she had the ardent woman's need to rule beneficently by making the joy of another soul.
اما چیزی به فکرش نرسید و دوباره دهانش را بست.	couldn't think of anything to say, and closed it again.
هر سه وعده غذایش را در آنجا خورد.	had his meals as usual
او صدایش را پایین آورد و به طرف من خم شد	I saw him''she lowered her voice and leaned toward me''change.
ساعت به ساعت منتظر آمدن وی بود.	all day long she waited for him to come.
کمی مکث کرد تا اتاق بچه ر وشن شود	pausing for just a moment to let the light spill into the boy's room
دلفین خود را روی صندلی انداخت و گریه را سر داد.	flinging herself into a chair
تلاش کردم به یاد بیاورم که چگونه باید آن را ببندم.	I floundered around in my head, trying to remember how to close it.
این باد زن خیالی را در خاطر او انداخت	this fan awakened a recollection
ولی من برای دیدن آن زیاد راغب نبودم.	but I felt disinclined to go and look at them
نگاه متحیرش با مسیر جریان آب همسو شد.	his glance wandered away with the stream
مث اینکه صدا از سمت بال هواپیما میاد	coming from the wing?
یکی از یاغیان و راه دیگری وجود ندارد.	death by the hands of the mutineers.
به این جهت از تمام بیان او تنها متوجه کلمه زشت و رکیک آن شدند	so of what she had said they only noticed, and repeated in a whisper
بلکه نوعی تنفر مثبت از او نیز دارد پاک در حیرت شد.	but that he had a positive dislike for her.
نمی خوام برای بار سوم روی قلبم قمار کنم .	I'll not risk my heart a third time.
او این وسوسه را نپذیرفته بود.	he had withstood this temptation.
با هم جزئیات انجام دادن آن را تنظیم کردیم.	between us we settled on the details of its accomplishment.
زیرا وقت ندارم بار دیگر نظری به آن بیفکنم و آن را اصلاح کنم	I shall have no time to read it over and correct it
مثل این که در سلامت عقل من شک داشتند.	as incredulous of my sanity.
که چگونه ممکن است مردی با شخصیت تمام توش و توان خود را صرف توطئه ریزی و نقشه کشیدن کند	that a man of character should devote his energies to plotting and intrigues
همه اسرار زیر این گنبد برای او آشکار و روشن است و دیگر هیچ چیز ابدی و اسرارآمیز نیست.	in which all was clear, but nothing eternal or mysterious.
اگر چنین کنی آن وقت لذت عفو و اغماض را درک خواهی کرد.	then you will know the happiness of forgiving.
بدان گونه که گویی زحمت و کار خود زندگی بود	as if toil were life itself
اما وقتی در را گشودم دیدم که به اتاقی شبیه به انبار راه پیدا کردم.	but when I came to it and opened it I saw that it was a garden room
بدیشان اطمینان داد که محض تبجیل و تبرک عملی که کرده است	assured them that by way of doxology to the deed he had done
زیرا ارلاندو برای او مرد بود	for a man he was to her
سر دیگر آن را مثل افسار به گردن حیوان بست.	tied it to the other side of his collar like reins over his neck
تنها راه عاقلانه این است که با بدگمانی به آن نگریسته شود.	that suspicion was the only wise attitude with regard to it.
در این لحظه دستش را بالا برد.	here he raised his hand as if unconsciously
که کمال میل را داشتم که مدتی طولانی از او محظوظ گردم.	which I would gladly have enjoyed longer
دو تن دیگر را با دو ضربت پشت دست بر زمین انداخت و هر یک از آن دو را زیر یک زانویش جای داد.	then with two backward sweeps of his hand he had overthrown two more assailants
در حالی که همه بلااستثناء هراسان و آشفته بودند	when everyone was just confused and scared?
با احساسی از ماجراجوئی بلند کرد.	with almost a quaking sense of adventure.
کیفم را برداشتم و فوری از دفتر کار بیرون آمدم.	I grab my jacket and almost run out of the office
تا نشان دهد که کارش عمدی نبوده	show it was no mere irresponsible venture of his hand
یکی از علاقه من دان به موضوع را عشق چشم بسته بود.	one of the interested parties had his eyes blindfolded by love
باعث شد که وقتی ما در وسط دریا بودیم	brought it about that when we were now in mid sea
به سوی پنجره آمد که آن را باز کند	hurried to the window and tried to open it
حتی اگر تا آن هنگام ایمان به خدا نداشته است.	even though he had not believed in it till then.
بلکه بر اثر افراط در باده گساری تب کرده است و مرده است.	but died of a bad fever by excessive drinking.
من رمانتیسیسم احساسات گرایی را ول کردم	I've abandoned romanticism
من حتی هیچ وقت راجع بهش فکر هم نکرده بودم.	I didn't even think about it.
اول به تو مزاجی سالم و تندرستی داده	has done for you he gave you health
او مذاکرات را چنان به دلخواه رفیق خود اداره کرد	conducting the negotiation so much to the satisfaction of his friend
بعد از اینکه با تب و لرز از لجن بیرون آمد.	when he has come out on the other side of the mud with an ague.
امیدوارم که این برای شما درس عبرتی باشد.	let this serve you as a lesson.
فکر کردم که شاید واقعا داره دیوونه می شه.	I wondered if he was really going crazy.
دختری حدوداً پانزده ساله پشت خم بیرون آمد و قد راست کرد.	a girl of about fifteen ducked out, straightened.
حالا تفنگ به من می دادن و می گفتن برو آدم بکش .	they let me out with a gun in my hand and a free pardon to do more killin'.
که چرا او را همان طور که خودش میخواهد معالجه نمیکند.	because he wasn't treating him quite as he liked,
او مرا به عنوان طبیبی حاذق به چندین بیمار معرفی کرد.	by him I was recommended to several patients.
بهترین حرکتش این بود که مرتباً دور خود بچرخد.	turning round and round was the manoeuvre she was best at.
درینجا برای آخرین بار خواننده محترم را بدرود میگویم	I here take a final leave of all my courteous readers
قیافه او در این حال به یک مرده از گور گریخته بیش از چهره انسانی شباهت داشت.	he looked less like a man, than like some hideous phantom, moist from the grave, and worried by an evil spirit.
مخصوا شرح داد که چند لحظه قبل از ورود ایشان این مرد دیوانه و سست این تپانچه پرشده را ربود و اهل خانه نتوانستند آن را از دست او بیرون آورند	how just before their arrival that drunken imbecile had seized the loaded pistol which they had not had time to recover from him
دنیای کوچک و نا امن او در حال فرو ریختن بود .	his small and insecure world tottering.
تئاتر بزرگی آن کنار به خر سنگی یله بود.	to one side a great theater lapped up the rock.
تنها برای ابراز وفاداری خود نسبت به شما هم شده است در اینجا خواهم ماند و هرگاه مثلا خطری شما را تهدید کند.	I have remained until now simply because of my devotion to you, and as for danger
ترسشان از این بود که این صفات نامساعد نگذارند در زندگی روی سعادت ببیند و شوهر مناسبی پیدا کند.	until she had made a good match.
چنان به اعماق دریا فرو رود که خطر آن در پیش باشد که تمامی ریسمانی را که در اصل به زوبین بسته بوده است با خود ببرد.	should sound so deep as to threaten to carry off the entire line originally attached to the harpoon.
اما تنها چیزی که به آن یقین داشتند این بود	but all they knew was
قصیر شرم آور و غیرقابل عفو خودم بود!	my fault! shameful, unpardonable!
مقداری بوته در زیر خود گستردم	strewing some heath under me
ولی خود را به نشنیدن زد و موضوع صحبت را تغییر داد.	he pretended not to understand, and turned the conversation.
عطش یک پرخور را با رازداری یک قاضی جمع کرد.	the thirst of agormandizer with the discretion of a judge.
من که زیاد سر این موضوعا ناراحت نمیشم	I shouldn't trouble.
حتی یادآوری این موضوع که وصیت نامه دیگری هم هست	even the recollection that there was another will
تازه از طبقه بالا پایین آمده بود.	he had just descended from the upper storey.
اعتراف کردم که مرا بد بار آورده بودند.	I was badly bred.
با کف دست روی در اتاق خواب او ضربه زد.	his pounding with the flat of his hand on her bedroom door.
با وجود این مصاحبت او خالی از لطف نیست.	but queer tempered I should think, difficult to know.
بلکه به باز آمدن ترغیب کرد.	but lured him back again.
بی درنگ بر سر میز کار خود رفت.	went straight to his bench and to work.
پس از گشت و گذار مشئوم اخیر فقط بیست و پنج دلار ناچیز برایش باقی مانده بود.	for he was thinking of the miserable twenty five dollars left him from all his recent ghastly adventures.
ولی رایحه را در خانه دنبال کردم.	but I followed the scent through the house.
که تنها اندرزهای روح دهشت انگیز و نیرومند	that nothing but the advice of the great dread spirit
اما تمام محوطه را سکوتی مرگ آسا فرا گرفته بود.	but all was still as death.
حتی هنگامی که دست بر صورت او گذاشت و به صدای قلبش گوش داد باورش نشد.	even when she touched him and listened for his breathing, she could not trust her conclusions.
اما پرس تارک گرامی من با سوزنی کوچک آن را از دهانم در آورد .	but my dear little nurse picked it out of my mouth with a small needle.
بیش از سه ساعت از شب گذشته بود	the night about three hours spent
افکار مزاحم را از ذهنم خارج کنم و به چیزهای خوشایند فکر کنم.	to dismiss what importunes, and recall what pleases.
گوئی که از بیماری برخاسته بود.	she recovered from it slowly.
اما زمانی رسید که او نارو سوار ارابه کردن.	until the very moment when they climbed into the tumbrils.
آن ای که تو وصف جمال او را چنانکه باید نگفتی	that is that thou didst ill describe her beauty to me
از این پیچم که بگذریم هاگوارتز معلوم می شه.	jus' round this bend here.
ایستادند تا با هم شور و مذاکره کنند.	stopped to take counsel together.
هرگز مانند آن سال با این همه سوء حوادث و این همه سوء تفاهم میان خود و ورستاییان مواجه نشده بود	never had there been, or, at least, never it seemed to him, had there been so many hindrances and so many quarrels between him and the peasants as that year,
امری نیست که آدم بتواند افکار خود را به آن معطوف بدارد و در نتیجه از آن لذت ببرد.	not a matter one can comprehend, or consequently enjoy, all at once.
پسرک را به مانند یک کیسه خالی با خود می کشانید	dragging the boy, now, as easily as if he were an empty sack.
کمی ثبات رأی و پایبندی به اصول از او یاد بگیرد.	acquire from hers the steadiness and delicacy of principle that it wants.
صورتی کشیده و لاغر و مو و ریشی ژولیده داشت و لنگ لنگان وارد دفتر شده بد با شاخه خمیده درخت به جای عصا.	a lean, haggard face, ragged beard and hair, and had walked in limping, with a crooked branch of a tree for a staff.
لذا به زحمت بلند شدم و نشستم.	I sat up and saw the battle over
پس از نیم ساعت کشتی مرا از دور دید.	in half an hour she spied me.
در راه به او قول دادم که برایش نامه بنویسم	I promised, on the road, to write to her.
در مقابل این دشمن که نیمی از افراد خود را از دست داده	experienced a similar feeling of terror before an enemy who
اگرچه دو تا مرده به دنیا آمده و یکی او را ترک کرده بود	yet two had been base born and one had deserted her
از همه سپاسگزاری نمود که موجب تفریح و شادی او شدند.	she thanked them all for having entertained her so well.
بهتر است در رختخواب استراحت کند و دکتری بالای سرش بیاید.	he ought to be in bed, under the hands of a doctor.
هنگام خواب هر کدام از ترس در اتاق خود را کلید کردند.	at night they locked their doors in fear and dread.
آنگاه هردو نفر با هم بیرون آمدند	they went away together
انگار آگاهی همچون نور نامرئی ذهن هردو را روشن کرد.	as though an invisible beam of understanding shot between them.
جز پیشنهاد خواستگاری برادر زنش از راستوا و جواب رد شنیدن وی خبری نبوده است.	that his brother in law had proposed to her and been refused.
یعنی باید از ظلم و تعدی جلو گیرم و به کمک بیچارگان بشتابم.	to put down force and to succour and help the wretched.
من چیزهای خیلی مهمی داشتم که ذهنم رو مشغول کنه.	I had too many more important things to obsess over.
یکی دو نفر حاضر بودند با خطرات فک ین او رو به رو شوند.	few of those hunters were willing to encounter the perils of his jaw.
خاله جون تمام بعد از ظهر و منتظر تو بود.	auntie has been waiting for you all the afternoon.
شلوار کوتاه او را پایین کشید و از دیدن بدن آغشته به خونش لرزید.	pulling down the bloodsoaked shorts to see blood soaked flesh, shivering.
منم فقط یه ذره دیرتر بهش گفتم.	I just'let her carry on a bit.
به چشمان او خیره شدم و صدای خودم را بای اولین بار شنیدم.	I stared into his eyes and heard my own voice for the first time.
فقط یک تغییر جزیی در حالت صورتم که کسی متوجه نشود.	just a small change in the set of my mouth.
حاضرم برای خدمت به شما جانم را بدهم.	I'd give my life to serve you.
چون باید به خاطر داشت که هیچ فلس ندارد	for, remember, he has no gills.
به محض اینکه لباس پوشیدن شما به اتمام رسید	as soon as you had finished dressing.
من بدبختانه در ازدواج فریب خورده ام	I have the misfortune, to have been deceived in my married life,
کاترینا ایوانونا به سوی او دوید.	she ran to him.
خود چند نمونه تاریخی ذکر کرد که برای دور تا ناشناخته بودند.	could mention historical examples before unknown to her.
امکان دارد که واقعاً هم چیزی بر آن افزوده باشد.	perhaps he exaggerated.
چنانچه خوانندگان این آثار فقط به این توصیف گوش کنند.	if readers would only take this advice.
این کار از همه چی به دیوونگی نزدیک تره.	that's the foolishest thing you could do.
اگر زنده بمانم دائماً خطا خواهم کرد.	I should have been continually at fault.
یکی وظیفه داشت که در ر چند ثانیه یک قوطی خالی را در نقطه معینی قرار دهد	one of whom knew how to place an empty lard can on a certain spot every few seconds
حتی از دیدن دهات پرخاطره حذر کرد. یأس را از دل خود بیرون راند.	but instead she avoided passing through the villages of her nostalgia.
من این سخنان از آن جهت گفتم که اگر دیشت نتوانستم قصر بانو را پیدا کنم	I say this because, if we could not find my lady's palaces or castles to night
یک لحظه برق اخمی حقیقی در چشمانش درخشید.	he continued, with a twinkle of genial scorn in his eyes.
من با جست و خیز از وسط جنگل بزرگ به سمت محل حرکت کردم.	I loped through the thick forest toward them.
به سرعت رفتم و ظروفی را که خواسته بود آوردم.	I flew thither and back, bringing the desired vessels.
یک لحظه احساس ناراحتی کردم.	I felt a moment of unease.
که بتوانم چنین مسأله دقیقی را حل کنم.	to be able to solve so delicate a question
چنانکه دوستی پس از غیبتی ممتد و بسیار طولانی بازگردد.	like a friend come back from a long absence.
اولیور اجازه یافت که در تمام حیاط گردش کند.	he was at liberty to wander about the house.
از هرگونه سختی که آرامش خاطر او را بر هم زند و احساس امنیت رفاقتش را تباه سازد پرهیز خواهد کرد.	he would say no word that might disturb her peace or spoil her tranquil sense of comradeship.
من فکر کردم شخصی قصد مزاحمت دارد.	I imagined it was some importunate person who
این قدر خودشان را به زحمت بی اندازند و این قدر در حق من مهربانی بکنند.	should take so much trouble and show me so much kindness.
ایستاد و دیگران را از رفتن باز داشت.	he stopped the others.
دارای فرزند پسری شده بودند که سراسر عمرش را مجبور به پوشیدن شلوار گشاد خمره مانند شده بود	had a son who went through life wearing loose, baggy trousers and
برای رسیدن به یک دست سرویس چای خوری طرح بیدمجنونی دعا کرد.	to pray for a willow pattern tea set of her very own.
بعد از زور خستگی و دود زیادی که سایکس راه انداخته بود کودک اندکی کش و قوس رفت	then, quite overpowered by fatigue and the fumes of the tobacco, fell asleep.
بنابراین با لبخندی حاکی از رضایت خاطر به او جواب دادم.	so I answered him with a contented smile.
ولی از طرف دیگر صریحا به او میگوئید که خوشبختی شما در دور شدن اوست.	you persist in telling him to his face that it's fortunate he is going
پهلو به پهلو مثل سر پارچه گوشت به تیر شراع بستند و تا صبح به همان حال آویخته رهایشان کردند.	side by side, were seized up into the mizzen rigging, like three quarters of meat, and there they hung till morning.
ناگهان تیر شش لولی از جنگل بیرون جست	when just at that moment a pistol cracked in the bush
در حالی که باید یک نه مصمم و حسابی بگویی و خودت را راحت کنی.	instead of giving a good, decided no.
بکوشید تا از موهبتی که خدا به شما داده است استفاده کنید	make use of the liberal share of it that heaven has been pleased to bestow upon you
سپس با شرمندگی از اتاق بیرون رفت.	he stomped out looking embarrassed.
با علاقة گربه وارش به نظافت شخصی که از خصوصیات او بود ترتیبی داده بود	he had contrived, with that catlike love of personal cleanliness which was one of his characteristics
بلکه شکل و قیافه هر دو به تفصیل برای ایشان توصیف شده بود.	but the appearance of both had been minutely described.
رون حتی لباسش را نیز عوض نکرده بود.	still fully dressed.
آقای شاهزاده! شما در اینجا نزدیک بخاری بنشینید و برای ما چیزی نقل کنید.	sit down, prince, near the fire and talk to us.
تا به فرمان او تغییرات ضروری در آن انجام بگیرند.	dictate any changes that she would like to have made there.
زیرا در اعماق روانش بیم داشت که این نکته درست باشد	because at the bottom of his heart he was afraid that it was true
کنت عزیمت را به فردا انداخت و به خوابگاه خود رفت.	the count, having put off their departure till next morning, went to bed.
اجازه خواستم که خودم کفاشی را یاد بگیرم	I asked leave to teach myself
مردهای بسیاری نظرش را به خود جلب کردند.	she saw many young men who attracted her.
لذا از اتومبیل پیاده شدم و با برداشتن مقدار کافی مواد منفجره بر شترم سوار شدم تا پیشاپیش نیروها حرکت کنم.	I left the car, took a load of gun cotton, and mounted my camel, to push in advance of the force.
از روی میز گیلاس خود را به گیلاس کنت و اطفال و سپس به گیلاس یکدیگر زدند.	reached across the table to clink glasses with the count, with the children, and with one another.
زیرا من به ایشان فرمان خواهم داد که پس از شرفیابی به حضور بانو به نزد من باز گردند و گزارش مشهودات خود را بدهند.	by commanding them to return and give me an account of what happened to them in this respect.
حواستون به کاری که می کن ین با شه.	observe what you do.
استدلالاتم نیز بسیار خوب بودند.	I gave myself very good reasons
گویی حتی از شنیدن صدای خود نیز وحشت داشتند.	as if they were afraid to hear the sound of their own voices.
اول باید فکرامو بکنم یعنی ترتیبشو بدم.	I'll have to see first, you know.
بلافاصله متوجه شدند که سرسرای بزرگ را مثل هر سال تزئین نکردند.	they saw at once that the usual decorations were missing.
برای نابود کردن نیروی دریائی آنان که اکنون آماده تاختن بر ما هستند هر چه از دستش برآید انجام خواهد داد.	do his utmost to destroy their fleet, which is now preparing to invade us.
با این همه اذعان دارم که او از حیث مقام از من برتر بود	yet I allow he preceded me in right of his post.
سپس برگشت و دو آن دو آن در راهروی تاریک از نظر ناپدید شد.	she turned on her heel and ran, ran all the way up the corridor and out of sight.
از آن روز توتسکی با ین زمین دورافتاده کوچک توجه خاص مبذول داشت.	to have taken a great fancy to this part of the world
انگار اصلاً هیچ زمانی سپری نشده بود.	like no time at all had passed.
اما پدر و مادرش حتی سرشان را هم برنگرداندند.	but the other two didn't even look back.
اکنون همان علامات را در اینجا علیه او به کار گرفته بودند.	now here it was being used against him.
سپس تفنگ خود را از دوش برگرفت.	then removed his rifle from his shoulder.
در آن هنگام احساساتش به غلیان درآمده بود.	at the time they had been overwhelming.
از فشار گردن بند به خرخر افتاده بود.	choking itself in the collar.
من از آن وقت دیگر دوست ندارم این آواز را بشنوم	I never rightly liked to hear it since.
وقتی نگاه تونی با نگاه او تلاقی کرد وجودش آکنده از شور و شوق شد و گرمای محبت سراپای وجودشان را فرا گرفت.	their emotion was an irresistible riptide that caught them both up and swept them away in a glorious explosion, an eruption, and a contentment beyond words.
کلاهش که در نوار آن یک پر بزرگ قرارداشت به زیبایی روی سرش به طرف عقب کج شده بود.	his hat with the feather in the band cocked back well on his head.
من داخل یک اتاق کوچک بیدار شدم.	I woke up in a small room.
آنگاه از جای پرید و چنان به شدت عقب رفت که پشتش به دیوار خوردو در آنجا به دیوار چسبید	he cried, and rapidly jumping up, he drew back, so that he knocked his back against the wall and stood up against it, stiff and straight.
اون آقا گفتند که تو خیلی دستپاچه بودی و ازش پرسیدی که بیگ بی ترن شلوغ یا خلوت.	that you were 'very nervous' that you asked him whether there were many people over that thatday
ناگهان دردی در قلبش نفوذ کرد.	suddenly her heart was sick.
اطمینان نداشت لا ید را در خانه بیابد.	wishing, in her immediate doubt of finding him at home
نگذارد که امیدهای بر حق او نقش بر آب گردد	not suffer her reasonable hopes to be disappointed
پس از این که شریک زندگی خود را به ملایمت بوسید	having exchanged a long and affectionate embrace with his future partner
دور هم جمع شدند و هرکدام با صدای بلند بنا کرد به برشمردن هنرنمایی خودش در جنگ.	each recounting his own exploits in the battle at the top of his voice.
همه این بلیه بزرگ به وضع عجیبی جریان یافته است.	thewhole of this cataclysm is wonderfully conducted.
همه چیز برایم قابل تحمل بود.	I could have borne any thing.
که وقتی بحث سر میهمانی رقص شد بسیار جدی گفته بود که قرار است بلا را با خود ببرد.	that he'd meant it literally when he'd spoken of the prom, that he was staking a claim.
بعلاوه این فکر اصلاً متعلق به دیروز نبود.	besides it was not only yesterday's thought.
لذا بستر کودکان را به اتاق پذیرایی بردند.	so that the beds had to be carried into the drawing room.
فقط یک لقمه تا احساس گرسنگی شدید خود را تسکین دهم!	for but one mouthful to allay the pang of famine!
در انتهای خیابان از حرکت بازایستاد و مانند حیوانی ترسان و محتاط دوروبر نگاه کرد.	paused at the street end and looked about like a frightened and cautious animal.
اسنیپ که رویش به سقف دفتر دامبلدور بود شروع به صحبت کرد و صدایش اندکی پیچید.	who opened his mouth and spoke to the ceiling, his voice echoing slightly.
به طوری وحشت کرد که سخنش قطع شد.	who, in something of fear, stopped talking.
جز احساس تعجب از این که چه طور ممکن است مردی در دنیا پیدا بشود	than surprise at there being any men in the world
اما به هر حال بدان خاطر در آن مکان نگه داشته شده بود که وجناتش در خاطر زندانبان و زیردستانش حک شود.	in either case detained to be imprinted on the memory of the chief and his subordinates.
من ذهن شما رو مثل یک کتاب باز می خونم .	I can read you like a book.
به نظرم آمد که ظلمت چون گردبادی مرا در میان گرفته و من در آن شناورم.	eddying darkness seemed to swim round me
خلاصه تمام منظره شهر طوری بود که گفتی همان دیشب از آنجا دور شده	there was nearly everything as if he had left it but yesterday
به کلی اشتهایش را از دست داده بود.	she lost her appetite
این بود که رفتم و جوانی را که ذکرش گذشت آوردم و معرفی کردم	whereupon the young man already mentioned was accordingly introduced
بالاخره بدون آن که چیزی بگوید	finally without saying a word
بعد یک بار دیگر زنگ کلیسا را زدند	the bell rang once more
صدایم کمی بیش از حد کنجکاو بود.	I asked, my voice a little too curious.
وقتی دختر تا حدی به خود آمد گفت	she said, when she had somewhat recovered
به بهداری مدرسه فرستاده شد و در آنجا مورد معاینه قرار گرفت.	she was sent to the infirmary and examined.
انگار تمام اهالی روستا آمده بودند اظهار عشق مرا تماشا کنند	the whole countryside seems to have been out to see me do my wooing
حفاظی برای امید واهی لذت بردن از عزلت و آخرین پناهگاه برای سکوت بود.	where it guarded the forlorn hope of solitude, and a last refuge for silence.
حقیقة نیز فقط چند قدم به تنهایی دوید.	really he only ran a few steps alone.
دیدن مکان عجیبی که مردان خاندانش مدتی چنین مدید بر آن تسلط داشته	this first sight of that strange spot where the men of his blood had held sway so long
هیجان درون صدایش باعث شد لبخندی بزنم.	I smiled at the enthusiasm in his voice.
در همان لحظه نخست سوی افسر کشی شک دویده	infact, at the very first instant, hastened to the officer of the watch
پس این سنجاق را به عنوان گرو گذاشتم.	I leave behind me as a pledge this pin
ولی دکمه کنار خودش را فشار نداد که که پرستار را سریع بیاورد.	never pushed his own button which would have brought the nurse running.
ده یا یازده ساله بودم که خواندن را شروع کردم.	I must have been either ten or eleven when I started reading
شمدانی را محکم گرفت و به زمین کوبید.	seized a candelabra and dashed it to the ground.
او سعی نمود که خودداری کرده و قلبش را آرام کند	she was engaged in stilling the beatings of her heart
مسلم بود که در حرفه خود به بالاترین درجات خواهد رسید.	it was certain that he would rise to the greatest heights of his profession.
که شرافت دارد بر اینکه پدر چون شما دختر فیلسوف و منطقی دان است.	who is proud to own so good a logician as you for his daughter.
چون چند ساعت پس از صحنه مغناطیسی چشمانش به چرخ افتاد به یاد آورد که اسطرلاب او دیگر موجود نبود	as he happened to glance upon the reel, not many hours after the magnet scene
ولی از تأیید او واقعاً استقبال کردند	but as an approver,she was truly welcome.
تنها ران خود را در انحنای قلاب نهادمانند نشستن در دنباله لنگر یا دو شاخه درخت سیب بود	slid his solitary thigh into the curve of the hook it was like sitting in the fluke of an anchor, or the crotch of an apple tree
فقط یه چیزی تو شکمش پاره شده بود.	something just bust in her.
به سوی او خم شد و دید که به خواب رفته است.	he bent over her and saw that she was asleep.
به علاوه بر مقصودی که داریم آن راه مساعدت دارد.	the chances that may come to us on the way.
خواب که نمی شه این قدر دراز با شه	as long a dream as that
پس از آن نگاهی به پاهای اسب انداخت و تبسمی کرد.	he surveyed its legs with a smile.
یکی از درها از لولایش آویخته بود.	one of them was dangling off its hinges.
حالا باید ارتباط میان این آدم و آن درنده را ثابت کنیم.	now we have to prove the connection between the man and the beast.
کشیش و خلیفه و دلاک بسیار کوشیدند تا او را از رفتن باز دارند ولی سودی نبخشید.	though the curate, the canon, and the barber ran to prevent him.
کاترین برای در امان ماندن به طرف اتاق خود دوید و در را بست	she ran for safety to her own room, and, locking herself in
امّا پس از پیدا کردن گنج ما باید آن را پیدا کنیم	but once we hit the treasure
او فوراً خم شد و آن را برداشت	he had to stoop quickly to catch it.
آنچه را که دیده بودم برایشان تعریف کنم.	tell them what I had seen.
هردو دستش رو به کف دست خم شده بود.	her two thumbs were bent into the palms of her hands
این حفره را دیدم و تصمیم گرفتم که داخل آن شوم تا قدری از رنج راه بیاسایم.	travelling downwards into that dark region without any certainty or knowledge of where I was going, so I resolved to enter it and rest myself for a while.
به یکدیگر فشار داد و پل آزاد شد و قشون توانستن به جلو حرکت کند.	had cleared off the bridge and the troops were now moving forward.
مدت مدیدی بود از او تقاضای عکسی کرده بودم.	I asked her for it long ago.
بیچاره پیرمرد فوت شده آری حق است	the poor old man did die
حساسیت به اصوات خوش بیشتر باشد تا به احساسات من.	a more acute sensibility to fine sounds than to my feelings.
ولی نی در دست او همچون کمان خم شد	but it bent in an arc from his hand
زیرا با وجود آن که پسرانی زیبا بودند	for though both were fine lads in their way
فکر کرد که دور بزند و برگردد.	thinking she would turn around and go back.
به او گفتم به رختخواب برگردد.	I told her to go back to bed.
این چهره سیمایی نیست که او با آن آشنا بود	this is not the face she knew
اما حالا فقط یک پیرزن در لباسی سیاه رنگ بود.	after all she was only a little old woman in a black dress.
مگی را روی سکویی مرمری نشاند تا صورتش در برابر صورت او باشد.	picked her up and sat her on a flat topped marble pedestal, where her face and his were level.
منهم مایل بودم که تو به مین شکل و قیافه باشی!	that's how I want you to look.
زیرا اگرچه قسمت اول داستان ارباب او را خوانده بود	for though he had read the first part of his master's history
بعد هر دو را قاطی انجام داد.	then did both together.
بعد به او گفتم لازم نیست دنبال کار را بگیرد.	at the same time I told him not to let the affair go on any further.
عادت داشت به همه دوست و آشناهای قدیمی برسد.	a strong habit of regard for every old acquaintance.
باید در فکر باشم که چکار باید بکنم.	I must think what to do.
من جاهایی دارم که باید بهشون سر بزنم.	I got places to go.
بالاخره سر خود را بلند کرد	but at length she raised her head
در آنجا فوراً افسری از آشنایان خود را دید و با او راجع به یک زن بازیگر و حامی او به گفتگو پرداخت.	where he promptly came across and aide de camp of his acquaintance and dropped into conversation with him about an actress and her protector.
تمام صفحه را به یکباره کندم و دور انداختم.	I cut the page right out of the book.
من باید زودتر برگردم تا سوءظنی نسبت به خودم ایجاد ننمایم.	I have to reach home without suspicion of having been on such an errand as this.
از پلکان بعدی بالا رفت. به صورت سه پله یکی	he ran up the next flight of steps three at a time
موفق شد بر ترس خود پیروز شود.	she managed to overcome her fear
گذشته از این در این خصوص مطالعه خواهم کرد	I mean to go into all that.
مستخدم مهمان خانه را بفرست تا تمیز کند.	send the waiter to clear away
هنوز احتیاج به استراحت داشت.	he was still in want of quiet.
هر کدام از شما دوستی دارد که در این لحظات نابودی همدرد اوست.	each of you has a comrade to sympathise with him in his decay.
قلبش با چنان شدتی به تپیدن افتاد	his heart beat so violently
برای روزهای گذشته تاسف نخوردی.	sob for the old days.
یکی دو بار سر برداشته و به ساعت نگاه کردم.	I lay on my side watching it.
یعنی هیچ آدم عاقلی این چرندوپرندیاتو رو سنگ آسیاب می کنه!	want to tell ME't any cretur 't's in his right mind 's a goin' to scrabble all them crazy things onto a grindstone, s'I?
برای پنهان ساختن اشک خود به سرعت برگشت	she turned quickly to hide them and left the room.
حتی زمانی که او را از تیر پشت سرش باز کردند و به داخل تابوت گذاشتند باز هم لبخند به لب داشت.	who was still smiling even when they untied him from the post
مو دی بار دیگر نعره زده و همه را از جا پراند.	he roared, and the whole class jumped again.
با این حال احساس کردم نباید بگذارم کس دیگری به جز خودم از این حق استفاده کند.	yet I felt that I ought not to let it be used by some one else instead of me.
اما من مزاحم شدم و اکنون همچنان منتظر است که من بروم.	but I prevented him, and he is just waiting for me to go away.
شاید برای مادر بیش از یک پسر بود.	maybe he was a bit of a mothers boy.
دست او را در بازوی خویش نگه داشت.	kept her hand drawn through his arm.
قاطر که از این ضربت سهمگین رم کرده بود به میان صحرا تاخت	the mule, taking fright at the terrible blow, made off across the plain
از خبر عزیمت ارباب و دایی خود به شیون و زاری پرداختند	they raised a lamentation over the departure of their master and uncle
ولی هرمیون بهش گفته که قرا ره با یه نفر دی گه به جشن بره.	but she told him she was already going with someone.
ممکن بود دست از مبارزه بردارم و در ملاء عام همه را بکشم.	I might lose this battle and end up killing everyone in sight.
آمد و اجازه خواست باز کنارشان باشد و به رایشان کتاب بخواند.	entreated for the permission of attending and reading to them again.
ولی جوانک آنقدر بر اولیور دقیق شد	but the boy remained in the same attitude of close observation so long
منو فرستاده که درشکه شما رو برونم .	she sont me to drive you.
دست برد به کتابی که در سر میز حاضر بود.	, and took up a book marked by a mother of pearl knife inlaid with gold
وی لفور خود را قوتی داده و گفت	said the procureur, making an evident effort to appear calM
که او اندکی عصبی و دستپاچه شد.	he felt a little nervous and embarrassed.
ترکیب صورت نیز ظریف و مقبول بود.	the figure almost too graceful.
به علت آمدنش به آن جا فکر کرد.	thinking about what he had just heard
جاستین دستش را در بازوی دین انداخت.	tucking her free arm in his.
اکنون تصمیم گرفته است که آن اتاق را اجاره دهد.	she had made up her mind to rent it.
زیرا گناهان بی شمار او است که وی را به پس دادن این کفاره مجبور کرده است.	as it was binding upon him in order that he might work out a penance which for his many sins had been imposed upon him.
فرمود که سرگذشت خود را بگویم	commanded me to give his majesty an account of myself
در میان مهمانان افتاده باشد	had broken out among the guests.
یک ساعت و نیم منتظر ماندیم.	waited an hour and a half.
من هیچ ارتباطی با این ماجرا نداشتم.	I had nothing to do with that.
حقیقتا شروع به شناختن سرشت زنان کرده است.	one who was truly beginning to know women.
چند بار به روش خودم نوکش را چیدم.	I took him down several times, you know, in my way.
به من اشاره کرد و فهماند که جای ادامة صحبت نیست و باید سکوت کرد.	made such impressive motions to me not to ask any more questions
بعد فکر کردم یک مرد سالم مثل من جاش تو جبهه جن گه.	I thought the place for an able bodied man was in the fighting line.
چون شیطان همه را با خود برده است.	for the devil himself has carried all away.
حالا با کمال میل یکی دو ساعت در اینجا خواهم ماند.	I shall stay an hour or two willingly.
ناگهان متوجه شد پیر شده است	realized with a shock that he was an old man
قبل از اون سه تا لیوان ودکا و شامپاین خورده بودم	I'd had three vodkas
ولی وقتی برای درک آن وجود نداشت.	but there was no time to find out.
بلکه به علت آن که تأثیر آنا وی را سرشار از شادی و غرور کرده بود.	but because the impression she had made on him gave him happiness and pride.
اما میدانم که چه اتفاقی خواهد افتاد.	but I know what would happen.
که او اطلاعی راجع به او دارد.	that he knew anything against him
تقریبا روی اسب دراز کشیده بود.	until he almost lay along the animal's spine
فنرهای صندلی همانند حیواناتی در قفس آه و ناله را انداخته بودند.	whose springs wailed like an animal in heat.
مشروط بر اینکه کاغذ و ادوات و افزار کار در اختیارش بگذارند و آن غلام بادکنک بدست هم در کنارش نباشد.	if he be but provided with paper and implements, and without his flapper at his side.
خوب دی گه باید جلوی احساسات شهوانی خودمو بگیرم.	well, I mustn't let my carnal lusts obtrude.
چون نگاهی بر او انداختم شناختمش.	I recognized him at glance.
سرش را بالا گرفت و گوشش را تیزکرد.	as she cocked her head and listened.
مثل این بود که آدم در خفا یک جرعه بنوشد.	as a surreptitious glass of brandy!
پسر عمو! من فقط یک خواهش از شما دارم.	I ask just one thing of you, cousin, she went on
او که این راه را جلو پایم نگذاشت.	he never encouraged me, you know.
اربابم تازه از سفر برگشته و خسته است	the instant they have returned from a long journey.
هر دو برادر را در خود خیره یافتم.	I found both the brothers intent upon me.
مادرم دربارة همة آنچه گذشته بود از من سوا لات مبسوطی کرد.	my mother asked me all about the day I had had, and what they had said and done.
شمشیر خود را به کمر خواهد بست و جای خود را در ارتش رفقا و برادرانش اشغال خواهد کرد.	who will gird on his sword and take his place in the army of his comrades and brothers.
بیدار خواب عظیم در این رؤیای منهدم شده.	which had crumbled, essaying once more toadvance.
تا این لحظه من بیم داشتم از تو در این خصوص سئوال کنم.	till this moment I've been afraid to ask you, you, even you.
این بود که سر صحبت را با او باز کرد.	attention disengaged, he necessarily began on the subject with her.
یک روز تمام آنقدر وی را داخل یک دیگ بزرگ با آتش ملایم جوشاندند	boiling him for a whole day over a slow fire
من جدا شدن روحش رو حس کردم.	I felt his soul depart.
من که یه حرومزاده ی بی احساس به دنیا نیومدم.	I wasn't born a compassionless shrew.
باز هم انتظار بروز هیجان و اضطراب در میان مردم کمتر بود.	there would have been even less reason to expect a disturbance among the people
اما از این پس هرگز به عصایی تکیه نخواهم زد.	but never will I lean on a staff again.
بلکه مثل یک شبح در خانه گرفتار کهنگی و پوسیدگی گردید	but overnight the house had plunged into a crisis of senility.
گویی همه از همان رشته بالا رفته بودند	as though they had all climbed it to get outside.
زن جوان را آرام به پشت گردانیدم	I turned her gently over
ناگهان با حالتی جدی به جلو خیره ماند	suddenly they started forward in a rigid, fixed stare
اون کلاه و خو نه آقای کرنستن جا گذاشته بودم.	I forgot it and left it there.
ولی طعم گرم و کلر زده آب حالش را به هم زد.	but the warm, chlorinated taste of the water made his stomach turn.
گوئی آنان آدمیانی کوتاه قامتاند و من غولی بیابانی.	as if they had been pigmies and I a giant.
یکی دو دقیقه حواستان را به من بدهید.	give me all your attention for a minute or two.
من این کار رو خیلی عقب انداخته بدوم.	I'd already put this off too long.
از این که در اتاقی پر از مرد غش کنم بیزارم.	I hate fainting in front of a roomful of men.
زیر فرمان شخص اوست و جز به میل او نباید از آن جلوگیری کرد	nor should it be stayed but according to his good pleasure.
اگر سر جایش مانده بود که حسابش را رسیده بودم.	if he'd a stayed where he was he'd a been a tolerable sick rat.
با دروغ تشویقش کردم با من ازدواج کنه.	I lied to him and I married him.
یقین دارم که واقعاً صدای گریه زنی بود.	I am sure that it was really the sob of a woman.
هرچه زودتر به یارانش پیوست.	slipped yet more smartly back again to his companions.
کاتبرینا ایوانونا مجدداً بازگشت و بالای سرش ایستاد.	she returned and stood by his pillow.
موقعی به خود آمدم که ازدواج انجام گرفته بود.	a marriage was achieved almost before I knew where I was.
برای هیچ کار جز برای دوست داشتن وقت نداشتند.	there had been no time for anything except love.
برخی از سایرین نیز شروع به ترک جلسه کرده بودند.	as some of the others were beginning to depart
هرگز یک لحظه هم نبود که با هم احساس خوشبختی بکنیم.	never had one moment of happiness together.
همه خواستار امتیازات خشمی شاعرانه هستند که توجیهی برای هر کاری است در ادبیات و در تئاتر	claim the privileges of a sublime rage which is an apology for everything in literature and the drama .
دیروز او را به اتاق پایین آوردم	I brought him down one evening, the day before yesterday
چیزی نمانده بود که سلامت خود را هم بر سر این کار بگذارند.	they had almost ruined their health.
معیبم هنوز در وجودم ریشه ندوانیده بود.	my faults were not confirmed in me.
آهنگ صدای او چون غرش و هیاهوی میدان کارزار پر معنی و با ابهت و خاموشی ناپذیر بود	the sound of his words was as weighty and uninterrupted as the booming on the battlefield
من از نبودنش آسوده خاطر بودم.	his absence was a relief to me.
خداحافظی کردم و بیرون آمدم.	I took leave.
شاید هم درباره گانیا مرتکب اشتباه بزرگی شده بود	perhaps, also, she made the mistake of depending too much upon her brother
ولی راستش من منتظر آقای خودم هستم.	but, the truth is, that I am waiting for my lord and master.
چیزی نمانده بود از دست بروم و دیگر یارای دست و پا زدن نداشتم.	when I was almost gone, and able to struggle no longer.
شک دارم خوشش بیاید کسی درباره دختر مزه پرانی کند.	I doubt he'd appreciate wisecracks at her expense.
پیشنهاد من آن است که قضیه را در همین مرحله مختومه اعلام کنیم.	I say, stop there.
نیمی از سر این جوان را تراشیده بودند.	that had been half shaved, was again covered by short hair.
سر دیگر آن را یکی از مستحفظین برگرد مچ خویش تابیده بود.	the end of which one of the patriots kept girded round his wrist.
پنداشتی که حال دیگر برای ورود به این اتاق کسب اجازه لازم نیست.	as if there were now no further need for permission to enter that room.
هیچ مرد حق ورود به اونجا ندا ره جز طبیب اموات.	into which no man may enter save the doctor of the dead.
خودم را با پا بند بر پا و دست بند بر دست دیدم	I found myself with fetters on my feet and manacles on my hands.
آنگاه ناگهان بر بالش افتاد	then suddenly fell back on her pillow
چندین بار به بانگی هر چه بلندتر فریاد زدم.	I called out several times, as loud as I could raise my voice.
هنگام تا کردن آن در پشتش جمله بعدالتحریری را دید که قبلاً متوجه آن نشده بود.	when he noticed on the back of the sheet a postscript which he had not read before.
من این اسب را از فداکار گرفتم	I grabbed a horse
این صدایی نیست که او به شنیدنش خو کرده بود.	this is not a voice she ever heard.
دستش را به دیوار سنگی تکیه داد.	clutching at the stone wall
ولی اینکار را از این جهت نبود که به آواز خواندن میل نداشتند	with great effort, evidently not because they wished to sing
برای اینکه تسلیم شدن خود را نشان دهد	he showed his submission
من همیشه آرزو داشتم که تو هم با ما باشی	I always wanted you to jine
تا گل شمعدانی زیبایی را که در کنار پنجرة ما بود از نزدیک تماشا کند.	to look at a famous geranium we had, in the parlour window.
چون دخترش از همان ابتدا توضیح داده بود که کلاید عضوی از خانواده صاحب کارخونه است	for, from the very first she had made it plain that he was a member of the family who owned the factory.
با صدای وحشتناکی محکم روی سر صاحبش فرود آمد.	dropped, with a sickening crack, onto its owner's head.
وی را به همسرش بدگمان کند مسخره این محفل است.	he had to admit almost been jealous on his wife's account, was the butt of this set.
چون برای دومین بار فقط دومین بار در عمرم از ترس بیهوش شدم.	for the second time in my life only the second time I became insensible from terror.
من باید صراحتاً افکارم را به او بگویم .	I must express my view of it and my decision.
چیزی نمانده است که جیغ بکشم.	I almost scream.
راه از ساحل تا مدخل غار سر بالایی ملایمی داشت.	there was little amiss beyond the wreck of the main sail.
فقط کمی قدش بلند است و این تنها امتیازی بود که حاضر بود به او بدهد.	that was the only concession she would make.
او وی را تا اتاقی بزرگ که با سلول او مقداری فاصله داشت دنبال کرد.	he followed into a large dark room, at a distance.
بدنش مثل قورباغه بالا و پایین جهید	her whole body seemed to swell up like a bullfrog's.
احساس رضایت کردم و خوابم برد.	I felt satisfied, and fell asleep.
اما یک شکست شجاعت آمیز در خور رأفت ملل است.	but a heroic defeat merits their tender compassion.
نزدیک بود بالش کنتس را فراموش کنم.	but the cushion for the countess
سر جیمز کلاهش را از سر برداشت	he said, raising his hat
گفت من دلم میخواد هم خو نه داشته باشم و هم یه همچی ماشینی	I like to have the house an' one a them, she said.
خود ما هم ممکن بود چنین کنیم.	as we ourselves might have done
در تاریکی شب طنین روشنی داشت.	falling clear upon the dark silence.
یک چیزی بود از آنجا تا اینجا.	it there was a what there
حتی خواهش کنم فردا باز هم بیاید.	or even to come again to morrow.
آرام گفت و به داخل خانه بازگشت.	he said softly and went back indoors.
که شاید روی هم رفته نیت خوبی داشت	who perhaps meant well enough upon the whole
حقایق مسلم و باورکردنی و اثبات پذیر.	to solid, believable, verifiable fact
دیده است که داشتن عمر دراز یگانه آرزوی بشرست و همه در تمنای آنند.	he observed long life to be the universal desire and wish of mankind.
در دریایی از سرما غرق شده بودم	I was lost to a sea of cold
درست بم وقع رویش را برگرداند	she turned just in time
به شما زحمت دادم از برای این بود	I beg pardon for my intrusion
چشمانش را به چهرهء سوال کننده دوخت.	he sat looking fixedly at the questioner.
بدون این که مهمانش را آدم مزاحمی بداند.	without thinking him at all a tiresome wretch.
خانهء او را محاصره کرده بود	surrounding his house
وحشت از نزدیک بودن زمان مرگ در دنیای اموات او را چنان به ستوه آورده بود	so terrifying the neatness of that other death which exists within death
هوا مرطوب و گرفته و اندوهگین بود.	it was damp, somber, and sad.
روی هم رفته دنیا آن طور هم توخالی نیست.	it was not such a hollow world at all.
آن پرچم لعنتی را از بالای کشتی پایین انداختم.	handed down their cursed black flag
به همان گونه که رد واقع مثلا دهان خود شما زیر چانه شما واقع باشد.	much in the same way, indeed, as though your own mouth were entirely under your chin.
که چگونه به گرمی پذیرایی شده است	how warmly they had received her
تا زمان رسیدن به مقصد را طول بدهدو.	in order to postpone their arrival.
تو همیشه برای خودت صاحب جایی بودی	you were always somewhere
آن وقت شهود خود را به نزد من بفرستد	he will bring his witnesses
او را از آن خود ساخته بود.	he had made her for himself.
زیرا در مدتی قریب بیست سال فقط به او یک محاکمه مراجعه شد	because he had only one brief and a motion of course, in twenty years
از جمله به یک خانم جا افتاده که آمده بود صورت حسابش را بپردازد و بعد هم قرار بود که بیماری را به تمام اعضای باشگاه بازیگران بریج که او هم عضو آن بود سرایت دهد.	including a matronly woman who just came in to pay her bill before going on to pass the disease to her entire bridge club.
که او قلب دختری را که دوستش دارم از من برباید.	that he would take from me the heart of the girl I love.
پاها را زیر خود جمع کرد و در میان بستر گسترده روی زمین نشست	she sat down with her foot under her on the bed that had been made up on the floor
یه طرف جاده رو برانداز کردم	I was off to one side
لحظه بعد آن را شکافته و با خود برده و پارو بزن را هنگام کشیدن نشیمن از زیر او به انتهای قایق پرتاب کرده بود.	in an instant tore it out and carried it away, dropping the oarsman in the boat's bottom as the seat slid from under him.
به اتفاق تابوت خالی را دفن کردند.	together they buried the empty coffin.
گویی سری در خود نهفته بود.	as though he were keeping something to himself.
که ناگزیر دو هفته بستری شدم.	that I was forced to keep my bed a fortnight.
اما تمام سرسرا پر از مردم شده بود.	but the passage was full of people
اهانتی را که بر او وارد شده بود نبخشید.	he would not forgive her his disgrace.
به چشم خود دیدم که این هر دو عمل را در مورد سگی آزمود	I saw him try both experiments upon a dog
به او التماس کنند که خر بشود	implore him to be a merciful ass
نمی دونم که می تونم این کار و انجام بدم یا نه	I didn't know I should do that.
خیلی ترسیدم که بروم و باز شما را نبینم.	I was so afraid I should have to go away without seeing you again!
که بعد از شنیدن این کلام این بار تمام سکوت کردند	which silenced the tumult.
او یقهٔ پالتویش را بالا کشید	he pulled up his coat collar
خود را کاملاً از چشم اهل خانه پنهان نگه داشتم.	I was shrined in double retirement.
من حتی یقین دارم که به فکر تحمل سختی و مصیبت خواهید افتاد.	I am convinced that you will decide, 'to take your suffering.
من توی اتاق پذیرایی یک کلمه هم از این قضیه نگفتم.	I did not mention a syllable of it in the other room.
با تمام قوای خود پای به گریز نهادند.	ran for it with all their might.
در حالی که چوبدستیش را بالا گرفته بود تا جلویش را ببیند با عجله به راهش ادامه داد.	hurried on, holding his wand high over his head, trying to see as far ahead as possible.
این دفعه دی گه نمیذارم مخمو به خوره.	I'm not going to be chewed out again.
اما او نیز مانند هری موهای مشکی پرکلاغی داشت.	but he, too, had jet black hair.
پس از آنکه دومی دشمن را دفع کرد	when he has driven out the invader
ولی چند لحظه بعد در حالی که چندین جلد کتاب در بغل داشت وارد اتاق شد	but presently reappeared, bearing half a dozen volumes in his hands
هر چند طیبت آن را درست تمیز نخواهد داد و ظن قریب به یقین خواهد برد که آن شوخی نسبت به هیچ کس نبوده است مگر خود او.	though the wit thereof he but dimly discerns, and more than suspects that the joke is at nobody's expense but his own.
من دست به سوی او دراز کردم	I held out my hand
به علاوه اکنون وضع او چندان نشا طبخش نیست.	so her position now is not a rosy one.
خودش دو کمک منشی در اختیار داشت.	he had two undersecretaries.
سپس چشمانش را نیمه باز کرد.	with his eyes almost shut
بار دیگر از صمیم قلب نسبت به آنان ابراز علاقه نمود و ضمن دوست داشتن آنان آزارشان داد	he loved them beyond measure, but he harassed and tormented them in love.
دلم خیلی برای مادرم تنگ شده بود.	I missed my mother terribly.
برای او توضیح دادم که پدر و مادر ندارم.	I explained to her that I had no parents.
تنها به همت و یاری مردان خود از لگدکوب شدن نجات یافتند.	were only saved by the men belonging to them from being trampled under foot.
ولی بعد فهمیدم که اشتباه کردم	but in a minute I see I was mistaken
دو قلپ بزرگ تند و پشت سر هم بلعد.	took two quick swallows,recorked it
به اشتغالات سابق دیگر علاقه نداشت	his former pursuits no longer interested him
می دونم عمدی نکردی اما در هر حال کار توئه.	I know you didn't mean to but you DID do it.
چنان که گفتی سخت تردید دارد که این ورزش پشیزی ارزش داشته باشد.	as though he had grave doubts whether this game were worth the candle.
همیشه شکستن سکوت و شروع کردن سخن با اشخاص تو دارد مثل او مشکل است	it is at all times difficult to break the ice of reserve glassing over such natures as his
فکر کردم شاید شما بتوانید لطفی در حق من بکنید و مرا در این خصوص راهنمایی کنید	I wondered whether you'd be kind enough to advise me.
در آن میان حتی یک نفر نبود که بتواند حدس بزند این زنی که به ظاهر مظهر پاکی و صفا و صمیمیت است در باطن شیطان سیاه دلی است که بویی از طهارت و شرافت نبرده.	they never knew how she laughed at them behind their backs, jeered at them, mimicked them.
من در خشکی به زورق دست یافتم.	I got dry to the boat.
چنان روی فرمان فشار آورده بود	gripped the wheel so tightly
سپس یک نفر را با خود برداشت و در بهترین قایق وال گیری سوار شد	took one man with him, and setting the sail of his best whaleboat
در این میان سربازی به جانب او آمد و رکاب او را گرفت و آن را رها نکرد.	when a soldier came up and took hold of the commander's stirrup, almost leaning against him.
به من فقط مبلغی برای بازگشت به روسیه وام داد	gave me just enough money for my journey
این کشف اخیر تمام اهل منزل را به تعجب سختی دچار کرد	a discovery which made a considerable impression on everybody
اصلا قصد نداشتم راجع به تو چیزی به گم.	I didn't mean to say anything.
در همین موقع با پسر بزرگش مواجه شد که در طول چند روز گذشته به ندرت در کارگاه کیمیاگری پیدا شده بود.	he ended up in front of his older son, who during the past few days had barely put in an appearance in the laboratory.
حالا اگر کسی چیزی بگوید که نیست نقض غرض کرده	now, if any one said the thing which was not, these ends were defeated
ای کاش برای شکار جای دیگری رفته بودیم.	I wished we'd gone hunting somewhere else.
در این میان ردای نویل در اثر واژگون شدن پاتیل آغشته به معجون شد	had been drenched in the potion when the cauldron collapsed
ولی ناگهان چشمش به عبارتی افتاد که نظر او را به سختی جلب کرد.	but, lighting on a passage which attracted his attention, he soon became intent upon the volume
اسم و محل کتاب را به خاطر سپرد	she memorized what he had said
ولی لبخندش چیز کی ساختگی داشت.	, but her smile seemed studied.
دیروز هیچ انتظار شنیدن این خبر را نداشتم و به عمق قضیه فکر نکردم.	I was yesterday taken by surprise, and saw it superficially.
شما حق حیات به گردن من داشتید	I owed my life to you
به نظر من شاعر بودن بدون شعرش ناقص است.	I think they are wanted to complete the poet.
که نزدیک است رشته غیر قابل تحملی را پاره کند و با سر در منجلاب کثیف هرزگی غوطه ور شود.	who is just about to burst an insufferable bond and plunge headlong into wild license.
که رویش پوشیده از کاغذ و نقشه بود چند صندلی	littered with plans and papers, a few chairs
یا لا حالا برین گم شین و اون نصفه مردتونو هم همراهتون ببر ین.	when they come they'll bring their masks, and fetch a MAN along.
می دونم چند روز گذشته خیلی برات سخت بوده	I know the last couple days must've been hard for you.
شاید شما در این خصوص چیزی شنیده باشید.	maybe you've heard?
هیچ کدام از رعایای مزبور را بی رضایت خود آنان بردست نگیرد.	nor take any of our subjects into his hands without their own consent.
آسیاب که تکمیل شد و به همة حیوانات شخصاً تبریک گفت	he personally congratulated the animals on their achievement
همین که ترا دیدم علل این کار را خواهم گفت	I will tell you everything when I see you.
خطی چرب و کثیف نیز بر پیشانی سپیدش افتاده بود.	a greasy smudge crossed his white brow.
تمام معلومات او محدود بیک عنکبوت و یک درخت کوچک بود که در زیر پنجرهٔ زندانش رشد کرده بود.	his only acquaintances were spiders and a tree that grew outside his grating
امروز باور داشتن به اینکه گذشته تغییرناپذیر است.	today, to believe that the past is unalterable.
سپس کیف بغلی خود را بیرون آوردم تا به او پول بدهم.	I drew my note book from my pocket.
سکوت مرگ آسایی حک مفرما بود.	a dead silence.
وقتی کمپوت سیب را از گنجه آوردم	when I brought out the baked apples from the closet
اگر برای پیدا کردن او به اینجا آمدند	if they come here after him
تا وقتی که آب نیلگون زیر کشتی نبیند آرام نخواهد یافت.	he never rests till blue water is under him again.
تا بتواند رویش را برگرداند	in excuse for leaning down her face
یک هدف مسلماً بزرگ و عالی و در خور ستایش است	an end undoubtedly noble, lofty, and deserving of high praise
او را از مسیرش منحرف کرده بودم	I'd deflected him from his path
ماشین را روشن کردم و به طرف پایین تپه به راه افتادم.	I shoved the clutch in and started slowly down the hill.
به خوبی میدانست که چگونه باید از من نگاه داری کند	understood to do it so well
هر کسی از راهی به همین بلیه گرفتار است	that everybody else is one way or other served in much the same way
اگرچه از زیروبم کار اطلاع داشت	though he knew the business inside out
از میان پناهگاه خود بیرون آمده	he slipped quietly down
از روزی و حالتی که روز مرگ امروز را بخواهی.	from ever wishing for that death which to day you so much dread!
من خودم را خواهم کشت زیرا از همه چیز متنفرم.	I shall kill myself, because I loathe everything!
از مردایی که فکر همه جا رو میکنن خوشم میاد	I like a man with hidden depths.
من شهادتمو دادم و دی گه کاری اینجا ندارم.	I gave my witness. I have no more business here.
که احتمالا مایه دندان درد او شد.	which probably gave him the toothache.
یاد گرفته و دیگر فراموش نکرده بود	but once he learned it he never forgot it
دعا و مراسم نزع را به جا آورده بود.	she had already received the sacrament.
قبل از این که صبح به شه بازم باید غذا بخورم .	I will need feeding in the night.
از ای نرو یکباره غرق شده بود.	sunk to rights.
نوشتم بیاید و با ما شام بخورد.	I'm telling him to come to dinner.
مجبور میشی با گریه هم که شده او نارو بدی.	you'll cry and let them go.
میان آن نقطه و کشتی قایقی در رفت و آمد بود.	between that point and the ship one of the gigs kept coming and going
توجه جمعیت را به خود جلب کند	to recapture his audience
دی گه نمی تونم روی پای خودم بایستم .	I bury forever any hope of ever standing alone.
تمام افراد قشون نیز آرزوی این حمله را داشتند.	the whole army desired to do so.
همه در قسمت جلو کشتی جمع شده بودند و منتظر بودند که جزیره در افق پیدا شود.	forward looking out for the island.
با انگشت به یک صندلی که در سمت دیگر میز قرار داشت اشاره کرد و به بازجویی مقدماتی پرداخت.	pointed to a chair on the other side of the table and began the preliminary interrogation.
با نهایت ملایمت به راه خود ادامه دادند.	they walked on very lovingly together.
فرانک وحشیانه و امیدوارانه جواب داد.	he countered wildly, hopefully.
باور کردنی نبود که کسی با وی به عشق بازی پرداخته باشد.	it seemed incredible that anyone should make love to her.
منظورم تنها آشنا شدن با شما بود	my principal object was to make your acquaintance.
به اطاقی دیگر رفتم که تارهای عنکبوت از سراسر سقف و دیوارهای آن آویخته بود	I went into another room, where the walls and ceiling were all hung round with cobwebs
که شاید خود من هرگز آن را بکار نبرم.	that I shall perhaps never use!
ولی در تیراندازی عادی چندان ماهر نبود.	but he had not yet hit the bulls's eye twenty times out of twenty two.
ولی سورچی گفت که سرفه عارضش شده است.	but the carrier said he was only troubled with a cough.
تو اگه شرافتمند باشی باید خودتو توی دریاچه غرق کنی.	if you had any decency you d jump in a lake.
شاید من دیر انجامش داده باشم.	maybe I was too late.
این مجله را از جیب خود درآورده و آن را در مقابل دیدگان الیزابت قرار داده و یک ستون آن را که با مداد مشخص شده بود به وی نشان داد.	had pulled this paper from his pocket, and presented it to her, indicating a few columns marked in pencil.
از سوء قصد مادام دولیفور و نهایتا	revealed the crime, and,finally
از پشت کسانیکه در مقابل وی ایستاده بودند	from between the backs of those in front
همیانی کوچک و نیکو به طول یک گز و نیم ساختم و نام ملکه را با زر بر آن نقش کردم	I likewise made a neat little purse, about five feet long, with her majesty's name deciphered in gold letters
تمامی جاذبه آزادی را که قبلا از آن بی خبر بود و آزادی در عشق را آزموده و خرسند بود.	he had felt all the delight of freedom in general of which he had known nothing before, and of freedom in his love,
اما به علت شلوغی از آنها گذشت	he passed several as being too crowded
تا متوجه بشوید چه قدر عقلم سر جایش آمده.	that you may see how rational I am grown.
مثل شاخکی باریک و مرتعش که در انتظار فرا رسیدن یک لحظه صلح و آرامش بود	like a slender, vibrating feeler of that progress waiting outside for a moment of peace
تا فردا شب توی چنگ من خواهد بود!	the fellow shall be in my power before another day is past!
من چطور از مرگ نجاتش دادم	how I saved his life
این شد پاروب زدن. این جور باید پاروب زد!	that's the stroke to sweep the stakes!
بعدها مشعل قهرمانی را در کف ملت خود قرار دهند	or later on to place an heroic torch in the hands of their own people
متآسفانه باید امشب این جا بخواب ین چون این جا از همه جا امن تره.	for your own safety, you will have to spend the night here.
حال وحشتی که داشتند این بود مبادا در این چند شب نقب خود به خود در زیر پای قراول خراب شده و امر واضح و کارها بکلی ضایع گردد	their greatest dread now was lest the stone through which the sentry was doomed to fall should give way before its right time
اگر موافقت کنم که سالی دو سه هزار لیره باج بپردازم و تا وقتی زنده هستند تعهد خودم را انجام دهم هرگز مزاحم من نخواهد شد.	if I cared to settle two or three thousand on him for life he would never worry me again.
