چهار ساعت با این وضع به سر بردم	I was four hours under these circumstances
نیم تنه و شلوار شطرنجی پوشیده بود.	in plaid frock and trousers.
حتی امکان این تصمیم باشکوه هم منتفی بود که بلافاصله برای همیشه جواب رد بدهد	even the more simple sublimity of resolving to refuse him at once and for ever
من اجازه نخواهم داد که ماجرا به این شکل پایان یابد.	I won't let it end like this.
سعی کرد که قصد بانوی سالخورده را درک کند.	trying to grasp the old lady's meaning
روزنامه را از کنار میز برداشت	he picked up the paper.
کمی تحت تاثیر قرار گرفته بود.	feeling a little overcome.
چند ذره از آن غبار بر روی ما نشست و سبب شد که ما باهم چندین بار عطسه زنیم.	some part whereof flying up to our faces set us both a sneezing for several times together.
شاید این دختر نازنین برای همیشه از دست برود.	she might be required to sink herself forever.
با دشنامی تهدیدآمیز فرمانم داد	he ordered me in with an oath
زیرا زمامداران کلیسا بر خطایند.	for he knew that the authorities were wrong.
راه حل مهمی که باید بر طبق آن عمل شود	which is such that I have made it my law of action.
کلاید به راستی اسیر شده بود.	so truly was he captivated.
باید در همچو لاکی بخزم و خودم را زنده نگه دارم.	that is the sort of shell I must creep into and try to keep my soul alive in.
صدایش از استرس و ترس خشک و گرفته بود.او پرسید	she asked, her voice rough with stress and fear.
آهسته به قوت زانو برخاستم	I raised myself gently upon my knees
با این حال تمام شواهد و قرائن موجود از جرم او حکایت کنند.	yet every circumstancesurrounding him at the time seem to indicate that he did do it.
بلافاصله این افکار را در ذهنم گرداندم و شعر ساختم.	I immediately turned this thought over in my head, creating lyrics.
با این گمان که مدال از طلای ناب خواهد بود.	thinking that it was a medal of solid gold
ولی خیلی برایشان احساس تأسف کردم	but I felt so sorry for them
جغدی با صدای گور آسایش جواب داد.	an owl answered with his sepulchral note.
این او را با نهایت احترام و ادب پذیرفت.	who received him with great civility.
من زندگی را زیاد دوست دارم. بدبختی همین است.	I've loved life too much, shamefully much.
اما در حالی که روی دستها و زانوانشان میخزیدند و از لا به لای بوته ها پیش می آمدند و سرانجام با شلیک همزمان تفنگهایشان حضور خود را اعلام کردند و پس از آن شلیکها نیز بسیاری از سربازان از روی زین اسبها به زیر افتادند.	but creeping on their hands and knees through the bush, and only let their presence be known by a general discharge of firearms, which emptied many saddles.
شوالیه با تمام نیرویش آن را کشید	though he pulled with all his might
مانند ژیمناستیک کاری که به این کار فادت دارد	like a man accustomed to that kind of gymnastic exercise
خدمتکاری از پشت صندلی خم شده و شمع مومی را در میان شست و انگشت سبابه راست بیمار نگه داشته بود.	a wax taper had been thrust between forefinger and thumb, and an old servant, bending over from behind the chair, held it in position.
به طنین صدای پای زمان گوش فرامی داد.	listening to the echoing footsteps of years.
با حال و هوایی جدی و موقرانه وارد شده بود با کتی مشکی و چروک که دکمه هایش تا زیر ریش پر پشت و قهوه ای رنگش بسته شده بود.	had entered solemnly, in a black creased coat buttoned up under his spreading brown beard.
واقعا بد بختی باورنکردنی است	what incomprehensible misfortune
از سرسرا با این انگیزه مقاومت ناپذیر گذشت که برود	hurrying along the corridor, with the irresistible impulse to go
من فقط باید این خانم را ببینم.	I must see the lady.
اول آن را با یک دست و بعد با هر دو دستش گرفت.	he took it first in one, them in both his own.
به نظر توهم آدم بدرد بخوریه	he struck you as being pretty handy.
اما سوسک از دسترس او دور بود.	but it was safe out of his reach.
همه تون باید بتون ین اون تو رو ببین ین.	make sure yeh can see' now
تمام آمال و آرزوهایم بر باد رفت.	I have lost all my illusions.
صاحبانشان یا مرده بودند و یا فرار کرده بودند.	all of them silent now, their owners dead or fled.
به زودی این منفذ کوچک به صورت راهی برای عبور آماده شد.	it soon stood wide open also.
با قطعیتی ناگهانی و دلسرد کننده فهمیدم که این آخرین سال من است.	I knew with sudden, chilling certainty that this was my last year.
با در نظر گرفتن این نکته که آن ضربه سهوی آلوده به خشمی زائیده نفرت از ربرتا بود	the fact that theunintentional blow still had had anger in it angry dissatisfactionwith her really
پس ده نم را بسته نگه داشتم.	I kept my mouth shut.
ما فعلاً همان جایی هستیم که ایستاده بودیم.	we're still where we were.
فوراً فهمیدم که این کلید مال کجا بود د	I knew immediately what this key was to
زیرا این مقصر غریبی است و مستوجب قتل است	he must be a great criminal
پس تو می تونی راهتو بگیری و بری و منو تنها بذاری.	so you can get the hell away from here and leave me alone.
ولی کسی جرأت دخالت در کار را نداشت.	but nobody dared to interfere.
یا اینکه ناخدا سرش را خواهد شکست	or knocked on the head
آنسلم تا حین غروب آفتاب در آنجا ماند.	there he remained till nearly nightfall
بنابراین کوشیدم برای جلب مجدد دوستی او آخرین سعی خود را به عمل آورم.	I was moved to make a last attempt to regain his friendship.
که ساختمان اصلی آن روزی یک خو کدانی سنگی بوده است	as though it had once been a large stone pigpen
این کاری دردناک و دشوار بود.	that was painful and difficult for him.
متأسفم از رختخواب کشی دمت بیرون.	I'm sorry I've dragged you out of bed.
که وقتش رسیده که تو کناره گیری کنی.	it's time for you to step aside.
از آنجا به شیروانی و ناودان برآمد.	thence upon the leads and gutters
آخر تا به آن روز صاحب چیزی نشده بود که ارزش غصه خوردن را داشته باشد.	for until now she had never owned anything worth grieving for.
به هیچ وجه برایم امکان نداشت	as I could not possibly have done
تردید ندارم که موجب مرگ فجیعش شد.	I have no doubt that it led to his tragic end.
نخواهد توانست بر سر قراری که مثلا دو سه روز پیش باهم گذاشته بودند حاضر شود.	he would not be able to keep an engagement with her that night, for instance, that he had made a day or two before.
وقتی به خیال این که دزد آمده سیخ شومینه را برداشته	when he got the poker in case of burglars
گاه برای خلاص کردن جانوری از پا افتاده و گاه برای زدن گراز یا دینگو.	sometimes to put a suffering beast out of its misery, sometimes to fell a boar or a dingo.
به اسب کرند یعنی خدمتگار و هم قطار من فرمان داد	ordered the sorrel nag, my fellow servant
البته فقط یک سلام علیک رسمی	that they had never gone further than formal greetings
خواست داخل شود در را از داخل بسته دید.	but the bolts were in place.
سکوت دردآوری بر دادگاه چیره شده بود.	while a painful silence reigned in the court room.
من خوشحالم که او به موقع برگشته است.	I'm glad she got back in time.
این بار اعصابش زیاده از حد ضعیف شده بود.	his nerves were terribly overstrained by now.
با مادر خود به کلیسا میرود و به علت بارداری ناگهان احساس ناخوشی میکند و نمیتواند در آن جا بماند.	was at church with her mother, and suddenly overcome by indisposition, arising from her interesting condition, she could not remain standing,
ولی به گمانم گناه این بدبختی تماماً به گردن من است	but I take all the blame upon myself
او نم یه همچی کاری این وقت شب با این همه جادوگر و غول که دورو ورمونن.	besides this kind of thing's too awful, here this time of night with witches and ghosts
بلافاصله از او چشم برداشت	looked quickly away.
جنگل حالا از سیاه به رنگ خاکستری دراومده.	the forest was gray now instead of black.
تقریبا ساعت یک بعد از نیمه شب بود که کوزت یک قهقهه بلند خنده شنید.	at one o'clock in the morning, possibly, she heard a loud burst of laughter
این کار ما را به کاهلی و تن آسائی وامی دارد	which disposed us to sloth
که این وال را تا این حد مایه وحشت طبیعی ساخته بود	that so much invested the whale with natural terror
برای اجتناب از دیدار دخترک چوپان تصمیم گرفت جلای وطن کند	in order to escape from her, he determined to quit the country
هیچ از اوضاع خودش ناراضی نبود.	her mind had no distaste for her own set
کلاید تعهد خود را از یاد بدر.	the obligation faded.
باد هم امان نداد و زمین و زمان را به هم ریخت	I never see the wind blow so.
اما شاهزاده بر او پیشی گرفت.	but the old prince interrupted him.
اما بخار گرم محتوی آن مرا ترساند که مبادا انفجار عظیمی به وجود آید و افراد خودی را که در آن حوالی مش ول ارت ترنم بودند نابود کند.	but the sizzling steam made me fear a general explosion which would sweep across my men swarming like ants over the booty with a blast of jagged fragments.
به خاطر رگباری شدید و ناگهانی پراکنده شد.	turned into a rout because of a devastating downpour.
پاها دراز به سمت جلو لبه پهن کلاه عقب و سری که بیش و کم شبیه هاله نور شده بود.	legs thrust far forward, the wide brim of his hat set far back, making a sort of halo for his head.
آنجا را برای این که در آینده هم کلاس درس ما بشود مرتب کردم.	arranged it for the future schoolroom.
من کشیشم و باید از هر سوءِظنی مبرا باشم.	I am a priest and therefore I ought to be above suspicion
هنوز با هری شش پله فاصله داشت.	still lying on the staircase six steps below him.
سه دقیقه تمام چشم به حرکت اسب دوخت	watched the horse's action for the space of three minutes
ولی فکر کردم غم و غصه چیزیه که بهر حال به آدم دست میده.	but I thought grief was something you felt anyway.
از پلکان بالا رفت تا در راهرو به دری رسید.	went up the staircase to a door in a corridor.
هر چند این همه زحمت اجری در خورد نیافت.	though with but small success for their pains.
تا به هنگام اعلام رأی دادگاه در کنار او باشد و شخصا جزئیات آن را برای روزنامه گزارش دهد.	on his day of sentence that she, his mother, would report the samefor him.
در نتیجه وکیلی را واسطه فرستاد تا ترتیب جدایی او را از او بدهد.	but sent an intermediary to arrange the terms of the separation
چون اگر راست باشد من یقین دارم این زوبین انداز دیوانه محض است	which if true I take to be good evidence that this harpooneer is stark mad
چون قبلاً هرگز این همه نیاز به شتاب کردن نداشتم.	for I have never had such need of haste before.
از دستوری که شوهرش به او داد	at the orders her husband left her
به کنجکاوی و دقت در زمین عجیبی که افتاده بودم دور و بر خود را نگاه کردن.	look around me with some interest on the strange land that I was in.
به پشت بر کپهء سنگ دراز شد	lay down on his back on the heap of stones.
قرار نبود دوباره او نو ببینم	I was never supposed to see him again!
که از فردا دیگر ملازم من نخواهد بود	or rather him who will no longer be my servant to morrow
هیچ نشانی از سر به هوایی مخصوص چهارسالگی در آن نبود.	with none of the rather wandering attention span typical of a four year old.
اما شعله زرد وکم فروغ در شفق آن قدر رمق نداشت که هاله رمز و راز پیکر سیاه با آن صورت نامرئی در زیر کلاه بزرگ محو گردد.	but the short flick of yellowish flame in the dusk was powerless against the muffled up mysteriousness of the dark figure with an invisible face concealed by a great sombrero.
اما در قلبش هرگز او را رها نکرده بود درست مثل این که جوان واقعا پسر خود او بود.	but in her heart she had never given him up, as though, indeed, he had been her son.
انگار ناچار بودند بگذارند او حرفش را بزند.	as if they were forced to let him say it.
این است که من به خانه شما دویدم.	that is why I hastened to you.
نمیخوام دی گه راجع به این موضوع حرف بزنم	I don't wanta talk about it no more,
برای همین است که سطح کشاورزی سقوط کرده .	that's how it is the whole level of husbandry has fallen.
پوششی بر فراز گذرگاه ماند رلی پدید آورده بودند.	making a vault above my head like the archway of a church.
باید بهت هشدار بدم از این اتاق هم بزرگ تره	I should warn youit's bigger than this room.
ماجرای مرموزی در این خانة دلگیر جریان دارد که دیر یا زود به کنه آن پی خواهیم برد.	there is some secret business going on in this house of gloom which sooner or later we shall get to the bottom of.
برای خود و فرزندانش پزشک استخدام کرده بود.	for herself and the children she employed a physician.
تا جایی که مقدور بود موفق شد میز مقامات مهم را آماده کند.	she did everything possible to keep the places at the table of honor in order
حیوان سرخ منخرین برنده شده بود.	the brute with the red nostrils had won.
جبران وجود نحس مادرش را بکند!	a recompense to you for his mother!
برای همین شبانه به آنجا رفت .	he went down that night.
خود مهمیزی به اسب زد به جانب رودخانه رفت.	spurred his horse and galloped into the river.
تو گویی مسایلی بدیهی هستند و ارزش توجه ندارند	was easily accounted for as belonging to the sense of haste
در این هنگام من گریه یاس را سر دادم و خود را در این دنیا یتیم و تنها یافتم.	I had already broken out into a desolate cry, and felt an orphan in the wide world.
حقیقت و تشبیه دیگری تحویل او دادم.	I gave her another truth and another analogy.
من هم به زمزمه کردن خود ادامه دادم.	I still humming my little tune.
در نزاکت طبعی که والانتین داشت	, feeling, with true delicacy
چند تکه یخ را داخل دستمال ریخت و روی سر او گذاشت.	ice cubes on her head
کشید و از آن برای بیرون آوردن عکس پسرش استفاده کرد.	she used it to push out her son's photograph.
تو پیش خود خیال کرده بودی که جنگ کوچکی با من بکنی!	you reckoned on a bickering!
از نظر ترحم نیز اتاقی به من خواهند داد.	I should be given a small room as a favor
بهتر از اسلحه و گلوله سراغ دارم	than either a bullet or a knife.
هرکسی که یه بار طعم شهرت رو بچشه	once you've had that first taste
یا سعی کند در آن حال و هوا یکی دو ساعتی بخوابد	or trying to snatch an hour or so of sleep
گویی اصلاً اتفاقی نیفتاده است.	just as if nothing had happened.
این تکلیفی بود که در حقیقت من حق نداشتم و او حق داشت که قبول نکرد	a proposition which I was wrong to suggest and he quite right to refuse
با این کار قدری از پوست و لباسش دریده شد.	tearing both skin and clothes to some extent in the effort.
من سرنوشتم اینست که تمام روز را جان بکنم و رنج ببرم	I shall have to toil and moil all my days
دسته آدمیه که زندگی تازه شروع کرده و ترجیح می ده که عزرائیل جونشو به گیره تا دو مرتبه بی عاری کنه.	it's the hand of a man that's started in on a new life, and'll die before he'll go back.
بعدش هم سعی کرده بود جلو دیگران را بگیرد تا کیک را نخورند.	as earnestly tried to prevent any body's eating it.
تا وقتی سفیدی چشماشون معلوم نشده من مشکلی ندارم.	I'm not really in trouble until I see the whites of their eyes.
من انتظار نداشتم که خودم باشم.	I hadn't expected to be myself.
من این دورغ و ریاکاری را ریسک کردم.	I risked the fraud
زیرا که هرچند بیش از هشت سال نداشت	for, although she was only eight years old
اول باشند چون نردبان جز برای عبور یک نفر راه نداشت.	both of them could not be first, for the ladder would but admit one man at a time.
خودش مایه نگرانی و دلشوره بود.	was a point of painful solicitude
پشت نرده شروع کرد به بالا و پایین رفت.	walked slowly up and down on the outer side of the sweetbriar fence
هیچ چیز به جز استخوان آنجا نبود.	naught was there but bones.
من به دور و بر میز نگاهی انداختم.	I look helplessly around the table.
حتی مقدار زمانی را که در او محبوس مانده است	not even the length of time he had been imprisoned
او را به سوی خانه کشانید	dragged him to the house.
شما اولین کسی خواهید بود که از آن با خبر شوید.	you'll be the first to know.
به شما گفتم که من دی گه کشیش نیستم.	I told you I ain't no preacher
ظاهراً از انگشت میانه من اندکی بلندتر بود.	seemed to be somewhat longer than my middle finger.
زیرا که خود نیز محتاج به عفو و بخشایش خدایی هستم.	because he hopes to be forgiven
بعد از آن دو نفری شروع به بوسیدن یکدیگر و وراجی کردند و ساعتی به بیهوده گویی گذراندند بدون اینکه از حضور ما خجالت بکشند.	there they were, like two babies, kissing and talking nonsense by the hour foolish palaver that we should be ashamed of.
رفته است دار و دستة خود را بردارد و برگردد.	would bring the whole hornet's nest about our ears
با ناباوری سرم را تکان دادم.	I shook my head in disbelief.
این چیزا باعث نمی شه همه چیز رو فراموش کنم و تو رو ببخشم.	I still think you were hateful that night and I never expect to forgive you.
دلش برای جدول حل کردن تنگ شده.	he missed doing the crossword.
که عدم حصول پیروزی در نبرد تهاجمی پس از هشت ساعت عملیات جنگی چه مفهومی دارد.	by the attacking side in eight hours, after all efforts had been expended.
بدان که من به رازداری و ادب و نزاکت بانوی خود بیش از الطاف معجزآسای قضا و قدر امیدوارم.	from whose discretion and courtesy I look for favours more than miraculous.
به یک میخ که به دیوار وصل شده بود وصل کرد و با دقت شروع به تابیدن آن کرد.	he tied them to a nail in the wall, and carefully plaited them.
روحی بلند و دلی مهربان دارد.	able to understand her position and her sorrow.
من باید سخنان خیرخواه خود را تا آخر گوش بدهم و آن را درک کنم.	I want to hear and understand my benefactor's words.
در همان جا او را دفن خواهد کرد تا سرو صدا بخوابد.	they'll bury him right there.
ولی شکر را فراموش کرده بود.	but he had forgotten the sugar.
بار دیگر یک گل کاملیای سفید دیگر دریافت کرد	she received a white camellia again
از ارلاندو خواست که به او افتخار دهد تا ناهار را با هم بخورند.	asked her whether she would honour him by lunching with him?
یک لیوان مفرغی به بزرگی یک سطل جلویش روی میز بود	there was a pewter tankard almost as big as a bucket in front of him
هیچ ندیده بود که مرد از آنجا گذشته باشد.	had not seen the man pass.
وقتی به این خلوتگاه خوفناک درآمدم	but as I was making my way among these crags,
هرگاه شما هم نخواهید من به امید و آرزوی خود دسترسی یابم	if you oppose me in this great stake
حتی زمانی که پروفسور مک گونگال جلوی چشم همه خود را به شکل یک گربه کوچک و ظریف درآورد که خطوط رور چشمانش شبیه عینک بود هری او را ندید.	wasn't even watching when she transformed herself in front of their eyes into a tabby cat with spectacle markings around her eyes.
عمیقا غرق افکاری دیگر بود	was deep in thoughts of something else
کلاه را روی سرش گذاشت و نشست.	put on the hat and sat down.
که به علم و حدسیات خود بسیار معتقد است	who will certainly ruin himself in experiments
تبهکاری چنان جسور و غدار است	was so daring and such a villain
مادر شوهرش از عروس خود نفرت دارد	her mother in law detested her
ایستاد و به دوروبرش نگاه کرد.	after stopping to look about her,
تا آن موقع خال سیاه شما پشیزی هم ارزش نخواهد داشت.	in the meantime, your black spot ain't
همچنانکه من نباید بر خود ببالم که دست و پایم ناقص نیست	than I should be for not wanting a leg or an arm
باکش از آبروریزی جلو مردم بود.	he was afraid of creating a scene in public.
از این سخت برآشفته بود که با آن که خود به کار دیگران کاری نداشت دیگران با لجاجت مراقب او بودند.	he was angry that people should go on being interested in him when he took no interest in them.
اول به خاطر این که آن طرز لباس پوشیدن عادتش شده بود	first because his personal taste would not allow him to dress in any other way
سانکو بسیار مایل بود که قدم به آنجا نگذارد	but though he would have rather not entered it
اگرچه فورا آمدم تا اگر بتوانم کمکتان کنم.	though I have come only to aid you if I can.
بزودی تصدیق کرد که راه فرش شده با تخته سنگ امتداد دارد.	he discovered that the paving continued.
به زحمت توانست سطل را بلند کند.	she could hardly lift the pail.
از برای او شراب که بهتر بوده است.	why did he not take wine?
صبر کرد تا یک دقیقه پایان یافت.	he allowed a minute to pass
متوجه شده است که من یک یاهوی کامل عیارم	I was an exact _Yahoo_ in every part
این تلگرافچی را اخراج نمودند و	that the man employed there was dismissed
من احمق بودم و هیچ کس دوست ندا ره که آدم احمقی یکباره عاقل شه	I was stupid and nobody likes to see a stupid guy wise up.
اگر فرض کنیم فردی بیا این صفت عالی هرگز وجود داشته است	if ever that solitary superlative existed
کارهنین گفت که فردا تصمیم خود را به آنا اطلاع خواهد داد.	he said that tomorrow he would let her know his decision.
دقیقا در همان ساعتی که شب قبل خبر داده بود	precisely at the hour named the night before
از تالار به سرسرا و از پلکان به حیاط شتافت.	through the ballroom to the anteroom and downstairs into the yard.
کاترین نیز ساکت و آرام و در حالی که معلوم بود بسیار افسرده و رنجیده خاطر شده است به اتاق خودش رفت	she mutely, and with a sense of intense injury, retired to her private apartment.
اما حالا خیلی بیشتر به او شبیه شدی	you're much more her now
که معلوم بود اساسا صدا زدن آنان را نشنیده است.	that it was doubtful whether she had even heard their calls.
در سن بیست و یک سالگی خط مشی نادرستی در پیش گرفتم یا بهتر بگویم مجبور شدم در پیش بگیرم	I started, or rather was thrust on to a wrong tack at the age of one and twenty
دلایل کافی هم دارم که آقای فرانک چرچیل چنین احساسی ندارد.	I can answer for its being so on his.
که به مغز خود فشار آورند و برای دیدن هرچه زودتر یکدیگر راهی بجویند.	think of some way by which they could meet before, if possible.
با عزمی جز به بالا رفتن پرداخت.	he resolutely began the ascent.
شیرینی و کمپوت سیب و شراب هم بود.	biscuits and baked apples and wine before she came away
فقط مستقیم به جلو خیره شدم.	I just looked straight ahead.
بعد گویی برای تشخیص اینکه ناتاشا تب دارد یا نه لبانش را به پیشانی او گذاشت و او را بوسیده	then touched her forehead with her lips as if to feel whether she was feverish, and finally kissed her.
در عجب بودم که حتی به خودش زحمت داخل شدن را داده است یا نه.	I wondered if she'd even bothered to go in?
زمانی که در خانه خودش صاحب اختیار بدن خودش بود.	when she was young and free in her own house, mistress of her own body.
ابلانسکی ناگهان خشمگین شد.	he had suddenly felt uneasy.
متأسفم من با کسی قرار دارم که کمی هم دیر شده است.	I'm afraid I am late for an engagement.
که احساس کنن دارم سرش ون منت میذارم.	that he was condescending when he noticed them at all.
اداره امور خانه را به عهده خواهد گرفت	she would keep house for him
او نیز وقتی ثروتمند شد و خواست دار فانی را بدرود گوید روح خود را به شیطان تفویض کند	after he has grown rich he will give him his soul
بار دیگر به اطراف نگاه کرد.	looking around him once more.
سرانجام چون خشم و حتی وضعشان با وضع پهلوانان سرگردان بهتر تطبیق کند	all anger and gloom removed, not to fix upon any being the proper thing for true knights errant
همین بود که با برادران راهزن خود برگردد	the scheme to return home with his brother pirates
باز متحیرست که چگونه کشوری ممکنست سرمایه و دارائی خود را مانند کسی که شغل غیر دولتی دارد از دست دهد و خرج او بیش از درآمدش باشد.	he was still at a loss how a kingdom could run out of its estate, like a private person.
حالت سگی باهوش که میداند مرتکب خطایی شده است.	like the expression of an intelligent dog when it has done wrong.
کلید بزرگی بدست داشت که از در یک زندان دزدیده بود.	held in his hand an enormous key stolen from the door of some prison.
که چاقو نزدیک جنازه پیدا شده بود.	the finding of the knife near the corpse.
هیچ برایم مهم نیست که امروز صبح با ناراحت کردن من چقدر خوشحالی.	I don't care how merry you are at my expense this morning
باز هم یک گره او را به هدف عظیم و زاده یکه خلی او نزدیک نخواهد ساخت	all that would not one jot advance his grand, monomaniac object.
راز وحشتناکی را درباره یکی از اعضای باشگاه خودمان.	something terribleabout one of our own members.
من خشمگین و عصبانی هستم ولی نه زیاد بالاخره این جوان ناگهان به این فکر افتاده است که عاشق من شود.	I feel cross, but not very , that frivolous young man, would you believe it, seems to have taken it into his head to fall in love with me.
کوشید تا به او چیزی بگوید	tried to speak to him
در آنجا شخص چهارشانه و میانه سالی را دیدم	found there a stoutish, middle aged person
او خودش به من دستور داده است بچه را به همراه ببرم.	he has ordered me to take him
انگار با صورت به دیوار خورده باشد.	as though it had run headlong into a brick wall.
به دختر شما گفتم که ماشاءالله مثل یک گل سرخ شاداب است.	I told your daughter that she is like a rose.
که درانتظار پیدا شدن شریک رقص بودند از او برای والس دعوت شد.	waiting to be asked to dance when she was asked for a waltz
به علت تمرین و ورزش سالم و هوای پاک عرصه زیرین کشتی است.	because of the wholesome exercise and pure air of the fore castle deck.
حالا خواهند دید که همان مهتر است که بود.	they will see him come back a horse boy.
او که به ظاهر بسیار خوشحال شده بود	quite pleased apparently.
باز هم تا ابد و ابد و تا فرا رسیدن فنا دریا انسان را خوار خواهد داشت و خواهد کشت	yet for ever and for ever, to the crack of doom, the sea will insult and murder him
میخ وام اجازه بدی که جونشو نجات بدم.	I want your permission to save her life.
من حق دارم که اگر بتوانم خودم را نجات بدهم.	I have a right to deliver myself from it if I can.
آقای به مبل از دیدن آن سخت متوحش شد.	that it was much distorted and discoloured.
که ما قصد داشتیم پس از گرفتن موضع نبرد را در آنجا شروع کنیم	which we intended to take up our position and begin the action
از فرط انزجار بر خود لرزید.	she shuddered with loathing.
مثل اینکه این مدت خیلی بیشتر از یک هفته بود.	that at its close I seemed to have been with him for a much longer time.
موهایم را از روی صورتم کنار زدم .	I push my hair back off my face.
تصمیم گرفت برای او مربی بیابد و او را به وی بسپارد.	putting the boy in his charge
پایبند هیچ اصل اخلاقی نیست و حاضر است در حق دیگران بدی بکند تا خودش ناراحتی نکشد زن چقدر باید زجر بکشد.	when he hasn't got a principle in him to make him more afraid of doing the wrong thing by others than of getting his own toes pinched.
مطلقا چیزی باقی نمانده بود.	nothing was left.
بلافاصله صحبت را کشاند به موضوعی که شاید پدرش را از غم و ناراحتی در بیاورد.	she immediately led to such a branch of the subject as must raise them.
هرچند اگر دست و پا نداشته باشد بدبخت و بیچاره است .	although he must be miserable without them.
در آن صورت هم خیال ما آسوده خواهد بود	in this way we shall be satisfied and easy
ولی هنوز به شدت دلواپس بود	but was still extremely nervous
بهتر است که این تصوراتت را برای خودت نگه داری	I think you'll do best to keep your visions to yourself
تا حد امکان با خونسردی پرسیدم.	I asked as lightly as I could manage.
از آن موقع تا حالا که آقای جر وی این جا بود اصلا خبری از او ندارم.	I haven't heard a word from him since he was here.
منم باید برگردم به سرسرای بزرگ.	I must also return to the feast.
مگر لری اواازاین کار بازمی داشت.	unless he cut her off entirely.
ابروهای پرپشت او به هم پیوسته بود.	with very heavy eyebrows
که نخست دربارهٔ آن سکوت اختیار کردند زیرا هویدا بود که بیم داشتند کشف خود را با دیگران در میان نهند	at first only observed in silence by those who came in and out and were evidently each afraid to communicate the thought in his mind.
من تا آن روز اسکوایر را از نزدیک ندیده بودم.	I had never seen the squire so near at hand.
طوری که سرش بالای قلب مادر بود	with its head upon her breast.
چرا نگهبان آژیر خطر نکشیده است.	why the watchmen had taken no alarm.
ولی جلوی زبانش را گرفت.	but held his tongue.
دو ناخدای آن دو کشتی در حد خود تمامی تضاد فاحش منظره را مجسم ساخته بودند.	their two captains in themselves impersonated the whole striking contrast of the scene.
چشمهیش در تاری کی کاملا بازبودند.	eyes wide in the dark.
به برداشت خواننده از روابط او با شوهرش بستگی دارد	as the reader chooses to consider it upon her relations with her husband
صورتش رو بین دستام گرفتم.	I took her face in my hand.
نفسی عمیق کشیدم و موهایم را عقب زدم	I take a deep breath and smooth my hair back
براق و درخشان شده و نیروی جوانی به او بازگشته بود.	he was glossy and seemed to have the vigour of youth.
من در دنیا چیزی ندارم که متعلق به تو نباشد.	I haven't nowt in all the wureld that ain't yourn, my dear.
در حالی که در واقع کاری انجام نداده بود بجز یک عمل جسمانی.	when in reality he had accomplished no more than the physical act
شهامت آن را نداریم تا از لاک همیشگی سر برون آوریم	we lack the courage to step from our accustomed role
کس دیگری را هم ندارم که ازاو خواهش کنم.	I don't know who else to ask.
با خوش رویی غیرعادی لبخند زد.	he finished, smiling more broadly than ever.
صدایش بلند و همراه با معصومیتی تصنعی است.	she asks, voice high and fake innocent.
که پروفسور اسپروات از دور پدیدار شد.	when she came striding into view across the lawn
روزنامه را به دست مادرش داد	he now passed the paper over to her.
در هیجده سالگی با شما برابر بودم کاملاً برابر.	I was your equal at eighteen quite your equal.
قطار رو هم به آتلانتا فرستادند.	so our train was sent here.
با دقت او را از نظر گذراندم.	I examined her carefully.
مگر اینکه به آن موضوع کاملاً وارد باشد.	unless he knows that subject well.
ولی این موضوع اهمیتی نداشت.	but what did that matter?
من او را به همراه خانم دیگر به خارج فرستادم	I sent her out this morning with the other young woman
ولی گمان نکن که این موضوع را برای همیشه از وی پنهان خواهم داشت.	but you needn't imagine I shall keep your ridiculous secrets.
از ته دل خنده را سر داده بود	bursting into a hearty laugh
مگر اینکه خود فلگ اینطور بخواهد.	unless he wanted to be noticed.
با دیدن او به اتاقش برگشت	he disappeared into his house
اگر او صاحب مسافرخانه واقعا جای دیگری ندارد که به من بدهد	that if he the landlord really had no other place for me
او را خواستم خاتم قلبم باشد	I kept her in my heart
بدون عجله همدیگر را دوست داشتند مثل عاشق و معشوقی پیر.	loving each other like unhurried old sweethearts
میدانم در آن لحظه که همهٔ افراد بشر ناگهان علت همهٔ این حوادث را در خواهند یافت منهم حضور داشته باشم.	I want to be there when every one suddenly understands what it has all been for.
ظاهراً هنگام سقوط بر روی زمین مچ پایش رگ به رگ شده بود.	he had sprained his ankle when the spider had dropped him.
بلافاصله به شکل چیزایی درم یاد که هر کد وم از ما ازش ون وحشت داریم.	he will immediately become whatever each of us most fears.
بنابراین چشم انداز دریا را داشتم و نیمه چشم انداز چمن همسایه را قرب جوار تسلی بخش میلیونرها را و این همه فقط در برابر هشتاد دلار در ماه.	so I had a view of the water, a partial view of my neighbor's lawn, and the consoling proximity of millionaires all for eighty dollars a month.
اما فقط پنج دقیقه به ساعت ده مانده بود و دوشیزگان هنوز لباس نپوشیده بودند.	but it was already five minutes to ten, and the girls were not yet dressed.
یک ماه تأخیر دلیل قاطعی بر حاملگی نیست حاضر بود یک ماه تمام لاقیدانه این مسئله را پشت گوش بیندازد.	that the delay of a month might not prove fatal was sufficient to cause him to be willing to wait, and that rather indifferently, for that length of time.
این بود که آن دور و بر گشت	so he searched around
باز به کالبد جا نواران خواهد رفت.	will go back into animals again.
خود را برای هرگونه پیشامدی آماده سازید	prepare yourself for every emergency.
این خداست که تو را زده تا بمیری	when he is striking you dead?
که شما از وصلت با من کراهت دارید.	that you decline allying yourself with my family
به شرطی که رفتار صحیح و تواضع رعایت شود.	provided that a proper humility of behaviour is at the same time maintained.
درست است که اگر در واپسین لحظات به میل خود رفتار کرده	it is true that if he had done as he liked at the last
من همیشه ضعیف تر از آن بودم که با عوامل خارج از کنترل ام روبرو شوم. به دشمنانم حمله کنم یا شکستشان دهم.	I'd never been strong enough to deal with the things outside my control, to attack the enemies or outrun them.
امکان دارد که این مه صدایشان را خفه کرده باشد.	this fog may have deadened them.
یک مرتبه از جای برخاست	then he suddenly arose
در عین حال برای گریز از آن حالت به آهستگی در تالار به قدم زدن پرداختی.	you betook yourself slowly to pace the gallery.
با عزمی راسخ داخل کلیسا شد.	he resolutely entered the church.
چنان بخار و چنان صدای یکنواختی از ریزش باران ایجاد شده بود	such a steaming and droning rose from the downpour
هوسش را در بازداشتگاه اندازد و به پای خود به پاسگاه رود.	one must set one's own fantasy to the violin, and carry one's self to the post.
چون یا شما باید به نحو رضایت بخشی این مسئله را برای خود حل کنید	for you must either satisfactorily settle this matter with yourself
قیچی رو هم پیدا کن. تم وم شب که وقت نداریم. زود باش.	fine de scissors without takin' all night 'bout it.
یا باید الان بروم یا هیچ وقت نروم.	I must go now or I shall never go.
از بچگی تا حالا همدیگر و ندیده بودند	they hadn't seenm him since they was boys together
البته من انتظار نداشتم که بعد از این همه وقت نتونیم پی داش کنیم	I agree we would have expected to have found her by now
در چنین مواردی فاش گویی کامل همواره حالت دورویی گذشته را دارند.	in such cases the complete revelation always produces the impression of a previous duplicity.
هولمز سرگرم حل و فصل دو ماجرای بی نهایت مهم شده بود.	he had been engaged in two affairs of the utmost importance
شبی طولانی که اسکار لت تا سحر بیدار ماند گوشش را تیز کرده بود که صدای در را بشنود .	a long night during which she lay awake until dawn, her ears strained to hear his key in the latch.
اصلاً ناراحت نبود از این که کسی حرفی را بشنود.	she said, and she did not trouble to lower her voice.
که به عقیده من ازدواج اصل مقدسی است که باید از آن پیروی کرد.	that I look on marriage as a divine institution to which we must conform.
هرچند هزار وال دیگر را به کشتی او بیاورند	though a thousand other whales were brought to his ship
کلیسایی فرض کنید که محل سرود خواندنش با دست عظیمی گرفته شده	suppose a church whose choir is grasped in a gigantic hand
من تواضع را از یاد برده بودم.	I lacked humility.
بنا کرد به کمک کردن به تام برای آزردن و برگرداندن زندانی.	began to assist in exercising the prisoner.
داخل قایق کوچک پارویی شدم.	I climbed into the dinghy.
سپس با عصبانیت چنین نهیب زد	he exclaimed, getting angry.
بعد از این کار می تونیم به مسائل دی گه بپردازیم.	then we can turn our attention to other matters.
دو قطعه را در طرفی و دو قطعه دیگر را در طرف دیگر درب غار آویزان کنند.	to hang two on one side and two on the other, within the door of the cave,
ولی آخر تو هم قول داده بودی که برایم نامه بنویسی	but then you said you would write me
بامداد روز دیگر به سفر دریائی ادامه دادم	repeating my voyage early in the morning
با نشاطی که مقتضی این سن است	who rose full of the enjoyment of his age.
مو رل آنجا پنهان شده بود	he had taken refuge.
خواهرش را با لباس خواب دید	saw his sister sitting patiently in her prim nightgown
روشنائی شما را من نخواهم چشید.	I shall not reach your light
او نوشیدنی را در گیلاس کوچکی که از اموال خودش بود دوره انداخت.	dispensing the currant wine in a little glass without a foot, which was his own property.
به علت اینکه علاوه بر احساس طبیعی رابطه آگاهی از برتری اخلاقی هم اضافه شده است	because, to the natural feeling of relationship was added the consciousness of his moral superiority
زیرا آب آشامیدنی برای افراد و سپاه خود نداشتند.	for they had no water for men or horses.
اما او چیزی بروز نداد تا هر کدام مطابق برداشت خودشان قضاوت نکنند و به قصد او پی نبرند.	but he did not say anything that allowed anyone to guess his intentions.
من می تونم ببینم که هر دقیقه بلندتر میشی.	I could watch you getting taller by the minute.
آبروی او در نگهداری آن است	his honor being engaged in keeping it
صدای زوزه مانند او جواب داد من	I did the wolf whined
سکوت عمیقی بین ما حک مفرما بود.	silence on both sides.
جیبش را برای پیدا کردن سکه لازم زیرورو کرد	he dug into his pocket for the required coins
دوربین را مجدداً به نگهبان ساحلی پس دادم.	I gave the glasses back to the coastguard.
چون خداوند مخلوقی نیافریده و دوزخ موجودی بیرون نداده است که بتواند در دل من ایجاد رعب و وحشت کند یا مرا در محظور بگذارد	as neither heaven has created nor hell seen any that can daunt or intimidate me,
مدیر تیمارستان به وی گفت که آن مرد هنوز دیوانه است	the governor assured him that the man was still mad
خانه هاشان را سوزانده و زنانشان را به کنیزی فروخته است.	burned their homes, and sold their women.
یه روزی منو تو جمع خودش ون قبول کنن.	in him as a suitable social figure if only he did nothing to offend them?
به او برای ناشیگریش چند فحش داد	he muttered various curses on her awkwardness
مبلغ پنج هزار پز و برای سر او جایزه تعیین کرد.	put a price of five thousand pesos on his head.
باز هم در کنار نرده با مادرم مشغول قدم زدن شد	my mother and he had another stroll by the sweetbriar
سرگرم خوردن کباب گوشت و بیسکویت شدیم.	over biscuit and fried junk.
سرانجام طنابی که دختر بچه را به مجسمه بسته بود پاره شد .	at last she was free.
نهایتا حانهای دیگری هم از دست خواهد رفت.	many lives must inevitably be sacrificed.
بعد از آن بیست و پنج هزار اکو طلا شمرده که تقریبا هراکو هشتاد فرانک قیمت داشت	then he piled up twenty five thousand crowns each worth about eighty francs of our money
با شور و شوق دوربینش را بالا آورد.	raising the camera hopefully.
به همة آ رزهایشان نرسیده بودند	that not all of their hopes had been fulfilled
سپس آن جلد را بیرون آوردم.	then pulled the volume out.
بنابراین یه جوردیگه منظورم رو گفتم.	so I said it in other ways.
اما واجب دیدم که نام کشور خود را پنهان کنم	but I thought it necessary to disguise my country
جای خالی دندان را نشان داد.	showed the vacancy.
نگاه و حرکات او کافی بود که به نفس جسارت نیز بیم و وحشت بدهد.	a spectacle and demeanour to strike terror into temerity itself.
اکنون مساله به خودی خود روشن است!	that's the solution of the mystery!
این اواخر هم کسی او را از شاگرد معمولی مدرسه به شاگرد مخصوص تبدیل کرده بود	somebody had lately raised her from the condition of scholar to that of parlour boarder.
شاید هزاران روبل پولشان به دست او خرج شده بود.	more than one thousand rubles of their money had passed through his hands.
درست ده سال بود که من پهلو به پهلو با یکی از دخترهایم قدم نزده بودم.	it must be quite ten years since I walked side by side with one of my girls.
بیمارتر از آن بود که خواهرش را دوست بدارد.	too sick to love his sister.
دید مردی بالاتنه خود را از طبقه فوقانی به پایین خم کرده است	descried a man looking out of a door, breast high, on the second story.
یعنی یک سرکارگر خواهد شد!	that he was to be a boss!
به ارواح مادرم که هرگز اقرار به این مزا وجه نخواهم نمود.	that is most sacred to me in the world, namely, by my mother
چنان ناگهانی وارد اطاق شد	burst into the room
به قدری ناتوان و خسته بودم که فقط فکر پیمودن راهی به درازای شش میل برایم غیرقابل تحمل بود.	I was so faint and tired, that the idea of holding out for six miles more, was too much for me.
چیزی که برای فراصوت ها محافظ بود و و خیلی سخت برای سوراخ شدن.	something that was too impenetrable for ultrasounds, too tough for needles.
بلکه باید بگذارید شوخی خود را بکند و تحویل بگیرد.	but let him cheerfully allow himself to spend and be spent in that way.
در صورتی که حال من واقعا خراب است.	when I am almost crazy.
یعنی بجای کلاه خود کامل کلاه ناقصی بیش ندارد.	that it had no closed helmet, nothing but a simple morion.
رطیل پیر او را خوب محک زده بود.	she had gauged her quarry well, the gross old spider.
که اندکی برکنار واقع شده بود	standing a little apart
چه خبر ته مرد حسابی! چه چار نعل میری!	how you do gallop on, my good man!
البته در مواقعی که با لاری نیستم .	when I'm not having laurie..
نفس زنان وارد یک جای دل گیر و شلوغی شد که جای تکان خوردن نداشت.	he went panting into the confused and gloomy place where there was barely room to move.
اگر تو در وجاهت دختر من تردیدی داری خوب او را تماشا کن تا پی به حقیقت گفتار من ببری.	only look at her well and thou wilt see I am telling the truth.
در همان حال دخترک مانند کسی که در شطرنج مات شده باشد درمانده بود که چه واکنشی نشان دهد.	checkmated in this general way, was at a loss as to how to proceed.
گفتی من نیز با او در کار مردنم.	as if'the thought passed through my mind'I were dying too.
من با اضطراب و ناراحتی گفتم.	I looked up in confusion.
هیچ اثری از او ظاهر نساخت.	had failed to rouse him from his lethargy.
پالتوی پوست و کلاه پوست خز را بگیر و بیاور!	ask her for the sable cloak.
اگه او نا بخوان برن من حرفی نمی تونم بزنم	I can't say nothin' if they want to go
یا او را مغلوب و در برابر خود به طلب زنهار وادارم	or, in short, vanquish and subdue him
کری بدون اینکه بایستد گفت البته باید کفشم پاشنه بلند با شه	I should be in heels, of course, she says, without stopping.
ما او را در خانه گذاشته بودیم	we had left him behind us
اما جرئت ندارد حرفش را تمام کند.	but hasn't the heart to finish.
بی آنکه حتی نفسی تازه کنند	without even taking a breath.
با این همه سرو صدا باور کن حتی نمی تونم صدای تخم طلایی رو بشنوم!	I won't even be able to hear the egg over this lot.
گفتم که من آلت بنده کرده مردمی آزاد و دلیر نخواهم شد.	I would never be an instrument of bringing a free and brave people into slavery.
حتی در سنین پیری هم اسیر افکار متضاد خود بود.	not even with the most desperate act of her old age
لابد رنگم عین روپوشم سفید شده بود.	I am sure I must have been as white as my gown.
مراتب تشکر خود را ابراز داشت.	thanked him for it.
اما در مورد این که ثروت هنگفتش را چکونه به دستاورده بود روایات متعددی وجود داشت. برخی از ان روایات نیز اصلا جنبه چاپلوسی و تملق نداشت.	but there were a dozen different accounts of how he had achieved his vast fortune, some of them not flattering.
وبی هیچ علتی لگدی به کشاله رانش زد	needlessly kicking it in the groin
بنابراین چگونه ممکن است مرا ببخشی!	so how can you forgive?
من که مقدمات این کار را فراهم نکرده بودم.	I haven't prepared anything.
ولی او هنوز مشغول کلنجار رفتن با در بود	on which he was expending fruitless oaths and violence
من نیز در جهان به شهرتی باور نا کردنی رسیده باشم	that I have won incredible fame throughout the universe
عمیقاً از شما ممنون و سپاسگزارم.	banker, advancing towards him with the check.
من پیش از رفتن به آنجا از آغاز عمر آشنا به وضع دربار نبودم.	I had been hitherto, all my life, a stranger to courts.
به خاطر اذیت هاش ازش متنفر بودم.	I hated the way he teased me
لازم است که مرا هم به مجلس عروسی تو دعوت نماید	he ought to invite me to your wedding
به ویژه اگر دوستان همیشه برای هر مقامی که میل دستیابی به آن را داشتند شایسته بودند!	especially if one's friends were invariably fit for any function they desired to undertake!
البته صورتش در اثر آفتاب کمی سوخته ولی نه زیاد	a little weather beaten to be sure but not much
ما نیز گام به گام او را دنبال خواهیم کرد.	so, at her own pace, we will follow her.
چشمانی ریز و عدسی و درخشنده داشت و رفتارش با خودنمایی توأم بود.	she had little eyes, sparkling like beads, and an effusive manner.
اینان جانورهای مخوفی بودند که بر آدمی تسلط داشتند.	fearful beasts which were above man.
در نیم متری زمین توپ را گرفت	a foot from the ground he caught it
اگر هنوز کسی هیچ مزاحمتی برای شما فراهم نیاورده است!	since they haven't begun to worry you?
مگر اینکه به من قول دهد که از سخنان من نخواهد رنجید	unless he would give me his word and honour that he would not be offended
چون همه غذایشان را کشیده بودند	they were all helped
برای تحصیل معاش راه دریا را پیش گیرند!	should take to the sea for a livelihood!
حرکت اعضای شما به شما عود نماید.	your gesture, your movement
فنجان شیر و بشقاب نان را کنار زد.	he withdrew the cup of milk and the plate of bread.
که امپراتور شما به او هدیه کرده بود	which your emperor presented hiM
ردایش را جلوی صورتش نگه داشته بود	her robes pulled up over her head.
دی گه هیچ وقت نبینم اسم این جنده خانم رو بیا ری .	I do not even want you to speak to her again.
اومدیم مسابقه رو تماشا کنیم.	we'd come and watch you.
آهسته گفت بهتره یه خورده غذا برات گیر بیارم و دستم را از دور کمرش جدا کرد	I'd better find some food for you, he said in a quiet voice, and he gently unwound my arms.
آن ما را به شتاب بیشتر وامی داشت	this increased our haste
همان افسری که به خانه مراجعه کرد تا از او یک ملکه بسازد.	the officer who came to get her at her house to make her a queen
نمی دونم. نوک دماغم را خاراندم.	I don't know, I say, rubbing my nose.
اگه از هم ون اول طوری باهاشون تا کنم	if beforehand he chose to impress on them the fact
خواهش کردم مرا هم بیرون بیاورد.	I demanded my release.
چون مجبور بود دائم این طرف و آن طرف برود.	because he was hardly every around
دور تا بی درنگ به امضای آن نگاه کرد.	she immediately looked at the signature.
فکر کنم بتوانم تحمل کنم.	I thought I could pull through.
نیازی هم به کارشناس خط ندارم و به خانه شما نخواهم آمد.	I do not wish for experts, not I, nor to go to see you.
از جوری که بهش نگاه می کنه خوشم نم یاد.	I don't like the way he looks at her.
که مدام در زمین و آسمان در جستجویش بود	for whom she continued her hopeless search in heaven and on earth
اما در همان دم به ترس و هراس	but it instantly awoke my fears.
ملالی جانکاه بدو دست داد.	then he was sick to death of it
چند صد متری را دویدم و بعد ایستادم. به نفس نفس افتاده بودم	run about a hundred yards down the road and stop, panting.
دوان دوان بس وی باریکهٔ خشکی رفتند.	they raced to the point.
از لحاظی به این خاطر که آن را پیش از هر جای دیگر دوست داشت	partly because he liked it best
من دلم برای همه در اینجا تنگ می شه	I'll miss everyone here.
ولی انگار تازه داشت پامیگرفت.	yet it seemed he had only tapped it.
یک هفته بود که چشمش دنبال این فندک بود.	bought the electric cigar lighter whichhe had coveted for a week.
چون واقعاً زمانی مال خودش بود.	what did really once belong to him
دماغه قایقش به شکل قویی بود	her prow was fashioned like a swan
با خودم گفتم. قطعاً ازدواج ما اتفاق مهمی نبوده است تا او چیزی بنویسد.	I supposed I was not a major event.
زیرا اسب ابرش نزدیک من آمد	for the gray horse came to the door
جایی که همه سرب ازا توش حموم می کردن.	where the whole regiment had bathed in the same water!
شوورش او نقد مذهبیه که آب جیمم تا حالا پونزده تابچه زائیده.	he's so bloody religious that she's got fifteen kids now
در این باره مطمئن بودم چون کشش از بین رفته بود.	I knew it for sure because the pull was gone.
سخنان عاقلانه شنیدنش هم خوشایند است.	it's always pleasant to hear words of wisdom.
بعد حواسش از اون کنده شد	then he dropped her out of his mind
وال بار دیگر سر از زیر آب به در آورد و چون در این هنگام جلو قایق پیپ کش پدید آمده بود	the whale rose again, and being now in advance of the smoker's boat
گمانم به این علّت است که تو را خیلی دوست داشتم.	I suppose it's because I loved you too much.
چون من تو رو بیشتر دوست داشتم .	because I loved you best.
آقای عمر هم یکی از انگشتان چاق خود را به دست کوچک بچه داد و بچه به روی پیش خان دکان مشغول رقصیدن شد.	as her father put one of his fat fingers into the hand of the child she was dancing on the counter.
برای خوابیدن لخت شده بود	he was undressing to go to bed
به بهای جان هفده تن از سرنشینان هیسپانیولا تمام شده بود.	that had cost already the lives of seventeen men from the HISPANIOLA.
زیرا او آنقدر متوحش شده بود که دیگر هر حرفی را از یاد برده بود.	for the fright was so great, that she had quite lost her voice
که شاهزاده خانم خوشگل بچه سالی بوده و تازه ده سالش تمام شده بود	a pretty young princess just turned of ten.
شما باید به فکر استقرار خود باشید.	you must begin to think of settling down.
من هیچ خیال بدی در حق شما ندارم.	I will not harm you.
ولی به نظر من به راحتی اینجا نیست.	nor as comfortable, I am thinking
که وقتی درس خود را بلند نیستید شما را ریشخند کنند	who plague you if you don't know your lessons
با وضعی متعجب توقف کردند.	stopped in surprise.
فقط عشق میتونه ماروازاین مهلکه نجات بده.	only love will get us through this
لحافی را که ظاهراً به جای پشم از کرباس آنژو بود به سر کشیده بود.	which merely consisted of a rush mat and a blanket that looked as if it was of threadbare canvas rather than of wool.
من خیلی میل دارم با افراد توده صحبت کنم و حاضرم در احقاق حق آنان کمک نمایم	I like talking to the peasants, and am always glad to do them justice.
از زمان اولین پیامی که دریافت کرده بودند به این موضوع وقوف یافته بودند	since that first transmission they had found out that the old woman
راهروهای بلند و تاریک آن از آرامش و قدوسیت محسوسی سرشار بود.	its dark high corridors awash with quietness and a tangible holiness.
درست مثل بیست سال پیش اسم هر احمقی را که دلم بخواهد به یاد بیاورم.	remember every fool's name as well as I could twenty years ago.
رفتار و حرکاتی جذاب و گیرا داشت.	his demeanor easy and prepossessing.
هیشکی نمیتونه به هیچ جوری باهاشون جوال بره.	nobody would fool around with a preacher anyway.
با دست دیگر به صورتش چنگ انداخت.	while she scratched his face with the other.
قطعات چرم را با ریسمانی که از کنف ساخته بودم خوب به هم دوختم.	well stitched together with hempen threads of my own making.
من بهتر از هرکسی می دونم که تو می تونی مواظب خودت باشی	I know better than anyone that you can look after yourself
مگر اینکه پهلوان غالب اسب خود را در جنگ از دست داده باشد	unless indeed it be that the victor have lost his own in the combat
ولی اگر راهنمائی این باشد که سربازان امنیتی کاخ محتاج به تعلیمات طولانی اضافی باشند و بایدیک دوره تعلیمات فشرده را ببینند	but if the advice was that the palace security troops needed extensive further training and a crash course, at that
موقع استراحت و وقت ناهارم عمدا مسیرم رو کمی دورتر کردم	I deliberately walked further than usual in my lunch hour
اما چیزی به جز ابر و آسمان ندیدم.	could see nothing but the clouds and sky.
آنقدر داغ که هیچ انگشتی تاب حفظ آن را نداشت.	so hot that no fingers can hold it.
به احساسات دیگران زیاد توجه نداشت.	little concerned about the feelings of others.
صرفا یک تصادف جالب توجه است.	was a remarkable coincidence.
در حالی که خود او کام لا مرده است.	the man being stark dead.
من خود همین الان برمی گردم.	I myself shall turn back at once.
متأسفانه باید بگویم که حق با تو است.	I am afraid you are right.
درست مثل زمان بعد از تصادف که مردم منتظر دکتر هستند.	as it might be after an accident, when people are waiting for the doctor.
من می خوام به تو چیزی بدم نه اینکه چیزی ازت بگیرم.	I want to give you things, not take things away from you.
او در دست شویی گیر کرده و چیزی را نشنیده بود.	she was locked in the bathroom and did not hear anything.
اما پروژه دوباره در حال پیشرفت بود	but the project was under way again.
امروز که میومدم بهش ۵ دلار انعام دادم.	I tipped him five dollars when I came out this morning.
شاید هم بعد از بیرون آمدن چاکر از منزل تا به حال رسیده باشد	it may have arrived since I left my office
بلکه جان و دلشان شادمان و خندان بود	but because gaiety and mirth were in their hearts
به همسر عزیزم خواهم پیوست.	I shall rejoin my dear wife.
اما باید یاد بگیرد که عقل او را هم بپذیرد.	but he must also learn to accept his brain.
تحمل کردارهایش موضوعی شخصی بود که با روابط و تصورات معنویش درباره مصلحت پروردگار تطبیق داده شده بود.	the bearing of his deeds a matter of private vision adjusted solely by spiritual relations and conceptions of the divine purposes.
پلیس در تعقیبشان بود و هرآینه ممکن بود سر برسد و پیدایشان کند.	the police were in pursuit and might even find them there at any minute.
هر کس که از او ستایش کند غیرمستقیم از ما انتقاد کرده است.	any one who admires him passes an oblique criticism on ourselves.
پشت خود را به بخاری کرد	spreading himself before the fire with his back towards it
پابرهنه از پلکان مرمری بالا رفتند	they sprinted in their socks up the marble staircase
برای همین آنجا مخفی شد.	so he lay in hiding there.
من استعداد راهنمایی مردم رو دارم.	I got the call to lead people
پول را گرفت و در جیب گذاشت .	he pocketed the bill
نتوانست بار دیگر فریاد نزند	she could not help bursting out again
بنابراین اگر این خیال را داری زودتر کلکش را بکن و خیال مرا راحت کن .	so if you mean ever to do it, make haste and have it over quickly,
گویی چای آن قدرت نیروبخش برندی را دارد.	as if tea had the restorative powers of brandy.
سه اسکناس از آن بیرون کشید و روی میز نهاد.	opened it, drew out three bank bills, which he laid on thetable.
اگر هم آزاری به او زدم. شکایتی نکرد.	if I hurt him, he didn't complain.
با یک حرکت پسرک بخت برگشته را از روی صندلی بلند کرد و وسط زمین و آسمان نگه داشت.	she lifted the helpless boy clean out of his chair and held him aloft.
اما تورو هیچ وقت ندیده بودم.	but I never saw you.
شما آقایان موظف هستید که در مجرمیت متهم شک کنید.	it will be the duty of you gentlemen to givethe defendant the benefit of the doubt raised.
خیلی دلم میخواس می تونسم اینو به تو بفهمونم اما غیر ممکنه	I wisht I could tell you so you'd know, but I can't.
مطمئن نبود که نادین راجع به چه کسی حرف میزند	he didn't know who she was talking about
سعی کردم نگاه خود را به جانب دیگر معطوف کنم و به آن نظر نیندازم.	I did not look at the cottage.
مرا به دنبال مشتی حوادث و ماجراهای پرخطر انداخته	to engage in many perils of various sorts
گچ را به کیتی داد و برخاست.	gave her the chalk, and stood up.
ولی اطمینان دارم که بعدها مرا دوست خواهید داشت.	because I am sure that you will have a kindlier feeling towards me later on.
ناگهان به حالت عادی درآمد	abruptly resuming his old manner
امیدوارم فکر نکنی که من مشغول رقص روی قبرمرده های عالم هستم.	I hope you don't feel that I'm dancing on the grave of the world, so to speak.
اما هرگز احساس فقر نکرده بود	but he had never felt poor
نیز نگریستن به حیات و اخلاقیات از پشت عینکی که فلان فرقه مذهبی به دستشان داده است.	the contemplation of life and conduct through the lens furnished by a purely sectarian creed.
حادثه بزرگی اتفاق افتاده	a great misfortune has happened
من هیچ اشتهایی به خوردن غذا ندارم.	I don't feel sharp
انگار سعادت هر دو جهانش به رنگ فلان پرده یا نیم رخ فلان یخدان قدیمی بسته بود.	it was as though her eternal happiness depended on the color of her hangings or the shape of an old chest.
از مدتی پیش فهمیده باشد	he had long ere this realised that
لباسش کهنه و فرسوده و چندان گرم نبود.	his clothing was old and worn thin, and it never had been very warm.
درِ بزرگ باغ را برای شب بسته بودند.	their gate was shut for the night.
من مثل ماهی از آب بیرون افتاده می منم.	I am a fish out of water.
اما البته راست است که در آن به حکم شئامت تقدیر زندانی شده بودند.	it is true that they were fatally hemmed in there.
اما به سؤال سوم که نتوانست آن را درک کند	but in reply to the third question which he did not understand said
نمی تونم اجازه بدم تارا رو ازم بگیرن!	I can't let it go!
با بیزای این یکی را به یاد آورد.	with loathing she thought of what she meant by that love.
خود تو هم ممکن است آدم دیگری بشوی.	you yourself might have become a different person.
همان رایحه به مشامش رسید.	he caught the smell.
حقیقت داشت که کلاید صرفا جوان آسمان جلی است	despite his looks and charm and family connections here
با چشمان خود اسیر را نشان داده	he indicated the prisoner with his eyes.
ناگهان با لهجه شیوایی شروع به وراجی کرد.	she suddenly commenced chattering fluently.
چون نصف دیگرش مال یک زوبین انداز است.	that the other half belongs to a certain harpooneer.
که هیچ وقت این همه ستایشش نکرده بود!	never had she admired her so much!
در همین موقع مرد دیگری که برجایگاه راننده قرار داشت پیاده شد	while another man, who had been seated on the box, dismounted too
سیلاب با جریانی پر حجم و سنگین بر سرم فرو ریخت.	in full heavy swing the torrent poured over me.
آنچه مورد نظر من است کلمه خطاست.	my word is error.
این چنین بیست و شش جلد نوشته بود.	so had scratched out twenty six volumes.
به تازگی او را خشک کرده بودند.	she had been recently stuffed.
با گستاخی نخندهای سر داد.	she laughed impertinently.
پشت سر شما به این میخانه داخل شدم	I walked into the wine shop here
پس سرش را با زلف مجعد تا روی زانو خم کرد و خنده بلند آهنگ داری در فضای تالار سر داد.	she bent her curly head to her knees and made the whole room ring with her laughter.
یا من مجبورم دور پارک بگردم و از آن دری که باز است وارد شوم	or else I must run round to the porter's lodge.
اما پس از قضیه رم کردن اسب امپراطور همین که از راه رسیدند پیاده به نزد وی آمدند	but upon the accident that happened to the emperor's horse, they alighted, and came near his person
آن دو تن جز پرتوی از این کانون زندهٔ مهر و نیکوئی نبودند.	the others were only reflections of that living fire of goodness and love.
هیچ آسیبی به شما نخواهد رسید.	no harm can befall you
الوارها ناگهان کج شدند و به شدت به بازویش ضرر وارد کردند.	a sudden tilt struck her arm up roughly
راستش از این کوتوله بی شرف خوشم آمد	I kind of admired the littlecuss
لیکن کاروانسرا دار که به کار خود بیش از کار سایرین توجه داشت	but the landlord, who minded his own affairs more than other people's
شوهر بهتری از آندره در این ایام با زحمت به دست آید	a better husband one would think could hardly be found nowadays
هر امری داشته باشید اطاعت خواهم کرد.	I am at your command.
گفتم که حساب مرا جدا نگه دارند.	explained to him that, my bill was to be rendered to me personally.
هنگامی که سربلند کرد و چشمانش به نگاه گرفته و ناامید فرد افتاد	when, looking up, her eyes met his dull despairing glance
اما هیچ مسرت احساس نکرد.	but he felt no joy.
واقعه امروزی اسباب صحبت امشب است.	this funeral is the news of the day.
چون آلبر را دید دست او را گرفته	she pressed her son's hand
امروز همهٔ کارها تمام خواهد شد	I'll settle it to day.
هرگاه که موقع اقتضاء کند حقایقش را بازمی نماییم.	when the occasionpresents itself, we tell the truth about it.
شرم را در نگاه خود بپوشاند.	quench the shame in her own.
دلم خیلی برای جنگل تنگ شده بود.	I missed the woods so much.
گردن او را فشرد و مرا از آن رنج رهانید.	who wrung off the bird's neck
اما من در این مورد فکر بودم که این تصمیم بیشتر نتیجه حسادت طبیعی بود تا احساسات مادرانه.	but I thought it was due to a very natural jealousy rather than to maternal solicitude.
چه چیزهای مضحک اتفاق میافته!	said he, what queer things do happen!
مجبورم به قوانین او احترام بگذارم.	I have to respect his rules.
چون روی میزش کاری دارد که باید امروز صبح تمامش کند.	because he has some work at his desk that must be done this morning.
به خصوص که ممکن است به پرحرفی و پخمگی تو هم نباشد.	not so thickheaded or talkative as you are.
که مکرر اسر او را شنیده بود .	, of whom he had heard much
دوست ندارم فکر کنید من آدم بزدلی هستم	I don't want you to think I am a coward
چون حالا دیگر تعطیلات تمام شده بود	for now the holidays were over
سر هیچ کس را نخواهم برید و کاری هم با دادگاه ندارم	I shan't murder anybody, and I've no need of it.
من از روزی که شما را شناختم	since I fell in with you.
خود برای ثبت نام وی رفت.	went himself to enter his name.
پاسخ داد از اوِرتور خوشم آمد	I liked the overture, was his answer.
اتحادی که نوع عالی و جدیدی از قدرت است.	which was a new and higher kind of strength.
روی سکوی ایستگاه منتظر ما بودند.	were waiting for us upon the platform.
یعنی در همان محلی که پیکار را به وقوع پیوست مستحکم ساختند.	at the very place where the battle was fought.
هنوز هم از این بابت اطمینان کامل دارم.	I knew it quite as well as I know it now.
فکر جدیدی در سرش افتاد.	an idea struck her.
که آن توله کوچک به ظاهر هنوز به واسطه آن به مادر خود بسته بود.	by which the young cub seemed still tethered to its dam.
فقط اعتماد دارم که هنوز باید زیاد زندگی کنید.	I only believe that you have long life before you.
اما از سوراخ کلید در نگاه کردم	but I looked through the keyhole
به این فکر افتادم که آخرین باری که کسی به او گفته بود دوستش دارد کِی بوده.	I wondered when the last time someone had told him they loved him was.
ماریا کارش را از دست داده بود!	her job was gone!
تا برای دو پسرش بهترین امکانات آموزشی ممکن را فراهم سازد.	in order to give his two boys the best education possible.
تا به زمین چمن نمناکی در کنار قلعه رسیدند.	damp grass right in the shadow of the castle.
که تو از آن بی خبری ولی من نیک میدانم.	that you know nothing about, but I do.
اما در باب این کاغذ مطلقا چیزی نگوی	but do not breathe a word of this letter
بدون آنکه به هم نگاه کنیم.	not looking at one another.
من فقط قصد دارم تصویری از او در ذهنم داشته باشم و بدانم چگونه ادمی بود.	I'm trying to get a picture of the man himself.
یک تراکتور کافی بود که زمین مرا بگیرد	a single tractor took my land.
من واقعاً اهمیتی به بچه دار شدن نمیدم.	I didn't really care about having a baby.
زیرا تاکنون سه جفت کفش برای نوکر خود خریده	for there were to be taken into account and deducted three pairs of shoes he had given him
من به تن او مانند فرشته ملوسی لباس خواهم پوشانید.	I'll dress him up for you as fine as you please.
او پیش تر به طرف ماشین دویده بود.	she was already running toward the car.
دستم از هر چیز مادی که بگویید کوتاه است.	I am thwarted in every thing material.
اما وال تیر خورده بدون آنکه به زیر آب برود همچنان به گریز بر سطح آب ادامه داد و تنها بر سرعت خود افزود.	but the stricken whale, without at all sounding, still continued his horizontal flight, with added fleetness.
تشکر به خاطر نیت خیر و رفتاری که در قبال او داشتی.	for every wish and every endeavour to do her good.
انگار که از هیچ چیز خبر ندارد.	pretending that she did not know the truth.
رئیس طرف محجر پله را به او تکلیف کرد	the president offered him the side of the railing
ولی من همیشه به نظرات شما گوش خواهم کرد.	but I'll always listen to your ideas.
که حتی در آن هنگام نیز به کلی از امکان برخورد نومید نباشد.	as even then not to be wholly without prospect of a meeting.
که بیمار از وی رضایت نداشت.	as the patient was dissatisfied with him.
پرسید که آیا استحمام آب دریا برای او مفید است یا نه.	she asked if sea baths would do her any good
اما از حضورش ناراحت بود.	but she felt ill at ease with her.
از این قرار هرچه بوده خراب بوده است!	one was dismantled from top to bottom!
هنوز خیلی چیزها در پردة ابهام بود.	much was still hidden by the shadows.
مرا معاف بدارید و این پنجاه فردریکتان را هم بگیرید.	I also beg to return you your five hundred gulden.
خود را غرق در احساس آرامش یافت	she let herself be saturated with a soft feeling of relaxation.
که گول تام را خورده بودند و کلاه سرشان رفته بود.	as being the dupes of a wily fraud
انگار که درد متعلق به اوست.	as if it had been her own.
دو آقا پریدند بیرون و کالسکه را سپردند به او.	the gentlemen jumped out, and the equipage was delivered to his care.
سعی کرد ایستاده بگذار دش	tried to stand him on it
این یک بحران موقتی است که بدون شبهه با کسالت پیشین شما ارتباط دارد.	it's a passing crisis, it's the result of your illness, perhaps.
یک کت رسمی مشکی کهنه به تن داشت همگی دور میز نشسته بودند.	was wearing a very old and rather moldy looking tailcoat.
من خودم بدون معلم یاد گرفتم.	I taught myself.
امروز فقطمی خواهم خوشحال باشم و بس.	to day I mean to be perfectly happy.
از او هم مطمئن باشید که یقین دارم با کمال شوق اطاعت خواهد کرد.	I will answer for him, count
مانند کوری بود که تیز گوش باشد.	like a blind man whose hearing becomes more acute.
هر چند نه تنها تردید داشت بلکه تقریبا مطمئن بود	though he not only doubted but felt almost certain
بلکه چون کسانی سوار بر قاطران را هوار خلیفه	but like men who rode canons' mules
زیرا در این حالتی که هستم هیچ علامتی و آثاری را نباید اهمال کرد.	but no indication should be neglected in this terrible situation.
زندگی این بیست ماههتان برای من روشن بود.	your whole life during the past twenty months lies within my knowledge.
اما همه کارها خود به خود انجام گرفت.	but it all got done as if of its own accord.
فقط همان یکی که تازه چهارده سالش شده بود.	only one, who had just turned fourteen
در دنبال کردن و سرانجام نیز در سقوط به ورطه آن رابطه ناپاک مرتکب شده بود.	he had committed in pursuing and eventually allowing him self to fail into this unhallowed relationship with her
قبلا به شما گفتم که برای من میسر نیست زیاد شما را ملاقات کنم	I have told you that I cannot receive you myself very often
وگرنه ما دست و پایمان خواهد شکست	or we shall go breaking our necks
که اشخاص هم عقیده او هم به معتقدات خود بیش از او پای بند نیستند.	was that the men who shared his views had no other construction to put on them,
بازم هر اتفاقی عجیبی پیش او مد منو با خبر کن ین.	I still want to hear about anything odd.
من در کنار برکه نشسته بودم.	I was sitting on the grass bank
برای بدست آوردن دل او تصمیم گرفت به وی قول ازدواج بدهد.	he determined to pledge his word to her to become her husband
مبادا که زن و فرزندانت را فراموش کنی.	don't forget me and your children.
اما بر خلاف از دیدار او بسیار خوشوقت خواهم بود.	I assure you I shall be happy to see hiM
امیدوارم جایی درست درمان برایم پیدا کرده باشی.	I hope you found me a nice pub
اما ایشان گوششان بدهکار نبود	she wouldn't hear a word.
من مدیون اون هستم بیشتر از چیزی که قابل جبران کردن باش ه.	I owe her more than I can ever repay.
روی زمین نشسته و پاهایش را به دست گرفته است.	he sitting on the ground, with his feet in his hands.
به تخت اشاره کردم اما از بس لباس روی آن بود جای نشستن نداشت.	I gesture to the bed, but it's covered with clothes.
به عنوان هر نوع خداحافظی یا ابراز احترامی فقط ساعت نه را دوباره تکرار کرد.	he departed, without more ceremony than an emphatic repetition of the hour of appointment for the following night
حتی نزدیک بود قول بدهد با نظر خیلی مساعد به این قضیه فکر خواهد کرد.	pretty nearly promised,moreover, to think of it, with the intention of finding it a very good scheme.
اما به جای باروت از لودانوم انباشته شده بوده است.	but, which, instead of containing gunpowder, was supposed to be charged with laudanum.
ضم نا یادم رفت کاغذ جوهر خشک کن ببرم و خودنویسم جوهر پس داد.	I forgot to take any blotting paper and my fountain pen leaked.
خود پیاده از میان شهر رفت.	went on foot through the town.
اما دستش به موهای درشت پیشانیش خورد.	he met only the short growth of wiry bristles,low on his forehead
برای آنکه به تجربه یقین حاصل کنم که این نوشته در خور حسن ظنی است که خود به آن دارم	to try if it came up to my own opinion of it
مهربانی ایزدی لبخند پر شفقش را.	the divine goodness of her smile of compassion.
من حاضرم در راه سعادتش هر کاری را انجام دهم.	I would do anything for his happiness!
با این احوال این کار ممکن نیست.	he rejoined with a sigh, after a short pause.
امار فتار رفتار او واقعا اهانت امیز است	but his his behavior is reprehensible.
حتی از همان وقتی که بچه بودم.	ever since I was a child.
مهم نبود که والدینت چطور هستند.	no matter what your parents were like.
با این وجود چنان مرتب که گویی هر قسمت برای گسترش خود جای کافی داشت	yet so well set out was it that it seemed that every part had room to spread itself fittingly
بهتره گاری رو نگه دارم و حرفمو تم وم کنم.	I guess I'd better stop right here till I've finished.
پس از آنکه اخم و شکلک میمون به اندازه خواندن یک دعای مختصر طول کشید	having kept this up as long as one would be saying a credo
همگان از وی چون دشمن دوری گزیدند.	people turned away from him as from a common enemy.
چون از حال مزاجیش جویا شدند	they asked him after his health
خنک ای غروب بر دشت تشنه و قله گر گرفته کوه سایه افکنده بود.	dew fell cool on panting plain and scorched summit.
مگر آن که به مرزهای سرزمین خودت رسیده باشی و نیازی مبرم به این کار باشد.	until you stand once more on the borders of your land, and dire need is on you.
که حالت هیجان آمیز سردار جنگی را در میدان کارزار داشت	who was in the excited condition of a commander on a battlefield to
فهمیدند که باید به واقعیت فکر کنند.	they found they must talk of the actual.
با آن که تمام روز را سرپا بودم	though I had been on foot all day
سپس با خشم و ناراحتی از جایگاه گذشت و در میان جمعیت ناپدید شد.	stormed off across the dance floor, disappearing into the crowd.
این حروف الف را بیادبسپارم	that's a thing to remember, that letter _a_
در تزئینات داخله کوشش و سعی به عمل آورده بود.	in the taste displayed in furnishing, and in the rapidity with which it was executed
بعد سه دفعه دور خودت بچرخی.	then turn around three times
واقعا مسی و دبرای چه شده و کجاست	apropos, what is become of him?
بعد از شام به خوابی عمیق فرو رفت.	fell sound asleep after dinner.
در حرکت با پاهای برهنه و راست و مستقیم چون پیکان با بافه های موی پرکلاغی نیم رخی آکنده از غرور و نخوت	stepping barefooted and straight as an arrow, with braids of raven hair, a thick, haughty profile
پنج برابر این عده کشتی سوخته و غرق شده باشد.	five times as many ships burnt or sunk.
بدون شک به آخر داستان رسیدم.	properly speaking that's the end of my story.
در عوض هر مبلغی که بخواهد قبلاً به او بپردازم.	offering him whatever payment he pleased.
به هوس کمک کردن به من میفت	give me no aid or succour
آن موقع فرصت خوبی است که این جاها را درست و حسابی بگردیم.	that will be our time for exploring.
تو فقط باید در صورتی در صحبت من مداخله کنی که کار خیلی مهمی داشته باشی.	you may interrupt me only if it is very urgent.
عمر تو به برطرف کردن آن کفاف نخواهد داد.	it could never be set right in your lifetime.
آن مرد با چهره آرام و مثل سنگ سخت و بی حرکت خود جواب داد.	he replied, maintaining a marble immobility of feature.
گل میخهائی که دست چپم را بزمین متصل کرده بود برکندم.	wrench out the pegs that fastened my left arm to the ground.
شاید مجبور بشوم از این شهر بروم.	I may be obliged to leave the town.
با لحن کم و بیش سردی گفتم	I cried with some bitterness.
اما هرگز راجع به عشق خویش با او سخن نگفته بود.	remained alone with her, but had never spoken to her of love.
باید واسه انسان بودن تمرین کنم	I'm out of practice with the whole human thing.
ناگهانی عصبانی شده بودم.	I was suddenly furious
چند نفر ناگهان به مترجم جواب دادند.	several voices at once began answering the interpreter.
اگر بیشتر به اطرافت نگاه کنی مطمئنم سموم مختلفی را در این خانه پیدا خواهی کرد	if you look around, I'm sure you'll find various poisons in the house.
اگر دشمنی با شخص پدرم داشت	if my father had offended him
من برای صرف شام به خانه شما خواهم آمد.	I will come to supper with you.
مردک در حدود چهل سال داشت و یقه لباسش قهوای بود و به شنیدن صدای پای او به سرعت از آشپزخانه گریخته بود.	a man with a brown collar, about forty years old, who, at the sound of her step, had quickly escaped through the kitchen.
مختصر آنکه منظورم آن است که مطمح نظر شماست.	in short, my meaning is everything you could desire.
شاید هم واقعاً ندیده بود.	perhaps she had not.
امیدوارم دماغش شکسته با شه.	hope it broke his nose
قایق حرکت آرام و خوشایند خود را از دست داد	giving up at once her gentle dancing movement
معمای من ممکن است تا ابد روشن نشود.	mine may remain forever a mystery.
که به همان اندازه متروک است برخورد کنند هر قدر هم بکوشند	if casually encountering each other in such inhospitable wilds, these twain, for the life of them
ولی منظورم این دور و اطراف بود.	but I was meanin' anythin' unusual a bit nearer home
پسرش را با معلم سر خانه عملی شود	his son, and the boy's tutor
پس از آنکه وضع کاروانسرا را سنجیدند	the accommodation of the inn inquired into
پیرمرد را دلواپس و ناآرام سرگرم قدم زدن در اتاق یافت.	he found the old gentleman walking to and fro in restless anxiety.
تغییر شکل من از فانی به جاودان	the brink of my transformation from mortal to immortal.
به نظر من باید ترتیبی داد که شب و روز یک نفر در بالینش باشد.	I have an idea that someone will have to be with him day and night.
صدا شنیده و دانتس دیده شد	he was both seen and heard
راستی که خیلی خوشبخت و راضی بودم.	I recollect and was very happy indeed.
چون خیلی وقت بود خبر داشت	for he knew of old
تردیدی نداشت که گابل این حقایق را که مستند در دست خویش داشت	no doubt he had put the fact in plea and proof, for his own safety
لکن عقیده دارد قاتل من هستم.	but, of course, he believes I did it.
کاری به چیزهای دیگر نداشت.	looked no farther.
که ابداً متوجه پرسش پدرش نشد	that she did not hear the appeal
مسلما قابلیت آن برای مغشوش شدن و پی گم کردن و منحرف گشتن است.	it can become confused, thrown off the track, and defeated.
لبانی گلگون و سبیلی نازک داشت و لباسش بسیار آراسته بود.	with a high colour, red lips, fashionably dressed, and moustaches.
دستش را به طرف قندان دراز کرد.	reached for the sugar bowl
او هم با شادمانی این قول و قرار را پذیرفت	he not only accepted the new conditions
راهی را برای فرار پیدا کند	some way of escape
در این قسمت اگر چیزی باشد به من خواهد رسید.	remember _this_ neighbour's goods are mine.
هیچ وقت از این کارها نکرده.	he'd do nothin' of the sort.
اما بعد از تعطیل کارخانه برای چند دقیقه به منزلت خواهم آمد.	but will drop around to the room for a few minutes right after closing.
زنی صاحب خانه یا سرپرست ملک او را برای روز مبادا بگیر!	somebody in the landlady way, or lodging letting way'and marry her, against a rainy day.
وقتی از آن عبور کردم بلافاصله خود را در روشنایی ضعیف دو ردیف از درختان سر به هم آورده یافتم.	passing through them, I found myself at once in the twilight of close ranked trees.
در یک همچو موقعی که من هوس راه رفتن دارم باران هم هوس باریدن کرده است.	I want a walk. I can't stand this sitting about.
بله هنوز هیچ اثری ازش پیدا نکردن آها.	yes no trace of him yet I see.
فکر نکن ین قرا ره با این گنده بک بهتون خوش بگذره.	I suppose you think you'll be enjoying yourself with that oaf?
این هم که ناراحت کننده نبود	what was little less uncomfortable
تم وم که شد خیلی خوشحال شدم.	I was glad when it was all over.
دست فربه خود را به دخترک لاغراندام داد و برای اینکه زیر بازوی او برسد دستش را بسیار پایین آورد.	lowering his big arm he offered it to the slender little girl.
این همه بنا به توصیه کشیش و دلاک بود که دانشجو قبلاً با ایشان مشورت کرده بود.	all by the advice of the curate and barber, with whom he had previously discussed the subject.
اون هم فقط به این دلیل که ربرتا تو کارخونه کار می کنه.	for instance, just because she worked in the mill.
مرگ یک دوست و جشن ازدواج نقره یکی از شاگردانش.	the death of a friend and the silver anniversary of an eminent pupil.
ولی کاری کن که متوجه بشود منظورم چیست. به بهترین نحو ممکن این کار را بکن.	but make him understand what I mean, in the properest way.
چه بسا بعضی از شما تا آخر همین کلاس بتون ین چیزی ببین ین.	some of you will see before the end of the class.
چنان صاف و براق بود که از تناسبی که با سراپای لباس سوار داشت	so brightly polished that, matching as they did the rest of his apparel
در آنجا یک ظرف کوچک دارو و یک لیوان کوچک پیدا خواهی کرد زود!	take out a little phial and a little glass you will find there, quick!
چون این موضوع چندان حایز اهمیت نیست	but as it is of no great consequence
غیر از این چیز دیگری نبود.	that was all.
که اینک در تاریک روشن شامگاهان مرئی بود ناگهان به شی وی و زاری پرداختند.	the smoke and even the flames of which could be seen in the failing twilight
در نتیجه حضور امپراطور آن مناسبات متزلزل و نامعلوم	from the consequent presence there of an indefinite, conditional
دیر یا زود باید با سرنخ درست رو به رو شویم.	sooner or later we must come upon the right.
از آن جایی که به من گفته شده	, since I have been told
با دلاوری و رفتار و وفاداری خویش قهرمان دفاع از شاه و مملکت خود گردند.	to be champions always ready for the defence of their prince and country, by their valour, conduct, and fidelity.
این پیرمرد بانشاط همیشه تندرست بود.	this jovial old man had always had good health.
اسکار لت دید که از فشار آهن زخم شده است.	raw from the chafing of the iron.
زیرا او گناهی مرتکب نشده است	which had not been in any degree her own fault
زیرا او طبعاً نازک دل بود.	for she was naturally tender hearted.
دروغ زیر این نقاب جای دارد.	the lie lurks beneath it.
شباهتی به سیاه گوش پیدا کرده بود .	giving them the tufted look of a lynx's ears.
مردی را در حال آمدن به سرسرا دید.	she saw a man coming along the hall.
دست را با نیروی سهمناکی روی شانه خود برد	with terrible strength he drew the man's arm over his right shoulder
خوب به یاد دارم لکن هیچ کس به این حرکت توجهی نکرد.	I remember that, but it was hardly noticed.
که آنچنان زیبا و ظریف سخن بگوید.	which formerly sprang so fluently from her ready wit.
در این صورت برای آنکه ایشان را وادارند تا با تأکید بیشتری به کسان خود نامه بنویسند	for then, to make them write for it more pressingly
لوله بخاری پاک کنی راندن نعش کش را به عهده گرفته بود	with a chimney sweep driving the hearse advised by the regular driver
اما احساس کردم که فقط یک نکته هست که واقعا اهمیت دارد.	but I felt that there was only one point which really signified.
بدون به جان خریدن خطرات و صرف پول زیاد	without a certain amount of personal risk and without a great profusion in spending his money.
توی اتاق خواب مادرش بود.	he was in his mother' s bed.
اون وقت ممکنه که سه هزار نفر راه بیفتن	maybe two three thousan' folks gets movin' account a this here han'bill.
که برود شلاقش را بخورد	to go to his punishment
که بعد از تمام شدن کلاس در کلاس بماند و میزها را بسابد.	stay behind to scrape tubeworms off the desks.
چگونه شوهرانشان مهربان خواهند بود و چگونه ایشان خوشبخت و سعادتمند خواهند زیست.	how their husbands would be friends, and how happy they would be.
منم باید به چند نکته اشاره کنم	I have a few points to make.
اکنون شما اعتراف من را شنیدید	now you have my profession of faith.
که هر لحظه ممکن بود فرو بریزد.	so crooked it looked
با احتیاط ازمحلی به محل دیگرمیرفت.	moving with great deliberation from one hold to the next.
شما لطفاً از نفوذتان استفاده کنید تا دوشیزه وودهاس متقاعد بشوند.	would not she give him her influence in procuring it?
همه این کارها را من انجام دادم.	I did it all.
در جواب رادنی گفت که جاروب کردن عرشه کار او نیست و آن کار را نخواهد کرد.	he answered him saying that sweeping the deck was not his business, and he would not do it.
شاید تنها دوستی عمیق بتواند هرگونه گرایش به انزواطلبی را نه فقط ناپسند بلکه زشت و تحقیرآمیز بنماید.	perhaps it is only to be overcome by a sense of fellowship deep enough to make all efforts at isolation seem mean and petty instead of exalting.
بسیار اندک به زنی پارسا شباهت داشت.	she looked very little like a devotee.
گفت و گو به بازی کریکت کشانده شد.	the conversation moved on to cricket.
وقتی آن دو از اتاق بیرون رفتند	when they had departed
او با من به جز مهربانی و دوستی کاری نکرده است.	I have seen nothing but kindness and affection from her towards myself.
که برای این چیزها که امشب گفت.	did I ever get so angry as over his words.
اکنون یک ساعت بود که بایست راه افتاده باشند.	they should have been on the trail an hour gone.
وقتی که ربکا در کابین بود.	when she was in the cabin,
ولی از دست من کاری سا خته نیست	but I can't help it.
دیروز فکر کردم که اسم کوتاهی است.	I thought it was rather a short name, yesterday,' I confessed.
در همان حال از دیدگاه قانون و کلیسا هم مجرم و گناهکار باشد.	yet nevertheless, as the law and thechurch see it, guilty of sin and crime.
این بالاترین حد شجاعت و دلاوری بود	which leaves nothing more to be said on the score of courage
با این حال اشتهایش حرف نداشت.	although her appetite was excellent.
خرده نان های ساندویچش را در آب ریخت	he sprinkled the crumbs from his sandwich paper over them
از سرما به لرزیدن پرداخت.	shivered with cold.
ناگهان اسبی با یک جفت لگد شکم او را درید	kick of a horse crushed his chest and a crowd of outsiders saw him die in the middle of the street
باید بگویم که خیلی سخاوتمند است.	I must say hes generous.
اما هنوز سخت در خطر بود.	but that he was still in great danger.
دنیا از مهی که درنزدیکی زمین بود پوشیده شده بود	the world was swaddled in a thick white ground fog
در ضمن مرا به زور در آنجا نگاه خواهند داشت.	they would secure me by force.
مگر در کارهایی که منافعی اساسی وجود داشته باشد.	for any job of work where there wasn't valuable consideration to be gained.
هیچ نشانه آشکاری نداشت که مقام بلند او را در کشتی نشان دهد.	to denote his gentlemanly rank on board.
من نمیخوام از کارت سر در بیارم.	I wasn't gettin' nosy
من هیچ نمی تونم آفتابی به شم مگه با ماسک.	I can't go out otherwise than masked.
من با تعجب به او نگاه کردم	I stare at her dazedly.
این کار از قدرت من خارج است.	it is past my power.
چندین بار یکدیگر را بوسیدیم.	we kissed one another over and over again
ولی من دریاچه به خصوصی سراغ نداشتم.	but not to any particular one that I knew of.
بعد از دعای سپاسگزاری برخاستم.	I rose from the thanksgiving
به جست و جوی او پرداخت.	he went to look for him.
احساسی دارم که شاید احمقانه و نادرست باشد.	I am feeling something which is perhaps foolish and wrong
هیچ یک از آن صداها لزومی ندارد	not one of those noises was indispensable
که رو به روی ده به جای بازی رسید	he came out into an open place opposite the village
پای شکسته دخترک درمقابلش در گچ بود.	her broken leg in its cast stuck out stiffly in front of her.
یعنی بنا شد تمام بانوان را در انباری که به کرات از آن یاد کردیم منزل دهند	that all the women should retire to the garret that has been already mentioned
اما خیلی زود از خواب بیدار شد.	but waked early
به زودی صاحب فرزند دیگر خواهیم شد.	I'm going to have a baby.
زیرا تابلو را از آنجا برده بودند.	for the picture had been removed.
باش لقی از نوع همان مخمل بر سر داشت.	a montera of the same velvet.
من از جایگاه خود بر سر دکل منظره خوبی از آن صحنه که برای هر تازه کاری در حرفه صید در دریاهای دور دست جالب استپش چشم داشتم	I had a good view of that sight so remarkable to a tyro in the far ocean fisheries
تو باید این سرنوشت را بپذیری.	you must accept it.
در اتاق پذیرایی بیش از ده ژنرال و افسر نشسته بودند.	where he found some ten officers and generals.
تا با تاجر کوچک اندامی که تمام بدن خود را در میان صندلی کوچکی فرو برده بود صحبت کند.	to address a salesman of small stature, who had squeezed as much of his person into a child's chair as the chair would hold
هر کار دیگری هم که لازم است انجام بده.	do anything there is to do about the room.
فقط فهمیدم اشعه خورشید تابان در آسمان پخش شده.	any more than the rising sun had rays.
تو دیگر از من ترسی نخواهی داشت.	you needn't fear.
مدتی به یکدیگر نگاه کردند	regretting their friend's flow of cleverness.
که از زندان محلی فرار کرده و در صومعه مخفی شده بودند.	who had escaped from the local jail earlier that night and were hiding in the chapel.
با گنبدی چارگوش که در وسط چمن پردارودرختی قرار داشت.	with a square cupola, very retired among some trees and a lawn
من گفتم ظرف سه روز باید راه بیافتیم	I said that we must put off going for three days
ما مور چاپارخانه اسب او را با یک چرخش به درون محوطه برد.	the postmaster turned his horse into the yard
برایش بسیار عجیب بود که	when he had found it difficult to believe that
اتفاقاً صدای زنگ هم بلند شد.	besides, the bell rang.
این امر باعث وحشت من شد.	to my infinite terror,
می خوام خو نه رو نشون دی زی بدم.	I'd like to show her around.
من کاری را که بلد بودم انجام دادم.	I did the work I was fit for.
اکنون که نام این مرد به میان آمد	so the mention of his name
کیتی خم شد و یک بابونه صحرایی را از حاشیه جاده چید.	she stooped down and picked a wild camomile at the edge of the path.
به کلی مبهوت شده بودم.	I was perfectly bewildered.
این همه امیران بزرگ و فرماندگان که گرد هم آمده بودند.	so many great princes and captains were assembled.
باز خوشحالم از اینکه کالسکه به راه افتاد	I am glad to recollect that when the carrier began to move
در ساعت غیرعادی یازده صبح. شاداب و تعمیر شده.	refreshed and renewed, at the unusual hour of eleven o' clock
یه چیزی از دل من گذشت.	then something seemed to go all over me, you know
من احتیاجی به تخفیف شما ندارم!	I don't care about lessening the sentence!
بعد آن دل را با دستمالی توری پاک کردم	I wiped it with a lace handkerchief
به خصوص که توأم با تمرین و عمل باشد.	if it be accompanied by practice.
مصمم هستم که هم خودم شخصا پیش او بروم و هم به دوستانم بگویم	it is my plan to see him personally as well as to have some other people
فقط کافی بود او را لخت نکند.	but without taking off her clothes.
من خودم میدانم که او دیگر احتیاجی به دوا ندارد.	I know you need not
در کارخونه شوهر من جائی برای خودش ون باز کنند یا نه.	he can make a place for himself in my husband's factory.
ممکن نیست که شخص در دنیا به کلی آسوده باشد.	one cannot be completely happy in this world!
اما امیدوارم که تمام این حادثه سوء تفاهمی باشد و هیچ کس در اینمورد تقصیر و گناهی نداشته باشد.	but I hope it was all a misunderstanding and that no one is to blame for it.
اگر اجازه بدهید باید بگویم حتی شما را	if you allow me to say so or yet yours.
چهار تن دیگر توانسته بودند از روی پرچین به حیاط پناهگاه بپرند.	four had made good their footing inside our defences
فقط جوابی مبهم دریافت داشت.	she received an evasive answer.
من در نخستین نگاه آن را شناختم	I instantly recognized
هنوز هم صدای او در گوشم بود.	I can still hear his voice in my mind.
مدارکی را تقدیم حضورتان خواهند کرد	will, produce before you substantiations of every one of them.
قاعدتاً باید اکنون حالم خوب باشد.	I should feel well
به قسمی که ما مانند اشخاص حریص و ممسک متصل در نگهبانی گنجینه خود هستیم	so that we are like those misers who are unable to absent themselves from their treasures.
من چندان که بتوانم از صمیم قلب به او کمک خواهم کرد.	I will help him as much as I can.
شما می تون ین همه یه کناری بایستید تا چارلی فرصتی پیدا کنه که با اون آشنا به شه.	you all would stick around for a while and he would have a chance to get to know her.
این بی شرمی را تحمل کند	lost his temper
یک سری کلمات را دائم تکرارمی کرد.	the same words over and over
اگر در اجرای اوامر تردید کند	that if he faltered
سپس ابروانش را بالا برد	then he raises his eyebrows.
آنقدر طبیعتاً خوب و باصفا بودند که در این باره هیچ گونه توضیحی نخواستند.	with their true natural delicacy, they abstained from comment
بخت و اقبال پیاپی به او لبخند خواهد زد	he should have a run of luck
بعد صدایش را بلندتر کرد	then raising her voice
مگر حاسدان بدسگال که هیچ خوشی و سعادتی از زهر حسادت ایشان در امان نیست.	except indeed the envious, from whom no fair fortune is safe.
به اتفاق هم به اجرای یک قطعه هیجان انگیز پرداختند.	she commenced an accompaniment in spirited style.
چون سن او بیشتر از این است که از این جور چیزها برنجد.	why, she is too old for such pettishness.
من کسی نیستم که از مبارزه فرار کنم.	I'm not one for running away from a challenge.
همین امشب از این شهر خارج بشوی	I want you to get out of this town.
چند تلوتلو خورد و یک مرتبه با صدای بلند برگشت روی میز	there it teetered for a few seconds before finally toppling over and falling with a sharp tinkle on to the desk top.
مستقیم به جلو نگاه کردم	I looked straight ahead.
در عطر گرگم به خواب رفتم.	I fell asleep to the scent of my wolf.
روح زنده گوشش بدهکار اصول ماشینی نیست.	the soul won't obey the rules of mechanics
هیچ کس را راجع به مرگ من متهم نکنید	so as to throw no blame on any one.
از این گذشته پدیدار شدن و ناپدید گشتن لوی هیجدهم .	besides, the appearance and disappearance ofLouis XVIII.
اصرار دارم که وصیت نامه را ببینم.	I insist on seeing the will.
قدری آن سوتر بازبرمیخیزم	now raising myself up again
خودش به دنبال من آمده بود.	where he looked me up
سر مرا در دهان فرو برد.	got my head into his mouth.
من هم از حال کوفتگی بیرون بیایم	I am left none the worse of it
اما مبارزین در تاریکی بدرستی نمایان نبودند.	as for the men
راستش ای نه که تو باطنت از ظاهرت بهتره.	I reckon you're a kind of a singed cat, as the saying is better'n you look.
یک بار به آرایشگر اصرار کردم که کمی از کف صابون را به من بدهد و از میان آن چهل پنجاه موی بن ریش شاه را برگزیدم.	I once prevailed on the barber to give me some of the suds or lather, out of which I picked forty or fifty of the strongest stumps of hair.
هردوی شما متوجه باشید که دوباره مزاحم من نشوید	take care, both of you, how you worry me again for nothing.
که شاید حق با او بوده است.	that perhaps he was right.
البته ممکنه اشتباه کرده باشم.	unless I'm greatly in error.
یک ظلم و بعد صد کار نیک!	a solitary wrongdoing and hundreds of good deeds!
رفتند ساحل رودخانه را بپایند.	went off to guard the river bank
هر چه باشد خانه فرسوده بود	the house was ramshackle after all
خوشحال بدم که او تلفن کرده بود	I was glad she had rung up
یا اینکه خودش تو خیابون منو دید.	heard of or saw this.
خیلی هم به او خوش گذشت.	he had a very good time.
هرگاه بتوانیم با هم توافق بکنیم	if we can come to terms
راننده از پرده به قسمت عقب سرک کشید.	the cabbie poked his nose through the screen into the rear compartment.
همه هم بهترین لباسشان را پوشیده بودند.	all dressed in their best.
محکم او را در آغوش گرفت .	held her tightly.
او را همراه خود بردند.	to engulf himself with her.
به او گفتم کسی معترض او نخواهد شد	I replied that she would not be harmed.
میزهایی سنگین و تیره رنگ انباشته بود.	loaded with heavy dark tables.
من ازشما نمیخوام که جلوی این وحشیگری روبگیرید ولی ازتون میخ وام که اونوفراموش نکنید.	I don't expect you to stop it, but I do expect you to remember it!
که هنوز به پایان نرسیده است	the end of which is still in suspense
قبلاً اطلاعاتی راجع به آن به دست آورده بودم.	I had heard of it before.
ظاهراً این شانس را هم نداشت	though there seemed no chance
یکی صبح پیش از سحر در راه پله.	one, on the staircase at dawn.
سر تا پایشان را اشک شمع گرفته بود	smeared from head to foot with tallow drippings
باید خیلی آزارت داده باشم.	I must have hurt you very much.
سقف نیز یکپارچه سیاه شده بود.	the ceiling blackened.
در زیر آن آفتاب سوزان ساعت سه بعدازظهر.	burning under the infernal three o' clock sun
چیزی نمو نده بود که جنگ تم وم به شه.	it wasn't long before the war was over
که دلیل خودکشی او چه بوده است.	if anyone knew the reason for the suicide.
تنهایی دست کم به همان اندازه برای تو بد است که برای من.	solitude is at least as bad for you as it is for me.
با تشنگی و گرسنگی و گرما و سرما	in hunger and thirst, cold and heat,
خودش در معرض خطر قرار بگیرد.	if it did not terminate as she wished.
زنجیر مرموزی که هر چیزی را به چیز دیگر میپیوندد.	the mysterious chain that links one thing to another,
او به اکسیژن نیاز داشت.	he needed oxygen
آن هم نه خرج بیهوده و بی موضوع	not by spending as he pleases
پارسال وقتی کلاه را روی سرش گذاشت	when he'd placed the hat on his head a year before
شاید ازدواج به مین زودی اتفاقی بیفتد.	may even be about to marry her before he leaves here?
از برادرم این مرد همان قدر نفرت داشت که من داشتم.	hated his brother with a hatred as strong as mine.
موجود متفکری نیست که این را نیازموده باشد.	there is no living being who has not done it.
با دو دست دو طرف سبیلش را گرفت و تاب داد.	with his elbows raised squarely, he twisted both ends of his flaming moustaches
شبیه به موهای قدیسین ظاهری مصنوعی داشت.	had the same artificial appearance as the hair on the saints.
هنوز چند دقیقه نگذشته خبر در ده پیچیده بود.	WITHIN a few minutes the news had spread
استادهای خوبی داشتند و کم و کسری و کمبودی درکار نبود.	with proper masters, and could want nothing more.
هیچ وقت ندیده بودم رویه شخص واقعی کلید کنی	I've never seen you obsess over a real person.
برای همیشه آن را تعطیل کرد.	she lost no time in putting a stop to it.
دیگر هرگز میل ندارم به آن زندگی برگردم .	I should never like to return to it.
حال اگر این غنی روزی فقیر بوده باشد	if the said rich man was once on a time poor
لکن امور تابستانی املاکشان مانع مسافرت آنان شده بود.	but they had been detained all the summer by business connected with their estate.
اصلا بهتره ازت پس بگیر مش .	I've a mind to take the watch back.
به دامان عقل سلیم باز گردید.	return to the bosom of common sense
دیگر به این چیزها فکر نخواهم کرد	she would not think about them
راستش آن قدرها هم خودمو شیک و پیک نکردم	I mean, I haven't really made much effort
در آن حد نهایی خیلی دوست داشتم مهارت خود را بیازمایم.	on the extreme brink I liked well to try my skill.
خیلی به رام غافلگیر کننده بود.	it's just been such a shock.
او نیز رفته و در را بست.	he went out, closing the door after hiM
با این همه از او پوزش نخواستم.	I didn't ask her forgiveness.
من هم امیدوارم از عهدهء سهم خود برآیم.	I hope to do mine.
اما بسیار بدخو و بد نهاد بود.	but of a morose and sour complexion.
من درباره اینکار خوب اندیشیدم و اکنون نظر راهنمایی خود را به شما خواهم گفت.	I have now thought the whole matter over and this is my advice, she began.
به طرف جسد ادوارد پیش رفته	he threw himself upon the body of the child
مردی با سر از در کلبه به بیرون پرت میشد و زیر پاهای جلو اسبی که در واکنش فقط گوش هایش را تیز میکرد می افتاد.	a cargador would fly out head first and hands abroad, to sprawl under the forelegs of the silver grey mare, who only pricked forward her sharp little ears.
عیب ندا ره اگه می خو ای برگردی به فروشگاه.	I don't mind going back to the store.
تو داری با یه مرد میلیاردر میری بیرون	you're going out to dinner with a multimillionaire.
زیرا او به قیمت پول واقف است و به طور یقین آن را قبول خواهد کرد	she quite understood the value of money, and would, of course, accept the gift.
دختر چین به پیشانی انداخت	she knitted her brow
باز مسخرگی را شروع کرد.	began another laugh.
چون دندانی بیرون افتاده است	stickin' out like a tooth.
ژان وال ژان کام لا از پشت سر دیدش.	JeanValjean had a complete view of his back.
لابد این پالان هم بنا به ادعای آن آقا زین اسب خواهد بود.	why, then the pack saddle must be a horse's caparison, as this gentleman has said.
دلیل ملاقاتم را جویا شد.	asked me the object of my visit.
در را از پشت محکم بستم.	I bolted the door.
اما نوعی دلهره برجای نهاده بود.	but it left a sort of nagging uneasiness behind.
با فرزندانی بزرگ که خوب تربیت شده بودند	their children grown and well behaved
دیگر چیزی را رسوائی خود نگفتم	not mentioning a word of my disgrace
حاضرم آن را مفت بدهم برود.	I'd like to give it away, he added bitterly.
ولی احساساتش در باطن از همین قرار بود.	but relatively of such was their nature.
چند قدم به سمت من او مد	she took a few steps after me.
من که بهتون گفتم یه ماشین استیشن پیدامیکنیم واونوعقبش میذاریم و ادامه میدیم.	we can get a station wagon, put him in the back, and go on
در تمام این مدت ما خبری از ملاحان یاغی نیافتیم.	all this time we heard nothing of the three surviving mutineers.
همگی به گرد او به زانو درآئید	kneel down kneel round her
مجبوره برخلاف میلش با این نگهبانا همکاری کنه.	you sometimes have to join forces with those you'd rather avoid.
که در آنجا در ساختمان باز بود.	where a door stood open onto the landing.
برای یک لحظه به آن فکر کردم.	I thought about that for a moment.
تو بار دیگر باز خواهی گشت.	he repeated from the steps.
با این همه پاک نومید نیستم که بتوانم پس از مدتی به یکی از یاهوهای همسایه اجازه دهم که با من هم نشین شود	I am not altogether out of hopes, in some time, to suffer a neighbour _Yahoo_ in my company
آرنج بر همان لبه پل نهاد.	leaned on his elbows
فکر کرد که بدون اجازه رسمی نامزدش قادر نیست در آن جشن شرکت کند.	she did not think it was decent to accept without the consent of her fiance .
حتی یک گربه هم در خیابان نبود.	not even a cat.
دیگر چیزی نداشتند که ذخیره کنند.	there was no longer anything to spare.
پسر عمو غرق تعجب و تحسین گردید	the cousin staggered
با این همه بسته به میل شماست.	however, just as you like.
که از گرسنگی مرده بود نیافت.	who had perished from hunger.
را که در جنگ وحشتناک است ادا کرد و این کلمه با بیم و ترس در میان جمعیت دهان به دهان گشت.	that is so terrible in battle, and that word infected the whole crowd with a feeling of panic.
به هوای داغ از بوی گس شن پر بود.	the raw smell of hot dust was in the air.
همه با هم یه بطر شراب کهنه بزنیم.	let's go drink a bottle of old wine together.
تا این که برآمدگی روی آن اذیتم کرد.	until the ridged vinyl started to hurt my forehead.
همواره یک چشمش به دخترش بود.	one's eye moved on quickly to her daughter
ولی ادعای سانکو نسبت به ترقیاتی که تا به آن وقت کرده بود به نظرش راست آمد	perceived that what he said about his improvement was true
جز این مطلبی دیگر ندارند زیرا چیز دیگری نیست که بر زبان آورند.	but no one ever gets any further than that, for there is nothing more to say.
احدی میل ندا ره که اعضایش ناقص به شه!	then who wants to be mutilated?
دی گه هیچ کس نمیتونه جلو شو به گیره.	nobody seems to be able to stop her
که تمام اهمیت یک تصنیف فقط در کلمات آن نهفته است	that the whole meaning of a song lies in the words
ولوله همچنان ادامه داشت .	almost crumpling beneath the weight of a disapproval she had never known before.
از بیم آنکه مبادا قربانی به دام افتاده از چنگالش بگریزد با گارد خود عازم میدان کارزار شد.	afraid of letting a ready victim escape
بعد از این هم پیدا نخواهی کرد. بدان که من از سر یاری یگانه راه را به تو نشان دادم راه دیگری نیست.	I have truly pointed out to you and in allhelpfulness the only way the only way
من هیچ وقت تو زندگیم این قدر خوشحال نبودم.	I've never been so happy in all my life
فکر نکن که می شه تنهایی در برابرش ون مقاومت کرد.	don't you go fighting them alone.
بازوهای خوش تراشش عریان بود.	her beautifully moulded arms bare
اگه دروغ گفته باشی یه رقص عالی خواهی داشت.	if you are telling me a lie, I'll lead you a pretty dance.
پایانش نیز به ظلمت پیوست.	his end was night.
نزدیک بود قلبش از کار بایستد.	making her heart jump.
اما به حمد الله که نشناختی.	, but you did,
به ویژه به فرمان برداری ذاتی غاز ماده که به طرز زیبایی با نیروی مردانه غاز نر هماهنگی داشت.	especially on the innate submissiveness of the goose as beautifully corresponding to the strength of the gander.
دیگر به همچو آدمی اعتماد نکند.	he would never trust a man like that again.
هیچ کس حق نداشت اعتراضی بکند.	one not to be bothered with at this time.
که مانند رختخواب پر از کاغذ شده بود	which was, like all the rest, covered with papers.
مثل اینکه صدای پای آدم میاد.	I think I hear some one coming.
به این حادثه جنبهٔ تفریح بخشیدند	they took it as a joke.
هنوز چند گرهی از تیر بلند راست را با پارچه مه تز پرچم از آب بیرون گذارده بودند و پرچم	leaving a few inches of the erect spar yet visible, together with long streaming yards of the flag
غم و رنج یک سال گذشته نتوانسته بود نیروی پهلوانیش را مقهور کند یا به استخوان بندی استوارش آسیبی برساند.	not in one year's space, by any sorrow, could his athletic strength be quelled or his vigorous prime blighted.
پنج سال پیرتر از آن هستم که به خودم دروغ به گم و اسمش رو بگذارم شرافت.	I'm five years too old to lie to myself and call it honor.
مبلغی در حدود دویست هزار دلار نزد من جمع شده است.	I must be holding two hundred thousand dollars in bets.
خیلی بیشتر از یک خواهر واقعی به رام عزیزه .	dearer to me than any blood sister could ever be.
عنصر جبنش را در دلشان نهفته داشتند	each possessed of the anlage of movement.
سینی ابزار کفاشی او و کار ناتمامش همچنان در جای خود قرار داشت.	his tray of shoemaking tools, and his old unfinished work, were all as usual.
دزد من نیستم ولی دزد را خواهم کشت	I am not a thief, but I'll murder my thief.
این پیشانی بزمین زدن جنبهٔ معجزه خواهد یافت و همه خواهند گفت	though it's a poor sort of prophecy, flopping like that.
صدایش را با ملایمت بلند کرد	he addressed to him in a gentle voice
فقط اسیر ابر توهم عشاق هستم.	I have only the supreme illusion of a lover.
حتما جایی رو اشتباه کردم.	I must have done something wrong.
چندان اشک شوق و محبت ریخت	shedding such tears of heartfelt joy
بعدش شاید جذابیتش بیشتر هم بشود.	then the attraction may be the greater.
هیچ اشتباه هم توش نباشه!	without any mistakes in it!
گیلاس دیگری برای خود پر کرد	poured out another glassful of brandy
ابتدا تقریبا گمان بردم این مجسمه سیاه بچه حقیقی است و به همان ترتیب نگاه داری شده.	at first I al most thought that this black manikin was a real baby preserved in some similar manner.
