اصرار داشت که سوار سورتمه بماند.	she persisted in riding on the sled.
کارش را به روی زانو گذاشت	she let her work rest on her lap
همان دربان لاغر و ضعیف نیز دم در نشسته بود	there was the same lean porter standing at the gate
واقعا لطف کردید که تشریف او ردید	I appreciate your coming.
بلکه این منهدم شدن بنایی است که به چه تدبیرات او را بالا بردم.	but the ruin of projects so slowly carried out, so laboriously framed.
دهانش را دم گوش بکی گذاشت	with his mouth close to her ear.
روز بعد خود او با پسرش رسید.	he and his son arrived next day.
در تمام عمرم چنین دروغ وحشتناکی نشنیده بودم.	I've never heard such terrible lies in my whole life.
در مورد سر نیز به همین گونه است.	as the rind wraps an orange.
در آنجا مرا تنها گذاشت.	where she left me alone.
ببینیم کدامیک از شما تا الان هجی کردن را یاد گرفته.	see if any of you have begun to learn to spell.
هوش و حواس من کاملاً سر جایش است.	I've got all my faculties as well as ever I had in my life.
طلای غیرمنتظره و بادآورده.	a windfall, unexpected gold.
به این اختراع بزرگ توجهی نشان نداد	without giving a thought to 'that stupendous invention
خرسندی که با دیگران تفاوت داری.	very conscious of your exclusiveness.
لکن کافی نیست زیرا شما باور نکردید.	but that's not enough, for you didn't believe me.
با هم به انبار گندم رفتند	went together into the granary
هرچند موضوع به هر حال اهمیتی ندارد.	though it's not important.
آن زن برایش جالب شده بود.	he was interested in her.
تا یه دفعه دی گه فکر کنم.	to have another think.
احتمالاً بزودی باز هم خبری از ما به شما خواهد رسید.	it is probable that you will very shortly hear from us again.
ناراحت گوشی را پایین گذاشتم.	I put back the receiver.
برای گردش به باغ رفت.	went for a turn in his garden.
آن کشوری که مرا در ساحل آن فرود آورده بودند	of the country where they set me on shore
هیچ دلخوری از او نداشتم.	I cherished no malice towards him
ببینم چه کاری از دستم بر میاید	I'll see what I can do.
اندوه آناپاولونا رست مانند آن اندوه عظیمی بود	her melancholy was just like the august melancholy
طنابی به کمر من بسته بودند	I had a line about my waist
به شرط آن که بچه ها به ننگ آلوده نشوند و خود از وجود آنان محروم و یا به تغییر طرز فکر خود مجبور نشود.	so long as the children were not disgraced, and he was not deprived of them nor forced to change his position.
که هنگام ورودش به اتاق به جانب وی حرکت کرد.	handsome moving toward her as she entered the room.
که همیشه در آن مسابقه سالانه شرکت کرده بود.	that he had been an assiduous participant in the annual competition
ناگهان به یاد بچه افتاد.	remembered the child.
اما نتوانست آن را درآورد	he couldn't get it out again.
ولی باید دورمنو خط بک شه.	but not with him.
اما من به زودی دریافتم	but I soon observed
بغض گلویش را گرفته بود	he had to keep swallowing
امیدوارم از یک لحاظ اموراتش از دوشیزه تیلر بهتر بگذرد	I hope she will be better off in one respect
به سوی میز خالی جلوی دخمه رفت.	dragged it up to the front of the dungeon to the empty table.
با نگرانی این حرف را زد.	he said anxiously.
بدون آن هم به قدر کفایت مصیبت دارم.	I have enough without that.
اجازه بده به چیزی بپردازم که بسیار حائز اهمیت است.	let me end on that which is most important
فقط به دنبالش راه رفتم	I merely followed him round
فوری بروشور را در جیب صندلی گذاشتم	I stuff the safety instructions quickly back in their pocket
دو جزء قایق در هم شکسته را قبلا به کشتی برده بودند	the two parts of the wrecked boat having been previously secured by her
عشقتان را بدل به نفرت کند	to turn your love into rage
آشکار بود که بسیار جدی بود.	it was evident that he was very much in earnest.
فکر کنم باید باهاش حرف بزنم قبل از اینکه تورو به بینه.	I think I'm going to go talk to her before she sees you, I murmured under my breath.
به نظرم صدای پای اسب شنیدم.	I thought I heard a horse.
من از تقدس این ناشناس خوشبختم.	I'm glad of the holiness of breakfast.
که عاشقش است و تمام زندگی خویش را فدای او کرده است	who loves him and has sacrificed all her life to him.
به جانب بندرگاه دیگری روانه شوند.	setting sail for some other harbor.
به دیوار پشت سرشان چسبیدند.	backed against the walls
مرا تکذیبی تام و تمام واضح و مفصل لازم است.	with anything short of an entire retractation
اکنون که روز است با آنکه امیدی به یافتن آن نیست امیدوارم که موفق شوم	now that it is daylight I count upon finding them when I least expect it
با او بر تختخواب افتاد	scrambled into bed with him
چون کمان قدرت آدمی ممکن نیست همیشه کشیده بماند و ضعف بشری نیازمند است به اینکه از تفریحات مجاز نیرویی تازه بگیرد.	for the bow cannot be always bent, nor can weak human nature exist without some lawful amusement.
برگرد و نتیجه را به من بگو.	return and tell me.
از جوابی که داده شد فهمیدم خانم دنت به او یادآوری کرده بود که یکی از افراد آن صنف ملعون در آنجا حضور دارد.	from the answer elicited, it was a reminder that one of the anathematised race was present.
این مسئله ناشی از به هم پیچ خوردن دوقلوهایی بود که در شکم داشت و سه روز بعد هم در اثر خونریزی شدید جوان مرگ شد.	she died three days later, poisoned by her own blood, with a pair of twins crossed in her stomach.
لکن چوپان او را اخراج کرد.	but the cowherd would not have her.
مجاناً به کشوری آزاد می فرستادنش.	shipped to his new land free of charge
مردم هیچ احساس شعر و زیبایی ندارند.	they haven't any feeling of poetryand beauty.
چهارده سال انتظار آزادی و خلاصی خود را کشید	he had waited fourteen years for his liberty
شماها هم از دردسر و خطر فراری هست ین.	YOU don't like trouble and danger.
به شرط آنکه روابط بعدی آنان عادلانه و صادقانه باشد.	if only their future relationship can be an honourable and straightforward one.
از این جمله تقریباً گیج شده بود.	rather flustered by this onslaught.
لکن بهتر است فردا عذرش را بخواهید.	but I strongly advise you to pack him off tomorrow.
اما باز هم جوابی نیامده بود.	but again there was no answer.
اسب کرند خود را جلو پلکان اداره نگه داشت و تازیانه خود را تکان داده چیزی به دهقان داد زد.	stopped his sorrel at the steps of the town hall, and waving his whip in the air, shouted to the peasant.
پنبه توی حیاط و جلو خانه روییده و طویله را در بر گرفته بود.	grew in the dooryard and up against the house, and the cotton was about the shed barn.
به پدرش چشم دوخته بود.	watching his father narrowly.
کارهای دیگری انجام دهم که در دفتر وقایع آن امپراطوری تا ابد ثبت شود	perform those other actions, which will be recorded for ever in the chronicles of that empire
دی گه هیچ کاکا سیاهی حق ندا ره این جور در موردش صحبت کنه.	then it's not for any darky to talk impudent about him.
مرد مریض ناگهان فریاد زد و سپس ساکت شد.	the man on the floor cried suddenly, and then was silent.
در حین گفتن آن فریاد کشید	he would exclaim as he said this
گویی همه چیز در خواب بود.	everything seemed asleep
کارهای گربه هم عجیب و غریب بود.	the behaviour of the cat was somewhat peculiar.
احمقانه به تو اعتماد کردم.	I trusted you.
از طرف هنگ او را برای تهیه اسب فرستادند	by his comrades, was sent to obtain remounts
اما اگر روزی ازدواج کنم بدان که برای همیشه است.	but when I get married, it will be forever.
فقط صبر و بردباری لازم دارد.	it was simply a question of patience.
اومی خواهد از اسم تو بیش از اسم خود استفاده بکند.	he means to be more the master under your name than in his own.
بقیة شش پنی را هم به مصرف ناهار رساندم	I paid sixpence more for my dinner
فکر کردم دیوانه شده است.	I thought he was mad.
یک دقیقه بعد لباس پوشیده	a single minute later he was dressed
به من اشاره کرد که در آن پا گذارم	making me a sign to step into it
سربازها به خانه وارد شدند	entering the yards.
یا به حدس قریب به یقین چون همان گونه که قبلاً گفتم این قلعه جادو است	or perhaps and this is more probable this castle being, as I have already said, enchanted
هر چیز دی گه رو که تو دنیا دارم	every thing I've got in the world.
سرم را محکم تکان دادم	I shook my head vigorously.
اما یقین هم ندارم که بهترین طرز بیان آن توسط نقاشی باشد.	but I'm not sure that the best way of saying it is by means of painting.
زانوهایش را بلند کرد.	brought up his knees.
پیش از امضای سفته سخت نصیحتش کند.	before giving his signature he must give a rather strong admonition.
حالا اگر به رفتنش فکر کنم حتما دیوونه میشم .	I'll go crazy if I think about losing him now.
فردا صبح خواهرم یادم بی اندازید که کلاه کوچکم را که توری دارد سرم بگذارم.	tomorrow morning, sister, you must remind me to put on my little cap that has lace on it.
در هر حال باید پیشنهاد او را رد کرد.	all the same, you must refuse him.
ضمناً پیپ او هم خالی شده بود	his pipe being by this time smoked out
من به خاطر دفاع در برابر این جانوران منفور دچار درد سر بسیار بودم	I had much ado to defend myself against these detestable animals
زیرا ممکن است از این هنرها کسب شهرت و افتخار کند	for though they brought him fame
آن که را که باید فراموش نمایم.	all that I do not wish to remember.
من آدمی نیستم که در مقابل اضطراب و گرفتاری تسلیم شوم و شهامت مقابله نداشته باشم.	I'm not one of those men who submit to uneasiness and worry without having the force of character to face them.
آب دهانم را به سختی قورت دادم.	I swallow hard.
متأسفانه میز اطاق گرد بود	that the table was a round one
در حالیکه بیشتر متعجب شده بود	becoming more and more excited
خیلی تنها هستم و به یک کسی احتیاج دارم که سرم را گرم کند.	I'm solonely and I need somebody to cheer me up.
از همان پی به اصل و نسب پست و ناچیز او خواهند برد.	will show the thread of her coarse homespun stuff.
ناچار از کار کردن باز ماندم.	I was not able to work.
با احتیاط و یواش به طرفش رفتم	I went for it, cautious and slow.
بلکه پیش پرداخت سهم آتی او از سود حاصل است.	but an advance out of his future share in the profits.
جسم خود فرمانده کل نیز به خواب و تقویت نیروهای خویش نیازمند بود.	the commander in chief himself needs sleep and refreshment to maintain his energy
ولی خشکی آن به نحوی بود که مشخص بود با کمی ورزش خوب خواهد شد.	but it was the kind of stiffness you know will work out with a little exercise.
درست نیست که این کار را بکنم.	I couldn't do that.
به دنبال حوادث و ماجراهای عادی خود خواهیم گشت	seeking our adventures
برخاستم و آن را برداشتم.	I wandered to the table beside the bed. I picked up the book.
جمعیت با نعره سبعانه به طرف وی هجوم آوردند	the crowd closed in with savage yells and swayed about him
معتقدیم که یک یادآوری دایم قبر برای زندگان لازم است.	we believe thata perpetual memory of the tomb is proper for the living.
من خیلی کم وقت مطالعه دارم.	but I have little time for reading.
اما در پانزدهم همین ماه تلافی ضرر نمودیم.	but on the 13th we made up for it
بر تختخواب خود نشانید.	made her sit down on the bed.
قایقی که در آن نشسته بودیم	the little gallipot of a boat that we were in
اما بابت من دلواپس نباشید.	but have no fear for me.
برای حضور در آن مراسم حاضرم نه یک روز بلکه چهار روز سفرم را به تأخیر بیندازم.	I would delay not to say a day, but four, for the sake of seeing it.
ناگهان به گریه افتاد و اشک در چشمش ظاهر شد.	he suddenly sobbed as his eyes filled with tears.
منتظر شدم تا حرف بزند.	I waited for him to go on.
در آن لحظه راضی بودم زنبور یا سوسمار باشم تا بتوانم در اینجا غذای مناسب و پناهگاه همیشگی داشته باشم.	I would fain at the moment have become bee or lizard, that I might have found fitting nutriment, permanent shelter here.
به ترتیبی که بذرافشانی براساس نوین انجام گیرد.	so that the sowing might be undertaken on a new basis.
امروز صبح صدای زنگ را نشنیدم.	I didn't hear the rising bell this morning
اگرچه هنوز سر جای خود بودند.	though they were still there.
تا بادکنکی عظیم را ستایش کنند	to express their wonderment at the ascent of the enormous balloon
همه به کار خود مسلط بودند.	they were sure of themselves.
علایق مشترکمان به علم موجب شد با هم صمیمی شویم.	a community of interests in science kept us so.
می دونم به نظر احمقانه میاد	I know that sounds backward.
سابقا عضو دانشگاه و استاد فلسفه بود	he was a university man, and had been a professor of philosophy
به چنین گرسنگی سختی خو نگرفته بود	hadn't been used to that sort of thing
با یک دست اولیور را گرفت	assisted to hold him with one hand
اشک در چشم و التماس در صدا .	tears in her eyes at the jeering note in his voice.
چندین بار بیهوده مشتش در هوا بلند شد	upon which, she made a few ineffectual struggles
تنها به علایق و منافع صنفی خود توجه داشتند	of those preoccupied with personal interests imparted great confusion
امیدوارم فهمیده باشید منظورم چه کسی است.	I hope you know by those marks what young gentleman I mean.
وقت خوبی برای بخشش و فراموش کردن گذشته است	it is high time to forgive and forget
بیش از هر وقت دیگ ه دوستش داشتم.	I loved her more than ever.
اما من آن را نخواه پذیرفت.	but I shall refuse.
آن قدر صبر نمایم تا او برود	I'll wait till he leaves
من حاضر نیستم برای شما هیچ کاری بکنم.	I will do nothing for you.
هر کاری که لازم باشد انجام خواهم داد.	I'll do what has to be done, .
حتماً با آن پیراهن خیلی گرمت است.	I am sure your dress must make you feel ill.
منظورم آینه که تو نبایدم او نارو دیده باشی.	I mean, you're not supposed to see them, are you?
اگر شانس بیاورند و خواهرزن خوبی مثل من گیرشان بیاید	if they were fortunate in choosing their sisters in law!
شادی و امید دومین محرکم گشت.	my second was towards joy.
در آن روزگار ارزانی چهل سنت قیمتش بود	worth forty cents in those easy times
حاضر برای کمک و خوشحال کردن همه.	ready to help and cheer all.
این بار نیز چنان گرم کار شد که سر تبر در میان چوب گم شد	as he worked toward the center of the log the axe head disappeared entirely inside the cut
هیچ یک از صفحاتش به مرکب قرمز آلوده نشده بود.	not one of which had a trace of scarlet ink on it.
ناگهان همه چیز واضح بود.	suddenly everything was absolutely clear.
اگر من هم عقیده به جنون او نداشته باشم خود دیوانه و احمق خواهم بود.	I should be a dull blockhead to doubt it.
حرارت بدن او باعث میش دکه آژیر به صدا درنیاید.	her body heat keeping the sensors from sounding the alarm.
به شما شجاعتی بدون جسارت بیجا	brave without rashness
او آزادست که هرگاه بخواهد به حضور ملوکانه ما شرفیاب شود و مشمول عنایات و مراحم ما گردد.	with free access to our royal person, and other marks of our favour.
تازه خیلی با کارهای دیگرت فرق دارد.	then it is all so different from what you have always been.
آن دری است که نگهبان جل وش ایستاده است.	here is the door where the sentry stands.
باید به صورت زندگی نگاه کنی.	you must look life in the face.
کشیش از کف دستش کلی انفیه استنشاق کرد.	the priest drew in an immense quantity of snuff out of the hollow of his palm.
شنل مشکی بلندی مخصوص سفر به خود پیچیده بود	swathed in a long black traveling cloak
یعنی اگه خودش گریه نکنه حر فاش آزاری ندا ره.	anyways it don't if she don't cry.
صدای حرکت صندلی به گوش رسید.	the sound was heard of a chair being pushed back.
گذشته از واهمه ناشی از این واقعیت که یکیاز مست حفظان مدام مست بود	apart from such considerations of present danger as arose from one of the patriots being chronically drunk
اما شکل این خلیج باریک و دراز بود	but the space was longer and narrower
همان بود که فرشتگان در آن شب که روز ما بود اعلام کردند	was that which the angels announced on the night that was our day
آن را راست در هوا بلند کرد	holding it erect in the air
پس اگر کسی بر فرض از کاغذ بپرسد پاک انکار کن که خلاصی تو در این است	should you therefore be questioned deny all knowledge of it deny it boldly and you are saved
نوری که او در خدمت خود داشت	which had her at its beck and call
آیا حاضر است به خانه شوهرش بازگردد.	whether she will return to her husband
راز مقدس برادری خود را که نمودار برادری انسانی است نمایش داده و خوب از عهده برآمده بود.	the holy mystery of fraternity, symbol of the human fraternity.
آزادی امرار معاش از طریق شغل مشروعی که ممکن است انتخاب کنم.	maintaining myself by any lawful occupation I may choose.
زیرا گرچه ورود ما موجب ازدحام همه درباریان شد و به حد کافی سرو صدا راه انداخت	although our entrance was not without sufficient noise, by the concourse of all persons belonging to the court.
کنت عدالت را در موردم انجام داد	the count will do me the justice
خواهم گفت که آدم با فکری هستی و مهربان و آدم سختگیری هم نیستی.	I'll say that you're thoughtful and kind, and you're not exacting
ولی از ترس و وحشت جرئت نداریم نظرمان را بر زبان آوریم.	but we're just too scared to say anything.
یک دست لباس راحتی ششصد کوپن بود و زیر پیراهنی کثیف و شورتی را که روی صندلی افتاده بود برگرفت.	a suit of pyjamas was 600 and seized a dingy singlet and a pair of shorts that were lying across a chair.
یا از پلکانی مخفی سقوط کنی	either fall down some hidden staircase
راننده به مستخدمه گفت	he said to the waitress.
که آن روز ردای ارغوانی بسیار روشنی به تن داشت.	wearing robes of palest mauve today
ظاهراً قرار بود صدها مایل طی کنیم.	we appeared to travel over hundreds of miles of road.
من به هیچ روی قصد ندارم شما را تحریک کنم	I am not trying to egg you on.
به دنبال کنت راه افتاد	followed the count into the room
بی درنگ هفت هشت مفر به درون کالسکه و ده دوازده نفر بیرون کالسکه اطراف جای سورچی نشستند.	the coach was immediately filled with eight inside and a dozen out
ولی شما صدای مرا نشنیدید.	but you cannot have heard me.
چون بارها در زندگانی سختی دیده بودم	having been often reduced to hard fare in my life
تا آنجا که بتوانیم اکتشافاتی کنیم.	make what discoveries I could.
ولی این لعن و نفرین نه فقط بدین جهت است که ما باید با عرق جبین نان خود را به دست آوریم	because we have to seek our bread in the sweat of our brows
هنوز تحمل نگاه کردن به وان یه حمومو ندارم .	I still can't stand to look at a bathtub.
دیگر چیزی باقی نمانده است.	he has left me nothing nothing!
شما دو تا هم پشت سر من بیاین.	you two come right after us
که مادرش از بدو تولد در وجودش جای داده بود.	called on all the haughtiness she had been born,
یا دست کم بخشی از واقعیت را.	or, at least, a part of the truth.
تا وقتی جسد وال فرو رفت بدانند وقتی بالا آمد کجا باید دنبال آن بگردند.	they know where to look for it when it shall have ascended again.
یک دفعه دیگر به شما میگویم که هیچ برای اطلاع دادن به من ندارید.	I repeat to you that there is nothing which you can tell me.
ه ی چ وقت با اون سرعت در تمام عمرم نقل مکان نکرده بودم.	I've never moved so quickly in my life.
پاهایش را روی هم انداخت	crossed his legs
مطمئن باشید دیگر به او فکر نخواهم کرد.	I certainly do forget to think of her
گویا تازه کتک خورده بود.	probably he had just had a beating.
در آنجا به زندگی آبرومندانه خود ادامه دهند	where they might decently submerge themselves until themisery
عشق به دنبال این است که شعف درونی اش را با زیبایی بیرونی ثابت کند	it seeks to prove inward joy by outward beauty
اما بدان که ممکن است باز هم از شوهر کردن بت و چشم بپوشم.	I may not marry you, either. I don't know.
آن گاه بر خود صلیب کشید.	she crossed herself.
توانستند اندازه و تناسب دقیق اندام مرا معین کنند.	they fitted me exactly.
ورود او به خانواده شاهزاده آندره برخلاف میل و اراده پدرش زشت و ناشایسته بود و او خود مایل به این امر بوده است.	that it would be a bad thing to enter a family against the father's will, and that she herself wished it so.
که ناگاه آهنگ صدایی از دور به گوشش رسید	when the sound of a voice, still at some distance
اما وضع او باز بهبود نیافت.	but still his affairs did not improve.
اما دلش همچو گرفته بود	but there was such a leaden dread at his heart
او بدون تعجب و هیجان با بروز احساس به خبرهای قاصد گوش داد.	without surprise, without any active sentiment whatever.
امیدوارم که از یک زندگی طولانی و شاد و کسل کننده لذت ببری.	I hope you enjoy a long, happy, boring life.
اگه تو جیبش سوپ بلال هم داشت.	I wish he got a pot of hominy in his pocket.
تفاوت از زمین تا آسمان بود.	the difference was very distressing.
منتظر مانده بود تا پیشامدی مهم طرح آن را آسان سازد.	waiting, until it should be introduced by some decisive event.
من به کسی مثل تو احتیاج دارم.	I need someone like you.
فقط یک عایق دیگر یعنی مرکز سپاه دشمن باقی بود.	there now existed but onerallying point, the centre.
هرلحظه ازاحساسش یک هشدار بود.	every sense alert
اما در این انتخاب موفق نبودم.	but the obvious choice as ever failed.
برای او آتش خوب و زیبا بود.	the fire was beautiful
آن بود که نیاز داشت دور باشد	was that the one she needed most kept aloof
قدری خاک به روی سنگ پاشید و اثر حرکت را زایل نمود	the abbe sprinkled a little dust over it to conceal the traces of its having been removed
خوشبختانه به همه خوش گذشت و همین بالاترین چیزهاست.	I think everyone enjoyed themselves good and hearty, and that's the main thing
شوهرش از خشم منفجر شد	exploded her husband.
من به شما علاقه دارم. با من بیایید.	I ask you to come with me because I want you and your company
کشتی در اختیار ما خواهد بود	why we'll fight the ship.
قایق اسباب بازی او را به اوج مسرت رسانده بود.	the toy boat had raised her to the heights of joy.
من برای یک ماه تحت فرمان اویم	I am under his orders for the next month.
من حقیقت را به شما خواهم گفت.	I'd better tell you the whole truth.
درست مثل یک آدم مرغ دزد.	ostracized as a chicken thief.
او نیز چنین مرتعش شده بود.	so she rocked
خود نیز در قایق نشست و به طرف دهانه بندر پارو زد.	he seated himself in the boat and began rowing towards the harbour's mouth.
گرچه مغرور بود که پیوسته با مد روز هماهنگ است.	though he prided himself on keeping up with whatever was the latest fad.
پس تفصیل هدایت یافتن بناپارت را برایش بگوی	let us proceed therefore to the usurper's conversion
باری با هر وسیله که باشد طوری شود	if by any mean
با این همه پس از اینکه دوباره آن را به دقت مرور کردم چند جا را که چندان مهم نبود قلم کشیدم	however, upon a strict review, I blotted out several passages.
بر روی پلکان مارپیچی مرمری قدم گذاشت.	stepped onto the foot of a spiral stone staircase
به گه که سه ماه نمی تونستم با دستم کاری بکنم.	about how I couldn't use it for three months
اما خوب و بدزبان چیزی مثل من منتها او خیلی بیش از من است.	but a swearing good man something like me only there's a good deal more of him.
از دار به پایین کشاندشان	but he had them taken down
اکنون چیزی از آن باقی نمانده بود به جز اجساد متورم و متلاشی شده و مریض.	of which nothing remained but pestilence.
احتیاجی نبود او را ببیند.	she didn't have to see him.
که گرد و خاک گرفته و بسته بود.	I seen it all shut up and dusty
دکتر سلاح از دست او گرفت	beat down his guard a
پاهای کوچکش به حرکت درآمد.	her small feet turning under her
آدم باید تمام عمرش را بگذارد روی این کار تا به جایی برسد.	if you devote yourself to it, you get on.
دی گه مثل کنه به آدم میچسبن!	something more than they did!
جسد ژنرال کسنل است که کشته شده	the general has been killed
من یک بار یک هفته به خاطر برف در منزل یکی از دوستانم ماندم.	I was snowed up at a friend's house once for a week.
این نکته کام لا روشن است. قبلا هم دربارهٔ او مطالب عجیب و غریب شنیده بودم.	I have heard curious tales about her before now
همه از شرم تا بناگوششان سرخ شده بود.	everyone with a red face, you may be certain
بهتر است که صدایش را درنیاورم و اصلاً ننویسم.	I'd better lay low and keep dark, and not write at all
برای مکالمه در باب مالیات کشور	, and inscribed his name to speak against the budget
که در اینجا خاطر نشان شد و از این پس بیشتر توضیح داده خواهد شد.	which is here pointed out, and will be still further elucidated.
تحمل ندانستن را نداشتم.	I couldn't stand not knowing.
اگر آنچه انتظارش را داریم در زمان ما به پیروزی برسد	if it does come, while we live to see it triumph
خلاصه چنان ما را چپاول کرد	I say, we were so robbed,and hunted
ساعت را در آن جای داد .	laid the watch in the palm.
به نظر من شروع اختلال مزاج شما تا حدی همزمان با خروج شما از دانشگاه بودهاست.	I fancy the first stage of your derangement coincides with your leaving the university.
هرگز نتوانسته بودند فرزندان خود را در یک مدرسه واحد نگاه دارند.	they had neglected to keep their children in school in any one place.
اما همین طور در جایی ایستادن	this standing still
سربازان سر نیمکت را بلند کردند و پیرمرد در میان قهقههٔ خنده بر زمین معلق شد.	they lifted the bench and the old man toppled over amid roars of laughter.
انعکاس حریق دیگری را مشاهده کرد.	the small glow of another fire.
من اصراری ندارم که دائم با تو باشم.	I don't want to go with you.
ولی جلو خودش را گرفت.	but he restrained himself.
صد دلارم حالا بدند من این اسب و نمیدم.	hy, I wouldn't take a hundred dollars for that horse now
مشتاق آشنایی با او بودم.	I had a sudden desperate yearning to get off with her.
کاری به دنیا نداشته باشد.	made no sense whatsoever.
دیگران همه از مردان صاحب مشاغل گوناگون بودند.	there were various professional men.
من می دونم باید بیشتر تمیزش کنم.	I know I should clean it more
در محیط قشونی که وارد پیکار شده بود پیوسته بیشتر نفوذ کرد.	penetrating farther and farther into the region where the army was already in action.
هیچ لزومی ندارد که از چیزی بترسی.	you've no need to be.
اما امیدوار هستم که بلندی دستم عوض کوتاهی شمشیرم شود.	I think the arm will make up for the sword.
من به دروغ گفتم که پول خودم بوده است.	I replied that the money had been all my own.
ولی آخه به فکر من هم باش.	but how about me?
توانش به پایان رسیده بود.	its spirit spent.
هر چند باید یقین داشت که وقتی پس از آنکه اندکی از بندر دور شدیم	though to be sure when, after being a little while out of port
هرگاه نقشه جزیره همراهمان نبود	if it had not been for the chart on the companion
به تشریح مواضع قشون روس پرداخت.	began explaining the whole position of our troops.
شیشهء کنیاک را کنار زد	pushed the bottle thoughtfully away.
دی گه نمی خوام حتی یک کلمه راجع به این محکومان بشنوم.	I don't want to talk about convicts any more.
که پوزخند همیشگی بر لبش بود	who was wearing his usual sneer.
جهان کار و فعالیت آزاد کشیده شده است	the life of a world of strenuous and free activity
از بابت او مطمئن باشید که با من بد نخواهد گذرانید.	therefore do not make yourself uneasy on your brother's account.
اما نه به کسیکه او را دوست ندارد.	but not to one who does not
هیچ خدمتکاری هم با تو نخواهد آمد.	no servant will be offered you.
دروازه را پشت سر گله بست	shut the gate on the mob
زیرا که مسائل خانوادگی ما متعلق به خودمان است.	bur our family affairs are our own.
جز آنکه جهت سرقت تغییر یابد و کنار جاده آن راه باریکی سوی بیچارگان باز شود.	it only remained to impart a new direction to the theft, and to cause it to take a short trip in the direction of the poor.
به طرف آن خیز برمی دارم.	I dart after it.
من هم چه دختری مثل تو ندیده بودم.	I never did see such a girl as you.
یکی از ایشان که همواره در پی اذیت و آزار اوست	one in particular who is always persecuting him
آنگاه پول را روی میز ریخت	then spreading them on the table
تا آنجا که امکانش بود سقفی در کار نبود.	wherever possible roofs had been dispensed with.
چشمانش هنوز بسته بودند.	eyes still closed.
باید به سر کارم برمی گشتم	I have to get to my desk.
اما این هم برایشان خوشایند است.	but it's good natured.
هرگزنمیتوانست طعم ترش تردید را از دهانش بزداید	never able to get rid of the sour taste of doubt in your mouth
از همان لای در دیدم که میل و کاموای بافتنی من به روی صندلی راحتی افتاده.	I had left it on the divan, and it had been picked up.
خیلی بد تو را هم فریب دادم.	I did very miserably deceive you
اجازه بدهید جامعه را از یک دریچه تنگ نگاه کنیم.	let us look at society in the narrow sense.
پرونده در همین حد ماند.	it rested there.
گمان نکنید از احترام این دست خواهیم برداشت	do not think it will be less dear to us
علائق من موجب شد که سراسر این منطقه را بگردم	my tastes led me to explore every part of the country round
من اینجا هیچ کار مثبتی انجام ندادم	I'm not doing any good here.
من این کار و برای خاطر تو نکردم.	I'm not doing this for you.
که اکنون از شمارش بیرون است	which had become extremely important
همه چیز در تاریکی قرار داشت	all was still in shadow
ناگهان بدنش را از کمر تاکرد.	he abruptly bent double
الساعه باید خرگوش را بگیرد دوباره خرگوش پیچی خورد و روی مرز کلش و مزرعه سبز پرید.	the hare moved and darted along the balk between the winter rye and the stubble.
دو دفعه سوارها از مقابل انبار آمدند و رفتند.	twice I seen little gangs of men gallop past the log store with guns
تا همین دو ساعت پیش نمیدونستم که برامون جلسه گذاشتن.	I hadn't an idea until about a couple of hours ago that they were going to have this meeting.
پس من گمان کردم که شما رئیس هستید!	I thought you said you were the chief?
سپیده در آسمان دمیده بود	the dawn was in the sky
اما برخلاف کوه یخ به کلی پوک و توخالی است	but unlike the iceberg she has absolutely nothing below the surface.
دوباره روی به راه نهادند.	set forth again
اما برای زن جوان و خوشگلی مثل تو رفت و آمد به آن گداخانه هنوز زود است.	but for a pretty young woman like you it's early days for that house of charity.
کاشکی فقط میتونسین خودنن منو بشنو ین	I wisht you could a heerd me sing.
شخصی منتظر او بود و پیش آمد	a man who seemed to have been waiting for him approached
البته اولیای مدرسه هم حق دارند که به داشتن چنین شاگردی افتخار کنند.	they will have good reason to be proud of you.
کج خلقی و قیر و باقی قضایا بهتر بود تا حبس کردن خود در اتاق خوابی با کتاب دعا!	better distemper and tar and all the rest of it than sitting mewed in a stuffy bedroom with a prayer book!
چرا کاملاً واقعیت دارد.	I assure you I was,' she returned.
مجبورم کنه سحر و جادو کنم.	force some magic out of me
این پیرزن بدبخت وحشت انگیز را راهنمائی کنید.	to this old lady, a cette pauvre terrible vieille.
تمام به در نظر افکندند	all eyes were fixed on the door
سرانجام به خواب رفتند.	finally fallen asleep
اسبان و مهتران و دوشیزگان سرگردان	all those palfreys, and damsels errant, and serpents
نوعی دیگر از رطوبت را شاهد بود	it was another effect of the damp
من آن جا یک ویلا در کنار دریا دارم	, where I have a villa on the sea.
در این مورد پیشامدی در کار نیست.	it cannot be a matter of chance.
او فدای محیط خودش شده است	he was corrupted by his environment,' and so on.
زیرا این در خانه من بود	, for it was at my house
مبلمان آن جا کاملاً برایش آشنا بود.	familiar with its furnishings
مدت پنجاه دقیقه مداوم به نوشتن پرداخت.	he wrote steadily for fifty minutes
آن بانو هم بی آنکه اعتراض کند این وضعیت را بپذیرد.	the lady should accept the situation without protest is very amazing.
پیرزن زیرلب گفت اسم من	my name she muttered
قطعه کیکی برداشتم و مقابلش گذاردم	I took apiece of crumpet and divided it between the two dogs.
برادر و خواهر پیشنهاد کردند که یک روز صبح همراه کاترین پیاده به گردش بروند.	it was proposed by the brother and sister that they should join in a walk, some morning or other.
زمانی که همسرش یک پزشک بود	she was reminded of night calls to death and calamity
ما هنوز روزهای باشکوه تابستانی داشتیم بدون یک ابر در آسمان آبی.	we had a glorious still summer's day without a cloud in the blue sky.
اگر امکان دارد لطفاً این اسکناس پنج پوندی را هم برایم خرد کن!	I should be glad to have change of this five pound note.
زمین ما را بر پشت خود نگاه نداشته است.	or earth nourishment.
این چشم تفکر خشک بود.	that thoughtful eye was dry.
بکوشند تا از هر جهت اسباب شادمانی یکدیگر را فراهم کنند.	various schemes to enjoy one another's society.
من اگه پولمو به خاطر این جور آ دما خرج کنم احمقم.	I'm of no mind to have my money used for the benefit of such a person.
کشتی من در کشوری بسیار دوردست شکست	shipwrecked in a very remote country
اما من بد کردم که با آقای خودم بنای احتجاج گذاشتم زیرا که من اکنون در بند شما هستم.	but I am wrong to dispute with my master.
با دست دیگر آهسته نوازش کرد.	stroking me gently with the other.
من ناخواسته باعث مرگ او نا شدم.	I as good as killed them
ولی اگه کسی چیزی رو به تو پرت کنه	if someone throws something at you
گاهی با موسیقی و گاهی با گپ زدن.	sometimes with music and sometimes with conversation.
همه آن قدر هوشمندانه و غیرعادی بودند	a thousand more inventions so ingenious and unusual
تفنگ دورزن ندارم که شما را بزنم.	I have no long gun to reach ye.
بهتر بگویم اصلاً لازم نیست به او فکر کنی.	rather, you need not think of her at all.
ولی اینک چنان رنگ گرفته بود	but the color was washed out now
جوان ترها کلاهشان را روی سرشان سفت کردند	the young men self consciously clutching their hats
که عمر و حیات خود را بسته به این دیدم.	for to gain you would be life to me
آن دو خائن لرزان به شتاب بالا دویدند و در اطاق ناخدا را محاصره کردند و گفتند دیگر جرأت ندارند با جاشو ان در یک جا بمانند.	the two trembling traitors running up, besieged the cabin door, saying they durst not consort with the crew.
زیرا ما هر قدر اختیار مردم را محدود سازیم	for however man's free will may be restricted
اما فقط به عنوان تماشاگر.	but only as a silent witness.
میدانم که خشمگین است فردا او را محاکمه خواهند کرد	I should think he might be, with the trial to morrow.
سپس به وسط تراس رفت و در مقابل شاهزاده که هنوز بر صندلی خود نشسته بود قرار گرفت	walked to the centre of the terrace, and stood in front of the prince's chair.
اگر حافظهٔ کسی یاری نکرد من با و کمک خواهم کرد	I'll prompt anyone who forgets the rules!
جلوی در دفتر اساتید ایستاد.	stopped, right outside the staffroom door.
گوشت او از میان رفته بود.	the flesh pads had disappeared
شما میگ ین معلومه که میخوایم	you'll say, 'I sure do, mister.
با چه کسی باید مبارزت نمایم.	with whom I have to do
دوباره به زمین نقش بست.	fell prostrate on the ground.
اما کاری از پیش نبردم.	but I made little way with him.
دور تا خاموش در انتظار ماند.	she sat in silent expectation.
می ون مسافرخونه و اون دک ون آج ریه	between the tavern and the old rattle trap of a brick store.
به زبان اصلی خود شاعر نباشد	speaking any language but his own
توپ به غریدن پرداخته بود.	the cannon had begun the roar
بروند بچه مرا بیاورند!	to go and fetch my child!
به داخل کلبه سرک کشید.	peeped into the hut.
به کشاورزان و حتی به موسیقی	in the peasants, nor in music
خودت گفتی تمام وقتت گرفته است.	I thought you were all dated up.
در پاسخ دادن به من بی تاب نباش	be not impatient to answer me
که تا حد امکان آینده درخشان و آبرومندی برای خود تأمین کند.	he should try to make as successful a career of it as possible.
بازوهایش از رنگ سفید لک شده بود.	his arms splattered with white paint.
ناشناس بط رف حمام دوید آن را دور زد و سپس بط رف طارمی گریخت.	the flying figure went towards the bath house, ran behind it and rushed to the garden fence.
آن وقت دیگر هیچ ایرادی نداشت.	she could hardly have mentioned a deficiency in him.
موهای مجعدش نامرتب شده بود	his wavy hair was standing on end
اما از من چیزی گفته نشده.	that were never said of me
عمداً دو وصیت نامه تهیه کردم.	I made two wills on purpose.
نیمی از شیشه را سرکشید.	he swallowed half of it.
سوئیچ را به طرف او دراز کردم	I offered her the key.
ولی تو برو و مربا تعارف کن!	but you go and hand the sauces.
باید تصور موفق بودن را داشته باشی همیشه	one must project an image of success at all times
یکی از نشاءها را محکم گرفت	grasped one of the tufty plants firmly
بعد هم قدر مرا دانستند چگونه در جمع همکاران خود سخن برانید.	WHAT WE TEACH YOUHow to address your lodge.
بنابراین انتظار نداشته باش بلافاصله پا به پای تو مشغول بازی و دویدن بشود	therefore, don't expect him to play and run about with you directly.
به مش می گم اما این آدم مضحکیه	I will'but he's a queer man.
که همواره دوستش داشتند و	who were always so interested in him and who always
تازه اگه نداشتی هم کاری باهات نداشتم.	I don't want you for nothing, anyway.
مشغول تماشای مزرعه خالی شدم.	looked into an empty field
دوست نداشت با انبوه مردم بجوشد.	he did not like mixing with the crowd.
حالا می دونم که تنها نیست.	now I know that he's not alone, and that even I am not alone.
بلکه مغایر با تمام طبیعت بشری است.	but contrary to all human reality.
ولی چیزی از آن اظهار ننمود.	but she did not show it.
خدا نگهدار و خداحافظ شما باشد.	adieu, my friend adieu, my father!
به همان اندازه که با مخاطرات مواجه است باید مورد احترام باشد.	is the more deserving of being held in honour in proportion as it is the more exposed to peril.
البته که افتضاح در افتضاح است!	I'll say it's a doggone shame!
من که ملوان ناقابل فقیری بیش نیستم.	poor scrubby midshipman as I am.
چه ایشان مکان و فرصت برای ایفای این وظیفه را در گرماگرم کارزار خواهند یافت.	for there will be time and opportunity for doing so while they are engaged in their task.
ولی دیگر هیچ چشمی ندیدم.	I couldn't see no more eyes though.
اجازه بدین از چهل و شش نفر تشکر کنم!	may I thank the forty six people
زیرا این ناظر من متصدی این امور است نه من.	my steward transacts all this business for me
این خانه مانند خانهٔ خود من است.	I am quite at home in her house.
اولیس خود در هیئت گدایان به قصر آمد	ulysses came to the palace dressed liked a beggar
چوبدستیش را در دستش فشرد.	his hand clenched on his wand.
رفتم دنبال آن و پیدایش کردم.	I sought it and found it.
من دارای شخصیت و حیثیت اجتماعی هستم و حاضر نیستم آن را به خطر بی اندازم.	I have my reputation to protect.
اون تازه به دنیا اومده بود!	he was only a baby!
از پاره کردن چنین لباسی .	must 'a been jealous, to tear such clothes!
اما مرکوب را بجای راکب نگیرید.	but do not mistake the horse for the rider.
سر را حرکت کرده چشمش را گشود	he nodded his head and reopened his eyes.
اما وقت این کار را نداشت.	but she had no time at all for it.
جو دفتر بسیار سنگین و سرد بود.	the atmosphere in the office was grim.
یقین دارم کمترین اشکالی بین ما به وجود نخواهد آمد.	I anticipate very little trouble between us on that score.
بز پیری جلو در باز آشپزخانه لم داده بود.	there was an aged goat lying against the open back kitchen door.
می تونم بیشتر بهش یاد بدم	I could teach him more.
من آن را هیچ وقت قبلا نشنیده بودم.	I've never heard those words before.
برای این کار مقداری علف خشک را در وسط یک خیابان قرار داده	they put a pile of dry hay in the middle of the street
ما از قدیم و ندیم همبازی بودیم.	we are such old playfellows.
دست بندها را حرکتی داد.	clinking the handcuffs together.
من مایل خواهم بود که در حال یادگرفتن آن باشم.	I shall be about to have been studying it.
هر دم انتظار داشتیم که سواران مرزبان ساحلی بر سرمان بریزند.	expecting every moment that the coast guard would be down upon us.
لکن خودش طالب آن نبود.	but it was not of his own seeking.
من چندان باسواد نیستم.. اما دوستی دارم که باسواده..	I can do very little reading myself, but I have a friend he can.
اما اﻵن احساسم این طوری است.	but that's just the way I feel right now.
چای داغ رو به اطراف پاشیده بود.	squirted boiling tea all over the place
که بدون شک چنین خواهد بود	as doubtless she would
باید بروم آن درخت بلوط را ببینم.	I'm going to look at the oak.
خوشحالم که حالت خوب بوده و امیدوارم مهمانی به خوبی برگزار شده باشد	I am very glad you were well enough and I hope you had a pleasant party
با این حال باید در حدود قدرت خود کوشش کنیم.	we must manage as best we can!
ممکن است نادرست از کار دربیایند.	might turn out to be the wrong thing.
بهش می گم بهتره مشروب رو بگذاره کنار.	I tell her she ought to leave it alone.
اون هم به همین مقدار من رو دوست داره.	she loves me that way, too.
این عزم جزم و باور خلل ناپذیر ایجاد شده بود که باید از هر گونه اقدامی که توسط مردان تحصیل کرده و شرافتمند انجام میگیرد در کمال احتیاط و ملاحظه کاری حمایت کرد.	the conviction was growing that any attempt made by men of education and integrity ought to be discreetly supported.
دی گه هیچ جام درد نمی کنه.	I no longer suffer.
من به زودی ازدواج خواهم کرد.	I am going to marry.
مو لف مطالب را تحریف کرده	he will have put one thing for another
سپس خود نیز سوار خرش شد	mounting his ass himself
سوسوی آن وی لفور را بیدار کرد	its flickerings awoke him
با این که دفتر مو دی تاریک	even though the office was dark.
من تورو دنبال نکردم که مقامم رو ترفیع بدی	I didn't follow you because I was after a promotion.
در روز و تاریخی که نیازی نیست برای تکرار آن خود را به زحمت افکنم	on a day and date which I need not trouble myself to repeat.
تا او نیز قول خود را پس بگیرد	renouncing his claim
اما سخنی بر زبان نیاورد.	but said nothing.
اما بالاخره شکستت دادم!	but I licked you!
همونو تو بیداری می کنه.	he'd do if he was awake.
دزدی اسب اون هم چه اسبی!	stolen a horse and such a horse!
ابوطیاره رو بیخ ریشش ون بچسب ون.	sock it to them.
راضی شد که نصف نرخ معمول را بگیرد	he was contented to take half the usual rate
خوشحالم که اینجا همراه منی.	I am glad you are here with me.
تا ساعت دو بعد از نصف شب خانه نروم و بعدش هم مجبور نباشم به کسی حساب پس بدهم.	stay out till two and not do any explainingafterwards.
تجهیز کننده که کارش در خشکی بود	owner's servant, landsman
چون اون تو خواب میتونه حرف بزنه.	because in the dreams he can talk.
از دم! در تا آشپزخانه اشیاء مختلف روی زمین افتاده و به رنگ سرخ درآمده بودند.	endless erratic shapes dropped and smeared from the door to the kitchen.
چه مدتی در چنگ هیولا بوده است	how long he was in the creature's clutches
دزد! ها! حق مه که از این مردم که منو دزد میدونن بدم به یاد.	I should so hate for people to think me a thief.
تصویرک خود را در آن دید.	saw himself reflected in them as two tiny manikins of insignificant proportion.
با صدای بلندتری پارس کرد.	yelped even louder.
درست پس از پنج سال و شش ماه دوری از وطن چشمم به زاد و بوم خود افتاد.	saw once more my native country, after an absence of five years and six months complete.
لکن برای نظم حساب این خواهش را از شما کردم.	but I wish it to be so, if you please, for convenience' sake.
من قصد دارم جواهرات زینتی برای موهایش بخرم.	I am resolved to have some in an ornament for the head.
من هیچ وقت به کار تو کار نداشتم	I have never interfered in your
زیرا من پس از بازگشت به لندن آن را بدین غرض اندازه گرفتم.	for I measured the latter on purpose, after my return.
در قسمت دیگر قرار داشت.	was in another department.
اهمیتی ندارد که در فضای بسته یا هوای آزاد یا حتی جایی میان این دو غذا بخوریم.	I dont much care whether its inside, outside, or halfway between.
بی درنگ به اتاق خود برد	hurried her into his room
یه دلار و نیم هم تخفیف بده.	knock off a buck an' a half.
به شرافت من توهین کردی.	you sully my honour.
زمانی که او با عجله به آنجا رفته بود	when,half distracted,he had rushed to the count's house
لباس خرگوش پوشیدن در جشن کارناوال	the bunny costume
در حال حاضر چنان گرفتارم که فرصت پرداختن به این گونه شایعات جزئی را ندارم	I have quite enough to do at the moment without trying to quash these ridiculous rumors.
بالاخره مباشرها پاسخ گفتند.	at last the owner men came to the point.
سمی که توی چش مات هست او نارو تا چند ساعت دی گه از بین می بره.	the venom in your eyes will dissolve them in a few hours.
محتاج نیست که به شما خبر بدهم	it is superfluous for me to tell you
به این چیزا فکر نکرده بودم.	I never thought.
یار و یاور دزدان و گمراهان بوده است	given to the society of thieves and scapegraces.
زیاد وقتم را روی این تلف نکردم.	I didn't waste much attention on it.
که ناگاه مردی مسن با ظاهری فقیرانه که کتی سیاه و کهنه برتن داشت وارد اطاق شد	when an elderly man of decent but poor appearance, clad in an old suit of black
به این گمان که وکلایش او را نجات خواهند داد دل خوش کرده است	secure in the faith that his counsel may beable to extract him safely from this
ولی نه واجد آن پایه از انفاق که خطایی را دریابد و ببخشاید.	but not having in the same degree that charity which consists in understanding and in forgiving.
همیشه پیش جن خونگیمون بودم.	I was always with the house elf.
چطور انتظار موفقیت دارید اگر حساب عشق خود را نکنید.	for how are you to succeed unless love is laid under contribution?
من که شش پا ندارم و همین طور هم شش تا چشم!	I haven't got six legs, nor six eyes neither!
در روستا بود و شاید به خویشتنی دیگر نیاز داشت	being out in the country and needing another self presumably
دوربینش را به دست گرفت	raising his camera.
قطعا بیش از سی سال نداشت	he could not have been more than thirty
به عنوان احتیاط ضرری ندارد حتی ممکن است در عمل احترامی بجا باشد.	it is a sound precaution, and may be a necessary preparation.
جایی که مدیر استودیو گفت	whereupon the studio manager said
از حمام بیرون آمد. موهای طلایی و بلندش خیس و فر دار بود.	she came out of the bathroom with only a towel around her waist, her blond hair damp and curling.
جریان و اسم زیاد مهم نبود.	I didn't much care for it.
چون تمام لباسشان خیس بود	for they were soaked through
با این همه گاهی یکی از ین سه به حق دیگران تجاوز کرده است	have been sometimes violated by each of the three parties.
من با سرکارگری دعوا کردم	I got into a quarrel with a foreman
اوه حتما اون روز رو یادت میاد!	oh, you remember that day!
چون آنجاها را مملو از اشخاص ناشناسی دیده به اینجا آمده است	finding them filled with strangers come on here
به نظر من تو داری از پا میفتی.	I reckon you're cracking up.
باز همیشه همان پندارهای خام در سرم هست.	I have still the same old illusions.
کسی عادت نکرده است که قدری بیشتر در فکر آنان باشد.	we are not in the habit of bestowing much thought on them.
امکان نداشت از آن همه سر درآورد.	it was impossible to pick them out.
پیشنهاد کرد که اگر در خدمت او به سر برم مرا به مناصب مهم مفتخر خواهد فرمود	made me very honourable offers.
نهری از دربند به طرف پایین جریان داشت.	the stream descending the ravine
بعلاوه امید داشتند که در با گوچاروف دختران زیبایی را بیابند	farm where they hoped to find many domestic serfs and pretty girls
نقشه به خودی خود عیبی نداشت.	it was not a bad one in itself.
در تماشای سوسک آسایشی یافتند	found relief in the beetle
هیچ اعیان و کمانچه کش و قاضی و معلم رقص در آنجا نبود.	no lords, fiddlers, judges, or dancing masters.
کوشید آن را به یاد آورد.	she began to recall what.
خودش در عامل دوستی زنانه و احساسات زنانه کاری نکرده است که ناموجه باشد.	she had done nothing which woman's friendship and woman's feelings would not justify.
با این وجود سه بار شوهر کرد.	but she married three times
که با تو حرف لازم و مهمی دارم	I shall have something of the greatest importance to communicate to you
اگرچه زیبا و لازم نیز هست.	yet it is also beautiful and necessary.
او را به دزدی آثار دیگران متهم کردند.	they accused him of plagiarism.
اگر پیش چشم او با دیگری لاس بزند	if she flirted with anyone else.
به آخر نغمه که تمام شد.	as the selection came to an end
با وحشت از خواب پریدم.	I jolted upright, shocked out of the dream.
آرام شد و دستش را رها کرد.	her control came back, and her hand dropped.
من پس مانده دیگران را هیچ لازم ندارم.	I don't want anybody else's leavings.
به داشتن انصاف در داد و ستد	for justice in their dealings
ولی فکر کنم بدونم منظورت چیه.	I guess I see what you mean, though.
یک چیزی را به تو بگویم	I'll tell you one thing
من نباید اینو به شما به گم	I can't tell you.
هیچ وقت راضی نبود زنی را برای کمک در کار خانه استخدام کند	she would never tolerate the idea of having a woman in to help with the housework.
بایست دست کم یک فرسنگ مربع بوده باشد.	must have contained at least two or three square miles.
انگار تعداد زیادی ماشین هم آنجا پارک کرده بودند.	there seemed to be a lot of cars standing about.
من هم کیسه را آنجا گذاشتم.	I put it just here.
حرف او را نشنیده گرفت	as though she hadn't heard him
همه ناراحت و عصبانی بودند.	tempers were running high.
مبلغ سیصد فرانک در اواخر فوریه	you received three hundred francs at the end ofFebruary
همین که به شمال آن جزیره و در حدود پنج درجه عرض جنوبی رسیدیم	having got northward of that island, and to about five degrees south latitude
به طرف اتاق پدرم برد	he went off to see my father
چون ده همسایه کشیش مضحکی دارد	because there was a ridiculous curate in the next parish.
یکی از همین روزها اسمتو یاد می گیره.	I reckon he'll know your name soon.
رنگ رویش چون چلوار سفید شده بود.	as white as a sheet
آن را در اتاق نشیمن گذاشتند.	put up in the drawing room.
نگاهش را به جمعیت انداخت.	his eyes went quietly around the circle of faces.
من که دست کم دو سال از عمرم کم شد.	I lost at least two years of my life
تا مراقب باشند که عمل کور کردن تو به خوبی انجام گیرد	in order to see the operation well performed
یکی از سمتی و دیگری از سمتی.	one here and one there
حتی زمانی که انتظار جوابی ندارند.	even when they anticipate no answer.
چون ضخامت دیوارهایش کم بود فروریخت.	they said that it had fallen down because the walls were too thin.
مثل یکی که بااش برابر با شه	as an equal
تا مبادا با کسی برخورد کند.	out of danger of possible stragglers.
اما این راهرو در برابر یک ضلعی از اتاق من است	but the only bounds one side of my cell
من او را برای تو نجات خواهم داد.	I'll save him for you!
موافقت کردم من معمولی نیستم.	I'm probably not the usual, I admitted.
من برای همیشه بت و تعلق خواهم داشت.	I'm yours for ever
چیزی را که دیده بود.	something she had seen.
ولی احتمالا از آن اطلاع نداشت.	but probably unaware of it.
آب گرم و سرد را در آن مخلوط کرد.	filled it half with hot water and half with cold.
همه جا را آب پوشانده است.	covering the ground.
همین امشب باید به من برسد.	I got to have it to night.
پس شما دو تا از آن طرف بروید.	you two go that way
دوباره سوار اتومبیل شود	then get in the car again
اشاره کردم دنبالم بیاید.	I gestured for her to follow me.
تا کلاه را بر سر بگذارد.	to place the hat on his head.
حتی از هرچه ذوق و نبوغ هنری است عاری است.	he is even completely destitute of what is called the genius of art.
این موضوع اتفاق افتاده است.	this has to happen.
همه افسران به استثناء پنج تن کشته یا اسیر شده بودند.	allthe officers, except five, were either dead or captured.
از بوی خوشش مست بودم.	I was drunk with it, with the scent of her.
سربازان امپراتوری به اردو بازگشته بودند	the soldiers of theEmpire setting out on a fresh campaign
زیرا که از امورات بسیار مهمه است	for it is a matter of the deepest importance
با دست ان را کنار زد	pushed his hand away.
من پیر و وحشت زده ام و بیش از هرچیز میخوام همینجا توی خونه ام بمیرم.	I'm old and I'm scared and mostly I'd just like to lie right here on the home place.
اگه اون شخص دستگیر به شه	if the person was caught
که نیمه پنهان و به ظاهر فرمانروا بود	half concealed in this queer tenement
مطمئنم که در پایان سال دوم در شاهراه موفقیت گام بر خواهم داشت	I know that at the end of two years I shall be on the highroad to success.
نمی دونم چی شد که نتونستم.	I don't know what's gotten into me
او حالش خیلی خوب است معاینه روزانه شما نیز بیش از این لزومی ندارد.	she's well she does not want any more attendance from you!
با آتش سهمناکی پذیره گشتند.	welcomed the enemy infantry with a hail of bullets.
بی شک آن دیو الساعه مرده است	for no doubt the giant is dead by this time
آقا لطفا منو به یار بیرون.	please let me out, mister
به انجام تعمیرات خانه کمک نماید.	lend a hand in fixing up the house.
شنیدم راجع به سگم چی گفتی.	I heard what you said about my dog!
غرش توپی فضای جزیره را به لرزه انداخت.	all the echoes of the island awoke and bellowed to the thunder of a cannon.
فروشنده سراسیمه به سویش آمد	the manager came hurrying toward him.
آماده ان که گلدونشونو عوض کنیم	they'll be ready for repotting again
برملا کردن یکی از رازهاش.	I'd expose one of his secrets.
یا یه نفر مجبورش کرده بره.	or because someone made him?
وقتی شیطان دلقکی را مرا مسخره کند	the player devil must not go off boasting
به واسطه تقسیمات فرعی بی شمار بر اساس اختلافات غیر قاطع است.	that some departments of natural history become so repellingly intricate.
بادبان بزرگ را سوراخ کرد.	through the main sail.
چندان میانه خوبی نداشتند.	they were on not so intimate terms.
کمر و بازوانم را خود من اندازه گرفتم.	my waist and arms I measured myself.
حالا دیگر چیزی بیرون از خانه نیست که مرا وسوسه کند و نگذارد به کارم برسم.	I have no seductions now away from home and work.
من به کار خود ادامه خواهم داد.	I am going right ahead.
من همیشه همراه آن جمع بودم	I was always of the party
چرا که این ویژگی برای ما چندان هم بیگانه نیست	this trait is not quite alien to us
چیزی در طرف دیگر قاب او را به درون کشیده است.	hauled through the panel by something on the other side.
زندانی را با خود آوردند	the prisoner was brought in
پس از ملاقات از آل کس پرس و جو کردم و او به من گفت که درباره هیچ چیز به خصوصی صحبت نکرده بودند.	I questioned her afterward, and she told me they didn't discuss anything in particular.
این بود که گفتن این که یک بسته پیدا شده	so the suggestion of a captured bundle
بر طبق معمول در مقابل یک عقیده افراطی عقیده افراطی مخالف آن نیز وجود داشت.	one extreme, as always happens, was met by representatives of the other.
هرگز مرد معروفی نخواهم شد.	I shall never be a man of renown.
وضع مالی من خوب و از حد متوسط بالاتر است	I am more than fairly well off
راه گریزی جز بالای صخره نبود.	there was no escape except up the cliff.
محض مجری داشتن یک یا ده مغازله و معاشقه را که	because they have managed two or three intrigues
در هجومی از خلط و راحتی	in a rush of snot and relief, it emerged.
در چهره آن دختران جوان چندان شرم و ادب و در دست و پا و عضلات ایشان چندان چالاکی و نرمی وجود داشت که به نظر تماشاگران بهترین رقاصان عالم جلوه گر شدند.	with modesty in their countenances and in their eyes, and lightness in their feet, they looked the best dancers in the world.
به گمانم بزودی خواهم رفت.	I am going away soon, I expect.
یه لحظه به حرفم گوش کن.	just listen for a moment.
سپس به سوی قاضی چرخید	he panted and then he whirled upon the judge.
من گفتم شما میل آمدن ندارید.	I said you didn't really want to come.
حالا هر کاری از دستم بربیاد انجام می دم تا تو خوشحال باشی	I'll do whatever I can to make you happy now.
در اتاق به قدم زدن پرداخت.	she walked round the room.
بهشون گفتم هر وقت بازرسی تم وم شد بهشون اطلاع می دم.	I said I would inform them when our search was complete.
امروز هم تمام روز مشغول این کار بودم.	I've been doing it all day here.
گروهی قربانی قربانیان بودند.	the victims of victims.
جریان را برایش تعریف کردم.	I explained it.
آن آهنگ خشن و خالی از رحم نبود.	they were not harsh nor cruel.
در را به رویش قفل کرد.	locked her up in her bedroom.
که هیچ به نفع آدمیان نبود.	, by no means in the latter's favour.
که بر اسبی با کفل پهن سواربود	broad backed horse.
آن روز در تمام مظاهر حیات و زندگی مسکو یعنی از هوای گرم	the sultry air, the shouts of hawkers, the light and gay summer clothes of the crowd
من باید از اینجا فرارکنم	I've got to get out of this place
در حالی که پنج شبح تار که گویی تازه از هوا پدید آمده بودند او را دور کرده بودند.	who was surrounded by five dusky phantoms that seemed fresh formed out of air.
برخاست تا بیرون رود.	she was going away.
طومار کاغذ پوستی خودش را باز کرد	unrolling his own homework
مدت زیادی طول نکشید که فضای داخل ماشین گرم و خفقان آور شد.	it didn't take too long for the car to become stuffy and hot
معلومه که من خیلی دلم میخواد اونجا باشم	I sure will be glad to get out there.
ولی واقعاً منتظر نبودم.	but really I did not expect you.
لباس سیاه پوشیده بودند و حجاب ضخیم سیاه و روبنده بزرگ سیاهی از ابریشم داشتند.	attired in black, with thick black veils and large black silk poke bonnets.
آن را در کاغذ قهوه ای رنگی پیچید.	wrapped it in brown paper
ناگهان در میان راه زمین و آسمان تمام شد.	it broke off suddenly in mid air
از شفای او مأیوس گردیدند	of whose recovery they despaired
حتماً جارو جنجال به پا می شه.	I reck'n dey's gwyne to be mighty rough times.
اوم دن به مدرسه با ماشین پرنده	arriving by flying car.
متأسفم که این اتفاق افتاد.	I am sorry this has happened
سر کلانتر همراه آن دانشجو سررسیده	the inspector arrived with the intern
دوباره به او نگاه کردم.	I looked at her again
از رقبای خود اصلا وحشتی نداشت.	but she did not fear her competitors.
ولی نه به جهت آنکه رفتارش با تصور و اندیشه متعارف از نیکی و زشتی مطابقت دارد	not because it harmonized with any idea of right and wrong
کسی از این حالت سردرنیاورد.	mysterious gesture no one understood
ولی فکرش جای دیگر بود.	had no thought of trouble to come after the funeral.
دست دارز کرد و مگی را گرفت.	he reached out to clasp her hand.
شاید مروارید هم پیدا کردیم.	I may find pearls.
ساعت پنج دقیقه به هشت شد.	it was five minutes to eight
من هیچ اشتباهی نکرده بودم	I haven't made a mistake.
او را بانوی منطقه وسیعی بکنم	take her out of the stubble
آری مادام مجبورم به رفتن.	I am sorry to say I must do so, madame
آن را از حیاط بیرون برد.	they trundled out of the yard
کوشید از جای برخیزد	he tried to raise himself
فردا همه چیز را روشن خواهم کرد.	till to morrow, he muttered to himself, and you, he added, addressing his visitor
دیدن آن منظره مانند این بود که در یک آن ده هزار آذرخش در آسمان پدید آید.	it looked as if ten thousand flashes of lightning were darting at the same time from every quarter of the sky.
بلافاصله بعد از تولد من	just after I was born
من این گردن بند را همیشه دوست خواهم داشت و خیلی لطف کردید آن را به من دادید.	I shall always value the necklace, and it was very kind of you to give it me.
الان باید فقط میکشتمش.	I should just kill him now.
به تلخی اندوهگین بود.	was bitterly unhappy.
از این روی با خود گفتم	so that I thought
آن را به پرچم سه رنگ مزین کرده در تالارهای مجلل آن به نوشیدن کنیاک سرگرم بودند.	had marked it with the tri colour, and were drinking brandy in its state apartments.
محصل نیز آنقدر خوشبخت است که در بند روزی نیست	it is the student's good fortune
ربانهای موازی و براقشان را بر سینه علفزاری سوخته و پژمرده در شصت یاردی انتهای خانه پیچی داده و در افق از دیده پنهان کرده بودند.	curved away its shining parallel ribbons on a belt of scorched and withered grass within sixty yards of the end of the house.
سر میز صبحانه نشسته بود.	was seated at the breakfast table.
تا به منظور خود دست یابم.	till I get what I want.
به شنیدن این خبر دلشاد شدم.	was glad at heart to receive this intelligence.
من بیست و پنج هزار فرانک برای آموختن چیزی دادم	I have just made a discovery for twenty five thousand francs
ناشیانه بر صورت دخترک کشید.	he rubbed it clumsily over her face.
زخمی رون گلوله کرده بود.	scratched, and bleeding hands.
آنان وارث دارایی پدر هستند.	claimed that all his property descended to them.
گمونم یارو کاکا سیاهه خل بود.	I b'lieve the nigger was crazy.
مرا ببخش که تو را فریب دادم.	forgive me for the deceit I have practised on you!
ما هردو در حضور سر عسکر بودیم.	we were before the serasker
بعدش دی گه می تونم با هرکس که دلم میخواد عروسی کنم.	I can marry the person I want, I guess.
تولید مثل هم کرده بودند.	they had had time to multiply.
قلم را در دوات فرو برد	dipped the pen in the standish again
در این دنیا نه شرافت وجود دارد و نه عدالت.	that in this world there is neither honor nor justice.
لباس ساده خیلی بهتر از لباس زرق و برق دار است.	a simple style of dress is so infinitely preferable to finery.
به هر ضرب و زور و ابتکاری که بود	by a continued exertion of strength and ingenuity
اما حاضرم در راه کسی که دوستش دارم جان خود را نثار کنم و دیگران را هم اگر سد راه من بشوند خرد و متلاشی کنم.	but those I love, I love so that I would give my life for them, and the others I'd throttle if they stood in my way.
آنگاه به عرشه کشتی رفت.	going upon deck.
بعد برای حمله پایین آمد.	then lowered for the charge.
اما بیهوشی امشب ساختگی نبود.	but the swooning too was real this time.
ما برای خرج کردن این پول کلی نقشه کشیدیم.	we've got big plans for this money.
خدا کنه امروز یه ناهار خوشمزه داشته باشیم.	I hope there's something good for lunch
فقط مربوطه که این ابوطیاره رو برونی.	except skinnin' this here bull bitch along
من شوهرمو از دست دادم!	I lost a husband.
لازمه این تلفن رو جواب بدم	I just need to ' take this call.
دی گه نمی تونم تحمّل کنم.	I can't stand any more.
باید یک روزی نشانتان بدهم.	I must show it you some day or other.
چون چیز دیگری برای توصیف آن نیست	for it has nothing else to explain it.
او در جریان خونش به قند نیاز داشت	I think you should eat something, I disagreed.
اما خود سخت خرّم بود.	but for the moment he was in a very good temper.
من میل دارم بنوشم مخصوصا با تو.	I want to drink, and especially to drink with you.
حرکت بهتری برات سراغ دارم.	there's a better move than that.
احساس خستگی هیچ نداشتند.	but they were not at all tired.
سپرش را حایل سینه کرد	brought his buckler before his breast
آ ره حرف من غلط بود اما حالا دی گه نظرم راجع به شما خیلی فرق کرده البته این طور نبوده.	I see I wor wrang but I've clear a different notion on you now to what I had.
من حقیقت رو بهتر از تو می دونم .	I know the truth better than you do.
تا دهمی یا آخری که طول آن پنج قدم و چند گره بود.	till the tenth and last only spanned five feet and some inches.
تا وقت قرارمان در هتل برسد.	fill in the time until we are due at the hotel.
تا مدتی با هم حرف نزدند.	nothing was said for some time.
به مین خاطر بیدارشد.	that was what had wakened her.
لوازمی ساده و نسبتاً ارزان قیمت را جهت فروش به آنجا آورده بودند	simple earthly accessories put on sale without any fuss by peddlers of everyday reality.
اما لازم به بیان آن نیست	but needless to say that
تا رجا له دور من جمع نشوند.	to prevent the rabble from crowding about me.
آبگیر بار دیگر کوچک شده بود	the pool had diminished again
تام شده بود یک آدم حسابی که رنگش با رنگ مریم تفاوتی نداشت.	he was a man and a brother, without distinction of color
از یک طرف جاروی خیسش لیز خورد.	he slid sideways on his rain drenched broom
اسب زمین خورده و قوزک پای ارباب آسیب دیده.	his horse fell and his ankle is sprained.
تهیه جا و غذا برای آدم هم مشکل بود چه رسد به حیوانات.	it was difficult to feed and lodge humans, much less animals.
سپس چند تخته پوست گوسفند بر زمین گستردند	laying sheepskins on the ground
گونه و شانه و بازوی چپش خراش برداشته اما غیر از این آسیب دیگری ندیده بود.	his left cheek, shoulder and arm bruised, but not otherwise injured
برای یک کار خیلی مهم.	on a most extraordinary errand.
من هم دیگر سو الی از او نکردم.	I did not ask him anything more.
دارم واسه هیچی تلف میشم.	I'm going to wither away to absolutely nothing.
اون به صورتم دست زد.	he touched my face.
از آن پیروی خواهد کرد	that she would follow her advice
همینطور که حالا به زنده بودن خودم یقین دارم مطمئن بودم که صدای تو بود!	for those were your accents as certain as I live they were yours!
نتوانستم سرم را بالا کنم.	I can't look up.
با کار و زحمت خودم پیشرفت کنم	work my own way
جسد را روی آن گذاشتند	the corpse placed on it
از جای خود حرکت مکن و چیزی مگوی	stay where you are
وی گزارش داده بود که اثرات بمب ناامید کننده است.	issued a report saying that the effects of the bomb were 'disappointing'.
وحشت از کاغذبازی با مضحکه کابو سوار حکومت بدون قانون بدون امنیت و بدون عدالت.	the dread of officialdom with its nightmarish parody of administration without law, without security, and without justice.
جوزف همه را به ارباب نشان خواهد داد	the minute it is discovered.
گفت بگذارید تلاشش را بکند	said let him try
در یک جای امن دفن کرد.	buried them in a secret place
من شخصا این کار را خواهم کرد	I'll see to it personally.
تمامی زندانیان را از بندرها کرده و آزادشان نمود.	he headquarters she released the prisoners from the stocks.
ردایش شکافت و پاره شد.	his robes ripped
از کاراشون چیزی یادم نیست.	I forget what they did
دوباره دستش را گرفت.	took her hand again.
تا حالا هم حالش خوب خوب نشده.	has never been well since.
اما ممکن است اشتیاق او را بیشتر کند.	but it would make him yearn for her all the more.
دخمه دوباره پدیدار شد.	then, the dungeon returned.
مایلم به شیطان نسبتش بدهم.	I should rather refer it to the devil.
چرا باید زنی که به خاطر زیبایی خود محبوب است	why should she who is loved for her beauty part
ابروان انبوهش را کمی بالا برد	showed a deepened depression in the outer angle of his bushy eyebrows
اما دستشو عوضی پیش آورد	but sheforgot which hand was which
ناگهان با یک صدای بلند	suddenly, with a crunching noise
از خانه بیرون رفت و از سمت شمال از روی پرچین گذشت	crossed the palisade on the north side
درهم شکسته و آسیب پذیر.	tiny and vulnerable.
که در این موقع آهسته به سوی زن جوان رفت	swaying slowly from side to side, had drawn nearer to the young woman
مطمئن باشید من قدر این ماهانه را خوب میدانم.	I do appreciate that allowance.
وقتی من توی اتاق نبودم	when I wasn't around
چراغی در آن روشن بود.	for a light was burning there.
متوجه موهای سفید سرش بشود.	he would not have to watch his hair turn gray.
به سمت قلعه پرواز کرد.	sped off toward the castle
بدون اینکه اظهار نمایند که	without telling them
در هر کجا که باشی یک بار دیگر با تو صحبت خواهم کرد	wherever I may be I'll come to have one more talk with you
هر لحظه ممکن است دوستانم سر برسند.	I expect some friends every moment.
مهمیزهای او زرین نبود ولی لعابی به رنگ سبز داشت	the spurs were not gilt, but lacquered green
فنجان خالی را روی میز گذاشت.	put the cup down empty.
یک فنجان برایش آوردم	I brought him a mug
بالاخره نتوانستم پول سفته را تهیه کنم.	I can't find the money to meet the bill after all.
متمرکز شدن روی آن برایم سخت است.	I'm finding it hard to concentrate.
تا اینجا که تونستم تحت کنترل خودم درش بیارم.	I've held it in check so far.
من از آن بسیار متأسفم.	I'm very sorry about it.
خیلی عجیب است یک زن این حرف را بزند!.	it is so odd to hear a woman talk so!
خود در کنار آن نشستم.	sat down by it.
که حواسش بجا نبود	that he had not even presence of mind enough
ولی از آن صدایی درنیامد.	she said nothing aloud.
می تونم تو رو به خشک شویی ببرم.	I could take you to the cleaners!
حتی اگر دندان مصنوعی داشته باشد.	even if he does have to wear false teeth.
به تماشای ساحل مقابل پرداخت.	he gazed at the opposite bank.
نباید زود محکومش کنیم.	don't let us be in a hurry to condemn him.
یعنی درست مثل همسرش.	as she did
به چیزی کاملاً جدید برخوردم.	I came on something which was certainly new.
هیچ کدام بهتراز همان یکی نبود.	none was even better than one.
آنگاه ناگهان ایستاد	then he stopped short.
تقریبا متوحش گردید.	almost horrified him.
کار من این بود که مرتب قبل از خواب گیسوان او را برس بزنم.	I used to brush her hair for her every evening.
همچنانکه بین سگ و گرگ به معنی شب است.	the same as entre chien et loup between dog and wolf signifies the evening.
از این رو حسابداری محرمانه شرکت را به او پیشنهاد کرد.	if he would become confidential accountant.
هر چند که مبداء و زادگاه او هرگز مشخص نشد.	although his origins were actually never known.
البته به اشک فکر نکرد	she did not think of tears at first
سه سال بعد از آن یک قطره هم به دست نخواهد آمد.	the three following not a drop will be got.
ولی شما را خواهم بخشید.	but I will forgive you.
ولی من امیدوارم که او یک خانم نباشد.	I hope she won't.
من کام لا در اختیار شما هستم.	I am quite at your service.
چون سخت به ساکنان بینوای آن علاقه من دم.	I am so profoundly interested in its miserable inhabitants.
ولی شاید شما بدتان نیاید نگاهی به آن بیندازید.	but perhaps you may not dislike looking at it.
باشد اما من وحشتی ندارم	yes I can easily comprehend that
تا جایی که تمام دنیا را فرا گرفتند.	until they covered the whole world.
هرچه بر سرم آمده است	predicked the whole
برادرش آنجا داوطلب شده	her brother volunteered
مجبورم با هزار دوز و کلک زغال تهیه کنم	obliged to get my coals by stratagem
مگر اینکه جای آدمی روبهش بدم	at least not without moving someone else
فراموش کردم بهتان به گم	I forgot to tell you
می خوام بدونم که چه خبر شده	I want to know what's going on.
تنها %۱۶ زنان توانایی چنین عملی را داشتند.	only 16% of females could do it.
لیکن اگر زنی بیاوری که تمایل به انحراف از راه راست داشته باشد اصلاح عیوب او برای تو کاری بس دشوار خواهد بود	but if you take a bad one you will find it hard work to mend her
که از جمعیت معترض جدا شد	detach himself from the complaining crowd
من عقیده دارم که او عضو فراموش خانه است.	I believe he is a free mason.
خیلی بهتره که بکشمشون و گوشتشونو به سگام بدم	I'd shoot 'em for dog feed first.
از دانشگاه بیرون آمده بود	out of college
آن قدر از دیدارمان گذشته که دیگر چندان چیزی برای گفتن نداریم.	its so long since weve seen each other theres nothing much to say.
خارها را تو باید خودت بسازی.	thou must make them thyself, man.
مادرم او را خیلی دوست داشت.	my mother liked her very much.
به سوی بیمار برگشت.	returned to the bedside
پاک کرد و منتظر ماند	wiping he waited.
فقط به نظرم این یکی بهتر است	only, I should think, a better portrait.
اما قوی و آزاردهنده بود.	but which was powerful and troubling.
واضح است که در جزیره من زندگی هیجانی ندارد و	it is not exciting on my island
کسی نبود که سمج باشد یا به دیگران تشخص و تحکم کند.	no importunate, overbearing
دائم داره گریه می کنه.	crying her eyes out
پنج اسب چه خودشان و یکی هم بیشتر.	their own five and one more.
می دون ستم که او مرده.	I knew she was dead.
مادیانی را از گله جدا کرد	he selected a mare from the drove
سپس از پای درافتاد.	then he sank to the earth.
او نم واقعا با دخترهای دی گه معاشرت نمکینه.	I mean not having anything to do with any of the girls.
من دوست ندارم در کاری مثل این در گیر بشوم.	I don't need to get involved in anything like this, .
یک صدا بانگ برداشتند	raised a shout
اون بالا یه چیزی هست که ای نا رو به این فکر میندازه.	there's something up there that 'll help them think so
لابد من در این امر دخالتی دارم.	I wonder what it is?
زیاد هم تا آن وقت نمانده.	it would not be long.
زودتر از این تمام شده بود.	attempts to write poetry.
خود را به نام مستعار به کارفرمایان خود معرفی کی کند	represents himself to his employers under a false name.
نتیجهء شرایط حاکم آن زمان بود.	their ways arose out of the condition of the time.
اما لازم است بار دیگر شکایت کنم.	but one can't help complaining sometimes.
حالا کمی آرام بگیرید.	now be quiet
آری اینست کار عوامی که دشمن آشتی ناپذیر علم و دانشاند.	such constant irreconcilable enemies to science are the common people.
دوست داشتم این را باور کنم.	I would love to believe that.
پس از بازگشت به وطن در یکی از شهرهای کوچک به عنوان پزشک عمومی کار را آغاز کند	he provincial home again he would settle in some provincial town as a general practitioner
وقتی که مورس رف وارد شد	when he entered
حس کردم بدنم سخت شد.	I felt my body go rigid.
من خیلی بیشتر از این سرد مه.	replied the father, I am much colder than that.
ضمن سرکشیدن یک گیلاس مشروب	swallowing a glass of brandy
هدف دیگری در کار است.	he must have another object.
شاهکارها را تنها خواهم گذاشت و به چرند و پرند نویسی انواع لطیفه قطعات و مقالات کوتاه اشعار فکاهی اشعار محفلی و مزخرفات دیگری که ظاهراً این همه خریدار دارند خواهم پرداخت	I shall leave masterpieces alone and do hack work jokes, paragraphs, feature articles, humorous verse, and society verse all the rot for which there seems so much demand.
حتی اگر مرا دوست نداشته باشد .	even if he doesn't love me.
اما به طور کلی مواظب هستند که در اینکار موفق نشوند	but generally they take care not to succeed.
سر خود را برای فرار از باران زیر سایبان کشانده بودند.	mules were hitched, their heads bowed against the cold misty rain
او درست برعکس مادرم بود	she was the exact opposite of my mother
با طناب به زن به بستند.	bound to its place with the rope.
از من با مهربانی پذیرائی کنند.	encouraged to receive me kindly
تا بلایی سر پسرک بیاورد.	that would make the boy violently sick.
ولی راستش حقش ادا نشده.	but to be sure it did not do him justice.
من فقط موجود بدبختی هستم.	I'm simply unhappy.
قدرت انجام چنین کاری را هم دارد و بنابراین حق هم دارد و حق هم با او است.	it has the might to do so and therefore the right.
او را خوش آمده است.	found he had a fancy for it.
سواران تفنگ شم خال داشتند و پیادگان به نیزه و شمشیر مسلح.	those on horseback with wheel lock muskets, those on foot with javelins and swords
آن هم برای یک تاجر قاطر که سواد خواندن و نوشتن هم نداشت	for a mule trader who did not know how to read or write
دادستان استان کات اراکی با کفایت تمام مدارک و شواهد فراوانی را بررسی و عرضه کرده است	the counsel for the people, with very unusual thoroughnessand ability has investigated and presented evidence of a great number of circumstances
خیلی ترسناک و شاید خونی	certainly frightful, perhaps sanguinary
با کفش و شلوار تابستانی بودند	dressed in shoes and light summer trousers.
ناگزیر بیدار ماندم.	kept me awake.
در هر حال پیر خر گردنیه.	he's a tough old fellow.
به کمک احتیاج داشتم.	I had to have some help.
اکنون همه چیز دوپهلو است	now it all cuts both ways,
از شما ممنون و متشکرم که بیش از این نکردید.	thank you for not using greater severity.
جز اینکه او طالبم نیست.	except that she didnt want me.
ممکن است از شما ایراد بگیرند.	you are liable to be contradicted.
از کلیسا بیرون پرید.	rushing out of the church.
مجبور شدند بایستند.	had to stop.
جرأت نداشتم حرکت کنم.	I dared not move.
بنابراین من نباید شکایت نمایم.	so I won't complain.
پدرش درباره تلگراف صحبت کرده	her father had mentioned the telegram
همین روزها گیرش میارم.	it was only a matter of time before I caught him.
اما دختر من بسیار جوان است	but my daughter is so young
وحدت لوله کشی را با نقاشی صورت و پزشکی را با تولید سقز.	plumbing and portrait painting,medicine and the manufacture of chewing gum.
چه پول و مقامی نصیبم به شه.	what commercial and social honors might not come to him?
هر ساعتی که میل خودتان باشد.	if you like.
صدایش کمی بلندتر شد	his voice rose a little
جاد آن را محکم پیچید.	he wrapped it up tightly.
آیندگان به دشواری آن را باور کنند.	while posterity shall hardly believe them.
با دلی پراندوه از بالای در به طرف پنجرة اتاق نشیمن نظر افکندم.	looking disconsolately over the top of it towards the parlour window
من به شما نگاه کردم	I endeavored to catch your eye
ماه گذشته با کمال درستی در داد و ستد گذشت	the last month's payment had been made with the most scrupulous exactitude
تا مطمئن شود که در هر مورد معین باید از کدام کارد یا چنگال استفاده کند.	to ascertain just what knife or fork was to be used in any particular occasion,
یکی را در دیگری نهاده بود.	one in the other loosely clasped.
هر روز و در زیر همین آسمان.	under that sky there, every day.
بدنش کاملاً سرد بود.	he was cold.
من دوباره باز خواهم گشت.	I shall return
خسته شدم از بس نگاهش کردم	I get exhausted just watching her
کسانی را که نامشان در فهرست نیست به خانه راه ندهد.	not to admit anyone who was not on that list?
آدم و سیخونک بزنن اذیتش کنن.	pick at a feller and bullyrag him so.
لشکر سوم را متوقف ساخت و مطمئن شد	he stopped the third division
پوست تنش پوشیده از کرکی لطیف است	the skin of which is covered with a fine down.
باید یه جایی زیر یه درخت می ریختمش.	I'd go dump it under a tree or something.
به او قول دادم و اینک.	I gave my promise, and here
خوشوقتم که شما منزل بودید.	I'm so glad I found you in.
درکنار پهنای لخت پشتش.	next to the bare expanse of his back.
را قم این سطور که از شأن خود اطلاع دقیق داشته	the historian whose pen traces these words trusting that he knows his place
در نومیدی بسی امید است	despair of nothing we would attain,
من به هیچ کس و مخصوصا با و چیزی نخواهم داد.	I won't give away anything and to her less than any one!
نخست تعظیم غرایی کرد	first bowing profoundly
دعا را هرگز فراموش نکن!	be not forgetful of prayer.
فقط باید به روی خودم ون نیاریم.	if we just ignore it
آن را هر چه نیکوتر ببندم.	dress it as well as I could.
یک فکری به نظرم رسید.	I have a further thought.
دیگر آن اشلی سابق نبود .	so different from the man he used to be.
به سرسرای ورودی رسیدند.	headed down to the entrance hall.
فرمولی جادویی که بین آن نامه مخفی شده بود. بین آن سیصد و چهارده حرف و پنجاه و هشت لغت.	a magic formula hidden in one of the three hundred fourteen letters of its fifty eight words
دیگر هرگز با ستایشی چنان دل پذیر از جوانی و لطف و زیبایی آشنا نخواهم شد	I shall never more know the sweet homage given to beauty, youth, and grace
من تحمل این کاغذبازیها را ندارم.	I cant get through all the red tape
ولی دکتر خیلی خوبی است.	but a very good doctor.
خوشحالم که به فکر دخترش بودم.	I am very glad I did think of her.
میدانم که اینکار خیلی عجولانه است.	I know it's a short notice job
ما را همین جا بگذارید.	as to leave us here.
ترسیده بازویش را گرفت.	clutched his arm fearfully.
ولی راستش خیلی هم تعجب کردم.	but really quite surprized.
هرگز با من مشورت نشد تا در این مورد نظرم را شرح بدهم.	I was never consulted.
او را به کناری کشیده	he drew her aside.
اجل تو و زوبین تو در دستند!	thy hour and thy harpoon are at hand!
اینکار خیلی وقت خواهد گرفت.	one would lose too much time over it.
به من اجازه بدهید با او عروسی کنم.	permit me to marry her!
در ژرفای شیارهای زمینی شخم زده.	deep inside some fold or furrow
من سعادت آن را داشته باشم که خواهرم را به شما معرفی کنم.	I may have the pleasure of introducing you to my sister.
بعد طی ادامه حرکت دورانی خود به گرد لبه میز موفق شد	continuing to travel round the outer edge of the circle
که دو زن جوان خود را روی آن چون روی بالن زنجیر شده ای شناور کرده بودند.	on which two young women were buoyed up as though upon an anchored balloon.
به زندگی دیگری پای بگذارد که تا ابد برایش بیگانه باشد.	or living any other life, for that would be alien to them forever.
این مزخرفات را تحویل من نده.	the father shouted.
که دلت به حال ما بسوزه	to pity us
من دیگر به خدا ایمان ندارم.	I do not believe.
تنها هنگامی به راستی آزاد خواهند شد	that they will only become free
زیرا که هر کجا دود باشد آتش هست.	for where there is smoke, must be fire.
آنگاه ما خواهیم خوابید.	then we will go to bed.
توی اون مسابقه که سه ماه طول کشید مجبور شدن از بازیکنان ذخیره استفاده کنن تا بازیکنان اصلی بتونن استراحت کنن.	they had to keep bringing on substitutes so the players could get some sleep.
از درد و رنج راحت شده.	hes out of his pain.
من از صمیم دل آرزومندم که یاهوهای ما نیز همچنان رام باشند.	I heartily wish our _Yahoos_ would be so tractable.
حیف! حیف از این جوان شجاع!	I'm sorry, sorry for that fine fellow.
من مواظب هردو تون خواهم بود.	I'll take care of you.
کلاه گیس را در جلوی آینه امتحان کنم جلوی آینه قدی روی دیوار بچرخم و خودمو برانداز کنم.	try the wig in front of the looking glass, turn this way and that before the long mirror on the wall.
هنوز دار مش. میان به رگهای کتاب دعایم.	I have it still, in my missal.
من باید پیش او برگردم.	I've got to get back to him.
این اشتباه محض خواهد بود.	that would be a mistake.
نمی خوام از اول شروع کنم.	I don't want to start over.
ولی تاریکی جواب نداد	but the dark had no answer for her
تا به صندوق پست برسد.	until she reached the pillar box.
با سرعتی باورنکردنی	which took a surprisingly short time.
متأسفانه من میزبان خوبی نیستم.	I'm afraid I'm not a very good host.
من از این تبادل تنها با بخش کمتری از تمرکزم آگاه بودم.	I was only aware of this exchange with the lesser part of my concentration.
به اجرای آن موظفیم بکنیم.	what it is our duty to do.
ناگهان با خود گفت	he thought suddenly.
تعیین هر نوع مسئولیتی ناممکن شد.	it was impossible to determine any responsibility.
اگه بخواین می تونم با لگد بازش کنم.	I think I can kick it open if yousay so.
اما تو به آدمی نیاز داری که از خوب هم خوب تر با شه.	but you need more than a nice guy.
من نمی تونم جشن و افتتاح کنم.	I'm not dancing
از طریق من در این شکی نیست.	so far as it is straining through me
حق چنین کاری را هم ندارم.	I have not the right.
تا بالاخره توانست آن را در گلدان بگذارد	trying to squash a particularly fat one into a pot.
هوا پر از زشتی و بددهنی بود.	the air filled with obscenity and ribald language,
می گفتن یه شوخی زننده ست.	the work of a prankster
من مسیر را طی کردم.	I came through.
حالا دیگر تو بارون هستی!	so you are a baron now.
تا هر دو دستش آزاد باشند.	to have both hands as free as possible.
اما در آینده کاملاً طبیعی خواهد نمود	but in the future society it will be perfectly normal
به یکی از بومیان آن دیار برخوردم	meet with any of the natives
دستی به سبیلش کشید	stroked his mustache
با صدای زیرش فریاد زد	he cried shrilly.
زیرا عقل و هوش من بیشتر از یک شاگرد ملوان شانزده ساله نیست.	for I'll take my davy I should be rated
من عاقبت خواهم مرد	now I die
کمی بعد با گاری برگشت.	presently returned with the wagon
می دونم که مشروب خور باحالیه .	I'll say this for him, he always has good licker.
اجرت آن کار اگر حداقل احتیاجات مرا هم برآورده کند کافی خواهد بود.	the remuneration for which will keep me, if but in the barest necessaries of life.
همراهان با نظمی شایسته به دنبال آنان روان شدند.	the company followed them in due order.
هیچ تصادفی در کار نبود.	I was pretty confident it was no accident.
حتی در تابلوهای نقاشی	even in a landscape,
خلاصه شمردنش سه دفعه درست و سه دفعه غلط شد.	so, three times they come out right, and three times they come out wrong.
مقصود همین بود که درک نمودی.	that is what I intended.
من حاضرم جانم را بدهم تا ..	I am ready to give up my whole life.
من به زندگی علاقمند هستم.	I love life.
محافظ خوشبخت شما جلو دوید.	I saw you had one knight errant already.
چه حرفا میزنین اگه ده صد هزار بلیون دلار به هم بدن وزن انگشتمو روش ون نمیذارم.	I wouldn' lay de weight er my finger on um, not f'r ten hund'd thous'n billion dollars, I wouldn't.
هیچ کس آنان را متوقف نکرد.	they were stopped by no one.
در چند قدمی او مکث کرد.	it halted a few yards away from him.
ما در خلیج کوچک و محفوظ زیبایی لنگر انداختیم	when we cast anchor in a most beautiful land locked gulf
من گفتم یک کپی قشنگ از تابلوی اصلی است	I said it is a nice fake.
حسابی شرمنده شده بودم.	feeling completely torn.
دست او را نوازش کردم	I patted her hand.
گریز از انسان بودنمان.	of our humanity
نه چنین عزم جاهلانه ندارم.	all th at would be folly
نگاهم را برمی گردانم.	averting my eyes.
برانگیخته شده بودم.	I was intrigued.
اما وصف دقیقی است و از این لحاظ مفید است	but characteristic and useful
در آن امید که صدایش را بشنود.	hoping to catch the sound ofhis voice
روز تولدش یک ماشین کوچک به او هدیه کردم.	I gave her a small car for her birthday.
به شماره ده قطره به حلق او ریخت	carefully administered the appointed number of drops
من به او اعتماد کردم.	I trusted her.
امروز از سرکار اخراج شدم	today I quit my job
فردا حالم خوب خواهد شد.	I shall be quite well to morrow.
من باید تنها بروم بیرون.	I must go out alone.
بسیار متشکرم! من هم از جانب خود و هم از طرف کسانی که امروز جشن نا مگذاری ایشان برپاست از شما سپاسگزارم.	I thank you for myself and for our two dear ones whose name day we are keeping.
یه نامه برات ون آوردم.	I've brought you a letter.
از دسترسش دور شدیم	we were out of his reach.
که از ورود مهمانان جدید و وصف حسن و جمال دختر جوان باخبر شده بودند	who, having heard of the new guests and of the beauty of the young lady
شاید شما را سر کیف بیاورد. تعارف نکنید!	it will cheer us up do now no ceremony!
صدای نومیدی در دم آرام شد	voice of distress quickly thinned away
خودش یک جادوگر معروف در سطح جهانه!	he's an internationally famous wizard already!
اکنون چون گردویی درهم شکسته بر در میخانه بر سنگفرش خیابان نقش بر زمین شده بود.	it lay on the stones just outside the door of the wine shop, shattered like a walnut shell.
اما وقتی دلیلی نبود	, but there was no reason
در پیشاپیش صف نخستین و سوار بر اسبی سفید و درشت اندام	riding on a highstanding white horse in front of the first line.
بهتون می گم باید چیکار کنیم.	I'll tell you how we'll do.
تقریباً صد هزار روبل باختم	nearly a hundred thousand roubles!
خواب به چشمانم نیامد.	I could not sleep.
تا پنج دقیقه دی گه جشن شروع می شه.	the feast'll be starting in five minutes.
من هرگز چنین کاری نخواهم کرد.	I will never do it!
من که محرک کارگرها نیستم!	I'm no labor agitator!
بعدش بهتر توجه کردم.	I paid better attention later.
حالا باید سعی کنم که بشوم.	I must at least try to be one
برای نجات ما دو تن جایز کمال اهمیت است	for it is of much importance to the welfare of both of us.
چند پر از پرهای دمش افتاد.	a couple more feathers fell out of its tail.
برای هر کسی که گیج بشود.	for any body else who would be puzzled.
که سبب شد کلاید قافیه را ببازد دلیلش این بود که صددرصد مطمئن نبودم.	that he had scarcely time to collect his wits well, yousee I wasn't absolutely sure.
از او خواهش کرد که از کوه فرود آید و به نزد ایشان بشتابد.	begged him to come down to where they stood.
