ولی حس ناخوشایند چیزهایی که ناگفته مانده بودند را داشتم.	but I had the uncomfortable sense of things left unsaid.
چنان از فریادی پر درد و وحشی و غیر زمینی جا خوردند	was startled by a cry so plaintively wild and unearthly
ناگهان از جابرخاست و آنگاه بر خود مسلط شد.	then suddenly sat up
در راهرو زشتش راه خود را به طرف تلفن باز کرد.	then made her way back to the unlovely foyer to find a telephone.
بی آن که نشان بدهد چیزی شنیده در میان خشم پیرامونش گم شد.	disappeared deftly into the angriness around him.
احساسش عود کرد و احساس غم و الم و اندوه بر او هجوم آورد	then sight returned, and with it feeling and grief.
باری پس از پنهان کردن پول به جای خود بازگشتم و خوابیدم.	I went back to my bed, lay down and thought
به طور مبهم به آرزوهایی که برآورده نشده بود	sorrowfully of what had not,happened
ولی ظاهرا از این کار منصرف شد و آرام روی صندلی نشست.	but evidently changing his mind, sank slowly back again.
بدون توجه به اطراف. مستقیماً به طرف پنجره رفتم و آن را از هم گشودم.	I went at once to the window, and looked out.
تصویر فرمینا داثا با تمام زیبایی در آینه منعکس شده بود.	at an angle that allowed him to see her reflected in all her splendor.
که حاضر نبودند یک لحظه هم از کار خود عقب بمانند مشغول دوخت و دوز بودند.	unwilling to lose a moment, bent over their sewing.
آنگاه پس از چند ساعت به نزد گیلبرت بازگشت و اعلام کرد	returned after a time to say that the only thing he could think of
من برای سپاسگزاری بخاکپای اعلی حضرت افتادم.	I made my acknowledgements by prostrating myself at his majesty's feet.
مجبور شدم به محلی که آن حیوان از آن عبور کرده بود بروم و دنبالش بگردم.	I was compelled to go down to the spot where the animal had been and look around for it.
باز همان احساسات کذایی را در من بیدار کرد.	had his usual effect upon me.
من میل داشتم سگ را با همه استعدادهایش به شما نشان دهم.	I wanted to show him in all his glory.
که در ابتدای صحبتش به نحوی نتوانسته بود به مغزش راه یابد.	which somehow had not penetrated to his brain before.
تلاش فراوان لازم بود تا باور کند که همسرش زنده و سالم است	he had to make great mental efforts to take in that she was alive and well
تا آنکه سرانجام شهامت لازم را برای اعتراف به آنچه در دل داشت پیدا کرد.	until finally he had gatheredsufficient courage to tell her what was in his heart.
قصدم این بود که او را همچنان آرام به حال خود بگذارم	meant to leave him calmly.
نگاهش را پائین بط رف زمین بیرون از سلول انداخت	now he involuntarily fell back two steps.
تا آنکه رفته رفته توجه به آنچه در دستور بود معطوف گردید.	before bending forward with a strained attention.
علاقه شدیدی دارد که با تمام قلب و روح خود خدمت گذار آنان باشد.	was eager to serve them with his whole heart and soul.
اما در همان لحظه بیمناک به سوی دیگر جست.	but immediately jumped aside in terror.
آنگاه متوجه شدم که بر لبانش تبسمی نقش بسته است!	then he seemed to smile.
ولی وی چنان جیغی کشید که از شدت ترس به عقب پریدم و دستش را رها کردم.	but he shrieked so shockingly that I dared not proceed.
عاقبت چشمش به من که بر زمین دراز کشیده بودم افتاد.	at last espied me as I lay on the ground.
برای نخستین بار در برابر کلاید عصبی شده بود.	for the first time nervously, where he was concerned.
که ساعت را عوضی گرفته بوده و همه چیز به نحوه دیگری غیر از آنچه او تصور کرده بود صورت گرفته است.	that he had made a mistake in the time and that everything had been different from what he had imagined
دکتر به فکر فرو رفت و محاسبه کرد و نگران شد.	set him thinking and counting, and evidently made him uneasy.
ناهار را در آنجا صرف کرد و یک شیشه شراب خورد	dined there, drank a bottle of wine
بلکه ناشی از چیزی شبیه به یک اغوای مداوم بود.	it was like a continual seduction.
من که آمدم از پنجره در حال بالا رفتن بود.	I left him climbing to the window
اِما بلافاصله احساس کرد باید موضوع را عوض کند.	her immediate feeling was to avert the subject, if possible.
نتوانسته است مقصدش را به روشنی بر زبان آورد.	he hadn't spoken clearly enough
او سپس به بیرون دوید و سرکرده دزدها را به خاک انداخت.	than he ran out and threw the leader down,
بلافاصله از جایش برخاست و به طرف قفسه رفت	she was instantly upon her feet again
از او خواهش کرد تا هرچه زودتر از جاده دور شوند	entreated him to leave the place at once
روشن بود که بیماری سختی را از سر گذرانده است.	as if he had been pickled.
چنانچه با این وضع خود را به حاجب امپراطور معرفی کند	feared that if he were now to approach the gentlemen in waiting in that plight
متوجه شدم که نزدیک بوده به او حمله کنم.	I realized that I had been about to attack him.
اگر کرده بود با آن وضع و حالی که من داشتم شاید از نظر حزم و دوراندیشی و به سبب حفظ جان خود	if it had, yet, as my affairs then stood, I should perhaps, in point of prudence and self preservation
نوعی احساس یأس در وجودش خزیدن گرفت که مفهوم آن این بود که همه چیز برای اودرشرف تمام شدن است.	a creeping resignation that it was all over.
بی آنکه او خود ملتفت شده باشد تخفیف یافته و وارد مرحله نقاهت شده بود.	without her being conscious of the fact, entered upon its convalescence.
وقتی بدان جا رسیدیم نوکرم را در دهکده گذاشتم و خودم پیاده به طرف درهای که تراش کراس گرینج در آن واقع بود به راه افتادم.	I left him there, and proceeded down the valley alone.
دلش را به این خوش کرده بود که عضوی از آن خانواده شده است.	with the illusion of feeling that he was part of a family.
حیران بود که ناگهان چه بلائی سرش آمده است.	was asking herself what was this now that had so suddenly come upon her
آهسته از خوابگاه بیرون آمد تا کنتس را که تازه به خواب رفته بیدار نکند.	so as not to wake the countess who had fallen asleep only toward morning
مجبور شد بغض گلویش را فرو دهد تا اشک از چشمانش جاری نشود.	had to hold back the knot of tears that choked her.
حتماً عقلشو از دست داده و سر به بیاب ون گذاشته.	lost his mind
من تو را در گاری چهار چرخ گذاشتم و در خانة مردمم پنهان کردم.	I carried you to the wagon and hid you at the house of my people.
هورتنس مثل گربه خشنودی که غذای سیری خورده باشد خود را به کلاید نزدیک کرد و نجواکنان گفت که هرگز این لطف را از یاد نخواهد برد و امتنان خود را بزودی نشان خواهد داد قول داد که بار اول نیم تنه را برای او بپوشد.	coming out of the restaurant and purring like a cat, that she would never forget this and that he would see and that she would wear it for him the very first time.
پس برای رعایت کردن ادب از اتاق خارج شد.	laid himself out to be polite and social.
در همان حال نظری به سوی دکتر ما نت انداخت.	with a glance at her father.
ولی دیگر نتوانستند تصور کنند که او چگونه داخل رفته بود	but could not imagine how he had entered.
وال که به واسطه این ضربت دچار درد جانکاه تحمل ناپذیری شده بود	goaded by it into more than sufferable anguish
دست به سوی قلمش برد و نگاهی به نوک آن انداخت	reached his pen and examined it
به من یاری کن تا در حضور او بیشتر متوجه پستی و زشتی خود شوم	grant that in his presence I may rather see my own vileness
از تعجب نفسش در سینه حبس ماند و سپس جیغ کشید.	gasped, and then screamed.
هرچند این اضطراب در زیر نقاب آرامش و تمسخر خود و وضع خویش و آنکه در انتظارش بودند پنهان بود.	covered by a mask of unconcern and ridicule of themselves, their situation, and the person for whom they were waiting.
ناگهان در دنیایی خوشایند و وسیع و آفتابی و آرام رها شده باشد.	suddenly let loose in a gentle, sunny, spacious and welcoming world.
برای اینکه کارد یا چیز دیگری را بخواهد از کابین بردارد داخل اتاق رفته و ناگهان دراز بیرون به روی او بسته شده باشد.	then she slipped down for a knife.
تا اینکه لایدگیت مطمئن و از خود بیخود در کنارش زانو زد.	until he was full of rapturous certainty, and knelt close to her knees.
اما با وجود این خواب آهسته آهسته بر او چیره شد.	but nonetheless sleep crept over him.
احساس کرد که تنش از فرط هیجان به لرزه خفیفی افتاده است.	felt himself tremble the least bit with excitement
به چیزی که روی زمین افتاده بود نگاه کرد	to squint at what he'd fallen over
تا به درون رود و در پای دلبر جانانم به زانو درافتد	that he may come in and fall on his knees before my sweet lady
این حرف را به این گمان انداخت که شاید درباره کلاید قضاوت نادرستی کرده باشد.	a statement which caused her to feel that perhaps after all she might have misjudged him.
از فرط تشویش عقل خود را کم و بیش از دست داده است.	had in part lost his mind from worrying.
کورمال کورمال در تاریکی در جستجوی آن دست دیگر بود و آن را یافت که در انتظارش بر جای مانده بود.	felt for the other hand in the darkness, and found it waiting for him.
ولیعهد مال خودش را پوشید و به من گفت مال خودم را بپوشم.	now the king put his'n on, and he told me to put mine on.
در همان قاشق اول عقب افتادم و دیگر نتوانستم جبران مافات کنم.	I was left far behind at the first mouthful, and had no chance with him.
در یک چشم به هم زدن لگام بر سر مرکب زد	he had him bridled in an instant
ناگهان دوباره پایش بر روی زمین سخت قرار گرفت	then he felt solid ground beneath his feet
اما کاملاً مشخص بود که چیزی حواسش را پرت کرده.	but he was clearly distracted.
با قلبی لرزان به آنچه یهودی گفته بود اندیشید.	pondered, with a trembling heart, on the words he had just heard.
اما ناگهان مثل اینکه چیزی بیا دش آمد ساکت شد	but, suddenly, as though remembering something, he stopped short.
که پاکت با جای اولش نیم متر فاصله دارد	was lying two feet away from where it had started.
چون زن مریض با اوقاتی تلخ دست او را از روی بدن خود کنار زده	because the indignant patient had moved his hand away
وظیفة من به طور مشخص این بود که اجازه ندهم سر هنری یک لحظه هم از پیش چشمم دور شود.	my clear duty was never for an instant to let him out of my sight.
اما آن روز صبح به شنیدن سر و صدای روی عرشه از تخت به زر آمده تا اینجای صحنه را تماشا کرده بود.	but that morning, hearing the tumult on the deck, he had crept out, and thus far had watched the whole scene.
مدت اردو کشی که در طی آن از تمام وسایل راحت و نظافت و تجمل و ظرافت زندگی محروم بود	he had been deprived of all the comforts of cleanliness and all the refinements of life
چیزی بر آن بود تا آرامش فکری او را برهم زند.	something was brewing against her peace of mind.
سخنم را برید و آهسته گفت. مادموازل. برای شماست!	but he shook his head and said it was for me.
بنابراین لاری خیلی احساس آزردگی کرده و پشتش را به جو کرده بود.	he felt injured, and turned his back on her till the others were done with him
بعد از چند دقیقه که در من خیره شد گفت	after considering for a few moments, said
ناگهان بدون سببی واضح به عقب دویدند و از کرانه جنگل ناپدید گشتند	suddenly and without any apparent reason, ran back and disappeared from the outskirts
اما لبخند پیروزی روی صورتش نقش بسته بود.	but there was a grin of triumph on his face.
البته چهارسال از مرگ خانم سم پل گذشته بود.	now four years in her grave
قبل اینکه دستم بهش بر سه و بیچاره به شه.	before I came down hard on him.
از شدت ترس و وحشت شمعدان به دیوار گرفت و از دستم افتاد	in my terror, I let the candle bend towards the wall
حتی از فروتنی خودش که این وضع را پیش آورده بود کمی احساس خجالت کرد.	he even felt a slight shame at his lowliness that permitted it.
تا آشنایی خودش را با آن مرد مهم نشان بدهد	to be familiar with the great man
از خطری که اجازه داده بودم او را تهدید کند شرمسار بودم.	I was ashamed of danger I had allowed her to be in.
آنسلم لوتر را در خانه یافت و شرح اینکه چقدر بوسه بر سر و روی او زد	it would be impossible to describe how he embraced him when he found him
چشمانم را باز کردم و به وصله کوچک پرده بالای سرم نگاه کردم.	I opened my eyes and looked at a little patch of curtain above his head.
مهار اسب راکشید و او را به یرتمه انداخت.	reined his horse in.
دستم سست شده بود و بیشتر به طرف پنجره خم شده بود.	my fingers ached from holding to the ledge.
دوباره رویم را برگرداندم و زدم زیر خنده.	I turned away again, and laughed.
اصرار کرده بود اِما این تقاضا را رد نکند.	that she could not refuse him
بلافاصله خود را با خوردن مارمالاد سرگرم نشان داد.	quickly busied himself with the marmalade.
اما چنان سخت که او نتوانست حلقوم اسپیتز را بگیرد.	so hard that he missed the throat.
ولی اقدامی در این خصوص به عمل نیاورده بودند.	had come to their ears, still nothing had been done.
از ای نرو یاهو با اکراه تمام مرا رها کرد	whereupon she quitted her grasp, with the utmost reluctancy
آنگاه همه سرها را به زیر انداخته ساکت نشستند.	then all cast down their eyes and sat silent.
آنگاه او نیز به چنان حال تهوعی دچار شد که دلش به هم خورد	he was taken with such a loathing that his stomach turned
بعد صدای غرولند وزیر و اساتید را هنگام نشستن شنید.	then heard the grunts and sighs of the teachers and minister as they sat down.
در حالی که خود را بین در و همسرش قرار داده بود	placing himself between his wife and the door.
یعنی به حکم رفتار بعدی او در موارد مشابه بدین معنی که در جریان تهنیت و احوال پرسی	perhaps, have boarded her judging by his subsequent conduct on similar occasions
چوب پنبه شیشه شراب کشیده شده و باید آن را نوشید.	that the wine was drawn and must be drunk.
اما با دلیل و برهان بر این احساس غلبه کرده بود.	but he had overcome the feeling by severe argument.
امیدوار بودم این حرفم را فراموش کرده باشد.	I was hoping he might have forgotten.
چنان کتکی به وی زدند که چیزی نمانده بود رو به قبله دراز شود.	so belaboured him that they brought him sorely battered to the ground.
از اتاق بیرون رفت که سر و گوشی آب بدهد.	went to see what was going on.
اما احساس کرد باید نگاه دیگری را به آن زن بی اندازد	but felt he must glance at her once more
چشمانش را با نخستین تصور روشنی که از نظم دستگاه بدن به دست آورده بود خیره کرد.	startling him with his first vivid notion of finely adjusted mechanism in the human frame.
لیکن خونسردی خود را حفظ کرد و آرامش خود را بازیافت	he kept his head, found his temper
وی را مجبور ساخته بود تا بهانهٔ سریعی یافته و صبح روز بعد آنجا را ترک نماید.	had forced him to make a quick excuse and move out the following morning.
طوری کتاب را نگه داشتم تا به خوبی ببیند .	I held it out so that he could see it.
من با شکیبایی انتظار چنین فرصتی را کشیده بودم	I had waited patiently for the opportunity
سرانجام با عینک روی بینی پشت به آتش بخاری ایستاد	finally stood with his back to the fire, his glasses on his nose
لکن هنوز ننشسته بود که از پهلو افتاد و در مقابل دیوار بخواب رفت.	but as soon as he had stretched himself out, he turned his face to the wall, and slept the sleep of the just.
محبتی شامل و کامل نسبت بهاو احساس کردم.	I felt an overwhelming compassion.
برای او در آن هنگام این فرصت بود که حتی دو بار او را به بغل بگیرد.	so that he might have seized her twice over
من موضوعات بسیاری داشتم که به آن فکر کنم.	I needed time for its consideration.
من که به هر حال خوشحالم که تشویقش کردم.	I'm very glad, anyway, that I persuaded him,' she said
آن گاه از کلاس بیرون آمدند و دوباره شروع به دویدن کردند.	then slid back out of the room and broke into a run again.
به خوبی نشان داد که وقت خود را در آن شهر تلف نکرده است.	he gave overwhelming indications that he had not wasted a minute of his time.
تختخواب زینت شده همیشه حاضر و آماده بود.	in the enormous mythic bed that was always ready for him
ضمناً به سوی زن نیز حرکت کرد تا حرف خود را عملی سازد	as he crossed the road while speaking, as if fully prepared to put his threat into execution
بعد رو به جلو حرکت کنید و کشتی مثل سابق به پیش برود.	then brace forward again, and let the ship sail as before.
اما حالا دیگر دست خودش نبود و خیالش راحت شده بود.	but it now carried her captive.
ناگهان دریافت که حال خواهرش خوب نیست.	he came to a very keen realization that all was not well with her.
اکنون از آن اثری در وی بر جای نمانده بود.	it had quite gone out of her.
تا این آوازهای قدیمی را که خیلی دوست داشت بشنود	to hear the old fashioned airs he liked.
دوستان همشاگردی من هم از شنیدن این موضوع خوشحالی خود را با همهمه نشان دادند.	a murmur of pleasure ran through the ranks of my companions.
قبل از آنکه خود را بدار بیاویزد من بدی دن او رفتم.	I was with him just before he hanged himself.
باعث شد با دلواپسی برگردد تا ببیند کس دیگری هم آن را شنیده است یا نه.	made her turn apprehensively to see if anyone had heard him.
در آنجا آرامش خواهم داشت و کسی مزاحم زندگیم نخواهد بود.	there I shall be quiet and unmolested.
من از درد چیزی نمانده بود بیهوش گردم.	I thought would have made me faint.
مرد بار دیگر به جلو خم شده و آغاز به کار کرد.	he bent over it again.
احساس ایمنی و آرامش از وجود من رخت بر بسته بود.	no sense of safety or tranquillity befriended me.
چون اطمینان داشت که در چنان شه رهائی خواهد توانست در صورت لزوم در هتلی مشغول کار شود.	where he was sure that he could connect himself with some hotel if need be.
من بزودی در موقعیتی نخواهم بود که بتوانم به تو آسیبی برسانم.	I shall soon be out of the way of harming you
بی آن که کاری جز خیره شدن به بیرون و فکر کردن داشته باشم.	with nothing to do except stare out the window at the clouds, and think.
درست مثل اینکه پسری ژنده پوش شلغمی دزدیده است.	as if he were a ragged boy who had stolen turnips.
وقتی به دنیا آمد خودت هم خیلی سر و صدا به راه انداختی.	you made a fine fuss with him when he came.
ولی زن سرایدار که سعی داشت شنوندهٔ دیگری به چنگ آورد او را متوقف کرد	but the housekeeper, anxious to gain another listener, stopped him
گویی از یادش رفته بود که یک نفس چهارده ساعت روی پا ایستاده و کار کرده بود.	forgetful of the fact that he had been on his feet and working without let up for fourteen hours.
نتوانست شوهرش را از این معامله منصرف کند	was unable to dissuade him.
در حالی که متوجه نگاهم شد و جای دیگری را نگاه کرد	catching my eye and looking away.
یعنی همین که احساس کند از نو تعمید شده است.	as soon as he felt himself baptized again.
بر خلاف تمام شب به انتظار گذشت و از طرف همسایه حرکتی ظاهر نشد	but he was mistaken
نه لمس بدن و نه گند دهان و نه خصوصیات دیگر آن دخترک فقیر قادر نبودند وی را از اشتباه بیرون بیاورند	neither touch, nor smell, nor anything else about the good lass that would have made any
تصور کردم شاید بتوانم کاری انجام بدهم.	I thought I could have done some good.
کسی را که تنها داستان عشقش به آن شدت متأثرمان کرده بود به چشم خود ببینیم.	see with our eyes that which when heard of had so moved our compassion
با شگفتی متوجه شد که افکارش را به صدای بلند بیان کرده است.	speaking his thought aloud in his astonishment.
بغض گلویش را گرفته بود از اسب پایین جسته به جانب پرچم دوید	had already leapt from his horse and run to the standard.
بدون یک لحظه تردید به اتاق صبح برگشتم و در را بستم.	I darted back into the morning room again, just in time.
امواج خروشان کلمات ارلاندو را در خود پوشاندند	the swirling waters took his words
لبخندی بر لب داشت که چندان مهرآمیز و مسلما شاد نبود.	with a smile which was not exactly tender, and certainly not merry.
متوجه شدم که از ناپدید شدن سگ اسپانیل کوچکش بسیار ناراحت است.	I found him much troubled over the disappearance of his little spaniel.
گفت که بهتر است این کار را به صبح موکول کنیم و تقاضا کرد که او را از آن مکان پایین بیاورند.	said we would make a beginning on an early day, and requested the aid of my hand to descend from her elevated station.
سر خم کرد و طوطی بزرگی را دید که سوخته و زیر پایش افتاده است.	he looked down to see a great cockatoo roasting at his feet.
در دم میل تملک شدید آن در جانش دویده بود.	had been stricken immediately by an overwhelming desire to possess it.
آن قدر در کنار او با خوشی زندگی کند تا بعد از عمری طولانی در یک شب پر تب و تاب در آغوش او بمیرد.	to die with her, on top of her and underneath her, during a night of feverish license.
ولی هرگز مثل آن موقع متوجه نشده بود که آن ظهور نامطبوع ممکن است به زندگی او ربطی داشته باشد.	but never until now had it seemed so clear to him that this uninvited guest had something to do with his life.
یک لحظه به خود آمد و تصمیم گرفت موقع حرف زدن به خودش مسلط باشد.	the thought of the moment made her resolve to restrain herself when she did speak.
که له وین یکسره از رفتن به خانه او غافل شده بود.	whom he had utterly forgotten to call upon.
آنگاه پس از اینکه نگاهی مضطرب به اطراف خود افکند	glancing suspiciously round, crossed the road
سپس او را تنها در اتاق بجا گذاشتند	he was left lying down and alone
به این دلیل اکنون بالا فاصله دریافت که چه مشکلی پیش آمده است.	he now realized what the difficulty was.
چون ممکن است آن مردک شمعش را خاموش کند و برود.	as the fellow may put out his light and be off.
در سرتاسر بدنم احساس سرمای شدیدی نمودم و پشت و زانوهایم بلر زه افتاد.	I felt a chill down my backbone and my knees shook.
او بتواند این هدف را با کار روزانه مداوای بیماران در هم آمیزد.	was to be a twin object with the assiduous practice of his profession.
اگر چه مادر اولین نگاه با قلبش او را باز شناخته بود.	though her heart knew him at once.
پس از آنکه جبین والای خود را در برابر یوغ مقدس وصلتی شیرین فرود آوردند در یک جا آشیان گیرند.	having first humbled their haughty necks to the gentle yoke of matrimony.
که مدت یک ساعت نوشیدن آن به طول انجامید سپس بطری سومی را سفارش داد و آن را نیز نوشید	this took him an hour to drink, and then he had another, and another
دیمیتری در حالیکه هویدا بود سخت متلاطم است چنین فریاد برآورد	so that it was dreadfully apparent
همه به پهلوان بیچاره که آرام به خواب رفته بود و پروای چنین ماجرایی را نداشت نزدیک شدند	advancing to where he was sleeping tranquilly, not dreaming of anything of the kind happening
ناگهان غرق خجالت شد که چینین احمقی بوده است	overcome with shame suddenly at having been a fool
کلیة دوستان و علایق را نیز ترک گوید و در جلو او عالمی ناشناس و غیرمانوس هم باشد.	leaving all he knows behind, and not knowing what's before him.
به این ترتیب نشان داد که واقعاً در حرفه خود استاد است.	which showed he understood his business.
با این سخن گیلاس را تا آخر نوشید و روی زمین کوفت.	emptying his glass flung it on the floor.
ولی از دوری احتیاط سکوت کرد و نگاهی به مادرش انداخت	but cautiously kept silence and looked at his mother
زیرا که آن فاجر نابکار چندین بار بیهوده کوشید تا هر دو ناخدا را وادار کند که مرا به دریا بیفکند.	for that malicious reprobate, having often endeavoured in vain to persuade both the captains that I might be thrown into the sea
به خصوص که جماعت فانوسی شوم را بر دیگر سوی خیابان در مقابل دروازهء چاپارخانه آویخته بودند و از وجناتشان چنین برمی آمد که به جایگزین کردن آن فانوس با شخص او شایقند.	mention his having an ill omened lamp slung across the road before his posting house gate, which the village showed a lively inclination to displace in his favour.
گرفتار نوعی سردرگمی و بیچارگی گردید.	he fell into a desperate confusion.
دخترک با لبخند و نگاهی دلگرم کننده روبه او کرد.	encouraging eyes upon him.
دیگران ناچار شدند بسیار مراقب خود باشند که زیر خنده نزنند	the others had to take great care to restrain their laughter
برای نخستین بار دست او را بوسیده از وی وداع کرد.	for the first time permitting himself to kiss her hand.
کورمال کورمال به سراغ کاروانسرا دار رفت.	went after the innkeeper in the dark
این کار چه از نظر جسمی و چه از نظر روحی کاملا ً لازم بود تا اِما بر گردد به آن حال خوشی که غروب روز قبل داشت.	literally and figuratively, was quite necessary to reinstate her in a proper share of the happiness of the evening before.
امید داشتم که بدین گونه حالم اندکی بهتر گردد.	which I hoped would do me good.
یعنی خود از جا بلند شد و چند قدم به عقب رفت و خیز برداشت	for, going back a little, she took a short run
بدون آنکه به طرف تخت نگاه کند شمع را به فاصله زیاد از جایی که من خوابیده بودم در گوشه اطاق گذارد	without looking towards the bed, placed his candle a good way off from me on the floor in one corner
انگشتان را دیگر بار به گرد دهان چرخ داد.	restored the usual hand to his mouth.
این شخص دست به دستمالی برد که به عوض کلاه به سر داشت گفت	said the man with the red handkerchief
لذا اکنون وقت آن رسیده بود که جدی باشد.	it was time to settle down.
چند بار ناراحت و متفکر بالا و پایین رفت.	began walking up and down the room
این خنده بیجا وضع نامطبوعی را برای گوینده قصه به وجود آورد.	which produced an effect unfavorable to the narrator.
ولی جهت نگاه او را تعقیب کرد تازه فهمید که پیراهنش پاره شده و سینه بندش نمایان است.	but seeing the direction of his eyes and their quick averting
این بود که حالا با دل شکسته و راضی آخرین نگاهش را به ده دوخته بود.	so he looked his last with a broken and satisfied heart.
بلکه تنها گونه زبرش را که هنوز نتراشیده بود برابر شاهزاده خانم گرفت تا ببوسد	so he simply held out his bristly cheek as yet unshaven
یک آرزوی ناگهانی مرا در بر گرفت که بلند بخندم و بعد از شوق گریه کنم.	I was seized with a sudden desire to laugh, to cry, to do both
کوشید حدس بزند مهمانی که همراه برادرش آمده کیست.	tried to guess who was the visitor who had come with his brother.
به ناچار در همان جا ایستادم و شروع به گریه کردم.	I stood crying till the housekeeper reappeared.
تا کسی که در را به رویشان گشوده بود	while the person who had let them in
سپس آن دو آهسته سم دست خود را به هم ساییدند	they gently struck each other's right hoof before
خود را در خم دهلیز مخفی کردم و آهسته سرکشیدم.	I ran swiftly up the stairs and hid in the gallery.
پانتلئی پروکوفیویچ با شتابی تب آلود از دروازهٔ خانه گذشت.	he called, and stumped in at the gate.
ولی من پیش از آن از در خارج شده بودم.	but I was already out the door.
چشمانش آب مروارید آورد و اجباراً به نوانخانه فرستاده شد.	he got cataract and had to go into the workhouse.
سر گردش نه از مو بلکه گویی از مخمل سیاهی پوشیده بود.	with a shock of thick black hair.
باب گفتگو را گشود و لهوین توضیح داد که از درو علفزار برمیگشته و او را در جاده دیده است.	told her how he had been coming home from the mowing along the highroad and had met her.
متوجه شدم کوشش جهت پنهان ماندن نتیجه ندارد.	it was no use trying to conceal my presence.
سپس بیش از اینکه احساس لذت نماید ترسید و اندیشید که اغفال شده است.	he felt more fear than pleasure.
در آن لحظه خاطرش کاملاً به موضوع دیگری مشغول شده بود.	her mind had strayed to other associations.
فهمیدم که معنای این بی حرکتی ای نه که دی گه تم وم شده است.	I realized the stillness meant that it was over.
تا ببیند عشق کجای او را به درد آورده است	to see where love was hurting him
با این همه تصمیم داشت آن را اجرا کند حتی اگر بر اثر این اقدام نتواند آن روز خود را به صومعه برساند.	but resolved to act upon it, even if it meant not getting back to the monastery that day.
تا درست بفهمد آیا کسی در جایی کمین کرده است یا نه.	to see that no one was concealed
پیچ دور کند را نیز کمی چرخاند و از داخل آن نگاه کرد.	twiddled the speed dial, and put them back up to his eyes.
اینک نیز بالکونسکی از اشارات نامه و شاهزاده خانم کوچک دریافت	now, from the hints contained in his letter and given by the little princess
صندلیش را به کناری کشید تا از او دور باشد.	edged her chair away from him.
یعنی آن خصلت گران بها را که در اجتماع اشراف ضروری است دارا بود.	of composure and imperturbable self possession.
تمام مناظر گذشته واحساساتش باهم مخلوط شده بودند.	conning the terrain of her past and the landscape of her heart.
بعد با چهرة گرفته و عبوس زنی دل شکسته به ما نگاه کرد	then looked up at us with the set, rigid face of a desperate woman.
من هم ون هیولایی هستم که در جایی زندگی می کنه.	I was the monster that dwells in somewhere.
این بار بدون پوزخند با نوک پا بط رف در روان شد و آن را باز کرد و خارج گردید و سپس در را عقب خود بست.	but not smiling any longer, and walking very softly, almost on tip toes, to the door, he opened it, went out, and shut it behind him.
سرشار از بغض و در جان خود آن گنجینه زشت افکار هولناک را	full of hatred, concealing his soul in that hideous mass of frightful thoughts
بعد متوجه شدم لباس زیرش به یک طرف زده شده و یکی از بازوهایش تقریباً غرق در خون بود.	I saw too that his linen on one side, and one arm, was almost soaked in blood.
به ظاهر در آن باز افتادن به منزله بیرون آمدن از آن به حقیقت بود!	to fall back there in appearance was to escape from it in reality.
جغد را تماشا کرد که پروازکنان از عرض اتاق گذشت	he was watching, now, as it fluttered across the room
که نتوانسته بودم در مجلس یادبودشان حاضر شوم	whose dinner I was unable to attend ,
من آتش بخاری را به هم زدم و خودم مقداری ذغال سنگ آوردم و درون بخاری ریختم.	I stirred up the cinders, and fetched a scuttleful myself.
در اثنایی که مادرم در پهلوی پدرم نشسته بود	while my mother, reclining by his side, rested her head on his shoulder
اما در اشارات او چیزی نبود که مایهء وحشت دختر شود.	but, there was nothing to shock her in the manner of his reference.
فقط هنگام رویارویی با مارها قدرت داشت به این زبان سخن گوید.	he had to be face to face with a snake to do it.
اما له وین در چشمان او حالتی دید که در نظرش خوش نیامد.	but he saw in her eyes a constraint that boded him no good.
این تصمیم به قدری در نظرش راسخ بود که تصور کرد	it seemed to him that either
نتوانسته یا نخواسته بود به من جواب بدهد.	he was unable or unwilling to tell me.
تصویری انسانی را که او آن قدر مشتاقش بود به هم ریخت.	blotted it from human sight she hoped for ever.
به خصوص بعد از آبروریزی اخراج او از مدرسه.	above all after the dishonor of her expulsion
مرا به پشت سالن پذیرائیش بود و قریب نیم ساعت آنجا نشسته بودیم.	I, taking her to the lift afterwards
دنیایی نو او را با ستایش و کنجکاوی در آغوش گرفته بود.	besieged by the curiosity and flattery of her new world.
با تبسمی کرد که او را به لرزه درآورد	with a smile which petrified the dying man
مسافرت با کشتی با همراه داشتن چنین غول بی شاخ و دمی کار بسیار وحشتناکی بود.	a fearful voyage I had with such a monster in the vessel.
اما این بار سکوت سرسرا لبریز از هیجانی قآبل لمس بود.	but this time it was a silence so stiff with excitement you could almost taste it.
روی نوک پاهایم به پشت سر ناخدا سمولت خزیدم.	crept up behind the captain
که اگر در مثل شش ساعت پیاپی به همان حال بماند	that were he left so for six hours, say, on a stretch
اما فقط توانست او را از پشت بغل کند.	but somehow all he succeeded in doing was having her back in his arms
راستی قیافه پاسبان در آن موقع دیدنی بود!	shouted the count, dying with laughter.
به محوطه پر گل و درختی که وارد آن شده بودیم اشاره کرد	he pointed to the leafy enclosure we had entered
بنابراین اکنون بایستی شکر خدا را به جا آورد که کیتریا را به او داده است.	that he ought to thank heaven more for having taken her than for having given her.
من تنها در عین خوشحالی متفکر و مگنین بودم.	I, however, in my inmost soul, was doleful and cross in the midst of all my joy.
این بود که با ظاهر خوش و خرمی که به زور به خودشان دادند	so with such show of cheerfulness as they could muster
گفت که مرا در جائی نیکو به خدمت گمارده است	saying he had left me in a good service
ه ناگهان تلق تلق گاری زهوار در رفته را شنید.	heard suddenly the rumble of the trap.
مات و مبهوت به کنار صورت او خیره مانده بودم.	I continued to stare numbly at the side of her face.
دیگری با همان سودازدگی خنجری به پشتش فرو کرد.	the other no less passionately stabbed him in the back.
از اتاق بیرون برد و مراجع کرده آرام سر جای خود نشست.	carried it out, and returned, seating herself quietly in her former place.
در این موقع ترسیدم که ماجرای خودم را از دهان او بشنوم.	I feared now to hear my own story.
در زیر دست راهنمای خود بی حرکت ایستاده بودم.	I stood motionless under my hierophant's touch.
که آرزو میکرد ساعات شب هر چه زودتر سپری شود و بامداد فرا رسد تا باردیگر محبوب را ببیند.	longing to get as quickly, as quickly as possible, to tomorrow morning, when he would see her again and be plighted to her forever,
که باید به خانه برگردد و پدر و مادر پیر خود را شادمان سازد و آرامش و تسلی دهد.	that it was time for him to come back to gladden and comfort his old parents.
اگر چه بانوی من از ترس اینکه آن ماده گربه بجهد و مرا به چنگ بگیرد او را محکم گرفته بود.	although my mistress held her fast, for fear she might give a spring, and seize me in her talons.
دختر جوان درست در جایگاه مراسم عقد در کلیسا متوجه شد که آن آقا زنی دارد که هنوز هم حیات دارد هر چند دیوانه است.	that at the very altar she discovered he had a wife yet alive, though a lunatic.
در دایه خانه را هم به روی من بسته بود.	had closed the nursery door upon me.
که به خوبی دریافت که باز پاکی و صفای قلبش به ناپاکی و تیرگی مبدل گشته است.	that the former purity of her soul was again lost to her.
در به روی شما باز کردند و من احمق مقابل همان در بزرگ که پشت سر شما بسته شده بود ماندم.	you were let in, and I stood like an idiot in front of the great heavy door that had closed after you.
با حالتی آمیخته به خشم و هراس به آن نگاه کرد.	staring at it with an expression of mingled fury and alarm.
چون شنلی از پشت سرش پایین افتاده بود.	trailed behind her like a cape.
فقط در مورد پهلوانی شوم خود شعورش را به نحوی علاج ناپذیر از دست داده است	so hopelessly wanting in all, when his wretched unlucky chivalry was in question.
که من از به یاد آوردن آنچه قبلاً با صراحت با او در میان گذاشته بودم احساس شرم کردم.	I experienced some shame at the recollection of what I had already hazarded.
اما در عمق وجودم بخشی وجود داشت که کاملاً بی حرکت مانده بود.	but deep inside me, there was a part that held completely still.
که کاری که کرده هرچه بوده برای پوشاندن و غذا دادن هفت بچه کوچک بوده است.	which he had done, whatever it was, he had done for the sake of clothing and nourishing seven little children.
اما اینک دریافتم که دیگر ادامه این کار بیهوده است.	but now I found it in vain to do so any longer.
ولی افسوس که درباره شخصیت این پرنس روسی سخت دچار اشتباه بوده است.	but in this she made a woeful mistake.
بعدها هم هرگز نتوانست بفهمد برای چه این کار را نکرده است.	afterwards she did not understand how it was that she did not do so.
آقای مردستون انتظار داشت که من اوقات شب را صرف یک کار مفید کنم.	I was expected to employ myself
چون اینک مادرش تماماً متعلق به او بود.	for now he had his mother all to himself.
اینک او تصمیم خود را در این باره گرفته بود.	he had made up his mind to it by this time.
در همان حال ذهنش به ثبت زیبائی و دلربائی سوندرائی سرگرم بود	while his mind was registering that this truly was the beautiful
زیرا هما ندم چشمش بر همسر عزیزش افتاد.	as his eyes unexpectedly rested on the form of his lady wife.
ناگهان به طوری غیر منتظره مضطرب بودم.	I was abruptly and unexpectedly anxious.
با آن حالت هراسناکش کنار در کلیسای اعظم ایستاده بود	at the cathedral door with that threatening aspect he has
آنجا که من حضرت علیه بانو دول سینه را دیدم کلبه محقری بیش نبود.	when what I saw her highness in was only a very little house?
صدایی به گوششان رسید و قلبشان در سینه فرو ریخت.	they heard something that made their hearts stop
حال پیش از عزیمتم دیگر او را نخواهم دید.	I shall not see her again now before I depart.
نیز پدر لوسیند را از ماجرا مستحضر ساخته	as I did also to her father
که بدون شک و تردید چنین است و او در سراسر عمر واقعیت کوچکی را فراموش کرده بوده است	that it was indubitably so, that in reality, looking upon life, he had forgotten one little fact
ولی از همان شب اول مجبور شد دیگر از عقل مادرش سپاسگزاری کند.	but from the very first night he had reason once again to be grateful for his mother' s good sense.
فوری خود را به او رسانید تا این مطلب را بپرسد.	so he made after him to ask it.
اما به خودش گفت که باید در کمین آن پسرک بنشیند و پوستش را بکند.	but he said he 'lowed to lay for that boy.
این که او را فریب داده بود هم مطلب دیگری بود	she had deceived him was something
آری تعجبی نداشت اگر چیزی نمانده بود که فریاد بزند	it was no great wonder that she was about to cry out
آنگاه کلید را به میخی که مادلن عاد تا هر شب کلید را از روی آن برمی داشت آویخت	then she hung the key on the nail whence he was accustomed to take it
ضمن ادای جملهء آخر با حرکتی مرا میان خود و در کالسکه قرار داده بودند.	they both moved, as these words were spoken, so as to place me between themselves and the carriage door.
به همین جهت او را گرفتند و به بیمارستان بردند	so they put a strait weskut on her and took her to the hospital
اکنون هم تصمیم داشت احتیاط را از دست ندهد.	he meant now to be guarded.
اما تمام وجودش به نغمه سرایی برخاسته بود و عقل با سرودِ پیروزی بر لب به او اطمینان داد که حق با اوست.	but all his soul was singing, and reason, in a triumphant paean, assured him he was right.
آویز طلای کوچک را در دست او انداختم.	I shook the little golden locket into his palm.
با این همه چیزی که در این بخاری بود توجهش را جلب کرد.	but there was something which attracted the stranger's gaze,nevertheless.
هیچ حرکت دیگری نکرد جز این که دستم را محکم در دست خود گرفت.	making no movement but to possess himself of my hand.
مجبور بودم سر شام دوباره او را ببینم.	I was forced to meet him again at supper.
چنانکه چندی پیش راهبی را به حضور پذیرفت و مدتی مدید با او گفتگو کرد.	there was a monk he received and had a long talk with.
احساس کرد چیزی از دورنش کنده شده.	he felt that something had been torn out of him.
در کنار او احساسی خوش و شیرین داشت.	in the being near to the woman he loved.
دیگر دل و دماغ هیچ کاری برایش نمانده بود	she had lost all heart for action
برگشت و آن را با چشم دنبال کرد تا ناپدید شد.	he stopped and turned about and watched it until it disappeared.
مثل این که احساسی بجز دوستی ساده به هم دیگر نداشتند.	there was certainly an unusual feeling between them.
فکر کرد باید برود پایین و دلیرانه از میان جمعیت بگذرد.	she thought she would have to go down again, brave the throng about the desk.
بازوان خود را با وضع متأثری بالا برد	raised her hands with a look of sympathy
سرانجام وقتی او را تهدید کردم که ماجرا را به پا پا خواهم گفت	finally, frightened by my assertions that I would tell papa
اما چنان عشقی که آن دو را طوری به هم پیوند دهد که ورانسکی نتواند ترکش گوید.	but to be nearer to him, to be in such a position that he would not leave her.
زنی که به خاطر او چیزی نمانده بود خودش را نابود کند و نابود کرده با زنی خداحافظی کند که بدون آن مرد نمیتواند زنده باشد.	for whom he was ready to ruin himself, and has ruined himself, and who cannot live without him.
ولی اِما خیلی ملیح به این تصور خودش لبخند زد	yet she only gave herself a saucy conscious smile about it
که از این حقیقت یک دنده راه خلاصی ندارند	that there was no getting around the stubborn fact
شب گذشته او دیر به بستر رفته بود و قطعاً تا این لحظه خوابیده بود.	having been late last night, and would be still in bed, tousled in the head and irritable.
با فروتنی تمام بازرس را وارد خانه نمود.	showed him, with great attention and respect, into the house.
من از بامداد با دقیق شدن به قیافه تو جریان را احساس کردم.	I had a presentiment of what you would do, that day, ever since I saw you first in the morning.
سپس مقداری از یک معجون داغ را به زور در دهانش ریخت.	forced a measure of very hot potion down his throat.
به قول خودش با آنکه پالتوی گرم و کلفتی برتن داشت	although he had a great coat on.
لباست عجیب و جالب توجه بود درست مثل حالا.	you were quaintly dressed much as you are now.
امّا به سرعت از این فکر منصرف شد.	but immediately abandoned that thought.
اما موقعی که به آنجا رسید باخبر شد که نفر مورد نیاز استخدام شده است.	but when he arrived he found that someone had already been engaged.
من که از حیرت برجای خود خشگ شده بودم	where, as I still stood motionless
دیک به این گمان که ژنرال مهارش را از دست داده است	supposing he had lost control
بهر حال نوعی روال کاری درزندگیشان پدیدآمده بود.	what it was all leading to, and that was good.
چگونه پدرش موفق خواهد شد بر اینکه برائت ذمه از خود نماید.	, he could prove his innocence
او به ساحل آمده و همه پولش را باخته بود و حال خوشی نداشت.	he had come ashore and lost all his money and was in a bad temper.
پیش از آن که حرفی بزند خستگی مفرطش او را به خواب عمیقی فرو برد.	before he could say another word, his exhaustion had carried him off to sleep.
دختری با موهای طلاییش دم موشی با نگرانی گفت	said a girl with blonde pigtails anxiously.
اما من حق نداشتم جلوی این کار را بگیرم.	I should have been travelling out of my brief to have hindered it
نمیانم چطور خوابم برد که متوجه نشدم.	I don't know how I could have slept through it.
بعد از مراسم تسبیح انداختن و دعا خواندن	but after the rosary
وقتی آنجا را ترک کردم او حتی تکان هم نخورد.	she didn't even stir as I left.
در موقع ترک اینجا در چند ماه گذشته آن را با خودش به همراه برده بود	he had taken with him when he left
انگار زندگی ناگهان از وسط پاره شد رشته.	as if the fabric of existence had been torn briskly in two.
آنگاه باز تقلایی کردم تا در تابوت را باز کنم	I wrenched at it more desperately still.
گویی در برابر موجودی بسیار برتر از خود نشسته بود.	she felt something like bashful timidity before a superior
ماکزیم اصرار کرد که رفتن من موردی ندارد.	he insisted on going alone.
پاهایش از هم باز بود و سرش را پائین انداخته بود	his feet wide apart, and his head bent down.
سیگاری را آتش زدم تا به خود چند ثانیه مهلت بدهم.	I lit a cigarette to give myself a moment's time.
اینک چیزی برای کار و مبارزه در مقابل خود داشت.	he had now something to work for, to struggle for.
ولی فقط وقتی متوجه اشتباه خود شد که نیمی از راه را پیموده بود	but not discovering his mistake until he had got half way down it
ولی من این دفعه خیال ندارم در این نمایش نقشی داشته باشم.	I don't mean to act any more after this time.
اما نتوانست خودداری کند و اشک خشم و غضب از چشمش جاری شد و از اتاق بیرون رفت.	but unable to restrain herself she burst into tears of vexation and left the room.
یا چنگک برمیداشت تا علیق را در آخور جابه جا کند یا میدوید تا آبشخورها را پر کند و یا پهن و جارو میکرد.	he either snatched up the fork to pitch the hay out of the pens, or ran to get water or to clear out the dung.
به عوض آن نرمی و شیرینی را از دست داده بود.	rather it arrested the growth of softness and sweetness in him
در زیر پنجه آهنین کنت اسیر و مقهور ماند	failed in releasing him from the count's iron grasp.
سدر یک با حرکت سرش اطاعت کرد و هردو از تالار بیرون رفتند.	who nodded, and they left together.
دیگر بر حرفش پافشاری نکرد و هیچ اعتراضی بر زبان نیاورد	did not endeavor to resist it.
چمدانم را پایین دادند و دلیجان فوراً از آنجا دور شد.	my trunk was handed down, and the coach instantly drove away.
به او نگریستند و بعد با یکدیگر نگاهی ردوبدل کردند	they looked at him, they looked at each other
سپس به اطمینان قولش در فقس را به روی او گشودند	on his word and promise they unbound him
زن نقاب را از خود دور کرده و فریاد زد	cried she, throwing back her veil
سنگ نسب تا بزرگی دید که مسلما لحظه پیش آنجا نبود.	she observed on the spot which she had quitted, a tolerably large stone which had, evidently, not been there a moment before.
یک مورد از نیک خواهی له وین به شکلی جاندار به خاطرش رسید.	a recent instance of his goodness rose vividly to her mind.
اما هیچ کس ناسازگاری حالت او را با روحیه عمومی مجلس متوجه نشد.	but no one took any notice of his being out of harmony with the general mood.
در عنوان کردن این نکته تأکید بسیار به کار برد تا دکتر را از ناامیدی و بازگشت به خمودگی دیرین بازدارد.	he told him this, very strongly, with the hope of rousing him from any despondency or dangerous retrospect towards which he foresaw he might be tending.
ولی این فکر را به عقب مغزش راند.	but pushed the thought to the back of his mind.
از آوردن دور تا به آنجا سخت پشیمان بود.	he repented that he had brought her.
گفتند که دهگان خوب به من درس داده است.	saying, that the farmer had instructed me very well in my lesson
اندکی فاصله بین دیوار و نیمکت گذاشتم تا پشتم جا بیفتد.	leaving a little interval between, for my back to settle down in.
مثل اینکه خودش قادر به ارسال این پول نبود	as though she couldn't have sent it off herself!
اما هرگاه بار دیگر دچار حمله بشود کارش تمام خواهد شد.	but another stroke would settle him.
پس از چند لحظه در باز شد و شخصی داخل اتاق گردید.	this time, the person entered the room.
او نم بعد از اینکه به قول خودت تصادفا با دوربین به صورتش زدی	after as you say you accidentally struck her
با ما دوستی کند و برای اجرای این منظور پیش از آن کشتی را مورد نظر قرار داده بود	in order to do so, had already pitched upon a vessel
که چگونه تازه نواری به افتخار میهمان به سر خود بسته و آماده رفتن به اتاق پذیرایی شده بود که	how she had only just put on her new shoes for the benefit of the visitor, and on going into the drawing room
حالا دیگر کاری جز بستن دستش نداشت.	all he had to do now was to close his hand.
فشار امعا و احشا از یک سوی و شرم و حیا از سوی دیگر سخت عرصه را بر من تنگ کرده بود.	I was under great difficulties between urgency and shame.
اکنون به دلبستگی به موجودی آشنا و دلسوزی به حال او تبدیل شده بود.	had passed now into personal devotion, and tender thought of her lot.
چون به تمام افکار و تمایلات من واقف نبود و	not knowing all my thoughts and feelings,
با مرگ او آن پرتو شادی و شیطنت از چشمان پیر مادربزرگ رفته بود.	much of the bright malicious joy of life had gone from her old eyes.
شبیه لاش خوری بود که دچار سوءتغذیه شده باشد.	who looked like an underfed vulture.
چگونه فن شنا را در همان دریاچه آموخته است.	how he had learned to swim here.
بلکه فقط به خاطر اینکه بیش از این از او پرستاری نشود و تختخوابش را کسی که در وضع بدتری است اشغال کند.	but simply that he could get along without further attention, and that his place was needed for some one worse off than he.
من بزمین پریدم تا وضع را ببینم و خون مجروح را با دستمالم خشک کردم.	I jumped down to look at him, and wiped his face with my handkerchief.
سرانجام ناچارش کردم که از زورق در آب بجهد.	at last forced it to leap out of the boat.
مثل زنگ مرگ در قلب اسکار لت طنینی هراس انگیز بر جای نهاد .	dinged frighteningly in her heart like a death bell sounding.
در آن موقع البته از من هم گله نباید بکنید که چرا در ارجاع کار به دستگاه دولتی شتاب و عجله کردم.	do not say I plunged you down the gulf into which you rushed, yourself.
آنگاه پتو را بالا کشید و دوباره روی بالش افتاد	pulling up the rug he flung himself back on the pillow.
اکنون قوه غیب گویی از میمون سلب شده است	for his virtue is at present exhausted
اگر چه تحمل شنیدنشان را از دهان شخص دیگری نداشت.	though he would hardly have borne them from another man.
از نهر آب پریدم به میان درختان دویدم	I jumped the ditch and scrambled up into the trees
پنجولی به گردنش کشید و نعره گاوچران به هوا بلند شد.	sank her claws in his neck, at which he yelled horribly.
چند لحظه بعد قوت قلب خود را بازیافت	he took heart after a few moments
بعد با غرغر و دشنام زیاد دوای خود را خواست	then, with many grumbling oaths, called for his physic.
تا این که تصادفاً قسمتی از یک غیبت خصوصی به گوشش خورد که باز هم خوشی اون را منقص کرد.	till she overheard a bit of conversation, which disturbed her extremely.
پنداشتی در این حال آماده است که خود و دیگران را به قتل برساند.	as if he were prepared that instant to kill himself and everyone else
مدتی نشسته درباره سعادت و خوشبختی خود گفتگو کردند.	they sat a long time talking of their happiness.
این تصدیق در آقای پگاتی چنان موثر افتاد که پنداری او سخنی گفته باشد.	that the latter answered him as if he had spoken.
تصور کرد یکی از مهمانان نرفته و در را باز کرد و راه داد	he opened it immediately.
اما عمداً زیر پایش را خالی کردند گذاشتند خودش را به لجن بکشد.	let him fall into a dust heap on purpose!
از لای در به بالا و پایین خیابان نگاهی انداخت و فورا سرش را به داخل آورد.	peered up and down the street, then withdrew his head quickly.
تا ببیند این چیست که سر او را خنک کرده است.	to see what it was that made his head feel so cool
اما خود جز گوشها و گردن مادیان خویش و زمینی که زیر پای اسب او سپرده میشد	but he saw nothing except the ears and neck of his own mare, the ground racing to meet him,
تا آخر عمر در دلش باقی خواهد ماند.	painfully to the end of his life.
انگشتانم را میان انگشتانش گذاشتم.	I put my fingers into his.
من ناچار به قید اسارات او درافتادم.	I was left a prisoner in his power
این بگفت و از کاروانسرا بیرون رفت.	with this he went out of the inn.
پس برای ادای توضیحات نزد مادر رفت.	went to have an explanation with his mother.
پس چنان که گفتم شما را متمول گذاشتم اما نه صاحب شرف.	I leave you, therefore, as I took you, rich, but little respected.
نفس در سینه حبس کرد و او را زیر نظر گرفت.	held his breath, watched her.
یک مرتبه ترس و بیم بسیار برای حفظ جان خویش و برای نتیجه تمام جنگ سراپایش را فرا گرفت	suddenly he was seized by a panic of fear for himself and for the issue of the whole battle.
در بین افکار پرستاران یک چشمم به او بود.	I kept an eye on her through the paramedics' thoughts.
امیدوار بودم قبل از کشتن هیولا بتونم زندگیش رو نجات بدم.	I hoped to save her life before I killed the monster.
آماده بود که با راحتی خیال از ته دل بخندد.	ready to giggle with relief.
به این دلیل سخت مشتاق بود که این آخر شب پیش از کریسمس را با کلاید بگذراند	she had been most anxious that he should spend this last evening with her
با روحیه ای بسیار شاد همراه دخترش به سرچشمه های آب معدنی رفت.	set off with his daughter to the spring in the greatest good humor.
از آن شب که پلیس او را گرفت و به خانه آورد	not since that night in the barn after the police had brought him home.
پس آن قسمت از کار خطیری که به گردن گرفته بودم و بیش از همه محتاج دلیری بود در پیش داشتم.	so that the boldest part of my enterprise remained.
چون شوهر او آن روز بیش از حد معمول دیر کرده بود.	for he was later than usual in returning that day.
هر چند او را تا آنجا که ممکن بود از خود دور نگاه داشته بودم	though I held him at arm's length
زیرا که شروع کردم به بردن رنج و کشیدن زحمت.	for I begin to suffer again.
فقط زیر جامه پوشیده و جلوی له وین ایستاده بود.	standing before him in his underclothes only.
وقتی خواست از جایش برخیزد کاترین موهایش را گرفت و او را بر سر جایش نگه داشت.	he attempted to rise, but she seized his hair, and kept him down.
مثل اینکه آنقدر عاقل بود که از یک مد پیروی کند.	he was sane enough, after a fashion.
منتها به شرطی که از این وضع نجات پیدا کنم.	, so long as I get out of this.
بلکه نفس فداکاری در وی نشاطی تازه و نشئه آور بوجود آورده بود.	the fact of sacrificing in itself afforded him a new and joyous sensation.
پیدا بود چیزهایی دستگیرش شده منتها چیزی نگفت.	seemed to understand, but would say nothing.
اما به زودی از جا برخاست و جلوی سینی چای نشست.	but presently rose and took her place before the tea tray.
اگر شرح آن گفته آید مثنوی هفتاد من کاغذ شود	it's too long a tale to tell
ظاهراً چون حدس زده بوده که قضایا از چه قرارست به آن معلمه کینه پیدا کرده بود	she was like as if she knew somehow how matters had gone on, and had a spite at her
ان قدر محکم خندیدم که صدایم خرناس مانند شد	I laughed so hard I snorted.
پنجه هامو رو به زمین فشار دادم و خودم رو مثله یه گلوله به جلو پرتاب کردم	I dug my nails into the loam and shot myself forward.
این دفعه جواب کاملاً کلاسیک و مشهور را به زبان آورد	hazarding the usual reply.
با قلب چرکینی مشغول کارهای خودش شد.	went about her affairs with a troubled heart.
در اینجا با چشمان ریز و یقه ی باز و کراوات گلدارش مضحک مینمود	who now, with his little eyes and his open neck and flowered cravat, was uncommonly ridiculous and tedious,
با پیش بینی واکنش او احساس کردم گلویم فشرده شد.	I felt my throat tighten in anticipation of her reply
علا رقم نیتم اصلاً مهمان دار را نترسانده بودم.	I hadn't frightened the hostess at all, despite my intentions.
من با دقت و کنجکاوی زیاد سعی کردم آن را بخوانم.	I craned my neck sideways to read the lettering.
در همان جا مقدماتی فراهم آورده و برای خود پناهگاهی تدارک دیده است.	there also he had made preparations so that he might have a refuge.
او همین که سخنان مرا شنید لبخندی مخصوص که نشانه دلسوزی به حال جاهلانست زد و گفت	said to me, with a sort of a smile which usually arises from pity to the ignorant
از چه امتیاز و آسایش و ظاهر نیز از چه سعادت کاملی برخوردار دارند.	he could see how privileged and relaxed and apparently decidedly happy were those of that circle.
تمام هنر و دیپلماسی خود را به کار بیندازد.	she felt that she had to employ her diplomatic tact.
هنگامی که به پرواز درآمد با بالش به صورت هری سیلی زد و رفت.	cuffing him around the head with her outstretched wing as she went.
یک مرتبه آرزو کرد که آ و را آن قدر کتک بزند تا دهان بی دندانش را ببندد.	it so annoyed her she longed to shake the old darky until his toothless gums clapped together.
منظورم ای نه که اون تمام رازهای تو رو برملا کرد.	I mean, he gave away all your secrets.
خود را چنان بالا کشید که پاهایش را در کمر او قفل کند	heaved herself up enough to lock her legs around his waist
به او نگاه کردم و گازی دیگر به فلفل زدم.	I beam at him and take another huge bite.
مخصوصاً به قدری در فشار واقع شدم که نتوانستم طاقت بیاورم.	I was so squeezed that I could hardly bear it.
به استقبال ایشان شتافتند و با ابراز شادمانی بسیار آنان را پذیره شدند.	went out to welcome them with signs of hearty satisfaction
که به نظر شما چنین خیالات آورده است.	that disturbed you, madame,
اما او فوری رویش را برگرداند و دو مرتبه بیرون را نگاه کرد	but he immediately turns back and stares out of the window again.
ناگهان خواست به نحوی به این ژیگلوی چرم و نرم توهینی کند.	he had a sudden longing to insult this fat dandy in some way.
به فرمان خویش مجبورم ساختی که هرگز در پیشگاه جمال ماه مثالت رو ننمایم!	with inexorable obduracy banish me from the presence of thy beauty.
سپس دهانش را به دسته آن و خود آن را به طرف روشنی گرفت و توده بزرگی دود توتون بیرون داد.	then holding it to the light, with his mouth at the handle, he puffed out great clouds of tobacco smoke.
همسرش درگذشته بود ولی دیگر مورد قبول الیزابت نبود الیزابت حتی او را لایق فکرکردن هم ندانست	for his wife she could not admit him to be worth thinking of again
از قرار معلوم اطلاعات لازم را بدست آورده خوب خود را آماده کرده بود.	he obviously had collected some evidence and prepared himself cleverly.
حتی به جسد نزدیک شد تا کلاه و البسهء خود را بردارد.	even went near it, to get the bonnet and other things that she must wear.
در آنجا مثل مرده افتاد تا اینکه واگن اسبی زندان را آوردند و او را از آنجا بردند.	where he lay still until they had summoned a patrol wagon to take him away.
اما کم کم خود را با شرایط موجود خود را تطبیق دادم	but gradually I got into the way of the thing
که در چنین روزی بخوری و خود را از سیاست برهانی.	that you might escape the punishment that you deserve.
آخرین آدمی در جهان خواهد بود که زنش را به وحشت بیندازد.	he was the last man in the world to frighten his wife.
خود را در یک اطاق غریبه دید آئورلیانو ناباورانه نگاهی به دور و برش انداخت و از جایش بلند شده و صاف نشست.	he recovered it on a strange dawn and in a room that was completely foreign
لکن اکنون تصمیم جدی بازد واج گرفته است.	but that he wished, seriously, to marry at last
غیر ممکن بود که با آن احساس مبارزه کنی.	I sat up awkwardly, still tangled in my blanket.
تا این که سرانجام سیمش را از پریز درآورد.	until she took the phone off the hook.
چیزی که بیشتر بر تأثر ناشی از مرگ او افزود این بود	what made his death the more sad was that
آن را برای احیای شکوه و جلال بر باد رفته خاندانش به اینجا بازگرداند.	bring it back with him to restore the fallen grandeur of his line.
مصمم بود که همواره بر طبق میل پسر عمویش رفتار کند.	he was now determined to keep it and to conduct himself always as his cousin wished.
یا این که فرانک هر چه گفته فراموش کرده و تعهد خود را زیر پا گذاشته است.	or if he had merely trifled with her affections and then forgotten her.
من در آن هنگام یک کهنه سرباز بودم و خودم از این امر آگاهی کامل داشتم	I behaved like an awful fool on many occasions at that time, and I was conscious of it myself.
یعنی کام لا و یکپارچه تسلیم روح زمانه شود	which was to yield completely and submissively to the spirit of the age
پانسیون رها هم برای تفریح خود آلت دست مادام و که شدند.	who began to amuse themselves at his expense, and so gratified her desire for revenge.
وضعیتم خیلی بدتر از چیزی بود که بتونم جوابی بدم.	I was way past being able to respond.
دوست ندارم به خاطر ان جانور صحبتم قطع بشود.	I will not be interrupted because of that bastard.
وقت داشتم تا کیسة محتوی پول را بررسی کنم.	I had now leisure to examine the purse.
احساس کرد که جهان در نظرش تیره و تار شده و چشمانش را ابری سیاه پوشانده	a cloud came over the sky with him
که بیرون آمده است ببیند سهم او از آسمان محلی خودمان چقدر است.	come out to determine what share was his of our local heavens.
او خودش برای اینکه شما را نگران و ناراحت نساخته باشد خیال داشت زودتر بازگردد	she'd fain have ridden forwards, afeard you should be uneasy.
فقط به یاد دارم که با شتاب بجایم برگشتم و منتظر ماری شدم.	but it was done, and I went quickly back to the dining room and reseated myself at the dinner table.
اما این بار دختری نیز همراهش آمده بود.	but this time he had a girl with him.
این خود نویدبخش برآورده شدن توقعاتش از ازدواج بود.	promised to fulfil his most agreeable previsions of marriage.
در عین حال سرم را برگردانیدم تا ببینم او کجاست.	I glanced back over my shoulder at the cove.
پسرک با شیطنت نگاهی به جو انداخته و در پاسخ گفت	returned the boy, looking wicked.
اما دخترک بازوی خود را ماهرانه آزاد کرد	she maneuvered it free
در میان این امواج این حرف فاریا به خاطرش رسید به شتاب بالا آمده و بنای شنا به امتحان گذاشت	he hastened to cleave his way through them to see if he had not lost his strength
در حالی که هنوز لباس رسمی برتن داشت و در را بست.	still wearing the insignia of his rank, and shut the door.
اما به هر حال آدم متشخصی بود و رفتار مطبوعی داشت.	but still he was the gentleman, with a pleasing address.
حیوانات بعد از اینکه مولی را پیدا کردند برگشتند و فهمیدند که شاگرد مهتر که در واقع فقط بیهوش شده بود حالش جا آمده و زده است به چاک.	when the others came back from looking for her, it was to find that the stable lad, who in fact was only stunned, had already recovered and made off.
که اشیاء را به دنبال او بیاورد و با ایل ین به راه افتاد.	follow with the things and now slipping in the mud
که هر وقتی که من دچار شوم بر سگی درنده شوم	when I have the misfortune to meet with a mad dog
من به سرداب رفتم تا مدارک وجود یک گرگ نما را پیدا کنم.	I went down the cellar to find evidence of a werewolf.
با صدایی که هیچ کس جز خودش نشنیده است	by a bodiless voice no one but he could hear
یکی از ده تایشان نیست که همین که لحظه بعد برای خوردن ناهار به اطاق همان فرمانده برود	yet, ten to one, let those very officers the next moment go down to their customary dinner in that same commander's cabin
به زور به چشمان او که آثاری از ندامت در آن وجود نداشت نگاه کردم.	I force myself to meet her unrepentant blue gaze.
اکنون دیگر ترسش را از یاد برده بود.	now he had lost his fear.
اما اکنون این احساس عادی کهن خود را نشان میداد	but the habitual bent of feeling reasserted itself,
اوژن سرش را به علامت قبول تکان داد.	flinging up his head.
با این همه کشتی سازان اعلی حضرت به من بسیار یاری کردند	wherein I was, however, much assisted by his majesty's ship carpenters
دانست که این اندام دردناک خود اوست.	he felt that the aching place was himself.
از روی غریزه خواستم خودم را کنار بکشم در همین حال از ترس فریادی کشیدم.	I instinctively started aside with a cry of alarm
هنگامی که بخواهند مرا بردست گیرند دست و پای من بشکند.	break one of my limbs by taking me in their hands.
که به بهانه بازدید مجدد مواضع هنوز مشغول خوردن ناهار گوارای خود بود.	who on the pretext of inspecting the position was finishing his savory dinner.
ا یکاش فریاد زده بودی یا نوری نشان داده بودی.	I could almost wish you had shouted and shown a light.
که باید فاجعه مهم و شومی در شرف وقوع باشد.	felt that something important and disastrous was about to happen.
اما تشخص پیشین او به نحو اندوه باری خلاصه و مختصر شده است.	but his former dignity is sadly abridged.
تا واقعیت وجود باران و مه را بر گونه خود لمس کند.	to get the reality of mist and rain on his cheek.
تماه راه را داخل بیشه دویدم تا نزدیکی کلبه رسیدم.	I went down right away to the cottage.
سپس غلتی زد و دوباره به خواب رفت.	rolled over in his sleep.
برای اینکه قلب رنجور من از این لحظه کاملاً به او بسته شد	it is because my seared heart clung to him, from that time forth
اطلاع دارم که در اینجا نقاشی از او خوشش آمد و با او رفت و آمد پیدا کرد	I learnt that an artist here took a fancy to him, and used to go and see him
زیرا هدویگ پیش از آن نیز بیرون مانده بود.	she'd been gone this long before.
نهایت سعی را کرد تا اِما را از این کار منصرف کند.	he tried earnestly to dissuade her from it.
زیرا ممکن است وی از موضوع آگاه شود و خشمگین گردد و از ادامه کمک با و خودداری کند.	or he may in an unlucky hour hear of it, be angry, and withdraw his favor.
آنچه داشتند اول به مادرتان و بعد از او به شما رسید.	what they had was secured to your mother and to you.
دستور داد تا هر چه در آن غار عمیق و تاریک ببینم گزارش آن را به تفصیل برای او ببرم.	bring her a minute account of all that is concealed in those gloomy depths.
من بوی خون تازه رو حس کردم و یه فن جون دی گه توی دستش دیدم.	I smelled fresh blood and saw that the cup was in her hands again.
آنگاه گرفتار سرفه طولانی و دل خراشی گردید	which turned into a choking cough.
با ترس و وحشت گرفتن چیزی خود را عقب کشیدند.	they drew away as though they were frightened of catching something
بانوی من چون این بدید مرا در بستر خود نهاد	my mistress perceiving, she put me on her own bed
اما فوراً به خود آمد و آن را با تنفر روی میز نهاد.	but set it on the table again with disgust.
دست کم اینکه وارد پلکان که شد تازه به فکر تبر افتاد.	he was already on the staircase before he recollected the axe.
متأسفانه اطلاعات من در این زمینه بیشتر از شما نیست.	I can't tell any more than you,' he said.
زیرا آبجو خود را یک جرعه سر کشیده بود	for he had finished his ale in a hurry
احساسی نیرومند در درونش مانند باقی ما روحی آرزومند داشت.	was spiritually a hungered like the rest of us.
تأثیر خود را چنین ژرف بر آن باقی گذاشته بودند.	left their mark so deep.
ولی عاقبت متوجه شد که تمام آن چیزها فقط برای فریب مردم است	but by the time he realized that he had been swindled
به شیوه ای دلکش قامت افراشت و به پیرامون نگریست .	rose with a supple movement and looked round.
راسکلنیکف هرگز تا به حال در آن نظر نینداخته بود.	which he had never looked before.
تا دوباره ضاربانی که همراهشان بودند آنان را به خود آوردند	till their memories were again roused by their flappers
او خود نیم راه به استقبال آن شتافته بود.	he met the introduction halfway.
به گقتار خود ادامه دادم. مجبور بودم برای بازدید زن اسقف بروم.	I've been calling on the bishop,' I said
هرچه را که درباره او خوانده بود باور کرد	he believed all he had read of him
پس از آن صدای برخورد شمشیر با در و دیوار به گوش رسید.	then it seemed as though he were slashing vigorously at the wall.
چنانکه گویی کسی شیء سبکی را به سوی او پرتاب کرده بود.	as if some one had thrown a light missile at him.
در همین موقع موجی از افکار درهم و برهم و نامربوط ذهنش را پر کرد.	now, hosts of bewildering and confused ideas came crowding on his mind.
یک بار دیگر جذبه قوی آن مرد را احساس کرد.	she felt once again the powerful magnetism of the man.
ارلاندو در همان حال که دوک سر خود را مغرورانه خم کرده بود	when she cut the matter short, as he stooped his proud head
نگاه بیشعورانه یک زن بی گناه بیچاره پنجاه و هفت ساله بود	it was the stupid eye of a poor innocent seven and fifty years of age
اما آثار دود همچنان در فضا باقی مانده و مانند پرچم هنگام عزا به پایین آویخته بود	but the great scroll of smoke still hung in the air and drooped like a flag mournfully in valediction
که به شکل زیگزاگی تا بالاترین طبقه ادامه داشت.	that zigzagged through the house to the upper stories.
تا شرح ماوقع را با ایشان در میان نهد	told them how the matter stood
به زودی خواهید دید که بمانند دیگران دست به فعالیت خواهد زد.	it's time he began to work for his bread.
تا آن که به شکل و شمایلی درآید که دلخواهش بود.	to and fro in his mind till it gathered shape or momentum to his liking.
آن گاه با لبخندی محبت آمیز او را متبرک ساخت و	he blessed him with his kindly, ironical smile, and
نگاهی بر من انداخت و بعد طوری روی نیمکت نشست که دو سوم آن را اشغال کرد.	but she soon composed her face, and thrusting her large self between me and the table she leant forward to his chair
که حریصانه به جانش افتادند و با حسادت یکدیگر را گاز گرفتند.	which fell on it snapping and biting at each other jealously.
همین که در پشت سرش بسته شد پلکان به نرمی شروع به حرکت کرد	which moved slowly upward as the doors closed behind him
من نمی تونم از پشت سر گذاشتن این دوران بیش از این خوشحال باشم.	I couldn't be more eager to have mine behind me.
این حادثه کاملاً ناگهانی و بدون انتظار بود.	it all happened very suddenly, as you say.
لکن ناگهان شعلهٔ نامطلوبی در چشمان کزماکزمیچ تشخیص داد	but there was a malignant gleam in the old man's eye.
این مرتبه تام مدتی روی آن خم شد	this time he stood over it a little while
با خود فکر کرد که اگر نتواند این جور سر کنند چه چیزهای ژرف و لطیفی خراب خواهد شد.	he thought of how manydeep and tender things would be hurt if they really couldn't go on likethis.
عاقبت رئیس تشریفات را با خود هم داستان کرد.	at last brought off the chamberlain.
حتی سرویس مشروب خواری در اتاقت داری!	even to a liqueur stand in his room!
خنده نه از سرعتم کاست و تمرکزم را برهم زد.	the laughter neither slowed me nor upset my focus.
پس موی سر خود را طوری به دو دست گرفت	thrusting his hands through his hair in such a manner
اما پدر تو در آغوش تو با دولت و سعادت جان داد.	but your father died in your arms
هیچ چیز به من ضربه نزده یا آسیب نرسانده و یا مرا فلج و ناتوان نکرده بود.	nothing had smitten me, or scathed me, or maimed me.
نباید به انجام آن مبادرت کند موظف ساخته باشد.	that he ought not to do.
هم الساعه نیاز آنی به کمک بازوان توانای من و به لطف من دارند	who at this very moment may be in sore want of my aid and protection.
دست کم ده نفر دیگر نیز پشت سرش ایستاده بودند.	there, reflected behind him, were at least ten others.
شانه بالا انداختم و قدم به عقب گذاشتم تا بتواند درهای عقب را باز کند.	I shrugged and stepped back so he could open the doors to the back.
بعد آن را روی زانوی خود نگاهداشت	then held it on his knee
تا رو به در خروجی ایستگاه قرار بگیرد	to face the exit.
چون آمل یا با انبار آکنده از روغن گران بها به بندرگاه خود بازگشت	returning to her berth with her hold full of the precious sperm
که با شگفتی و بهتی آکنده از شک و تردید به او خیره شد.	who looked at him with doubtful surprise.
که وقت آن که سر یکدیگر را شپش بجویند نیز نداشتند.	that they had not even time to search each other's heads for lice.
سپس مشغول گفتگوی معمولی خود شدند.	then fell into natural discourse.
احتمالا مشتاق است با دیگران هم بستر شود	she was probably eager to bed everyone else.
با این حال سرش را کمی خم کرد تا بتواند وارد شود.	she had to stoop low to get through the doorway.
در این مورد نیز به قدر کفایت تجربه اندوخته بود.	for in such matters, too, he had gained experience.
بلکه شادمانی و سرمستی آن مرد حوان نیز برایشان جالب بود	it was the air of jubilation about the young man.
به سرعت به اطاقم رفتم و تنگ آب خودم را هم آوردم.	flew back to my own room, brought my own water jug
پیش چشمانش این تابندگی عظیم یعنی مرگ دشمنش را داشت.	he had before his eyes that splendor, the death of a hated individual.
آنگاه تمام سعی خود را به کار بردم تا بسیار با فشار و از صمیم دل صحبت کنم.	I spoke as deliberately as I could.
برای تمدد اعصاب پاهایش را چند مرتبه حرکت داد و کلاه نقاب دارش را مرتب ساخت.	took off and handed over his felt coat, stretched his legs, and set his cap straight.
چنان او را مضطرب ساخت که بدون کلاه به وسط حیاط دوید	alarmed him so much that he rushed into the yard without his cocked hat,
باطناً شرمسار بود از اینکه شهامت و جسارت نداشت تا بگوید که از این آشنایی چندان هم خشنود نیست.	she had a disagreeable consciousness of not appearing to imply that it had been an overpowering pleasure.
آن شب هاگریدبیش از اندازه هشیار و گوش به زنگ بود	looked slightly alarming
ستایش گر ارادهٔ خشن و بدبینی مردانه و تندرست شده بود.	he set up, with violence, a manly, healthy pessimism.
حالم بهتر شد و وجدانم از نیش زدن دست ورداشت و مثل پر سبک شدم.	I felt easy and happy and light as a feather right off.
من مجبور بودم که نگاهم را برگردانم	I had to avert my eyes
در سایه کوزت او توانست باز هم در راه تقوی پیش رود.	thanks to her, he could continue in virtue.
به دنبال این افکار سیگار برگ خود را دور انداخت و به رختخواب رفت.	she threw her cheroot out of the window and went to bed.
سخت کوشیده بود تا خود را در دل او جا کند.	began deliberately to worm his way into his good graces.
البته یک حصه از اموال مخصوص شماست که پدرت مضایقه نخواهد کرد.	there is, doubtless, a part of your fortune your father could not refuse you?
بلکه به او چنان آرامش و صفای درونی داد که پیش از آن هرگز به خود ندیده بود.	but of a spiritual peace he had never experienced before.
میزان معلومات خود را به او یادآوری کردم.	I recalled her to my level.
یک دقیقه شنگول است و دقیقهء بعد خمود!	now in spirits and now in despondency!
اما در عین حال احساس کرد که ربرتا برخلاف تصور او تنگ فکر و متعصب نیست.	but he felt that she was not nearly as narrow as he had feared.
یکی از ملاحان انگشت خود را در حلقه دستگیره فرو برد.	let one of the crew put his finger into the ring.
با اشاره و ایما خواهش کردم بگذارند بروم و او را بدوشم.	expressed a desire to go and milk her.
تکه گچ خود به خود بلند شده بود و شروع به نوشتن کرده بود.	then the piece of chalk had lifted itself up and had begun to write.
چندین ساعت بود که سخت در پیچ و تاب بودم و قصد قضای حاجت داشتم.	I had been for some hours extremely pressed by the necessities of nature.
راه درازی در پیش داشت و لازم بود نیرویش را نگه دارد.	it was a long way and he must keep up his strength for that.
ولی اندوه و خوشی به هم درآمیخته بود.	with an odd mixture of sadness and sweetness.
تا یک صندلی در کنار اِما پیدا نکرد ننشست.	till he could find a seat by her, would not sit at all.
می دون ستم حقه بازیه و نباید این کار رو بکنم.	I know I shouldn't have done it
زیرا خود او دو سه سال پیش در آرزوی همین کار بود.	for that was the sort of thing he himself had dreamed of, two or three years ago.
چه معتقد بود که این کاربرای تندرستی برادرش ضروری است.	but she thought it necessary for her brother's health.
من جوابش دادم که او به گردش رفته است!	I told him he was out walking.
اما ناگزیر بود این کار شروع شده را به انجام برساند.	but the task he had begun had to be completed.
از این گذشته گرمای هوا و تقریباً نیم بطری عرقی که هنگام فرود آمدن از کشتی نوشیده بودم در من سخت هوس خواب را برانگیخت.	with that, and the heat of the weather, and about half a pint of brandy that I drank as I left the ship, I found myself much inclined to sleep.
آنقدر نزدیک که ما مجبور شدیم برای جلوگیری از تصادف با سرعت راه خود را کج کنیم	so close that we had to strike sail to avoid running foul of her
به کلیسای خالی گام کذاشت و در جایگاه خانوادگی معاون کشیش نشست.	he went into the curate's pew before any one else arrived there.
در حالیکه سعی کرد که اضطراب خود و سرخی رخسار را پنهان دارد	trying to disguise the agitation of her voice and the flush of her face
دلیلی برای باور کردن این موضوع وجود داشت	there was every reason to believe
ولی بالاخره به ما اجازه دادند که او را دفن کنیم.	but at last we were allowed to bury her.
ظاهرا صفت محرری را برای خود حفظ کرده بود.	something of the notary had lingered in him.
احساس کردم که خیلی ناراحت تر از قبل هستم.	I began to feel more uncomfortable than ever.
با انگشت شست و اشاره لبهاشو رو هم نگه داشتم.	I pinched her lips together between my thumb and finger.
کلاهش را که از بالای دیوار در باغ انداخته بود یافته و بر سر نهاده بود.	his hat,which he had flung over the wall, had been found and picked up.
بیش از چهار مست لای عقل شنگول را به خاطر آن به قتل رسانده بودند.	that had cost many a carefree drunk his life.
زیرا مسی و دکتر قبلا به شما اطلاع داده.	since this gentleman has forewarned you
همیشه آماده بود که دقیقا آنچه را که محبوبش نیاز داشت به وی بدهد.	he was always there, ready to give her exactly what she needed
شاهزاده از اینکه مشاهده کرد وی صحبتی را که خودش آغاز کرده بود پایان بخشید آرزده شد.	but, still, it seemed queer to the prince that he should so abruptly drop a conversation commenced by himself.
که فقط به حکم غریزه کور پا تو را زده!	that simply smote thee from blindest instinct!
چندان با حریفان کاردیده و مخاطرات عدیده مواجه شود که با غلبه بر آنان شهرت ابدی کسب کند.	exposing himself to peril and danger from which, in the issue, he was to reap eternal renown and fame.
او دوباره به یاد آواز مردم دریایی افتاده بود.	he was thinking about the merpeople's song again.
از جمله راز عشقی را که به دل داشت برای من فاش کرد.	he made all his thoughts known to me, and in particular a love affair which troubled his mind a little.
آیا ایرادی به رخت و لباس و سر و وضع خادمان او دارم یا نه.	what quarrel I had with the dress or looks of his domestics?
به او اطمینان دادم که هر دو تنها هستیم.	I assured her we were alone.
تا آنکه معنای خود را یکسره از دست داد	until it had no meaning
چگونه اجرای این نقشه را تنها به او واگذار خواهند کرد.	how he alone would be entrusted with the executing of the plan.
گمان برد که با ماجرایی مواجه شده است	took it into his head that this was a case of adventure
همان دیوار ترک دار فروریخته ای که در شب تلاش بی ثمرش از آن فرود آمده بود.	the same crannied and crumbling wall down which he had climbed on the night of his unlucky attempt.
ولی وی به درون رفت و در را از پشت بست و مانع ورود من گردید.	she hindered me from going further by securing it against me.
هرگاه با ین فکر افتادم برای آنست که تا امروز هیچ کس به فکر آن نیفتاده است دعائی برای او بخواند.	I might have done it because I doubted if anyone had ever crossed himself for her sake before.
با این بیان پوست بالای شقیقه چپش را جمع کرد	the skin over his left temple puckered
همه قوایش به ته رسیده بود و پیدا بود که بیمار است.	much distressed and evidently fatigued.
دیگر هیچ چیز را از شما پنهان نخواهم کرد.	there is nothing which I shall hold back.
در طول مدت آن روز دیگر او را ندیدم و صبح روز بعد هم قبل از این که از خواب بیدار شود آنجا را ترک گفتم.	I saw him no more during the day, and was off before he had risen in the morning.
به محض اینکه نفسم را بدست آوردم بریده بریده گفتم	I choked as soon as I could breathe.
که کلاید بتواند علاقه مشروعی به او داشته باشد.	that he could have any legitimate interest in her.
مجالی برای خوابیدن یا دراز کشیدن وجود نداشت.	no chance to lie down or stretch out.
بزودی دست به اسراف و حیف و میل آن گشود	where, having quickly squandered it
در پایان چیزی نمانده بود تا به یک درگیری منتهی شود.	was at the point of ending in tragedy
آنگاه با کمال فروتنی و شکسته نفسی از حاکم درخواست کردم که مرا از اقامت در کاخ خود و پذیرفتن دعوتی که در ین باره از من کرده بود معذور بدارد.	but humbly desired his highness to excuse me for not accepting his invitation of lodging in the palace.
که کلاهش را به قفا گذاشته شنی را به دوش انداخته بود در میان توده جاندار و متحرک سربازان پیاده مشاهده کرد.	with his cap on the back of his black head and a cloak hanging jauntily over his shoulder.
گردنش را با حالتی اندیش ناک به یک سو گرفت.	she gave her neck a meditative turn
به آن طرف اطاق به سمت پنجره رفتم.	I walked to the window, across the room
نیمی از اوقات خود را از عشق او سرمست بودم	delirious with his love half my time for he would
خلاصه از بدبختی مرد و من هم هرچه داشتیم ورداشتم و مزرعه هم که مال ما نبود سوار کشتی شدم و سربالایی راه افتادم و شب از کشتی افتادم تو رودخانه	so when he died I took what there was left, because the farm didn't belong to us, and started up the river, deck passage, and fell overboard
به طرف ماشین قدم زدم و بعد به کاپوت تکیه دادم و با کلیدهام بازی کردم.	I wandered back to the car and then slumped against the hood and played with the keys.
حوله را محکم تر دور خودم پیچیدم و مصمم از حمام بیرون رفتم.	I hitched the towel tighter under my arms and marched determinedly from the bathroom.
ارلاندو را در یک قدمی خود سراپا برانداز کرد	she held him a foot's pace from her and looked him up and down.
مات و مبهوت به دور و بر نگاه کردم	I turn around, bewildered
از سوراخ رفت پایین و فاریا را از عقب خود کشید	but descended into the passage dragging his unfortunate companion with him
شال را کشید و سر را خم کرده از هر سو به او نگریست	now arranging the scarf and looking at her with her head bent first on one side
مهمانان از جا برخاستند و به کنتس تبریک گفتند	leaving their seats, went up to congratulate the countess
لبخند ملایم و مبهمی از روی قدرشناسی زد	made a vague smile of gratitude
خطری متوجهش نیست و بزودی مرخص خواهد شد.	he was in no danger and would be out soon.
وقتی مطالعه و درس معمول هر روز صبحش تمام شد به سوی کشوی مخصوص خود رفت تا ساعتی مشغول و سرگرم باشد.	so, at the conclusion of her morning studies, she resorted to the solace of the drawer.
اسکار لت گرفتار شده بود ولی خنده روی لبانش ظاهر نشد	in a rapture that she had neither laughed
مثل او با جیغ و فریاد از جای خودشان پریدند بالا.	they squirmed and jumped about as well, shouting
تا آخرین پنی پولش را خرج خواهد کرد تا موانع را از سر راهمان بردارد.	he would devote his last penny to removing the obstacles which divided us.
صدای صفیر باد را وقتی که خودش را به سوی من سوق می ده دمی شنوم.	I hear a whoosh as he propels himself towards me.
با سرو صدای وحشتناکی به این سو و آن سو هجوم بردند	they had started jabbering and rocketing around
این همان قایقی است که امروز صبح دیدم.	it's the same I saw this morning,' he returned.
او هم قصد نداشت کلاید را به زور وادار به کاری کند که برخلاف میلش باشد.	she was in no mood to compel him to do other than he wished.
اما مجبور شد پانزده دقیقه صبر نماید تا مرداش از حمام خارج شود.	he had to wait for more than fifteen minutes for the recipient to come out of her bath.
یا لااقل در مدت این سه روزی که من در آنجا بودم خواب به چشم کسی نرفت و من نیز چشم بر هم ننهادم.	at least, during those three days I was with them not one of them closed an eye, nor did I either.
با سرعتی باورناکردنی با سر خود را به میان آب انداخت	with marvellous quickness he flung himself headforemost into the sea
در زورق مقداری گوشت پخته پرندگان و خرگوش ذخیره کردم	I laid in a stock of boiled flesh, of rabbits and fowls
دست دیگر را نیز حایل چهره خود ساخته بود	shielding his eyes with his hand.
لابد خدمتکارهایش فراموش کرده بودند.	his servants forgot it.
جنگ پر ابهت و پر دقتی را شروع کردند	began a grave, careful combat
به داخل برگشتم تا یک کُت پیدا کنم.	I retreated inside to find a coat.
بعد جاده را بپیماید تابه شهر سیب ولا برسد.	then he would walk down the highway
درست بدان علت که او فریاد کشیده بود بسوی او تاخته بودند.	they had galloped to him because of his shout
از بسیار گریستن تقریبا خاموش شده بودند.	were almost putout with weeping.
برجسته و آگاهی از ضعف ارتش خود که زمانی مقتدر بود افزون شده	he knew personally had been killed or wounded, and the consciousness of the impotence of his once mighty arm
بعد دل و جرأتم را از دست دادم.	then my courage sank.
برای اولین بار حس کرد که از بازگشت چندان هم خوشحال نیست.	she suffered her first sense of displeasure at being home
که در تمام این مدت از کنار او تکان نخورده بود	which had never left her bed all these days
چون از این نظر دارای نیروی حافظه عجیبی بود.	which, as usual, after hearing once, she had remembered ever afterwards .
اما بعدها نه دیگر وقت داشت و نه تمایلی به دیدن مشتریان همیشگی این محل.	but afterwards he had no leisure for the game, and no inclination for the socialities there.
نگرانی و اضطراب حاکم بر جو قلعه را تبدیل به وحشت کرد.	it turned what had hitherto been nervousness into real panic.
که تمایل او به این شراب برای رفع عطش یا شراب خواری نیست	that it was not to quench his thirst or from greediness that he wanted it
یاد گفته آن پیرزن در جلوی خانه کشیش در جواب درخواستم برای ملاقات کشیش افتادم.	I remembered the answer of the old housekeeper at the parsonage, when I had asked to see the clergyman.
هر کدام مدتی از بالای رودخانه خیره نگاه کردند.	fell to gazing longingly across the wide river
امروز حتی فکر آن هم برایش دردآور بود.	today the mere thought of it was painful.
میدانید که منظورم چیست درست مثل ارواح خبیث و انتقام جو.	you know, like a sort of avenging spirit.
من ناگزیر بودم روزی چندین بار به این زیرزمین بروم.	I had to go to the cellar anyway, several times a day, indeed,
وقتی خود را به قایق رساند فوراً آن را تشخیص داد.	he recognized the boat at once.
چون بلافاصله به معنای این حرف پی بردند.	for they all realized what that meant.
معلوم شد که نوبت بعدی سکان بانی او ساعت دو بامداد روز سومی است که او را لو داده بودند.	found that his next trick at the helm would come round at two o'clock, in the morning of the third day from that in which he had been betrayed.
از سوی دیگر مادرش اورسولا نیز او را به حال خود رها کرد.	rsula abandoned her.
یه کاکا سیاهی هس به اسم به وب که یه دو به چوبی از آب گرفته بود و اربابش نمیدونس.	dat had ketched a wood flat, en his marster didn' know it
مثل یک ناخدای کارکشته شب و روز مشغول هدایت روح ماست.	a veritable soul pilot in her cross grained, uniformed way.
قامتش خیلی بلند نبود اما به طور کلی خوش اندام بود.	though neither tall nor graceful.
تلفظ این کلمه که نه تنها برای او بلکه برای دیگران نیز نامفهوم بود	she would go on, deriving much comfort from the utterance of that foreign word
اما این را نگفتم چون حس کردم با گفتن یک جمله طولانی خود را به مخاطره اظهار ضعف خواهم انداخت برای این که دیگر لحن کلامم کاملاً در اختیارم نبود.	but I stopped, feeling it would not do to risk a long sentence, for my voice was not quite under command.
از دیدار این طفل یتیم به سختی متأثر شد	took pity upon the poor orphan
به قسمی که اگر سفر کردن وی از ابتدا به این منظور بود که در قبال معشوق تعهدی نسپارد	if at first he feigned a wish to absent himself in order to cure his love
ظاهراً آنقدر کم تغییر کرده بود که نگرانی من فوراً از بین رفت.	she looked so little changed that my fear was instantly dissipated.
لابد خودتون دلیلشو می دونید و حاضرید با مسالمت همراه من بیائید.	I suppose you know what for, andthat you're prepared to come with me peaceably.
آنجا چیزی دیده بود که تأثیر زیادی روی او گذاشته بود.	she had come upon something there which had made a great impression on her.
به او گفتم آن خانه بانویی ندارد و کارفرمای من یک مردست.	when I told her there was only a master
همان موضوعی بود که او را صبح تا شب روی دیوار سرد و سخت به انتظار نگه داشته بود.	the real reason she had been waiting on a cold, hard wall all day
رفته رفته به خبر چینی و اغوای خود فرانسویان.	gradually, as a tempter and an eavesdropper among the natives.
بخشی از احساسات باطنی کلاید به ذهنش منتقل شد.	even as she listened to his words and felt his caresses.
ولی هرگز پیش نیامده بود که تنها باشند .	but she never saw him alone.
ترس محسوسی سراپای مرا در بر گرفته بود.	a little fearful now, a little afraid
شهرت او و احیای آن از طریق نقل داستان زندگیش برایش گرد آورده بود.	its revival in the floating whispers of his story, brought him.
که این برادر برای من حکم یک نشانهٔ الهی را داشت	that that brother had been for a guidance and a sign from on high for me.
لکن تو به ته و توی کار واردی و باید آنقدر عقل داشته باشی که خودت درک کنی.	but you've been on the inside, and you ought to have sense enough to see for yourself.
اما این خبر در شوهر او اثری محسوس به جا گذاشت	but the intelligence had a palpable effect upon her husband.
او ضمن گفتن این سخنان خاچ فلزی کوچکی از گریبان خود بیرون کشید	so saying he took out from his breasta metal crucifix
اما چنان متأثر شد که برای مدت طولانی نشان دادن ضعف از سوی خویش را تقبیح کرد.	it left her in such a state of affliction that for a long time she repented in her weakness.
از رابطه و تماس مستقیم با مردان و زنان به چنان نیروی محرکی دست یافته بود که تاکنون آن را نشناخته بود.	the directness of contact with men and women gave a thrill of power which he had never known.
اما آرزوی اصلی و آتشین و پنهانی او همان عشق خاکی و جذبه جسمانی بود	but her strongest, most deeply hidden longing was for earthly love.
من به مامانم قول دادم یک کلمه هم با او صحبت نکنم و هیچ حرفی هم به او نزدم.	I promised mamma that I wouldn't say one word to him, and I didn't.
یقیناً این نکته پنهان نمانده است که سگ نیز به همراه او نا پدی شده	it would not be forgotten that the dog was missing
همچنین از او خواهش کردم که راز جلد مصنوعی مرا به کسی فاش نکند	I requested likewise, that the secret of my having a false covering to my body
آرزو داشتم برگردم تا بتوانم تا هر وقت که ممکن بود آن نقش را ایفا کنم.	I itched to be back so that I could fill that role for as long as possible.
چه سراسر زندگیش او را بدان عادت داده بود.	for all his life he had been accustomed to it.
پیش از این که بالا بروم و وارد ساختمان شوم داخل سرایدار خانه شدم.	I stepped in there before going up to the hall.
اما با سرعت انتقال مخصوص طبقات ممتازه سر را حرکت داده فهماند که مطلب را دریافته و مشغول مطالعه آنست.	though, with the quickness of memory and perception befitting a man of the world, he indicated by a movement of the head that he was considering this information.
وقتی که مرگ به سراغ او آمد فقط و فقط من بالای سر او بودم.	I stood alone beside the body when death came over it.
کرما و صمیمیت نگاهش را به یاد آورد و تلخی رفتار و بیانش را تا حدودی ازیاد برد.	she remembered its warmth, and softened its impropriety of expression.
هرچه در طلب حیوان به جستجو پرداخت و به این در و آن در زد به مقصود نرسید.	though he did all he possibly could to find it, it was all to no purpose.
لیکن فقط دو اطاق داشت و تختخوابی نداشت که در اختیار یورگیس بگذارد.	but he had only two rooms, and had no bed to offer.
اون ملکه بیچاره که من دیدم روی گاری نشو نده بودنش و می بردنش!	to that poor queen whom I saw pass in the tumbril!
که اگر دلم بخواهد او اول لباس بپوشد و بیرون برود تا من تنها لباس بپوشم.	that, if it pleased me, he would dress first and then leave me to dress afterwards, leaving the whole apartment to myself.
شوهرش در باطن از این وسواس زنش ناراحت بود	her husband was inwardly afflicted at it.
همان طور که او ناپدید شد من آهی کشیدم	I sighed as he disappeared, moving too fast.
برای این کار مجبورشد دامن پیراهنش را کمی بالاببرد	pulling her skirt up a little so she could do it
خود را جمع کردم و از زمین برخاستم.	I crawled up from the floor
تصویر همسری که پریشان حال به عزای مرگ او نشسته بود در خاطرش برمی خاست	thoughts of the husband who would be left so desolate, and who would mourn for her so much
فهمیده بود که فقط دو نفر سد راه رسیدن او به ثروتی هنگفت هستند.	found that only two lives intervened between him and a valuable estate.
آنهم همیشه به سمت آن در کوچکی که فرار از آن ممکن نبود.	always toward that little door overthere, from which there was no escape no escape
اینکه رالف هم به خطای او پی برده بود.	the fact that he knew her mistake.
از لبه قایق به درون انداختیم و خود بالا جستیم و به جای خود نشستیم.	lashing them across the gunwale, tumbled back to our places.
تنهایی و بیگانگی دخترش را در گفتگوی عمومی مشاهده کرد.	the loneliness of his daughter amid the general conversation.
گفتی که دختر دل فریب از پرحرفی شرم دارد	her modesty seemed to suffer under the infliction of discussing such a question.
دست او را کنار زدم و دوباره به قدم زدن پرداختم.	shook off his hand, and began to walk about again.
هنوز از اینکه از لحاظ فیزیکی قادر به چنین توهینی به مقدسات بودم وحشت زده بودم.	I was still horrified that I was physically capable of such blasphemy.
واقعا هم مطمئن بود که دخترک در اینکا رم وفق خواهد شد.	he ventured to say, since he could not help feeling that she would.
ناگهان ضرورت چیزی که امروز در پیش رو داشتیم را حس کردم.	I suddenly felt the urgency of what we had before us today.
این فکر هشت روز دیگر از وقت او را برای یافتن نام جدید گرفت	he was eight days more pondering over this point
اما پس از تلاشی سخت توانست تنها لبخند شادمانی بر لب آورد.	but with a good effort he resolved it into nothing more offensive than a merry smile.
که ناگهان از فراز سرش فریاد چند نفر او را متوجه ساخت	when just above his head he heard several voices shouting
تا اینکه عاقبت هیچ کدامشان قدرت نداشتند حتی یک سانتی متر جلوتر بروند	until the time came when neither man had the strength to move another inch.
یکه خورد و از بهت و تعجب از جا پرید	then she shrank back and half sprang to her feet in amazement.
وضعی داشت که پنداشتی جرأت نفس کشیدن هم ندارد.	she had the appearance of nolonger daring to breathe.
من نمی تونستم راجع به پیشنهادی که داده بود فکر کنم.	I couldn't think about what he was suggesting.
همیشه هم بدون این که تقصیری داشته باشد سرش شلوغ بود.	always innocently busy
من خیلی از این بابت متأسفم و بایستی از او به خاطر این که سعی نکرد متقابلاً نسبت به من گستاخی نماید تشکر نمایم.	I'm sorry for that, and ought to thank him for not shaking me, I suppose.
خودش قبلاً از این موضوع باخبر بود.	he knew about it beforehand.
به چهره نفرت انگیز و زشت او که در آن موقع با کمال وضوح مشخص بود دقیق شده بودم.	I mused on the disgusting and ugly appearance of him who would presently deal it.
ثروت خود را در همان دوره به صومعه بخشیده.	she endowed with her fortune.
بدبختی بر ما باد که تو را بگذاریم به این قسم بمیری.	I have let thee perish!
ناگهان تانیس همان درد سری را که از آن بیزار بود برایش درست کرد.	instantly she put upon him the compulsion which he hated.
تنها منتظر است که در آن دنیا آرامش و راحتی را به چنگ آورد.	expected peace only yonder.
اما نایب کشتی جاودانه به زیر آب رفته بود.	but the mate for ever sank.
من در مقابل مجسمهٔ حضرت مریم به زانو درآمدم	I fell on my knees before the ikon
زیرا تاکنون یک پوند هم کلاه به سرش نرفته بود.	that he had never been cheated out of one pound.
اما من آن را برای یکی از خدام کلیسا خواندم و او کلمه به کلمه همه را از حفظ روی کاغذ نوشت	so that I repeated it to a sacristan, who copied it out for me from hearing it
ولی بهر حال فرا رسیدن آن لحظه قطعی است.	but I shall come to that at last.
زندگی از آن رخت بر بست و حالتی مرده وار و بی جان جای آن را گرفت.	all the life was gone out of it, and it looked weary and dead.
ما را روانه قسمت دیگری از جبهه کردند	we were off to another part of the line.
پدر خود را از آزادی و رؤیت پسرش با خبر سازند	send news to his father of his having been delivered and found
تنها در این اندیشه بود که هرچه زودتر از دفتر کار او خارج شود و در اتاق خود آزادانه به تفکر درباره این مسائل بپردازد.	could think only of how to get away quickly to her own room to make out the problem in peace.
که ناگهان سر این حیوان درنده از میان انبوه سگان بیرون آمد	when she suddenly thrust her head up from among that mass of dogs
زیرا متوجه شده بودم که وی دیگر از بابت خود ترسی ندارد و خیالش آسوده شده است.	since he was no longer in terror for himself.
تا در تالار عمومی مهمانخانه را گشودم	as I opened the parlour door
این بود که زندگی برای تام هیچ جلوهای نداشت.	so there was no bright side to life anywhere.
بنابراین همه با هم به راه خود ادامه دادند.	so they went on all together.
شاید هم برای اینکه او را از حالت بهت و تعجب بیرون آورد	perhaps to warn her to betray no surprise.
خودم را برای شنیدن چیز خیلی بدتری آماده کرده بودم.	I had dreaded worse.
اما کنتس با چهره سرخ شده عقب رفت تا لباسش مچاله نشود.	but, blushing, she stepped aside fearing to be rumpled.
گوشی را نیم متر دورتر از گوشش نگه داشت	held the receiver a foot away from his ear
فقط میل داشتم از پیش در جریان تغییرات احتمالی قرار بگیرید.	but I wished to apprise you beforehand of what may possibly occur.
بدانید که اگر آخرین دم را در برابر چشم شوهر محبوبم برآورم	for if I yield it up in the presence of my beloved husband
بیش از سه قدم بین آنان فاصله نبود.	three paces from her.
احساسی از مفید بودن را تجربه کرد	knew a sense of his own purpose
که روت از او خواست بر سرش بگذارد و بعد هم تعارفاتش را به مناسبت برگشتن مارتین اعلام کرد.	which she commanded him to put on and then complimented him on his appearance.
اما در ضیافت ختم او همگی پرهیز کارانه حمله وند.	but upon the banquet of his funeral they most piously do pounce.
هر دو چنان به جان هم افتادند و چنان قشقرق عجیبی به راه انداختند که هرگز نظیر آن دیده نشده بود.	he and she between them began the bitterest and drollest scrimmage in the world.
تصاویر اطراف دوباره واضح و روشن شدند.	everything came into focus again
ولی هنوز با تردید سرجایش ایستاده بود.	feeling that he ought to go away,
که از هیچ راهی امکان ندارد بتواند این مرد را به انجام کاری که مایل نیست وادار کند.	that there was no way this man could be persuaded to do anything he did not want to do.
آن بچه که برایم بسیار عزیز بود چون به هر حال از مادر که یکی بود	this same dear baby it was truly dear to me, for our mother's sake
تا آ مو برای برداشتنش مجبور نشود دست او را لمس کند.	so she wouldn't have to touch him to take them.
که در حق پدرم بدگمان شدم و نام او را انکار کردم	I doubted my father and renounced his name.
از این رو تا زمانی که لوئی زا را کام لا پریشان نساخت آرام ننشست.	she was not satisfied until she had upset her altogether.
فقط یک لحظه زنده شوید تا به دختر نادم خود آمرزش بدهید.	come back for one moment to bless your penitent daughter.
او همچنان خواب بود طبیبی را فرا خواندند.	he still slept, a doctor was summoned.
من به پرستارش تلفن کردم که تا یکی دو ساعت دیگر برای دیدن او خواهیم آمد.	I telephoned to the nurse that we were coming
که از خائن بدنام انتقام پدرم را بگیرم.	, 'that on which I find at last an opportunity of avenging my father!
خندهء بلند کرد و سیگار برگ جویده شده را از دهانش برداشت.	laughed the captain, taking a chewed cigar from his mouth.
که با چشمان بسته مستقیم روی صندلی خود که به کف اطاق پیچ شده بود	he saw him with closed eyes sitting straight in his floor screwed chair
پدر و مادرش او را به یک درمانگاه روانی بردند	his parents had to put him in a mental institution
راه تاریک و پنهانی که قبلا راجع به آن صحبت کر ردیم.	the dark and secret way that we have spoken of.
دست خود را به پشتی صندلی همسر خود تکیه داد	stood with his hand on the back of his wife's chair
در یک دست جامه دان سفری و در دست دیگر قطعه پوستی برای گرم کردن پا داشت.	while he carried a valise in one hand and the foot warmer of his establishment in the other.
قبل از آن که بتواند مقاومت نشان بدهد دستگیرش کنیم.	have him at our mercy before he can resist.
حالا فهمیدم که خیلی وقت پیش تسلیم هرگونه اشتیاق برای درخشیدن در چیزها شده بودم.	I realized now that I'd long ago given up any aspirations of shining at anything.
در دل تصمیم گرفت که دویست سیلی بخورد ولی احساسات خشم و غضب خود را برای جنگ با چنین هیولای مهیبی بیدار نکند.	he vowed in his heart to let himself be given two hundred buffets, sooner than be provoked to fight that monster.
هر چند هنوز کاملاً به خود اعتماد نداشت.	although he still did not realise this himself.
سر خود را نزدیک به سر بچه بر بالش قرار داده بود.	her head had gradually fallen on the pillow beside her pretty charge.
در را که باز کرد یک لحظه مرا نشناخت.	on opening the door himself, for a moment he did not know me.
شگفت زده بود و بدرستی متوجه نشده بود.	startled and not tracking very well.
به این ترتیب بچه در شرایطی نامساعد مطابق دلخواه ما باقی ماند	there the child dragged on an existence, miserable enough even to satisfy us
چیزی نمانده بود دوباره بیهوش کندش	it nearly made him pass out again.
نمی تونستم آخرین باری رو که او نو هیجان زده دیده بودم رو به خاطر بیارم.	I couldn't remember the last time she'd looked so excited to see me.
لطف موضوع در این بود که قندیل کاروانسرا دار خاموش شد	the best of it was that the innkeeper's lamp went out
همین الان هم از این که مرا ببوسی سرباز زدی.	just now you have refused to kiss me.
که به هیچ عنوان میل نداشته با سوء استفاده از دانش پزشگی خود به ربرتا کمک کند.	but adding that professionally he had been unwilling to doanything for her.
با این همه به درد کبر و خودپسندی دچار شده است	smitten with pride
آنقدر فریاد زدم و استمداد کردم که آوازم در گلو گرفت.	calling for help till I was almost hoarse.
دقت و توجه به حرف آقای تیلنی و اعتماد کامل به درستی این حرف.	attention to his words, and perfect reliance on their truth.
بلافاصله هر دو از خانه بیرون آمدند.	the two at once left the house
بلکه حتی دوست خوب من اورسولا را نیز برای خفه کردن صدای وجدان خودت تیرباران خواهی کرد.	but you'll shoot my dear friend 'rsula in an attempt to pacify your conscience.
چیز نامطبوعی است که با انتقام و کینه همراه است	a thing unlovely, wearing the aspect of vengeance and hate
این همه با صدای هولناکی بر زمین افتاد.	all which with fearful ruin fell to the ground, leaving him in a sorry plight.
چون زمستان سال پیش چندین بار او را در همان ایستگاه دیده بود.	because of having noted her several times during the precedingwinter.
با وجود گرسنگی چنان مشغول خود بود که ابدا به خیال خوراک نیفتاد	but he had not thought of hunger nor did he think of it now
میان او و دوستش بحثی مفصل درباره من در گرفت	much discourse passed between him and his friend concerning me
که اگر چه اسکار لت آن را دیده بود ولی در موردش فکر نکرده بود.	a look she had noticed but had not troubled to analyze.
خودم دیدمش. انگار چند یابوی خوشگل گیرش آمده.	knew him again directly, and he seemed to have got some very pretty cattle too.
از این شاهد جز در آن مورد هرگز متهم را ندیده است	except that he had never seen the prisoner on any other occasion
آن نور قوی قرمز آتش بخاری دایه خانه است.	that the red glare was the nursery fire.
حس کردم دوباره به خودم نزدیک تر شدم.	I felt closer to me again.
دستش را با فشار بیش از حد کنار زدم.	I shoved his hand away with unnecessary force.
زیرا ایب اینک برای آسیاب ذهن به گندم نیاز داشت.	for he needed grist for the grinding activity of his mind.
نزد خود تصور کردم که او تابلو مرا با صدای بلند خواهد خواند	who, I conceived, would read it in a rather strong voice
اما گوش میداد و احساس میکرد که سخنان او بیان همان نیروی بیدادگر قدرتمند است که زندگی وی را در ید اختیار داد و سرانجام باید به آن تسلیم شود.	but he listened to him, feeling that his words were the expression of that mighty brutal force which controlled his life and to which he would have to submit.
گفتگوهای آن روز چنان فکرش را به خود مشغول کرده بود	his head was still pounding with the conversation he had just heard.
بی آنکه بجز شگفتی و کنجکاوی از خود احساسی دیگر بروز دهند.	but showing no other emotions than grim curiosity and surprise.
یک دفعه از ترس نزدیک بود بمیرد.	was nearly died of fright.
دست خود را به مدت چند لحظه به روی آن تکه یخ چسباند	put his hand on the ice and held it there for several minutes
بعد متوجه شدیم که در واقع خیلی به آن نزدیک هستیم.	then we knew that we were indeed very close.
که امکان داشت هر لحظه او را سرنگون کند.	but at first he astonished them, as he rattled in with his two guns.
آخه دلیلی نداشته که لاوندر برای خرگوشش نگران با شه.	she can't have been dreading it
مانند پدرش عقیده خود را در باب وی تغییر بدهد.	as his father to change his opinion.
تذکر داد که درنگ کردن من در غار بیش از اندازه جایز نیست و ساعتی که برای خروج من شایسته است نزدیک است.	particularly as the time was drawing near when it would be necessary for me to quit the cavern.
که دیگر چشم از او برنداشت و در اتاق ماند	for he remained in the rooM
از این به بعد باید آماده باشد که از برخوردهای نادرست اولیه مردم ناراحت نشود.	he ought to be accustomed by now to making at first sight a bad impression on people.
من زنده هستم و در زنده بودن تقصیری ندارم.	I'm alive, that is not my fault
کوچک کردن خودم پیش او خیلی دردناک است.	to humble myself so to her is painful.
که بزودی درشکه برای بردن او بیاید.	that she only feared the trap would come for her too soon.
من تو را خیلی دوست داشتم و خیلی عاشقت بودم.	I was so dreadfully in love with you.
کارهای دیگری داشتم که انجام بدهم.	I had something else to do.
بلکه باید همسر او باشد و جز این نباید باشد.	but must, be his wife, and that it could not be otherwise.
من هم همین لباس را پوشیدم و به دنبال آن جمع وارد هوای آزاد شدم.	I was similarly equipped, and, following the stream, I made my way into the open air.
برای دو دقیقه در سکوت به آن پک زد.	puffed for a minute or two in silence.
هم شراع برافراشتم و هم بنا کردم به پارو زدن	I sailed and paddled together to the south
حال آنکه در تمام آن مدت احساس می کرد	all the while sensing that she was really doing nothing for herself because
به فواصلی از اتاق مجاور به دکتر سر زدند.	observed him at intervals from the adjoining room.
آناً قول دادند که مهترشان اوامر او را مو به مو اجرا کند.	promised that their squire should do all that had been commanded.
فکر کردم شاید شما هم با او کار داشته باشید.	I thought you might like to know he was there, if you had anything to say to him.
آنقدر فریادش وحشتناک بود که همه از جا پریدند	so fiercely they all jumped.
او را به شدت تکان داد ولی گرستکین بیدار نشد.	he tried vigorously, but the sleeper did not wake.
برای خود یک بالاپوش آستین کوتاه گل و گشاد زبری دوخت و به تن کرد	so she sewed herself a coarse cassock that she simply put over her
پس از انجام مأموریت خود مراجعت کرد.	having done this he rode back.
به علاوه باید اعتراف کنم که بیشتر به ملاحظة این بود که حالات مذکور به خودم دست ندهد.	I was no less afraid of confusing myself.
تنش خیس عرق بود دهانش بدمزه و سرش منگ شده بود	his mouth was parched and his body was wet with sweat, and his head was dissatisfied with his rest.
تمام این چیزها را دستی ماهر گردگیری و تمیز کرده بود.	but everything was kept free of dust by a diligent hand.
او فوری یک نی مسوز برداشت و آتش را به هم زد.	as he stirred it quickly with a piece of burning wood
در حالی که خواندن بقیه داستان را متوقف کرد	pausing as he was about to read the remainder of the novel.
که قواس فریادی زد و رفقای او دیدند و او را گرفته به قعر زورق انداختند	but four vigorous arms seized him as his feet quitted the bottom of the boat
تا وقتی که اون مرد به دار زده نشود	until that man was dead
مردی که از دوران بی دغدغگی بازنشستگی به خواست هم قطارانش وارد دوره کشمکشی آکنده از خطر شده بود به پاس از خود گذشتگی ای که نشان داده بود حال حق سخن گفتن داشت.	coming out of his retirement into a dangerous strife at the call of his fellows, had the right to speak with the authority of his self sacrifice.
اگر کسی در آن بخوابد عملا از بین خواهد رفت.	if anybody slept in that room he was just as good as dead.
تا خود را به محفل دلخواهش برساند.	to the society he so loved.
از دفتر کار بیرون امدم و از راهرو یکسراست به سمت اتاق کنفراس رفتم.	I stride across the office and down the corridor to the meeting room
ولی نسبت به مه خود را یکسان ظاهر ساخت و خود را مانند زمانیکه رق فرو خوشبختی بودنشان داد.	but no scrutiny saw any change in her, nor had she looked otherwise in the days of the glory of her happiness.
این دفعه احساس کرد الکتریسیته در سرش جریان پیدا کرده	very quickly this time she felt the electricity beginning to flow inside her head
در این لحظه احساس کرد که حتما توانائی آن را خواهد داشت که درست بر طبق دستوران جفسن رفتار کند.	for the time being at least, that certainly he could do as he was told, and would.
آنچه این جوان را اکنون به این وضع خطرناک انداخته است همین دو خصلت بوده است و نه عوامل دیگر.	it is thesetwo qualities, and no others, that have placed him in the dangerous position in which he now finds himself.
اکنون مانند من در وطن نزد زن و فرزندش بود.	he might have been safe at home with his family at this time, as well as myself.
همانی بود که خانه به آن نیاز داشت.	that was what the house stood in need of.
یک بار سرم را تکان دادم و بعد برگشتم.	I'd nodded once, and then turned my face straight forward.
من این بار به او توجه بیشتری کردم.	I took particular notice of him this time
از او خواهش کرد که نقاب از چهره بردارد.	requested her to remove her veil.
متحیر مانده بودم به کدام طرف بروم و حتی راه بازگشت را هم گم کرده بودم.	I thought, as I stood there, wondering which way to turn
پیکی به دنبال ایشان فرستاده شد که از ایشان استدعا کند در اینجا منتظر من بمانند.	I think a messenger was sent after him to beg the favour of his waiting for me here.
یک بار با لحن عادی خودم و بار دوم در حالی که روی همه قوای خودم تکیه کرده بودم.	the first time in an ordinary tone, and the second time with the greatest prolonging of the words of which I was capable.
هنگامی که در حال مرگ دشمن خود را دیدم و با این حال او را دوست داشتم احساس کردم.	when I saw my enemy and yet loved him.
شاید بتوانم یک اسقف پیر را از راه بدر کنم.	I might be the undoing of some poor prelate yet.
فقط بدنبال چیزی بودم که وارد مغازه شوم.	I'd merely been making a pretext to come into the shop.
همه چیز هم ون جوری که اتفاق افتاده بود دوباره از پیش چشمم رد شد.	I seen it all happen again.
در حالی که تنها سه تن از ملاحان را که در اثنای سفر بیمار شده بودند از دست داده بودیم	having lost only three men by sickness in the voyage
خود را بیرون خانه در زیر آسمان شب یافت.	was out in the night
از این پیروزی جدید اجتماعی و عاطفی خود چنانکه باید و شاید لذت ببرد.	this new and amazing social and emotional victory of his.
گویی تردید داشت که حرفش واقعیت داشته باشد.	as though he doubted it.
احتمالا در راه آمدن به اینجا سردتان شده است	you may have felt the cold in coming here
این یک لانه جانوران بود که زیر چشم داشت.	it was a nest of monsters that he had beneath his eyes.
برای ما مادرها یک کلمه هم کافی است که ما را از نگرانی و تردید درآورد.	we mothers can understand at a word, and that word would have spared me the anguish of uncertainty.
در آنجا اعلی حضرت در شورای سلطنتی موافقت کرده بود که مرا باید به آنجا برند.	whither it was agreed by his majesty in council that I must be conveyed.
به من قول داد که اسباب دردسر و ناراحتی من نشود.	she pledged her word, and kept it for my sake.
هرچند اطاعت از او لزوماً در حکم آشتی با او نیست.	though not necessarily conciliated.
اثر انگشت شصت دست شکلاتی و مخدوش شده در ذهنش باقی مانده بود	but that smudged chocolate thumbprint stayed on her mind
دهن خود را به شیشه چسباند و بینی را بر آن فشار داد و پخچ کرد.	he pressed his mouth and flattened his nose against the pane.
مرا برای نوشیدن چای به درون فرستادند.	while I was sent in to get my tea.
سبیلی کلفت و ریشی انبوه و دو شقه داشت به طرف در آمد	mustaches and whiskers rode up to the gate
فکر کردم زودتر باید خیالش را راحت کنم.	I thought it would be making her comfortable at once.
چند بوته گل سرخ پیچ در پیچ باقی مانده بود	a few old gnarled rose
که با زیبائی و ثروت و مقام اجتماعی بلندش دل از او ربوده بود	because of her beauty, wealth, position, he had become enormously attached
بوهای گوناگون را استشمام و به این طرف قدری وقت تلف کرد.	snuffed this smell and that and thus wasted some seconds.
صدای گرفته و آشنایی از درون سیاهی شب جواب داد	a husky familiar voice answered from the black night.
دست دیگرش نیز محکم در دست رفیقش بود	having the other firmly grasped by his companion
کلاید هم چنان مغلوب و اسیر تمنای درون بود	clyde, so completely overcome and swayed by his desire
بعد ناگهان مثل این که از روی تخته شیرجه برود صدایش پایین آمد	then plunged down as if from a spring board
شهوانی و نگاه سرد و مغرورانه به واسطه نزدیکی مرگ زشت و بدترکیب نشده بود	its cold, majestic expression, was not disfigured by the approach of death.
ولی هنوز شروع به خوردن نکرده بود که آن میل و تصمیم از بین رفت.	he was going to commence eating, when the inclination appeared to become suddenly extinct.
اما با یادآوری آن خاطره رخسارش روشن بود.	answered the princess, but her face beamed all over at the recollection.
اگر شوق پیشرفت کورکورانه وجود نداشت	if the stumbling forward ache were not alive
در واقع حتی تصور آن مکان نیز در ساعات پر سکوت شب کافی بود تا ساعتها دچار بی خوابی توأم با خشم و تب و تاب شود.	in fact, the mere vision of it arising before his mind in the still watches of the night had the power to exasperate him into hours of hot and agitated insomnia.
معتقد بود که سرانجام این سماجت موفقیت به بار خواهد آورد.	she was convinced that in the end persistence would succeed.
در اطراف چرخیدم و نگاهی به راهرو پشت سرم کردم.	I swung round, looking at the gallery behind me.
این نه ممکن است و نه درست به تو اعتراف نکنم	it is no longer possible or right that I should conceal from thee.
سطل را برداشت و به طرف حیاط عقب خانه راه افتاد.	took the bucket and carried it out into the back garden.
لیکن با آنکه لوتر این تعهد را کرده بود	but though this arrangement was made between them
به این ترتیب شایستگی خود را برای احراز مقام مدیریت نوانخانه اثبات نماید.	with the view of satisfying himself that he could fill the office of workhouse master with needful acerbity.
با صدایی شمرده و پرشکوه و به منظور پایان دادن به این نحو خودمانی صحبت کردن ناشناس	slowly and impressively, to check any undue familiarity the stranger might otherwise assume.
حالا در بالای ستون بدنامی در معرض دید همگان قرار گرفته بودم.	was now exposed to general view on a pedestal of infamy.
آن طوری که ایشان مستغرق اندوه و غصه هستند	, who is in deep distress
در عوض کمی استعداد در امور مکانیکی داشت.	he had a slight mechanical turn
پس راه را بر او بست و صورتش را به چهره او نزدیک کرد.	blocking her path, he brought his face close to hers.
اما بعد فهمید که پر ین از این کار منصرف شد.	but that he finally decided against it.
هم ون وقت هم اون یکی دی گه زد توی سر تو.	just as he fetched you another awful clip
یک نوار تمیز برایش ریخت تا روی زخم سر خود ببندد.	she gave him a clean diaper to bandage his head.
که هم او بوده است که نقشه خانه کنت را به تو داده	he had doubtless given you the plan of this house
تا این که آن یک جفت چشم قهوه ای اشاره به چایی کرد و او را به یاد چایی سرد شده انداخت.	till something in the brown eyes looking down at her made her remember the cooling tea
دست به دست به هم دادند و ربرتا را به فکر انداختند که چه عاملی کلاید را این چنین دگرگون کرده است.	she began to wonder what it was that was bringing about this sudden change.
نخست به خاطر امید زیاده از حد رنگ به رنگ شد.	first with a too definite expectation, and afterwards with a proportionate disappointment.
خیلی جالب بود که مردی را ببیند که این همه سال دوستش بود و نه معشوقش.	it was fascinating, suddenly to see a man who had been a friend for years as a possible lover.
در آنجا نبود تا از خونریزی پیشگیری کند	was not there, trying to do something to stay bloodshed
از ایشان پرسیدم که چرا دلایلشان را در دادسرا نگفتند.	I asked him the same question.
بلکه وحدتی مرموز که هر لحظه آن دو را بیشتر به یکدیگر میپیوست	but some sort of mysterious communication, which brought them every moment nearer,
بلکه سخنش را با خشونت بریدند و او را کنار زدند	but he was rudely interrupted, pushed aside
زیرا که از نو چشمانش به ظاهر در سرش به گردش در آمدند و او از دایره آب باز آمد.	for again his eyes seemed whirling round in his head as he swept the watery circle.
زیرا توی این آش قبلاً به مقدار فراوانی آب ریخته بودند	for there was quite enough water in it already
با این همه شامه دربانیش بیدار شده بود.	still, his porter's scent was aroused.
کمی ناراحت شدم که چرا زود جوابش به من نرسیده.	I was rather disappointed that I did not hear from her again speedily
تل و تل و خوران از اتاق بیرون رفتند.	stagger with her out of the room.
باور کن یا جای او توی دیوانه خانه است یا جای من.	you can take it from me that either he or I ought to be in a straitjacket.
از لای آن نگاهی به بیرون انداخت.	peered over the edge.
آن حجم از فضا را کام لا کر و کور کرده بود.	had made it dumb as well as blind.
هرچه بود در همان بعدازظهر اتفاق افتاده بود.	I had breathed it before, touched it surely, that very afternoon.
ایشان را به منظور بست دسته ایشان به آنجا آورده بودند.	were brought there to have their arms bound.
هر چند هیچ چشمی که اجازه رسوخ در آن قلعه مدقس که اطاق ناخدا باشد نداشت بدو نیفتاده بود.	though hitherto unseen by any eyes not permitted to penetrate into the now sacred retreat of the cabin.
هرچند هرکدام از ما کاملاً به خود و به دیگران اعتماد داشتیم و امیدوار بودیم	although each of us for himself and all of us together felt confident that
لکن لازمست در هر صورت برای این شوالیهٔ فقیر صورتی فرض کرد.	but she declared that, in order to make a picture of the gentleman, she must first see his face.
نسیمی تصادفی آن را به سوی او فرستاده بود.	a chance current had sent it alighting on her.
بعد دردی را که تازه در من سر باز کرده بود در خود فرو نشاندم	then I strangled a newborn agony
اورسولا نیز توجهی خالصانه او را زیر نظر داشت	rsula watched him with innocent attention
حتما مرا به یتیم خانه پس خواهد فرستاد.	she is going to send me away.
که با خود شرط کردم که دیگر بمیان آدمیزادگان باز نگردم	that I entered on a firm resolution never to return to humankind
یقین داشتیم عاقبت به کسی برخواهیم خورد که به ما بگوید در کجا هستیم.	as it could not but be that ere long we must see some one who could tell us where we were.
در آن واحد در دو عرض جغرافیایی مخالف دیده شده است.	that he had actually been encountered in opposite latitudes at one and the same instant of time.
به سوی مگی رفته و کنار صندلیش زانو زده	coming to her and kneeling at one side of her chair
همان جا که هستید باقی بمانید تا برگردم.	I shall take the candle.
نزدیک بود روی زانوهام بیافتم و همه چیز و دوباره از اول شروع کنم.	I almost turned around and fell down on my knees and started begging again.
من معتقدم کلاهم را توی ماشین گذاشتم.	I left my cap in the car, I believe,
بفهمد که شیر روی اجاق کی در شرف جوشیدن است.	she knew when the milk was about to boil.
بدون اینکه هیچ صدایی از راه رفتن او به گوش برسد	without a sound escaping under the touch of her light foot.
همه چیز را فراموش کردم به جز حیرت خودم را.	I forgot everything but my own amazement.
که رفاقت خود را با ربرتا از سر نگیرد و به هیچ وجه کوتاه نیاید	was determined not to be friends any more or yield in any way
بجز از برخورد با کشتی مسلح دزدان دریایی	except that of coming across some vessel out on a roving expedition.
نزدیک بود مثل تازه کارها ناله سر بدهد	he was about to begin to groan, as a starter,
یکی از شعرهایی که این بابا گفته یادم او مد.	I remember a piece of poetry this here guy wrote down.
ورانسکی را از دور دیده و با لبخند او را به سوی خود خوانده بود.	caught sight of him in the distance and beckoned to him, smiling.
به زمین اطرافش نگاه کرد گویی انتظار دیدن یک سگ را داشت.	he was looking around at waist height, as though expecting to see a dog.
بدین منظور از جای برخاستم و به درون حیاط رفتم تا وی را بیابم.	I got up and walked into the court to seek him.
اما چشمانش با چنان حالتی بر سیما و پیکر او خیره شد که به نظر جما گستاخانه و فضولانه رسید.	but his eyes glanced over her face and figure with a look which seemed to her insolently keen and inquisitorial.
مثل این بود که شنلی روی زمین کشیده بشود.	it sounded like a cloak trailing along the ground.
یا او را بر انگیزد و بدان گونه ابرهایی را که طبقه به طبقه بر ناصیه او خیمه زده بودند	thus chase away, for that one interval, the clouds that layer upon layer were piled upon his brow
چون در موقع رونویسی از یک سرمشق آن را کثیف کرده بود.	because she had blotted an exercise in copying it out.
بلکه موهای بیچاره هم همراه کاغذها پایین آمده	for the hair came with the papers
آن قدرها احمق نبود که در حضور یک استاد دعوا راه بیندازد.	he wasn't fool enough to pick a fight right under a teacher's nose.
او موفق شده بود طلسم را به قسمت گوشتی و نرم زیر شکمش بفرستد.	he had managed to hit it on its fleshy, shell less underside.
تا آن لحظه هرگز مدتی به این زیادی از نابود کردن دشمن در بازی کامپیوتری غافل نشده بود.	he'd never gone so long without blowing up an alien on his computer.
تا آن جا پیش رفته بود که از افراد مورد اعتمادش این مساله را بپرسد	he had asked people, indeed, whom he trusted
هم ون شب اول که به من جا داد بهش گفتم .	I told her the night she fuss let me sleep in her cellar.
اگر قرار بود که روزی آزاد شوم راه فرارم از آنجا بود.	which must be the only scene of my escape, if ever it should happen.
ولی این گوشت زنده بود و در نتیجه به مذاق او بهتر و گواراتر آمد.	only it was alive between his teeth and therefore better.
میدانست که دیگر آینده ای ندارد.	that there was nothing else left for him
گویی قصد داشتیم به آن خانه برویم	as if we were bound for the house
وقتی یقین حاصل کرد که کسی به دنبالش نیست	the murderer, finding that he was not followed
نیشخند وحشتناکی در چهره اش حک شده بود.	his terrible hot grin spot welded to his face
دربیمارستان به هوش آمدم. فقط دو روز آنجا ماندم.	I woke up in a hospital. I was only there two days.
که همه بگویند مقصودی از این وصلت همان مال بوده که چون ضرر دید دست کشید.	unless he were actuated by a decided feeling of avarice, but that is impossible
در راه نیز مشغول صحبت و شوخی کردن بود.	he was full of vivacious conversation as we went along.
به خصوص از اصرار و الحاح وی در رفتن به دنبال حوادث بدفرجامی که مقصد و منتهای غایی آمال و آرزوهای او بود بیشتر حیرت کردند.	at the pertinacity and persistence he displayed in going through thick and thin in quest of his unlucky adventures, which he made the end and aim of his desires.
تنشان را لاغر و بدبو گردانده است.	rendered the flesh loose and rancid.
باز کسی متوجه کوری تدریجی او نگردید.	but no one discovered that she was blind.
این دو زن به سهم خویش به او اعتنایی نکردند.	neither of the two took much heed of her.
با نگاه تابناک خود چنان مهر و نوازشی معصومانه در اطاق پخش کرد	threw into her beaming look, such an expression of affection and artless loveliness
فکری دارم که چنان گوشمالی به تو بدهم	I have a mind to play the mischief with thee, in a way
که پس از چند لحظه به دشمنی که هدف اوست خواهید رسید.	he saw that he would immediately overtake the enemy he had selected.
اگر باز هم مقاومت کرد به او بگویید خودم خواهم آمد.	if she resists, say I shall come
پای خود را روی زمین کشید و غمگین بود .	he scuffing one foot and looking unhappy.
پا و چشم مصنوعی رو ازش گرفتم.	I took his leg and his eye.
ولی دشنام و ناسزایی که درباره مادرش به زبان نوح آمد او را سخت از کوره به در کرد و خونش را به جوش آورد.	the cruel insult to his dead mother had set his blood on fire.
مثل این که ممکن بود صندلی از زیرش در برود و او را زمین بکوبد.	as if it might get away from him and buck him to the floor.
اورسولا در کنج دنیای تاریک خود آن را احساس کرد.	even 'rsula perceived it in her dark corner
دوباره خرسند و راضی به وظایفی که به آن آشنایی داشت پرداخت	he had cheerfully taken up his familiar business
آتش عشقم بی آنکه فرو نشسته یا سرد شده باشد از این دیدار تیزتر شد.	though it had not been dead or deadened, my love gathered fresh life.
