اما من او را از این عقیده منصرف کردم.	but I was very firm.
کارهای داخلی خود را سرو سامان داد.	settled his affairs at home.
دردی که تقریباً مثل درد عشق ظالمانه بود.	with almost as much cruelty as the pains of love.
بن ابر این تصمیم گرفتم اول اینجا بیام.	so I made this my first stop.
انگار ناگهان نوعی خوشحالی آمیخته به ترس و هراس در وجودش ریخته بود	as if overwhelmed by a sort of awed happiness
من و کوتوله نزدیک چند درخت کوتاه سیب در کنار هم قرار گرفتیم.	he and I being close together, near some dwarf apple trees
احساس تفوق و برتر بودنش در مقابل این دختر بچه کوچک مخدوش و نابود شد.	he had faltered in his affectation of amused superiority before that insignificant chit of a school girl.
به خودم یادآوری کردم که او همه جو ره حق داشت به من بی اعتماد باشد.	I reminded myself that she had every right to distrust me.
من برای چند لحظه ساکت شدم و سعی کردم به خاطر بیارم که دقیقا چه حرفایی بین ما رد و بدل شده	I'm silent for a few seconds, trying to remember exactly what he did say.
پس از اینکه چنین وعده خوشی به او داد	having made this obliging promise
صورتش رو دیدم در این مورد مطمئنم	I saw his face I could tell.
بعد خودم با خودم یواشکی مدتی تمرین کردم که احیاناً اگر کسی پرسید بتوانم مثل آب روان بنویسم.	I set it down, private, because somebody might want ME to spell it next, and so I wanted to be handy with it and rattle it off like I was used to it.
بزانو افتاده و رو به سمتی کرده است	turned towards the spot where
از رختخواب برخاستم و بازوهای خود را در تاریکی گشودم	I started up in bed, and putting out my arms in the dark
بوی ضعیف عطری را احساس کردم که به یاس سفید معروف است.	was conscious of a faint smell of the scent known as white jessamine.
بعد دوباره به روی نیم تخت افتاد	, then in a moment fell down again
یک طرف آن غشی کرده و روی طرف دیگر تکیه داده بود.	one side palsied as it were, and leaning over sadly.
اندوه آنان که توأم با یاد مطبوع و شیرین گذشته بود رنگ شادمانی به خود گرفته و از درد و رنج اثری نداشت.	for even grief itself arose so softened, and clothed in such sweet and tender recollections, that it became a solemn pleasure, and lost all character of pain.
در همین جا پیش یک تابوت سازی برای کارآموزی رفت	was apprenticed down here, to a coffin maker
به سرعت جلو رفت و طلسم را باطل کرد.	leapt up and performed the countercurse.
سپس به سوی اطاق ناهارخوری رفتیم.	while we went up to the dining room
این بود که دیگر نخواست من متحمل این زحمت شوم	so she would never again allow me to undergo the exertion
من باقی عمرم را به ستایش او خواهم گذراند	I will pass the rest of my life in venerating him.
فهمید که علت روشنی نا معمول راهروها تاریکی زودرس هوای بیرون است.	he realized that it was because it had already turned dark outside.
ولی سر که برگرداند و او را دید که به کنار تختخواب آمده	her head turned to watch him walk to the bed
سوارش شدم و پارو زدم و به ساحل آوردمش.	I clumb in and paddled her ashore.
او را دیدند که در چارچوب در ظاهر شد.	when they saw him appear in the door
همه چیز در همان حال بود که دیده بودم	all was in the same posture
ولی لزومی نداشت که هنوز به وی بگوید.	but there was no need to tell her yet.
مرا در حین ارتکاب جرم مشهود گرفتند	I was caught in the act
ولی بیش از این چیزی به یادش نیامد.	that was all he could remember.
عنی ترس از این که تو مرا به کاری واداری که از انجام دادن آن عاجزم!	the fear of being persuaded by you to attempt what I cannot accomplish!
بگیر این هدیه را و از من به یادگاری داشته باش.	take and keep this ring in remembrance of me.
مدتی بود که هم او و هم ماکزیم میل داشتند پیش تو بیایند	she wanted to come and see you before
حس کنجکاوی بر وجودش غلبه کرد.	he allowed himself to be carried along by curiosity.
چرا که مطمئن نبود آن جلسه چطور قرار بود پیش برود.	because he was not sure how he wanted the meeting to go.
از آن گونه زودرنجی غرورآمیز و باریکی که حجم تبدیل شدن به غمخواری ندارد	it was that proud narrow sensitiveness which has not mass enough to spare for transformation into sympathy
بزودی روشنی افق بر کوهستان گسترده شد.	almostimmediately the lonely dawn light crept over the land.
با نگاهی عاشقانه به تصویر زن فریبنده چشم دوخت.	looked at it rather languishingly at the bewitching portrait
آنچه اهمیت دارد آن است که بتواند واقعاً وی را خوشبخت کند و پس از مرگ من برایش چون دوستی غمخوار و دلسوز باشد و نگذارد به او سخت بگذرد.	if he could console her for my loss.
تا ببینی که چگونه بی آنکه سخنی بگویم و وقتی تلف کنم	thou shalt see how, without saying a word, to save time
اما در این مدت سنگرو خواهن گرفت و من تو سنگر نخواهم بود.	in the meanwhile the barricade will be taken, and I shall not be there.
طوری که بتونم از قبل ترتیبشو بدم مثلا به گم برادر مه.	where she could arrange in some way beforehand say that he was her brother or something.
3 شیوه زندگی و راه رفتنش آمیخته با فروتنی است	3. his action and his walking show modesty
با مشتریان محصولاتش قرار و مداری گذاشت	made some arrangements with her customers
بر آن شدم که دوباره بس فر دریا روم.	I determined to go again to sea.
چنان که دیروز به جزای عملی که در جوانی کرده بودم رسیدم.	, I last night received a severe punishment for it
همچنان که شما را باز مختار نکرده که مرا مجبور نمایید	as it has also of the power to compel me
یادم هست که ناچار بودی خم شوی تا وارد دکان سلول وارش بشوی	I remember you had to crouch to enter the prison cell sized store,
دیگر کس دیگری در میان دوستان نزدیک ما وجود نداشت که سرزده داخل ماند رلی شود و سراغ مرا نگیرد.	I wondered if someone had called.
آن بزرگان به مدد ضاربان خود با خشنودی به من پاسخ دادند	those noble persons, by the assistance of their flappers
به هم گفت نمی تونم ببین مش فکر کردم داره با خودش حرف میز نه.	I can't see it, she told me, though she might have been talking to herself.
من نیمی از روز و تمام شب رو خوابیده بودم.	I'd slept through the rest of the day and the whole night
در این یکی به زنجیر ایمان پای بند بودند.	in the other, chained byfaith.
اما مهماندار بی درنگ مثل تیر شهاب خودش را به من رساند	but immediately the air hostess swoops down on me.
صورتش را به طرف دیوار برگرداند	turned her face to the wall
برای این که از حال پریشان خود فهمید	for she understood from her own agitated feelings
در آن لحظه ای و دچار وحشت عجیبی شد.	in that instant she knew stark terror.
اما وقتی پایش را روی قبر بزرگ گذاشت پای مجروحش قادر به دویدن نبود.	but his injured leg shook under him as he stood on the overgrown grave
تا چشمش به او افتاد فوراً حالش را درک کرد.	was the only one who understood her condition as soon as she saw her
مخصوصا پس از پایان مراسم تدفین ماری بود که اهل دهکده به نفوذ من بر کودکان پی بردند و به اذیت و آزار من همت گماشتند. محرک ین اصلی مخالفین من کشیش و آموزگار دبستان بودند.	I was in ill odour after all this with the parents of the children, and especially with the parson and schoolmaster.
زیرا آن اسب با سر به من اشاره کرد	for the horse, beckoning to me with his head
دوخت و چند دقیقه دست به سینه در برابر آن ایستاد.	she stood before it with folded hands for a few moments.
از آنجا بیرون آمدم و هیولاها را دیدم.	I came out and saw demons.
همه با عجله وارد شدند و در را پشت سرشان بستند .	they piled through it, shut it quickly
از آن تاریخ ببعدداخل نظام شد و در این شل جدید رفتارش بسیار مورد پسند واقع شده است.	a bit of a gambler, who has since gone into the army, where his conduct has been unexceptionable.
من هم یک لنگ آن را خیلی آرام گرفتم و برداشتم از پنجره بیرون انداختم.	I picked him up very gently by one leg, and dropped him out of the window.
جمله اخیر را با چنان ناامیدی ادا کرد که گفتی بر اثر خواب ین فرصتی را که مقدراتش بدان بستگی داشت از دست داده است.	he added, almost in despair, just as though he had overslept something upon which his whole fate depended.
دستکم در برابر کلاید همان قیافه سرد و تحقیرآمیزی را گرفت	with that same rather clyde and inconsiderate air
بدینسان مرا به خانه خود برد.	in this manner carried me home to his house.
زیرا برای خاطرم طفلم بود که خود را گناهکار نمودم.	since it was for my son's sake I became criminal.
انگار گلوله بر سینه خود او نشسته بود.	as though the bullet had struck her breast.
من گفتم خوبست درجه طبی و قدری انگور و کمی نان بگیرد	I suggested that he should get a thermometer, and a few grapes, and some bread.
نوار قلبی شکلی را از روی بی کنش برداشت	wiping confetti off his bacon.
متعلق به یک عروس خیالی بود که مثل حباب ناپدید شده بود.	it was the visionary bride's who had melted in air.
وقتی به یاد آن شب و تماشای رقص فلامینگو افتاد	when she thought of the night of the flamenco dancing.
مرا در اطاق بزرگی تنها گذاشت	he left me in an immense room
اما نغماتی که فضا را پر ساخته بودند باعث شدند بیشتر بمانم.	but the tones that then severed the air arrested me.
قرار بود برم اونجا موقتا به شهر دیگری ببر مش.	I don't know unless it was that I was coming to get her and takeher away some where temporarily.
سیمایی شاد و خندان و رفتاری نرم و چالاک داشت	he was of a merry countenance
فکر کردم بهترست دروغ مصلحت آمیزی بگویم.	I bethought myself of an expedient.
من بسیار آرزومند دیدار آن بودم	I was very desirous to see
دختر اصرار نمود تا بالاخره با خنده به او تکلیف کرد که یک گیلاس لیکور با هم بنوشند.	she insisted, and at last laughingly offered to have a glass of liqueur with him.
که تقریبا کسی در کشتی نبود که به حکم غریزه آرزومند فرود آوردن قایق نباشد.	that almost every soul on board instinctively desired a lowering.
بر زمین بخزد و زوزه و خرناس بکشد	to lie down, and howl, and groan
اما با کمال آهستگی به طرز غمناکی که تمام تماشاچیان به حدس و احساس طبیعی یافتند	but so slowly and sedately that the idlers with that instinct which is the forerunner of evil
که اگر این نیت ناخدا به مرحله عمل درآید همه کشتی و تمامی نفرات آن از میان خواهند رفت.	devoting the ship and all hands to unconditional perdition, in case this intention was carried out.
زیرا بعد از این او فرد واحد در دنیا بوده و غیر از شما کسی را نخواهد داشت.	for henceforth she will be alone in the world.
اما با صدای ضعیف و تقریبا بر لب نیامده.	but in a feeble and almost inarticulate voice.
اما در حضور کنتس جرأت گفتن آن را ندارد.	but dare not say it before the old countess.
توانستم دور و بر خود را نگاه کنم.	began to look about me.
از فکر اینکه سعی کنم به شور و شوق داشتن بیشتر وانمود کنم از درون به خود لرزیدم	I flinched internally at the idea of trying to fake more enthusiasm than the bare minimum.
لازم نبود حتما فکرش را بخوانم تا بتوانم صدای آرام و واضح او را از آن سوی سالن بشنوم.	I didn't have to read minds to be able to hear her low, clear voice on the far side of the long room.
اما شاه با خشونت دستش را حرکت داد	but the king waved his arm severely
دست از حرف زدن کشیدیم که فکر کنیم.	WE stopped talking, and got to thinking.
پارو بها را به دست بگیرید و جانتان را بگیرید!	gripe your oars, and clutch your souls, now!
هری دست جن خانگی را گرفت و مانع او شد	grabbing the elf's arm to stop him.
تا شاید مردی را که به چشم ما ظاهر شد و بی شک صاحب اشیاء پیدا شده خود او است بگیریم.	perhaps we shall light upon this man that we saw, who no doubt is no other than the owner of what we found.
آخر شما گفتید که این پس ره ولگرد که یک قاتل است	this young man, though a murderer
من اجازه نمی دم یک موضوع بی اهمیت بین ما رو به هم بز نه .	I refuse to let this come between us.
حبسی که میانه دو نفر باشد مثل این است که نیمه حبس است	at the worst he would have a companion and captivity that is shared is but half captivity
در پایان جسد وی را داخل یک چل یک چوبی بزرگ محتوی قلیاب صابون خواباندند و گذاشتند شش ساعت تمام به همان حال بماند.	finally they put him in a barrel of lye and let him stay for six hours.
اما من از آن اندک آزرده شده بودم.	but I was not disconcerted by so little.
هنوز به این برنامه خوب نیندیشیده بود که آن را مردود دانست.	but he had no sooner set the thought into words than he rebelled against it.
سپس دستش را روی یک صفحه کاغذ سفید گذاشت.	then pressed onto a white card.
اگر در آن هنگام با طبع شاهان و وزیران آشنا بودم	because, if I had then known the nature of princes and ministers
پس از آن که شما پست خود را ترک گفتید	after your desertion
بازوی او را به شدت بس وی زمین کشید.	dragged the hand downward.
هنگام یکه در جستجوی قدری تسلای خاطر مجبور باشد که دردش را با قدرت تأیید کند مثل اینکه آدم در رنج بردن و در مردن از بی غذایی آزاد نباشد در آن انتظار که کسی بیاید بینوایی ما را تسلیت دهد.	for the sake of obtaining a little relief, to get oneself attested by the authorities as though one were not free to suffer and to die of inanition while waiting to have our misery relieved.
بی درنگ به اطراف خود نگاه کرد تا آنچه را که به جستجویش آمده بود بیابد .	began instantly to look about her for what she had come in search of
من با او در مهمانی خانه نی نا آشنا شدم.	I met him at her house party.
من پیش از آن هیچ وقت آن کلمات را نشنیده بودم.	I'd never heard the words before.
بالاخره یک نفر باید به همراهش برود و او را راهنمایی کند.	somebody must go,
رنج و ملال ناشی از حضور وی در این خانه برای من بیشتر از لذتی است که ممکن است از آزار دادن وی عایدم شود!	the nuisance of her presence outweighs the gratification to be derived from tormenting her!
موهای کوتاهشان واژگون شد و توی تاریکی ریخت.	their haircuts turned inside out
برای خود یک برتری و ارشدیت ساختگی دست و پا کرده بودم.	I took upon myself, as I describe it, a mock primacy.
تا اگر کار به جاهای باریک کشید باز هم از ازدواج امتناع کنم	I could and then when thetime came just refuse
از زیر تاق گذشتم و دروازه بی صدا پشت سرم بسته شد	I rode under the arch, and the gate closed silently behind me
پیش از آن که از نظر او محو شود	before she disappeared.
در حالی که مویش پریشان بر میز فرو ریخته بود و اشک شمع چون کفنی پیچان بر او سرازیر بود.	a long winding sheet in the candle dripping down upon him.
اما عقیده داشت که با نرمی نخوانده است.	but to his way of thinking there had been a lack of softness in her singing.
گمانم بر این بود که باز بر اثر مشاهدات خود بتوانم حقایق دیگری کشف کنم.	I believed I could yet make further discoveries, from my own observation.
او دیگر بر نقدینه و جواهری که از دستش رفته بود تأسف نخورد	who thought nothing of what had been taken
این آتش را با ربحش به شما پس خواهیم داد.	arrying away into the darkness a glowing stick.
امیدمو به طور کامل از دست داده بودم	I had given up hope, now
کمی فکر کردم و دیدم کوره راهی برایم پیدا شد.	I studied awhile and see my chance
چون که آیینه به سادگی به او گفته بود که او یک زیبای کوچک است.	she felt as if her fun had really begun at last, for the mirror had plainly told her that she was a little beauty'.
خبرش کرد که چه جور اسباب زحمت شده	told him the trouble he had been causing
وظیفه خود دانست که او را ببال ین ژان وال ژان فرستد.	she took it upon herself to request him to come up stairs.
به جایی برود که دیگر هرگز چشمش به روی وی نیفتد.	go where he should never set eyes on her again.
از آنجا دختری مرا تا اتاق خواب کوچکم مشایعت کرد.	a chambermaid introduced me to my small bedchamber
اما حتماً به این مسئله فکر کرده.	but he must have thought it.
جایی که دفینه را پنهان کرده بودم	where I had concealed my treasure.
بعد دو قرص آسپرین بالا انداخت و به رختخواب رفت.	drank it in bed with two aspirin tablets
پس کنت بیانیه را ظاهرا برای اینکه قبل از استراحت بار دیگر آن را در اتاق دفترش	them in his study before having a nap.
او خیلی زود عقب رفت تا به من نگاه کند.	he pulled backtoo soonto look at me.
چشمانش از الکل چپ شده و ثابت مانده بود.	his eye twisted by alcohol
وقتی که اون پیرمرده مرد من اونجا بودم	I was there when the ol' man died.
دوران نقاهت خود را در خانه من گذرانید	then, and lay recovering from sickness in my house
تا اتاق خوابم یکسره دویدم و به عقب هم نگاه نکردم.	never once stopped until I reached my own bedroom
سعی دارد هرچه بیشتر سر راه او باشد.	she tried to place herself more fre quently in his path.
هرمیون حرفش را نیمه تمام گذاشت	then stopped, very suddenly
شاید بعضی اوقات چیزهایی خیلی جزئی بلند کرده باشد.	a minor pilferer from time to time at worst.
چون دریافت که این زن کیست نشانی زندان استان را هم به او داد.	once he knew who she was,directing her to the county jail.
بعد وانمود کرده که خودکشی بوده.	made it look as though he'd done it himself.
یگانه آرزوی من این است که نخستین دقایق ملاقات برادرم با پدرم به خیر و خوشی بگذرد.	I only wish I could spare my brother the first moments.
گروهی با پوستی به سفیدی پوست خود او نشسته بودند	sat a group with flesh as white as her own.
ولی دو اسب در اصطبل منزلتان دیده بود.	but that he had seen two horses in the stables
وقتی دعوتم کردی با تو به تئاتر بیایم خیلی تعجب کردم.	I WAS surprised when you asked me to do a theatre with you.
سرش را به طور تهدیدآمیزی تکان داد	shaking his head threatening
من باید بگویم که او از فشار گرسنگی جان سپرد.	I say she was starved to death.
حالا بر خلاف همیشه به حرف آمده بود.	had one of her infrequent outbursts of speech.
دور اتاق مشغول قدم زدن شدم و به بررسی اشیاء مختلف و مبهمی که در نیمه تاریکی قرار داشت پرداختم.	I began to walk about the room, examining various indefinite objects in the half darkness.
نترس من نخواهم گریخت و بدرفتاری نخواهم کرد. آقا!	I won't be unruly, I won't run away from you, old fellow.
سرانجام ناگهان سرش به چیز سختی خورد.	his head hit something hard.
با علاقه و تعجب به آن تابلو نگاه کردم.	I gazed with interest and some surprise upon the portrait.
کت خیس خود را درآورد و به پشت صندلی آویخت.	he took off his wet jacket and hung it on the back of the chair
او فقط حواسش را به آنهائیکه رنگ سیاه داشتند معطوف نموده است.	he was concerning himself only with those in black.
یا مردی را که زیباییش را درست در این راه بکار گرفته باشد.	nor one who used his beauty in quite the same way.
این خبرهای خوش را به او رساندیم تا پاداش پنجاه بار نبردش را با ورود به دمشق از نزدیک مشاهده کند.	to him we carried the tidings, that he might have the honourable entry, a privilege of his fifty battles.
آخرش از آن چیزهای خطرناک خلاص شدند.	at last got rid of the perilous things.
سپس دو نفر دیگر در تاریکی شب پدیدار شدند.	then they saw two more figures materialize out of nowhere.
به لحاظ خودش غنی و به حد کافی دل پذیر و در عین حال گران سنگ.	rich and welcome enough in its way, but sobering from its weight.
ولی دو بار بازی آخری جیب مرا خالی کرد.	that subsequently I had lost the whole in two rounds.
ناچار شعری از دیوان شاعری رونویسی کرد.	at last ended by copying a sonnet.
اما یادت هست که همه چیز درست و مرتب و امکان پذیر بود.	but don't you remember that it could all be arranged and how nice it all was?
خورشید شکوهمندش با شتاب در حال افول است.	his glorious sun hastens to its setting.
به یاد داشته باش که من با جان و دل در فقدان مرگ پدرت با تو شریک هستم	remember that with all my heart I share your sorrow
از جای برخیزید و هر چه زودتر این حقیقت را اعلام کنید!	rise up and preach that, make haste, make haste!
آند را خود را روی صندلی انداخت	, throwing himself into a chair in
دست فربهش طوری روی زانو قرا رداشت که گفتی می کی شود شیئی را بگیرد.	his moist hand, as it lay on his knee, made faint movements, as though trying to catch something.
او بالای سر تصنیف خوانندگان ایستاده بود	he stood over those who were singing
اما نتوانست تصمیم به انجام این عمل بگیرد.	but not deciding to do so.
با هم سطل رو بیا رین و مواظب باشین که نری زه	carry it back together helpin', an' don't spill none.
اما آن سرکرده که دستور داشت مرا به حال خود بگذارد	but the other, who had received instructions to let me pass
اکنون با آنکه آرامش بر وی حک مفرما بود	now, while he was composed
حال که از تغییر جنسیت او با خبر شده	that he had heard of her change
قایق را گرداند و سر به دنبال روغندانهای لویاتان نهاد.	he slewed round his boat and made after the leviathan lamp feeders.
آنهم بیشتر به علت روابطی که با خویشاوندان ثروتمندش در لیکرگس برقرار ساخته بود.	could not in the face of his high family connections here.
کوتوله را به خواهش من بخشیدند.	the dwarf was pardoned at my desire.
حالا او را به اینجا فرستاده که شفا پیدا کند	she has sent her here to be healed
زمانی در پیرامون خود به پائین نگریست	looking round about under him for some time
از همان اول فهمیدم که با یک کپه آشغال طرف هستم.	I knew as soon as I saw you that you were nothing but a piece of filth!
اما میدونستم احتمالاً این زالو تنها شانس من برای ای نه که بلا رو زنده نگه دارم.	but I knew this angle was probably my best bet for keeping her alive.
دوست نداشتم فکر کنم که باید مخفی شوم.	I didn't like to think of myself having to hide.
ناپیدا از چشم مردم پنجاه سال پیش پنهان بود.	completely invisible to the people of fifty years ago.
به خوبی طرز استفاده از تلفن را بلد بود.	knew perfectly well how to use a telephone
اما من نخواستم او را بیدار نمایم.	still I hesitated to wake him
اما شراب و پنیر به سرعت در حال تمام شدن بود.	but the wine and cheese were being consumed rapaciously.
منظورش از این رفتار توضیح این نکته بود	that, as a highly trained military man
اکنون مشتاق بود تحصیل را هر چه زودتر به پایان برساند.	he was now anxious to qualify as soon as possible.
سوگند خورد که پشت ما را به پشت هم خواهند بست و به دریا خواهند افکند.	swore we should be tied back to back and thrown into the sea.
یا شاید هم ساعت او را و ناخدا خیلی اصرار دارد که آن را پس بگیرد.	mayhap, his watch he's so cursed anxious to get it back.
پاهایم را روی هم بیندازم و کمی هم دامنم را بالا بزنم.	one leg crossed over the other and my skirt hitched up seductively.
او هم مانند یک نجیب زاده خدمتش رسید.	has fallen by my brother's sword'like a gentleman.
عقیده او این بود که هرکس بتواند در زمین یک علف را دو علف و یک خوشه انگور را دو خوشه کند سزد که مقام او در عالم انسانیت والاتر از همه نژاد انسان باشد	he gave it for his opinion, that whoever could make two ears of corn, or two blades of grass, to grow upon a spot of ground where only one grew before, would deserve better of mankind
اما در میان خانواده خود تلاش دیگری کرد.	but he made another effort in his own family.
حق داشتید که نگذاشتید از این اشتباه بیرون آید.	you were right not to undeceive her.
نفس کشیدم و دوباره سرم را تکان دادم.	I inhaled once and then nodded again.
تا دست شما را در دست دارم هیچ چیز برایم اهمیتی ندارد.	I mind nothing while I hold your hand.
از آن پس هرگز لحن مهرآمیز خود را به پسر بازنیافت	he had never yet quite recovered his good humored tone to his son
آنگاه دیگر بار بر کار خود خم شد.	bent over his work again.
من همان لحظه جواب ندادم و او نیز پافشاری نکرد.	I didn't answer right away, and she didn't push it.
این قلب عفیف و خاموش را که خاطرهٔ کریستف در ته آن	once more took possession of that chaste and silent heart, in whose depths there still burned
که نیمی از شب و بیشتر صبح را در دفتر دلال بیمه گذرانده بود.	who had spent half the night and most of the morning with an insurance broker.
در تمام مدت هم رو به روی یکدیگر بودند	they kept face to face
فقط منتظریم شما موافقت کنید تا اجرا کنیم.	which waits only your approbation to be acted upon.
اما از آن ارزیابی شتا بزده و ناموافق که پیامد منطقی شکست خود ما هستند جان سالم به در نبرده بود.	but he had not escaped that low estimate of possibilities which we rather hastily arrive at as an inference from our own failure.
فراموش کرده بود که لیزا مرده است	he had forgotten she was dead
هر چه را که لازم بود درک کرد.	he saw all he needed to know.
به عنوان پاداش نگاه داری خانه برای مدتی طولانی	to recompense me for keeping house so long.
برخاست و در اتاق به قدم زدن پرداخت.	got up from his chair and began pacing up and down the room.
با یک حرکت در را باز کردم و داخل شدم.	I went straight in.
در این موقع به این اثر معماری زیر چشمی نگاهی انداختم.	I now glanced sideways at this piece of architecture.
آهسته پیش آمده و دستش را دراز کرد	again extended her hand
چیزی که دکتر را به ترس انداخته.	something which made him afraid.
احتمالا شیطانی و بد نیستند هر چند این مرد برجسته	were probably not evil, though, he went on, 'that distinguished man
در این وقت من چشمانم را سخت تنگ کرده به طرف مجسمه نیمه پنهان نگاه می کردم	I now screwed my eyes hard towards the half hidden image
که قد و هیکلی چنین و شکل و شمایلی چنان دارد	of such and such an appearance
حتی اگر بغض و عداوت شیطان در این تاریکی کور نیز از بین نرفته باشد.	if even his malice were not defeated by such a blind darkness.
برای بنای کاخ عمومی بشریت و برای تاریخ انجام دهد.	for history whatever had to be performed.
انگار که در دستانش خاصیت خردکنندگی دارد	because his hands seemed to have the property of breaking everything they touched.
سرنوشت طوطی چندان او را نگران نساخته بود.	he did not really care about the fate of the parrot.
که حتی نگاه کردن هم برایش دردناک شد.	so that it hurt him to look out of them
شیوه زندگی من گاهی با نظم و ترتیب است و گاهی مثل فیلسوفان هرچه پیش آید خوش آید.	I live now in one way, now in another, like a philosopher, taking pot luck
جایی برای همدردی انسانی به جای نگذاشت.	not a touch of human sympathy.
لیکن هرگاه زیبایی با فقر و احتیاج توأم گردد	but if beauty be accompanied by want and penury
اگر میتوانست خود را به جای خانواده ی او بگذارد	if he could have put himself at the point ov view of the family
این تنها کاریه که می تونم به راش بکنم.	I owe him that
مسافتی راه نپیموده بودم که یکی از آن موجودات در سر راه من سبز شد	I had not got far, when I met one of these creatures full in my way
در را به شدت پشت سر خود بست	slammed the door behind him
ملاحظه کنید چگونه قبلا همه چیز را شرح داده است.	but, look, everything is written there beforehand
به او گفت که به کنار میز بیاید	told him to come near the table
من خواهم کوشید که مو لف داستان را باخبر کنم	I will take care,to impress upon the author of the history that
ایستاده بودند و گرم گفتگو بودند	were standing deeply absorbed in their conversation
مهارت اِما در بررسی و سبک سنگین کردن قضیه را نیز ندارد.	nor with the skill of such an observer on such a question as herself
زیرا سرپوگفسکی نقشه ی مبارزه با قدرتمندان را میکشید و علایق و نفرتهای او معیاری جهانی داشت.	who was already contemplating a struggle with the existing powers, and already had his likes and dislikes in that higher world,
آری دیوانه زنجیری زیرا که هوشش را ضعفی و فتوری کامل رسیده	his head becomes weaker
حتماً ماجرایی برات ون پیش آمده.	I am sure it must have been some adventure.
با نگاهی مبهم به ذرات غبار طلایی رنگ سرانگشتانش خیره شده است.	looking vaguely at the powdering of gold dust on her fingertips.
او باز فکر کرد شاید خودش اختیار از کف بدهد و به طرف او حمله کند.	she thought she might be the first to rend him.
او به نظر لار اندام و مانندپرستوئی سبک آمده بود.	he seemed to see her before him, slender and graceful as a swallow.
نگار منتظر بود تا حرفش رو رد کنم.	like she was waiting for me to deny it.
حس کردم که ضعف دارم اما مریض نیستم.	felt that though enfeebled I was not ill
چشم من به سه تا از آن حیوانات منفوری افتاد که نخستین بار پس از فرود آمدن به خشکی دیده بودم.	I saw three of those detestable creatures, which I first met after my landing
آری! تصمیم گرفته بودم که بروم خودم را معرفی کنم.	yes, he said to himself, I had resolved to inform against myself.
بعید است با جوانی ضدیت کرده باشد که قبلاً گفته بود دوستش دارد.	very determined against any young man who told her he loved her.
تانیس یک عسلی را جلو پای او کشاند و روی آن نشست و نگاه التماس آمیزش را به او دوخت.	she dragged a footstool to his feet and sat lookingbeseechingly up at him.
نه این کلمه که نیت نهتفه در پس آن وعد در آزردن وی بوده است.	not so much the word itself as the intent to wound her with which it was said.
اما اتوبوس کنار زده بود که پیاده شوند و برای تفسیر فرصتی نمانده بود.	but refrained from comment because the bus had stopped on the side of the road to let them off.
ولی برای صرف نهار به خانه باز خواهد گشت.	but he would be in at dinner time.
آن همه چیزهای تزئینی دور و برش نریخته که هر روز گردگیری بخواهد.	lying around that have to be dusted every day.
با دقت بسیار به بیانات کشیش گوش فرا داده	was listening to all the curate said
بیرونم بیندازید چون من به میل خودم از اینجا نخواهم رفت.	push me away, for I'll not leave you of my own accord.
ولی به سرعت معالجه شد و شفا یافت	but recovered very soon
در سر تا پای خود احساس ضعف و رخوت کرد.	he was struck dumb and rigid from head to foot.
آن وقت خواهی دید که چه جوری به تو تحویلش خواهم داد.	you'll see what I'll serve her on the tray.
ضربات دیگری بر سر و پوزه الاغ فرود آورد	to give the donkey another blow on the head, and another wrench of the jaw
ایوان ناگهان در دل خود حس انزجار و تنفری احساس کرد.	he had felt a sudden twinge of gloom and loathing, which had immediately stirred responsive anger in his heart.
سعی کردم به او بفهمانم واقعا متاسفم	trying to convey to him that I had no choice, that I'm really sorry
پشت سر همدیگر به سوی ساحلی حرکت کردیم.	one after another, to the beach
با شتاب عذر خواستند و برای آن که مزاحم او نشوند تا انتهای نیمکت عقب رفتند.	they hastily begged his pardon and withdrew to their end of the bench so as not to disturb him.
من حتی شباهت ضعیفی هم به گل سرخ ندارم.	I am not even faintly like a rose.
یک بطری قرص برداشت و یک کپسول دردهانش انداخت.	took out a bottle of pills, and popped a gel capsule into her mouth.
سرهایشان را به هم نزدیک کرده بودند	their heads were close together
هر سه با هم باران مخالفت و اعتراض بر سرش باریدند.	remonstrances poured in from all three.
با صدای فریاد زنی یک مرتبه ساکت شدند.	but a woman' s shout stopped them dead
چشمانش رمق نداشت و دمش شل و ول از پشت آویزان بود	his eyes dull, his tail hanging limply behind him
اما معلوم بود که اگر مجبور شود تا بامداد سکوت اختیار کند با سؤال خود خاموشی را نخواهد شکست.	evidently resolved not to be the first to break silence, if she had to wait till morning.
بعد کارت عمه ما رج را برگرداند که پشتش را بخواند.	flipped over the postcard.
سر هر وعده غذا اصرار داشت که هری چهار بشقاب غذا بخورد.	tried to force him to eat fourth helpings at every meal.
ولی مرد آن را از جای کند و توی بخاری انداخت	but the man hastily drew it from the candlestick
دستمال را برداشت و بر ابروهای خیسش کشید تا مبادا به چشمش بریزد.	he had wound his handkerchief about his brow to keep the sweat from blinding him.
به محض اینکه حالش کمی جا آمد او را یساول قراول به ساختمان بردند.	escorted him back to the farmhouse as soon as he was able to walk.
خدمتکار مخصوص شما پیرمرد چنان نازنینی بود و پدرانه با من رفتار کرد که احساس راحتی کردم.	your butler is such a nice, fatherly old man that he made me feel at home at once.
هر چند از چند دقیقه پیش آن غول را سه سرد کلبان پارو بزن دیده بودند	though for some little time past it had been plainly beheld from the three sullen mast heads.
یه دفعه مریض بودم حصبه داشتم تو بیمارستان خوابوندنم چه راحت شدم!	I was sick once, typhoid, in the hospital, an' it was beautiful.
هرکسی از اون حوالی می تونست رفت و آمد آدم و به بینه.	where everybody went in and out and any body that was around could see.
تمثیلی بسیار جالب دقت و واجد معنی که چون آن را بخوانید ناگزیر توجه خواهید کرد	a remarkable and most significant one, by which you will not fail to see
خیلی زود به ساختمان بدن انسان علاقمند شدم	I was early bitten with an interest in structure
ون مردی کاردان قنداق آن را بالا قرار داده بود.	like a wise man, lock uppermost.
او را یک راست به در مهمانخانه و از آنجا به تالار عمومی بردم.	walking straight in at the door and towards the parlour
برگشتن شما مایه دل خوشی همهء ما خواهد بود.	your return will delight us all.
در ایوان پشتی مکث کردم و به تیغ ههای چمن شبنم پوش نگاه کردم.	I hesitated on the back deck, looking at the frost tipped blades of grass.
این بود که همین که وارد شدم اولین کاری که کردم آنب ود که سکندری به خاکستردانی در ایوان برخوردم.	so, entering, the first thing I did was to stumble over an ash box in the porch.
موقعی که اسم پدرش را برد نگاهش را پایین گرفت و به زمین خیره شد.	her eyes were turned to the ground as she mentioned his name.
دست در دست و شانه به شانه با فریادهای	all linked shoulder to shoulder, and hand to shoulder, hurried out with cries of
به نوعی امید وارد بودم که بخورد تا من هم جواب ندهم.	I sort of hoped it would so that I could not answer.
کلاهم را عقب زدم و نسیمی به پیشانیم خورد.	I hitched my hat back a bit to get the kind of balmy feeling of the air against my forehead.
ولی از جائی شنیدی که چند وقت پیش به یه نفر کمک کرده	that you heard of another case in which he helped some one else
او گفت که همه مجاور یکدیگر است	that they were all close together,
اما پیش از وارد شدن باید از اینجا بیرون برین.	but before bringing you in you must begot out.
میز ناهارخوری در بالای سرش چون سایبانی شده بود.	which spread its mahogany shelter above her head.
آن قدرها خندید که فکر کردم دیوانه شده.	I thought she would never stop.
با نشان و علامت پهلوانی خویش موجب سربلندی و افتخار دربار پادشاه خود گردد	let him add lustre to his sovereign's court by his liveries
تقریباً یقین دارم که این احساس دو جانبه بود.	I am much mistaken if the feeling was not mutual.
من آنچه را استری کلند درباره او گفتبه خاطر دارم	I remember what he said about him
یک مرتبه به طرف راست.بیرون جاده فرمان داد.	swung to the right, off the highway
به سراغ من هم آمد که چرا مدرسه رفتن را ول نکردم.	he went for me, too, for not stopping school.
چوب پنبه را دیده بودم که به زیر آب کشیده شده بود.	I'd seen the float dive under the water
احتمالاً نزدیک شده تا او را بو کند	the creature had probably approached to sniff at him
به همراه همسرش ناپدید شده است.	had disappeared with his wife.
دستانی زمخت که انگشت سبابه آن با انگشتر عقیق سلیمانی باد کرده بود.	his rough hands, the ring finger smothered by the opal setting.
خواست که او یک روز تمام امور خانه را به دست بگیرد.	that for one day he would take care of the domestic chores.
با یک دست مادر و با دست دیگر پرستارش را گرفته بود	holding his mother by one hand and his nurse by the other
صدای به هم خوردن دری از دور به گوش رشسید.	they heard a distant door slam.
آن را باز کرد تا بتوانند با هم صحبت کنند	pushing it up so they could talk through the bars.
درست مثل آن روزهای سرشار از عشق گذشته.	just as in the great days of their love.
دانش آموزان کلاسش نیز به دنبالش آمدند	followed by her own class
لامحاله به محض افتادن تلف شده	must have killed him instantly
احدی را در این قصر زنده نخواهم گذاشت	he would not, he thought, leave a soul alive in the castle
هنوز بدین واقعیت کاملاً پی نبرده بودم	I was no sooner certain of this than
به هیچ رو آمیخته به ریشخند و خودستایی نبود.	had no mixture of sneering and self exaltation.
فوراً ردایش را انداخت تا پایش را بپوشاند.	he dropped his robes quickly to hide his leg.
خر خود را با پالان و افسار نو چنان آراست که با اولش مثقالی هفتصد دینار فرق کرد.	rigging out his beast to the ninety nines and making quite another thing of it.
زنی که در تمام عمر دست روی کسی بلند نکرده بود.	such woman who had never struck a blow in her life.
باز هم مشتاق بود که با تمامی معنای نگاه کلاید پی ببرد.	still she was intrigued by it to the extent of wishing to know its further meaning.
سربازان اسواران سوم بار دیگر او را به هوا پرتاب کرده هورا کشیدند.	the soldiers of the third squadron tossed him too, and shouted hurrah!
دادگاه پر از زندانیان و تماشاچیان بود. تماشاچیان یا به خاطر کنجکاوی یا به این منظور به دادگاه آمده بودند که با شناختن یکی از مردها باج سبیلی دست و پا کنند.	which was crowded with the prisoners and those who had come out of curiosity or in the hope of recognizing one of the men and getting a case for blackmail.
ین گه لیوانی پر از کواس دردآلود تازه به دست پی وتر داد.	she said, handing him a glass of cloudy, over fresh kvass.
آخر چگونه ممکنست با آرامش خاطر بروزهائی بیندیشم که باید درمیان یاهوها به سر برم	how could I think with temper of passing my days among _Yahoos_
بلکه شخصی زیرک و هوشیار که محل اعتماد تمام و وثوق چاکر است و از طرف چاکر به مراقبت احوال و اخبار ایالات جنوبیه مأموریت دارد	but a serious minded man deserving all my confidence and charged by me to watch over the south
بعد تپانچه را بالای سر خود به گردش درآورد	whirling his pistol high into the air
با این همه برای اطاعت از فرمانی که شرف صدور یافته است وی احساسات خود را آزادانه معروض خواهد داشت.	however, in obedience to the command he had received, he would freely offer his sentiments.
اما امروز زندانبان ممکن بود که این صدا را بشنود و بروز بدهد و آن امیدی که هنوز معلوم نبود از کجا و چه راه است باطل گردد	but now the jailer might hear the noise and put an end to it and so destroy a ray of something like hope that soothed his last moments
که بتواند یک بار دیگر از بستر برخیزد.	if he would ever leave his bed again
طوری با من رفتار کرد مثل این که پسرش هستم.	he treated me as if I were his son.
انتخاب راهی را که باید برویم به من واگذار.	leave the choice of our road to my care.
در رستوران را برای او باز نگه داشتم و منتظر ماندم.	I held the restaurant door open for her and waited.
ولی ناگهان به نظر او جلسه اهمیت قبلی خود را از دست داده بود	but suddenly the meeting didn't seem as important as it had earlier
وقتی آسمان شروع به روشن شدن کرد به طور مبهمی متوجه شدم.	I sort of noticed when the sky began to lighten.
ولی روابط بین مردان بسیار صمیمی و دوستانه بود	but good manners in the other and with regard to the gentlemen
دست در ریسمانی حلقه کرده بود که مرد بینوا را در آن پیچیده بودند.	turned her hand in one of the ropes with which he was tied
ما به قدری که در قوه داشتیم سعی در خلاص کشتی کردیم و نشد	we have tried to save the ship
همه چیزتون به مادرتون رفته و همه چیزتونو از او به ارث بردین. زیاد کتاب خوندنتون هم به مادرتون رفته.	all your mother wor mich i' your way, and a'most as book learned.
پنداشتم که مگر طوفان آن را از کشتی به دریا افکنده است.	I supposed might by some tempest have been driven from a ship.
چشمانش را در آینه غافلگیر کرد و موذیانه خندید.	she caught her own eyes in the mirror and laughed ruefully.
چیزهائی مجهول پیشنهاد نمود و وعده داد و معلوم نبود چه کسی را تهدید کرد.	suggested this and that, made promises, and threw out threats against somebody.
که خیال دارد به منزل شخصی مسنی برود که چندان هم از آنجا دور نیست	he wanted to call on an old person who lived not far off
تنها گًلهایی را که تحمل داشت که چیدنشان را ببیند.	the only flowers she could bear to see cut.
چیزی نمانده بود باد چترهایشان را به آسمان ببرد.	umbrellas being whipped out of their hands as they went.
انتظار داشت تا او برای فرار تلاش کند.	he'd expected her to try to run.
از ساختمان خارج شدم و نزدیک او رفتم.	I went out and approached him
بلکه استخوانی از نظر پنهان مانده باشد.	looking for bones he might have overlooked.
کسی اعتنائی بدان نکرد و او هم دیگر دل آن نیافت که ادامه دهد	no one was interested in them, and he had not the heart to go on
چند دقیقه پیش تو بسیار خوب گفتی که لزومی ندارد این اسرار را بدانی.	that that was a very good decision of yours not to find out these secrets.
با پایم ضرب گرفتم و هر ضربه را شمردم .	I tapped my foot, counting each beat.
از شما استدعا دارم این نکته را هم باور کنید.	you will believe this of me.
افتان و خیزان به آن طرف آسمان رفت.	tumbling down the heavens and lost itself in sullen rumblings in the distance.
گویی صدایش را در کنار اتومبیل جا گذاشته بود.	he seemed to have left his voice back with the car in the clearing.
لیکن روشن بود که سخت رنجور و ناتوان است	though he still looked very sick
من نباید چنین پندارم که او بی آنکه با شورای سلطنتی مشورت کند دست به چنین کاری خواهد زد.	I am not to be thought on without the advice of his council.
سعی کردم صدایم را خشن نگه دارم. پرسیدم.	I asked, working to keep my voice severe.
اقلام وارده در دفتر را از مدنظر گذراند	went through the entries in the book
تیروکمانی در دست و ترکشی بر پشت داشت.	with a bow and arrow in his hands, and a quiver at his back.
دیمیتری کام لا از جریان آگاه بود.	he knew about him
که از سقف گلخانه آویخته بودند	dangling from the ceiling.
در حقیقت اگر بخواهیم بی غرض و نظر سخن بگوییم	for if the truth be told ungrudgingly
اما چوبی بود بسیار سفت و در عین حال به طرزی عجیب سبک.	but the wood was tough and yet strangely light.
در حالیکه دکتر خودش خجول و بی روح و کسل کننده بود.	white he was shy and dull and drab.
عبور نرم آن را از درون آبشش حس کرد.	felt it pass smoothly through his gills
دانتس که چنین دید مضطرب شده پرسید	inquired the young man much alarmed
چون که شیطان را دیده و اجنه از او سواری کشیده بودند.	because he got stuck up on account of having seen the devil and been rode by witches.
بهتر است دیگر از بازی دست بکشی.	you had better come away.
موجی از هیجان و کنجکاوی تمامی تالار را در بر گرفته بود.	interest passing over the entire room.
در آن دم که پهلوان لاقیدانه بر پشتی مسند تکیه زده است	for the knight to recline in the chair
من هیچ آزادی یا اختیاری در زندگیم ندارم.	I had no freedom or say over my life.
اما در عین حال متأسفم که چرا بیش از این شما را ناراحت نساختم	or rather, I am sorry that I have not troubled you enough.
آنگاه به آنان دستور روشن کردن آتش داد	then he bade them get the fire lit
به این طرف و آن طرف و جاهای مختلف رفتند.	they wavered about, went different ways
شکی نیست که ارباب او نیز اگر تا به حال از ترس روشنایی روز آنجا نیامده حتماً شب را به آنجا خواهد آمد.	there seems little doubt that his master either is, or will be, there, under cover of the darkness.
از همین رو بر آن بود که به کلیات بپردازد.	he wanted to confine himself to generalities.
در این هنگام علامت صلیبی کشید من شما را همچنان یک کشیش میدانم گو اینکه شما در این لباس تازه خود بسی دلپسند تر هستید!	she crossed herself I look upon you as a monk, though you look charming in your new suit.
اعتباری که نزد امپراطور داشتم به سرعت رو به زوال نهاد.	found my interest decline very fast with the emperor himself
پس کنت از روی میز کاغذی را برداشت	he removed the sheet of paper
مخصوصاً آن تابلوی خانم جوانی که لباس فاخر سفیدی پوشیده و کلاه سفیدی را به دست گرفته.	especially that one of the young lady in white, with her hat in her hand.
لکن اظهار او در حضار اثر عجیبی بخشید	but his words made a deep impression upon all.
آنگاه یک قطعه چوب نرم برداشتم.	I then took a piece of fine wood.
دیگر برای تو ممکن نیست که از آن من نباشی.	thou canst not help being mine.
با همه تن خود و با هر ضربان قلب خود عاشقش است	he loved her with all his body, with every beat of his heart.
ناخدا و ترس از او را پاک از یاد بردم.	I had scarcely time to think of the captain, far less to be afraid of him.
واقعا شرم آور است که با یک مذهب پر جنب و جوش مردانه سر و کار نداشته باشد.	shame if he doesn't take part in a real virile hustlingreligion.
بر سر آرزوهایش فرود خواهد آمد	descend into the deep against his will.
به هیچ چیز برنخوردند که ناراحتشان کند.	nothing to be astonished at.
چه برسد به اینکه خود را با آن وفق دهد.	still more for her to have readjusted
این کلمه با فریادی وحشتناک از سینة سونیا خارج شد.	broke in an awful wail from her bosom.
خانه نیمه ویران و حیاط را نگریست.	as she looked around the half demolished hut and the yard
بعد از هر گذار او حالش همیشه بهتر بود.	she was always better after his visits.
واقعاً چیز زیادی از لباس باقی نمانده بود.	there really wasn't that much left of the dress.
او را به عنوان سرکارگر باربرها و محافظ اسکله استخدام کردم.	I engaged him to be the foreman of our lightermen, and caretaker of our jetty.
او هم سر در بشقاب خود فرود آورد	then he bent his head over his plate
خود صندلی او را با دست دیگر پس کشید.	pulled out her chair with his other hand.
آن وقت دیگر آن دو تا خسته شده بودند	by that time the other boys were tired
سه خانه را رها کرده از در خانه طرف راست وارد شد.	passing three houses, turned into a yard on the right.
چندان کتکش زد تا نیمه جان شد.	gave him such a flogging that he left him for dead.
به مطبخ رفت و با اهل خانه صحبت کرد.	he went down to the kitchen and talked to the people there.
قیافه کاملاً مرموزی به خود گرفت	looked very mysterious
لابد اشتباه عجیب و غریبی پیش آمده.	there must be some unaccountable mistake.
آنگاه اشک در چشمانم حلقه زد	the tears rushed to my eyes
که شاید بوریس از او متنفر است	that she was repulsive to him
با این حال و روز او هیچ چیزی وجود نداشت که برایش خنده دار باشد.	there was nothing that would be funny to him in this mood.
که چون در یک تا آن هنگام آنقدر به هدف نزدیک شده بود ممکن بود	that from being already so nigh to his mark
من خطا کردم که کلاه آن آقا را خراب کردم.	I did wrong to spoil that gentleman's hat.
چند دقیقه ساکت ماند و چیزی نگفت.	for a few minutes he was silent,
هیچ نشانهٔ همدردی دیده نشد.	gave one sign of sympathy.
لبخند او یک لبخند زیبای طبیعی نبود.	his smile was not his own.
سپس از جا بلند شدم و به وسط اتاق رفتم.	I stand up, walk to the centre of the room
اما خیلی به سرعت سر و صدایش را خواباندند.	but it got hushed up pretty quickly.
در صندلی خودبه پشتی تکیه کرد	leaned back in his seat
سرانجام سبب شد که وضع خود را در کارخانه عجیب ببیند.	finally made his position here seem strange.
طلسم ولد مورت به سنگ قبر خورد و هری صدای ترک خوردن آن را شنید.	he heard it crack as the curse missed him.
اون وقت در مقابل یکی دی گه رو در نظر بگیر ین که بد ذاته تک و تنه پیر و ناکامه خب این از مرگ میترسه دی گه	but a fella mean an' lonely an' old an' disappointed'he's scared of dyin'!
بلکه با این احساس که در آنجا هنوز کسی ایستاده است.	but with a dull mechanical perception
زود هم راه افتاد تا مبادا چیزی پیش بیاید که مانع رفتنش بشود.	went early,that nothing might prevent her.
تنها آرزویش این بود که آن مردم به او کمک کنند	only wished that they would help him
در تاریکی سالن سینما توانست صندلی محل نشستن دخترش را تشخیص بدهد.	in the darkness of the seats she recognized her daughter.
چوبدستیش را آماده نگه داشته بود.	was holding his wand ready.
دوباره تقریبا سرشار از روشنایی شد.	became almost perfectly lucid once more.
تمام فصل تابستان را با پدر و خدمتکاران خود در آنجا خواهم گذراند.	where I shall be all this summer with my father and my servants.
تاپ و توپ کنان از کنارش گذشت.	then flapped past him
ولی به هر حال دیگر دیر شده بود.	but he was too late.
بلکه خاموش به جانب خانه گام برداشت	but he directed his steps in silence towards the house
ولی بعد از امتحان کردن چند جوهر عاقبت فقط یک شیشه کوچک جوهر اکلیلی خرید.	but after several trials she decided on a bottle of gold ink.
از اتوبوس پیاده شدم و به سمت خانه رفتم.	I get off the bus and head for the front door.
صبح روز بعد که از خواب بیدار شد خوابش را به یاد نداشت.	when he woke next day, he didn't remember the dream at all.
اما باز در موضعی کمین کرده بود	but it was only to place himself in a situation
خواهم توانست بگویم که خلاء آمال من پر شده	I shall be able to say that the cup of my desire is full
یعنی اون موقع نمیدونستم بسته به این بود که چند روزه بتونم حرفامو باهاش بزنم و مشکلاتمو بهش بفهمونم.	I couldn't tell whatever time it took me to talk things out with her and make her understand and see where I stood.
در برابر برخی تصورات و گرایشات که بر ذهن دور تا چیره شده بود	against certain notions and likings which had taken possession of her mind
چنگالش از دستش به داخل بشقآب افتاد و صدا کرد.	his fork falling onto his plate with a clatter.
من فکرم به هر قتل و جنایتی که بگویید رفته است.	I shall expect murder and everything of the kind.
من متاسفم که این موضوع تو رو از اذیت می کنه.	I am sorry about it hurting you.
همه چیز پشت سرش از نظر پنهان شده بود.	every thing left far behind.
در پاسخ گفت خون انسان است زیرا اینک مردی را به لاکت رسانیده است.	and he answered that that was human blood, and that he had just killed some one.
آن دو را در راه اصلی به حال خودشان گذاشت.	leaving them together in the main road.
خود را در داخل یک مرغ دانی بوگرفته و پر از کارت ونک عنکبوت به اصطلاح مطب او یافت.	he found himself facing a kind of dusty iguana whose lungs whistled when he breathed.
راستی پیشخدمت اطاق و خانه شاگرد را فراموش کردم!	I am forgetting your valet and your groom!
تازه همین دیروز در جریان امور قرار گرفتم.	it was only yesterday that I learned how matters stood.
اما اگر هم در دل خیال گفتن متلکی داشت	but if he had any dim idea of making any references to allusions
همسرش بار دیگر گریه را سر داد.	so that as he spoke she began to cry again
دانتس تیشه را برداشته و به شدت تمام مشغول کار شد	he again entered the cavern and attacked the wall
آن وحشی که زیر آب بود در دم آن رعشه اثیری را دریافت	simultaneously feeling that etherial thrill, the submerged savage beneath, in his death gasp
یعنی اگر بیدار بود خیال کنند که خودش را به خواب زده است.	she was still asleep when she no longer was.
عزمم را جزم کردم که هر طور شده فرار کنم.	I made up my mind I would fix up some way to leave there.
خون از گوش راست وی تراوش کرده بود.	had already stopped flowing out of his right ear.
با مرگ موشی که مخفیانه به دست آورد خود را مسموم ساخت.	with some arsenic she had stealthily procured.
در همین حین از پشت سرم صدای پایی شنیدم	when I heard the sound of steps
گویی دریافتند که زندگی ایشان تنها در کنار یکدیگر مقدور و میسر است.	an exclusive feeling of life being possible only in each other's presence.
سپس بار دیگر چیستان را خواند.	repeated the poem.
اثاثیه تازه را زشت و ترسناک جلوه داد.	made the new furniture ghastly.
من مشتاق بودم به سر پستم برگردم.	I was eager to get back to my charge.
یک پایش ورم کرده و در نتیجه در تمام روز در اطاق خوابش بر روی تختخواب دراز کشیده بود.	her foot had for some reason swollen up, and though she was not in bed, she lay all day half reclining on the couch in her boudoir
من از نو مسلمان در باب آنچه بین او و زبیده ردل و بدل شد توضیح خواستم	I asked the renegade what had passed between them
تنها به شرطی که دور تا هنگام نشان دادن این عواطف او را هم سهیم سازد.	if she would associate himself with her in manifesting them.
چیزی نمانده بود به دام بیفتم	where he had me trapped
حال که تقدیر مرا ناگزیر کرده است گوش بدهم ادامه بده!	as fate will have it that I cannot help listening to thee, go on.
با سوت دسته سگان خود را فراخواند	whistling to his own leash of borzois
عادت داشت که به ده بیاید و پیش ما بماند.	he had come to stay with us in the country.
که برای چند دقیقه از رقص خارج شده بود تا از دوست خود تقاضا کند که به رقص ملحق شود.	who came from the dance for a few minutes, to press his friend to join it.
هنگامی که او از این روشنایی عبور کند متوجه نشوند و به خوبی نبینندش.	he could not fail to get a good look at them, as they traversedthis illuminated space.
که در ملاقات بعد حتماً به او اظهار عشق خواهد کرد.	only with the thought that the very next time he saw her he certainly would propose.
لااقل آن اندازه نیست که بتوانم کار با ارزشی خلق کنم	at least not so well as to make it worth while.
کشوی میز کنار تختش از جا درآمده بود	the drawer had been pulled out of his bedside cabinet
شاه ابروها را در هم کشید و عقب نشست	who retreated a step and frowned
تلاش برای اطمینان دادن به او به سختی لبخند زدم.	I smiled weakly, trying to reassure him.
محجبو و آهسته پرسید که آیا شاهزاده و شاهزاده خانم خانه هستند.	inquired timidly and softly whether the prince and princess were at home.
که از این اظهارات سر ذوق آمده بود	highly amused by this declaration.
سپس همراهانم مرا مجبور به پیاده شدن در این سرزمین کردند	my companions forced me to land on this coast
محتوای آن را با تا نی در آتشدان ریخت	poured it slowly out upon the hearth
تا گروه مردان اکتشافی همراهش را به سمت شمال ناپیدا هدایت نموده	he kept on guiding his men toward the invisible north
ولو آن نشریه زودگذر باشد و دردم به دست فراموشی سپرده شود.	however transient and immediately forgotten that record.
داد به خرج او در قبری شایسته دفنش کنند.	he buried her at his own expense
وقتی هم که وی مرد آقا مرا نگه داشت تا سرپرست امور خانه باشم.	after she died, the master retained me for his housekeeper.
تا او به آسانی موفق به کشف حقیقت شود.	then he might easily discover the truth.
در آن هنگام من این طور عقیده داشتم.	I did what I thought best at the time.
تو هم به همراه او در اینجا خواهی ماند. تا اربابت نفس آخر را بکشد.	you along with her, till your master dies.
به هیچ قیمتی حاضر نبودم این دیدار را از دست بدهم.	I would not have missed this meeting for the world.
زیرا او فقط پرسید پول را آورده یا نه	for merely inquiring if she had brought the money
او موافقت خود را با اشاره نشان داد.	he made a silent sign of approval.
دوباره از خود پرسیدم منشأ آن کجا بود.	again I questioned whence it came
من مصمم بودم که آینده را تغییر دهم.	I was determined to change the future.
این مناظر روزهای جوانی را که پر از شور و دغدغه بود	it made her remember her girlhood again with all its strange fits and starts
از کسانی که دوستشان دارند بیزارند	to scorn the one that loves them
با وی مشورت کرد که سفر پهلوانی خود را از کجا و از کدام سو آغاز کند.	he asked his advice as to the quarter in which he ought to commence his expedition
اما تنبل و بی قید بود و از این رو در ردیف های آخر کلاسش قرار گرفته بود.	but he had been idle and mischievous, and therefore was one of the lowest in his class.
امروز است که باید مجازات بر مجرمین داد	to day the man who holds the blade of justice
اما این تنها چیزی بود که از آن به بعد در قلب هیچ مردی به وجود نی آمد.	but that was the only thing that did not occur to anyone.
به سَمت شرق جهیدم. می دون ستم که با اعلام شروع ماموریت اگه یه لحظه دیر بجنبم به هم میر سه.	I sprinted off straight east, knowing that even with the head start, she'd be passing me soon if I took it easy for even a second.
اما حمل بر عشوه و ناز و هوس جوانی و جاهلانه او کرده	but, attributing it to a caprice, feigned ignorance
آن سنت درخشان زندگی را با خود برده بود.	the old glamor of their way of living.
چراغی را که از وسط سقف اتاق آویزان بود روشن کرد.	had turned on the one incandescent globe which dangled from the center of the room.
پیشخدمت که خبر آمدن کشیش را داد به اتاق پذیرایی آمد.	came into the parlor when the maid told him who had called.
این کار تفریح دائمی او شده بود.	an occupation he seemed to find endlessly diverting.
گندمگون که گوئی شیارهایش را از ایمان و صفای دل قالب گرفته بودند	brown face molded in homely andyet convinced and earnest lines
که بیایید و خود را تسلیم کنید.	that you should surrender and confess.
توهم طبیعی آنکه اگر شخص در چنان تنهایی دور از بشری گم شود چقدر ترسناک خواهد بود.	the natural conceit of what a fearfulness it would be to lose oneself in such inhuman solitudes.
اما در این جا ظاهرا با نارضایتی از بیان افسرش سخن او را قطع کرده	but at this point, evidently not liking the officer's remark, interrupted him.
او هم دستپاچه حرفش را بند آورد.	he stopped, confused.
زیرا خدا تو را مشمول عنایات خود قرار داده است	for even thou hast found grace!
از برای مخفی داشتن سرخی یا زردی رخسار	helped him to disguise a blush, or his pallor
ظاهرا که مرض فجعه بوده است که طبیب هم چنین گفت.	it appears to have been an apoplectic stroke
تنها موضوع مهم برای لهوین همین بود.	this was the only thing that interested him.
ولی من نباید از احساسم به تو بگویم.	but I must not talk of what I felt.
پس از چند دقیقه درد تیرها آرام گرفت.	in a few minutes, removed all the smart of their arrows.
همی توانستم او را با همین ضربه بکشم	I could not have killed her by the same blow
اخباری که اول آنان را خوشحال کرد ولی بعد اضطراب و ترس و اندوه به وجود آورد.	news that raised them to the heights when they first heard it, but later created a gnawing anxiety in their hearts.
فکر کردن به این نکته بود که چه قدر زود اولین سربندهای بچه برایش کوچک شده است.	it was perceiving that the baby would soon have outgrown its first set of caps.
تنها یک دوست که او رادرک کند و با روح وی دمساز باشد!	one friend who would understand him and share his soul!
ولی هیچ کس نشانی دقیق شما را در دست نداشت.	but no one could tell where.
همیشه پا برهنه از پشت سر آدم را زیر نظر دارد.	is always stealing up behind one's back on his bare feet.
با این فکر بار دیگر از خجالت قرمز شد.	darted into her head, and cost her another blush.
برای همین باید ترا در آغوش خودم به فشارم.	I must kiss you for that.
واقع امر اینکه راهی برای انجام آن وجود نداشت.	indeed, there was no way of doing so.
وقتی لانگ با تم اطلاعات مورد نظر و در اختیارتون نگذاشت شما همسرشم شکنجه داد ین.	when he would not give you information.
تا همین هجده ماه پیش امکان نداشت بتواند کمترین اثری بر او بگذارد	which so late as eighteen months before could have movedhim in any way
مرا مقید به نظامی کرده است که از آن وحشت دارم.	has left me bound to a system that is frightful to me
اما سر برداشت تا یک راست به صورت رالف نگاه کند.	she lifted her head to look directly into his face.
خیلی به ندرت این امکان برایم پیش آمده تا چنین کاری کنم.	I so seldom have had an opportunity of doing so.
ملکه چنان خشنود شد که آن را به دامن گرفت و دوان دوان نزد شاه رفت.	the queen was so delighted, that she ran with it in her lap to the king.
تا بداند چگونه باید جلو برود.	in order to remember what he had planned.
اما خطایی که باید در سراسر عمرت پیامدهای آن را متحمل بشوی	but one whose consequences must follow you through life
هری خود را روی یک صندلی انداخت.	he sank into a chair
گویا در دومین هزار روبل هفتصد روبل آخر را اشتباه شمردم.	I fancy I made a mistake in the seventh hundred in that second thousand
همه دوباره به داخل ساختمان برگشتیم.	all re entered the house.
اما میدانست که پدرش هرگز هرگز نخواد تواسنت او را ببخشد	but she knew he would never' could never'forgive her.
به درون رفتم و به روی تشک دراز کشیدم.	I climbed into the back of the car and lay down with my legs tucked under me.
اینجا شاید چاشنی تندی و تیزی هم لازم بود.	in this matter it wouldnt serve him as well as bluntness.
مردم دریایی قبل از آن که موفق به بستن رون بشوند ناچار شدند او را کتک بزنند.	who had to beat him into submission before tying him up.
زیرا در هر صورت پدرش با و پولی نخواهد داد.	for his father would never give him any.
همان طور که او انجام داده بود.	as she would have done.
اما باور کن که این برایت بهتر است!	though there you are, and you may lay to it.
من شمارو وقتی تعمید دادم که غرق در لطف و جلال خدا بودم.	here's you that I baptized right when I was in the glory roof tree.
اما لطفاً نگذارید چنین موردی زیاد تکرار شود.	but please not to let the circumstance occur too often.
موجودات دم انفجاری خیلی بزرگ بودند.	it was enormous.
از آن مواردی که بتوان در نامه با خوشی و دلگرمی از آن یاد کرد.	the sort of affair they could refer to in letters with reminiscent pleasure and amusement.
فردا آفتاب غروب نخواهد کرد مگر اینکه جشن کتاب سوزان برپا شود	by my faith to morrow shall not pass without public judgment upon them
اما از آن زندگی بیشتر خاطراتی چند از یک اتاق پشتی و یک باغ بزرگ در یادش مانده بود تا از عمو و زن عمویش.	but there remained with him a recollection of an attic and a large garden rather than of his uncle and aunt.
در جنجال امروز من صدای فرو افتادن تیغهء گیوتین را شنیدم.	I heard the fall of the axe in that sound.
با سوءظن خود او را رنجانیده بود!	had insulted him with this suspicion!
از خداوند به دعا خواست که روح تازه داماد را غریق رحمت کند.	implored heaven to grant an easy passage to the soul of the newly wedded man
من یکی از دوستان خوب برادر شما هستم من میل ندارم با دیگر این نام زشت را بر زبان رانم.	yes, would you believe it, there's a paragraph that I was 'a dear friend' of your brother's , I can't repeat the horrid word.
زیر درخت بلوط کش و قوسی به خود داد.	stretching his limbs out under the oak tree.
موجب سردرگمی و ناراحتی فراوان دوستمان شد.	has caused our friend considerable perplexity and annoyance.
که اکنون تشییع کنندگان به تدریج از آن دور شده بودند	now abandoned by spectators and workmen.
چند نفر وحشت زده ولی آهسته گفتند	whispered their frightened voices.
هرگز جرات نکرده بود آن را به مادرش نشان بدهد	he had never dared show it even to his mother
حتی صدایش هم تغییر نمود و تمام بدنش گویی تاب برداشت	even his voice changed and he seemed to shrink together
این تصاویر همواره توجیه خود را به دنبال داشتند.	in the train of those images came their apology.
نه کاردی داشت و نه چیزی که بتواند او را به کار آید	he had no knife or sharp instrument
به همین دلیل پیشاپیش برای آماده کردن آن لباس به سراغش رفت.	she wanted to get the dress ready earlier
فقط آمده بود از من عذرخواهی کند و یک نوشیدنی با هم بخوریم.	just wanted to have a drink.
خیالم راحت شد و آهسته خندیدم	I chuckled in sudden relief.
از این جهت مصمم گشت که فقط دو هزار روبل آن را بردارد و بقیه را برای پرداخت قرض خود به پدرش واگذار نماید.	but now resolved to take only two thousand and leave the rest to repay the debt to his parents.
بلکه با نوعی روش کر و گنگ و خود به خود و مو به مو.	but merely by a kind of deaf and dumb, spontaneous literal process.
مگر آن که اوضاع و زمان هر خیلی وارونه شده باشد.	unless circumstances are particularly untoward.
اما در همان لحظه دوباره آسمان برقی زد و چشم هری به جایگاه تماشاچیان افتاد.	but at that moment, another flash of lightning illuminated the stands
در چهل سالگی آدم یا احمق است یا طبیب خودش	I tell you at forty a man's a fool or his doctor
که من باید همهء قبلم از شما تشکر کنم	that I thank you with all my heart
بستن یک تنظیف سیاه رنگ به روی آثار سوختگی بر روی دستش بود که تا پایان عمرش ادامه یافت.	was the bandage of black gauze that she put on her burned hand and that she wore until her death.
کلیدا رو تو ماشین جا گذاشتم و در قفل شد.	I just locked the keys in the car.
اما روشنایی آن بر نوک درختان افتاده بود.	though its light was on the tree tops.
آقا و مهتر بی هیچ تشریفاتی در کمال صفا و صمیمیت به خوردن ماحضری که در آن بود پرداختند.	without any ceremony very peacefully and sociably master and man made their repast on what they found in them.
اما هیچ یک از رفقایش امکان چنین امر را باور نداشت.	but not one of those who bet believed that she woulddo it.
دستی که به گمان ارلاندو به بدنی فرتوت متصل بود	a hand, he guessed, attached to an old body
یادم است که در مهمانی رقص به من گفته بودند	I remember her telling me at the ball
زیرا چشمان او از زیر عینک مانند ماه دو هفته بود که از میان دو پنجره به درون اطاق بتابد.	for his eyes appeared like the full moon shining into a chamber at two windows.
سخت احساس سپاسگزاری کرد و با لبخند مهرآمیزی پاسخ او را داد.	she felt a new sense of gratitude and answered with a gentle smile
خود را بزرگ زادگان در حشر و نشر ببینید.	may feel himself virtually in company with persons of some style.
در ستاد اصلی امپراطوری هم از وی ناراضیند	that at headquarters they were dissatisfied with him
زن و فرزند خود را نیز فراهم آورد	of his wife and baby
خیلی دوست دارم که دوباره فقط یک نگاه کوچک به آن بی اندازم.	I should very much like just to peep at it again.
تو عمرم هرگز این همه از دیدن کسی خوشحال نشده بودم.	I was never so glad to see anybody in my life!
بعضی از اجزال آمده و به او دست دادند.	several of whom came forward to shake hands with hiM
احساسات و نظرات پر طمطراق و اخلاقیاتی سست و لرزان	high sounding sentiments and a supine morality
فکر کردم حتما دزدی به خانه وارد شده است من اینجا تنها هستم	I was sure there were burglars in the house, and I'm all alone here.
از در زد و مردی در را باز کرد. ایوان سه روبل به او وعده داد	knocked at the shutters, and asked the man to whom the house belonged to help him carry the peasant to the police station, promising him three roubles.
هری برای ناهار مقدار زیادی غذا خرید	he bought himself a very large lunch
زیرا من به لطف و بزرگواری شما اعتماد دارم	because I have trusted in your goodness
با این قیافه آخرین تیر ترکش را رها کرد	from that position she delivered her last shot.
از اینکه با او دیده شوند مغرور بودند	as proud to be seen with him
شاید دیگر فرصتی دست ندهد تا بتوانم درباره موضوعی که پیش آمده با شما صحبت کنم.	I may not have another opportunity of speaking to you about what has occurred
تا دیرگاه شب در کنار او بستر او نشستم.	I sat at the side of the bed until the night was far advanced.
ولی چندی نگذشت که متوجه شد	but she soon realized that
من هنوز آماده برای این کار نیستم.	I have not prepared my judgment.
من در چند کلمه به او پاسخ دادم و سرتسلیم و رضا فرود آوردم	I answered in a few words, but in the most submissive manner
از چیزهای دیگری با روش دیگری حرف بزنید.	speak of other things, and in another strain.
که جاده را در جایی که امروز هم مشخص است سد کرده بود.	which barred the way, at a spotwhich is still pointed out.
با دشواری بسیار بیمار را به فروبردن مقداری دارو مجبور ساختم	I made the patient swallow, with great difficulty
ولی مجبور بودم به تو بفهمونم .	but I had to make you understand.
یک لنگه کفشش را در بخاری گذاشته بود.	had placed her shoe on the hearth stone also.
اگر هما ندم بر آن نشده بودم که شمشیر برکشم	if I had not resolutely drawn my hanger
در را نیز پشت سر خود با کلید بست.	locked the room door behind him.
چون که خبر ورود ما را از زبان یکی از پیش قراولان شنیده بودند	for they had by this time heard of our arrival from one who had gone on in advance.
دومین روز بود که تقریباً هیچ نخورده بود.	for two days he had scarcely tasted food.
مشخص است که از آغاز نیت سوئی در سر داشت چون همسرش را به عنوان خواهر خو معرفی کرد.	that he meant mischief from the first is evident from the way in which he took his wife with him in the character of his sister.
به زور بازویم را از دستش بیرون کشیدم و از لابه لای وکلای شیک پوش موبایل به دست رد شدم	I wrench my arm away and start striding away as best I can through the thicket of mobile phone gabbing lawyers.
شاید یک چتر به کنار آن وصل بوده است.	an umbrella it might have been.
دیگر از نیرویسر زندگی در وجودش اثری نمانده بود تا تیزی آن را احساس کند	he had no vitality with which to feel the prod of it.
دیگر نتوانستم چیزی از او بیرون بکشم	I could draw nothing further from him
فنجان چای را به روی میز کوچک کنار او گذاشت	setting it on the small table by his side,
کنار در اطاق صندوق بزرگ آهنکوبی قرار داشت	the room contained a capacious iron bound chest that stood close to the door
آکاردئونی که چند تا از کلیدهایش را با بند کفش در سر جایشان نگه داشته بود.	which by then had some keys held in place by shoelaces.
پیدا بود که مقداری از هواسشان پیش بازوهای لخت خودشان	conspicuously conscious of their bare arms
من میل دارم با خریدن این شیئی وسیله شگفتی او را فراهم سازم.	I wish to give her a surprise, you see.
ویی کس دیگری صدای ضعیف او را به کار گرفته بود.	as if some other will was using his small voice.
دختری که به احتمال قوی در موارد عاشقانه درست مثل او پاک و معصوم است.	who she supposed was as green as he in matters of the heart.
اثر غریبی که چند کلمه حاکی از اعتماد یک زن بر او گذاشته بود برایش تازگی داشت و از آن در شگفت بود.	it was something very new and strange in his life that these few words of trust from a woman should be so much to him.
عادت داشت این را درباره رویاها بگوید.	used to say of dreams.
زیرا که از این وصلت با شما امید شرافتی داشتم.	, for I had reckoned on the honor of your alliance
اولین بار چه وقت به این نوع مجالس پا گذاشتم.	when I find myself thinking the same thought
گندم زمستان لطمه یخبندان دیده خوابیده است .	, lay the winter rye under the frosts.
در شهرکی کوچک در مسیر خود خسته به رختخواب رفت.	he went to bed tired out, in a little town on the high road
تلاش او برای پنهان نگه داشتن دستخط خودش دلیل بر آن است که شما ممکن است این دستخط را بشناسید یا بعدها تشخیص بدهید.	his effort to conceal his own writing suggests that that writing might be known, or come to be known, by you.
تا پایان عمر در او به جای ماند	to the end of her life remembered
غذا به اندازه کافی برای سیر کردن شکم آن همه آدم وجود نداشت.	there wasn't enough food to go around for so many.
اون وقت من یه نفس راحتی کشیدم.	I breathed again.
در آخر لرزید و چشمانش روی زمان حال متمرکز شدند.	finally she shuddered, and her eyes flickered back to the present.
من هرگز نمی تونستم در مقابل خودش ازش محافظت کنم.	I would never be able to save her from herself.
زیرا شادی من با کمتر از تعجب من نبود	my joy was not less than my wonder
سپس گوش خود را به دیوار چسبانده	turning his ear to the partition
اما در همان لحظه بحث خاتمه یافت	but he was distracted almost at once
دیگر بار به جای خویش در کنار آتش بازآمد.	retired to his seat by the fire.
ولی عصایی داشت که یک سرش کج بود.	but experience had taught him a way of thrusting a cross headed camel
بعد از اون همه مهربونی که از شما دیدم تحمل این دلسردی رو ندارم.	I couldn't stand it after you been so kind and sweet to me.
بشقاب را جلو کشید و به خوردن پرداخت.	moving the dish up he began eating.
اندکی خوردنی که با خود داشتم برگرفتم و پس از آنکه مقداری خوردم و نفسی تازه کردم	I took out my small provisions and after having refreshed myself
از این رو در دویدن یا اسب سواری و یا عشق بازی بنا به اختیار خود آزاد بودند	were thus free to run or ride or make love at their own sweet will.
اکنون که بر اثر تسخیر نیروی دریائی دشمن میدان بدست امپراطور ما افتاده بود	yet our emperor, standing upon the advantage he had got by the seizure of their fleet
بالاخره از حرکات و سکنات و از سر و وضع او پیدا بود که مردی نیکو نهاد و متصف به صفات حسنه است	his dress and accoutrements showed him to be a man of good condition.
بعد از چند دقیقه تلاش مداوم طناب پاره شد.	after several minutes' hard work, they broke apart.
چون خودش هم از این تصمیم اطمینان نداشت.	because she was so upset at the very idea.
وقتی قطرات چای آمیخته به بزاق سگ بر روی کف پوش تمیز آشپزخانه پاشید	as specks of tea and drool flecked her clean floor.
به هزار زحمت خود را تا اتاق کشیدم	I dragged myself as far as the yard.
من وادارش کردم که به هم به گه	I forced him to tell me.
تصور کند که ما را کاملاً فریب داده است.	imagine that he has completely deceived us.
حالا آمدن این جوان بستگی دارد به این که خانم اجازه بدهد یا ندهد.	his coming now, depends upon her being willing to spare him.
بلکه در دو روز متفاوت از زمان قرار دارند.	but existed in two different times.
هوگو در مقابل همه آن جمع فریاد برآورد	he cried aloud before all the company
به او اطلاع دادند که اتاقش آماده شده است	he waited until they announced his room to be ready.
زیرا که من یقین دارم که شما که این همه چیز بلد هستید کشتیرانی هم بلد خواهید بود.	I dare say you know how to navigate, should he fail us.
ماجرایی که تعجب همگان را دوچندان کرد.	a thing that still further surprised everybody.
پایم را بیشتر روی گاز فشار دادم.	I shoved my foot down on the accelerator again.
برای همینه که فقط من تو رو توی لباس عروسی دیدم.	that's why I'm the only one who's seen you in the dress.
فقط برای اینکه راز سیاه من را حفظ کنند تا من شاد باشم.	to protect my dark secret and keep me happy.
به او اخطار دادم حتی اگه یه ذره حواسم پرت به شه نمی تونم نگهش دارم	I can't keep it up if I'm even the slightest bit distracted, I warned him.
با سرش به سرسرای ورودی اشاره کرد.	jerked her head toward the entrance hall.
هرچه برای او یا من پیش آید هرگز تا آخر عمر از عشق او دست برنخواهم داشت.	whatever may happen to him or to me, shall never cease to love him as long as I live.
بالاخره گیر افتادید! گنجشک به دام افتاد.	I've caught my cock sparrow!
بار دیگر با پزشک اموات خداحافظی کرد	again bade farewell to the strange doctor
هنگامی که با حامی خود همراه بودم	when my protector was with me
این بار از یک سرباز وظیفه جوان استفاده کردیم.	by means of a little conscript
در ساعت ده من باید از شما مرخصی بگیرم.	I must leave you at ten o'clock.
هر چند در واقع سخت به هیجان آمده بود.	although in reality he was flustered.
من باید او را اغوا کنم تا با دخترم ازدواج کند	I must entice him to marry my daughter
این یه چیزیه که فقط مربوط به خود ته	that's somepin to you lonely and away.
من به روح پاک و فداکار او پی برده بودم.	I divined his noble, resolute, self sacrificing spirit too
چقدر گریه کردم دیگر چشم برایم نماند.	I have cried till I have no eyes left.
که خود برای نوع بشر حکایت از طوفانی به نام زندگی داشت	that must follow all storms'emblem to humanity
این ترش و تردید همچنان بر جای بود.	this terror was still before him.
کسی را با خودت ببر که به او اعتماد داری.	lake someone as you can trust.
اما در مقایسه با سوار شاهوار که بر پشت اسب توسنش افسار حیوان را کشیده و روی پایه ستون بر فراز لوپروس خفته قامت بر افراشته به مراتب راحتتر و با محیط هماهنگتر مینمود.	but much more at home than the kingly cavalier reining in his steed on the pedestal above the sleeping leperos,
برای فهمیدن چنین چیزهای باید روی موضوع تمرکز کنم.	I have to focus to gain insights like that.
اینک شمشیر من در میانه حکم خواهد شد و صدق گفتار مرا به هر کس ولو مظهر بدگمانی باشد ثابت خواهد کرد.	here is my sword, that will compel incredulity itself to give credence to it.
بعد هم هر دو زن سر خود مقداری مشروب به او خورانده بودند.	she was labouring under the effects of a final taste of gin and water which had been privily administered, in the openness of their hearts, by the worthy old ladies themselves.
که هرگز و به هیچ وجه نباید از یاد برد.	which is a lesson by no means to be forgotten.
اما تو به من اهانت کردی و گفتی که گدا هستم.	though you have had the incivility to call me a beggar.
صورتش میان موهای او پنهان بود.	his face in her hair
هیچ وقت توی عمرم به اون خوشحالی نبودم.	it was the bes' feelin' in the world.
زودتر به این جاده برسند و راه او را مسدود سازند	encumbered by his baggage and transport
تو نباید بروی و مرا اینجا تنها بگذاری!	you mustn't go and leave, after all.
که دخترش همه چیز را فراموش کرده	his daughter had at last forgotten
هر چند که در حقیقت بیست مایل یا حتی بیشتر راه پیموده بودند.	though they must have actually walked twenty miles or more.
در همان شامگاه دوردستی که همراه با همسرش پس از مدتی اسب سواری شاق و پر زحمت در کوره راهی جنگلی نزدیک نهری افسار اسبهایشان را کشیده	on that far off evening when his wife and himself, after a tortuous ride through a strip of forest, had reined in their horses near the stream,
قبل از حرکت برای جستجوی قایق چهارم که درست به طرف مقابل رفته بود از دریا جمع کند	ere going in quest of the fourth one in the precisely opposite direction
بیایید ای شمای که شل و کور و کرید آمین	come, lame and halt and blind! AMEN!
اجازه بدهید تا من خر خود را در خانه بگذارم و هم الساعه برگردم.	let me put up this she ass at my house and I'll be back at once.
پیراهنش در اثر فشاری که انجام دادن آن همه کارهای ناآشنا در یک زمان بر او وارد کرده بود خیس عرق شده بود.	his shirt was wet with sweat from the exertion of doing so many unaccustomed things at once.
دستی را که چاقو در آن بود را در گل ثابت نگه داشت.	pinning the hand holding the knife to the muddy ground.
اما گرفتن استکان به نوبه خود بنا به ارشدیت از دست ظریف و فربه	but this made it all the pleasanter to take turns in order of seniority to receive one's tumbler
من آدمی نبودم که بتوانم به او بگویم حتی برای نیم ساعت تحملش را ندارم.	I'm not going to be the one to say I can't bear to stand next to him for half an hour.
من وارد پیکار شدم و افراد خود را گم کردم.	I came to the battle and have lost them.
من منظورم این نبود که شمارو ناراحت کنم	I didn't mean to worry you.
راستش به نظر من هیچ وقت دو پول سیاه هم برایش اهمیت نداشته.	I will answer for it, he never cared three straws about her
اسب سفید را به گاری سبدی بست و راهی را که از صبح پیش گرفته بود بازگرفت.	had the white horse put to the cart, climbed into it, and resumed the road which he had been travelling since morning.
با وجود تمام عشق و علاقه خویش به وی به نظریاتش تسلیم نخواهد شد.	that, despite her love for him, she would not give way.
من احساس کردم که لنگر آن دوباره سست شد	I felt the hawser slacken once more
ساعت پنج هرمیون به بقیه گفت باید به قلعه برود و برای شرکت در جشن آماده شود.	at five o'clock said she was going back upstairs to get ready for the ball.
که شما هم تصدیق و امضا کرده بودید	with your indorsement of course
که سر چوبدستیش از جیب آن بیرون زده بود.	with a wand sticking out of the pocket.
بلکه بر چوب زیر بغل خود تکیه داد	resting lightly on his crutch
ساعت پنج و بعد ساعت شش نیز نتوانست از آن مجلس دل بکند.	that although five o'clock came and then six
اطمینان کامل داشت که وی این راز را بهتر از خودش حفظ خواهد کرد.	he was quite sure that she would guard him better than he should guard himself.
صورتش داغان شده و یک چشمش کبود و بسته بود.	her face battered and one eye swollen shut.
میل ندارم خوی خوشتان را بدل به کج خلقی کنم چون خوی من بجز خدمت به شما نیست.	for my desire is none other than to serve you.
در آن لحظه لبخندی بر صورت رون پدیدار شد	a grin breaking across his face
راهی تاریک و پرپیچ و خم را پیش گرفت.	pursued an obscure and undulating itinerary.
زیر لب گفتم بهتره این ماشین رو به صاحبش برگردونم	I'd better get this car back to the guy I borrowed it from, I muttered.
اما پیرمرد از ته دل و بلند خندید.	but the old man laughed loud and joyously
زیرا متوجه شد که آئورلیانو سگوندو برای حفظ ظاهر و آبروی خود هم که شده است حتی قربانی شود.	because he seemed ready to sacrifice himself for the sake of appearances.
خشم و غضب را با خونسردی و صفای خاطر بکوبیم	anger by calmness of demeanour
بر استی که محبت شما برای من ارزش بسیار دارد	you do me too much honour.
که بر روی شاخه درختان باقی مانده بود.	from the boughs of the trees
به جهت اینکه نیم چاشت خود را در ساعت ده خبر کرده است.	for he ordered his breakfast at ten o'clock
هرچند او بارها اسمشو از من پرسید	though he asked me, many times.
لوسی به حال اغما در آغوش او افتاد.	she dropped insensible in his arms.
همان وقت هم که او بسیار کوچک بود من پیر بودم.	I was already old while he was very young.
اگه این دل خوشی نباشه دی گه پام پیش نمی ره	I'm jus' puttin' one foot in front a the other.
تا دوباره وسوسه شود و بخواهد برای بار دیگر تو را ببوسد.	that he would hang around trying to kiss you a second time.
من فقط همین یک فرصت رو دارم که کار درست رو در رابطه با تو انجام بدم	I only get this one chance to do things right with you.
بر سر او فقط کلاه بافتنی پشمی و سرخی نهاده شده بود	she simply had a red knitted cap
مبادا باز الهامی ناخواسته در کار باشد.	lest the pen might have been at some of its involuntary pranks again.
بلکه در اطاق را با انگشت نشان دادم	than by pointing to the door
به واسطه همان آرامش عمیق شخصیتی که	just by that profound quietness of personality which
وقتی که من جلو رفتم آن را رها کردند.	on my approach it was let drop.
بهتون قول می دم که به شرف کشور وفادار باشم.	I assure you I shall be faithful to it.
از اینکه گرفتار بازداشتگاه اسیران شوند نگران نبودند.	they didn't wondering how to keep out of the concentration camp.
این هورا هم با شور و هیجان بسیار و از ته دل کشیده شد.	this also was given with a will.
تلاش برای این که آبی برای نوشیدن و غذایی برای سیر شدن و جای مشخصی برای خوابیدن داشته باشند	under the burden of struggling for water to drink, food to eat, and the same place to sleep every night of his life.
نصایح چنین دوستی به سهولت ممکن است این عیب شوهر را برطرف سازد.	errors of this kind he could easily correct if warned by a friend.
باز هم قبل از آنکه صفحه مدور نهایی را بر آن سوار کنند	yet ere the final truck was put to it
با لحنی آرام مسأله ازدواج او را مورد بحث قرار داد.	adopting a quiet tone, discussed the whole matter.
هیچ نتوانست مطلبی از او بیرون بکشد.	he could get nothing out of her.
اشک عاطفه و ترحم در دیدگانش نشست.	tears came into his eyes from love and pity for this man.
در دل آن سرباز مو حنائی را دعا گفت.	boundlessly grateful to the red haired man
سرم رو روی ستون گذاشتم و گوش دادم.	I leaned my head against the jamb and listened.
ولی مثل همیشه یا شاید هم بیشتر نامطبوع یود.	but he would probably be as unpleasant as always, perhaps more so.
تمام تصورات و عقاید خود را درباره خوب و بد از اطرافیانش گرفته بود.	he had borrowed all his notions of what was right and wrong from those about him.
از آنجا مرا با حالی زار به کشتی بردند.	thence was taken into the ship in a very weak condition.
برای همین یک ساعت در راهروهای تاریک سرگردان شدند.	wandering around the dark passageways for nearly an hour.
ترسیدم مبادا به سراغ تو اومده با شه و حرفتون شده با شه و تو له و لو ردش کرده باشی	I was scairt he talked to you I was scairt you'd hit him if he talked to you.
که به سرعت ثابت ۵۰ کیلومتر در ساعت خود بیفزاید.	than the steady thirty five miles an hour pace he was setting.
ضم نا باید به گم که ربرتا اول این جور نبود.	but then, she wasn't always like that, either.
دامبلدور بهشون اجازه نمی ده وارد مدرسه به شن.	he won't let them inside the castle grounds.
کم کم باید حرفی را که اولین بار درباره خودتان زدید قبول کنم	I shall begin to admit what you said of yourself when you first came here
بدین طریق در میان آن همه خوشحال تنها من غمگین شدم	the only sad being among so many filled with joy
البته هنوزم کارش عالیه و فکرش مثل قبل کار می کنه.	though still quite brilliant, of course, the mind remains as great as it ever was.
قیافة شخص دیروزی که از زیر زمین سبز شده بود.	yesterday's visitor _from underground_.
ولی اگر من اینجا زنده بمانم او را لو خواهم داد	but if I am here I'll give him up.
جلو چشمشان دیدند که شما را کشتند.	you'd been killed before their very eves.
پیشخدمت ظرف ماهی را روی میز گذارد.	presently the waiter brought me my fish.
باید خاطرنشان کنم که من دیگر در خانه پیشین خود سکونت نداشتم	I must mention, by the way, that I was no longer living in my former quarters.
در برابر وحشت بیان ناپذیر عموم یکی از دو قلابی که کله از آن آویخته بود از کله جدا شد	to the unspeakable horror of all, one of the two enormous hooks suspending the head tore out
با آن سبیل چخماقی که از روی خشم با جویدن تنباکو کثیف شده بود.	his mustache stained with fury and his chewed cigar
طالب افتخار معاشرت با او بودند.	desired the honour of her acquaintance.
هر دم منتظر بودم که باد مرا فرو افکند	expecting every moment to be blown down by the wind
که همان جوان بود که از وی سؤال نمود.	the young man who had questioned him.
این بود که بدون اضطراب چندانی گذاشت هم رقصش از دیدرسش دور شود.	she could not have her partner conveyed from her sight without very uneasy sensations.
من خیال ندارم به خواهر خطاکارت حمله کنم.	I shan't attack your precious sister
او با نهایت دقت آن را زیر نظر گرفت و پس از اندکی توانست اسبی را در آن میان ببیند.	he observed it very attentively, and distinguished soon after a body of horse.
گویی از دنیای ارواح بیرون آمده بودند و دوباره خود را در دنیای آدمها مییافتند.	as if they had emerged from the spiritual world and found themselves once again in the world of people.
که این افتخار تنها نصیب او شود و کسی با وی در مقام رقابت بر نیاید.	that he should have the honour entire, without a rival.
مرا به داخل عمارت راهنمایی کرد.	conducting me into the house.
سال گذشته درست به مین شکل به زیرزمین افتادم.	I fell from the garret just in the same way a year ago.
من قصد ندارم که دوباره از تو چیزی بخواهم.	I'm not going to ask you again.
مادر و فرزند نفسی به آسودگی کشیدند و آرام گرفتند.	mother and child felt simultaneously soothed, and both subsided into calm.
یقینه که شیطون به جنگل اومده.	he was sure that the devil had come.
وگرنه من راضی بودم که رنج و خرج نقل آنان را به کشور خود تحمل کنم.	or else I should have been well content with the trouble and expense of transporting them.
مدتی بعد که دوباره به پایین ابرها رفتند	they flew back beneath the clouds a little while later
اما گندم سیاه در دستگاه رطوبت گیر جدید کمی برشته شده است.	but informed him that the buckwheat in the new drying machine had been a little scorched.
ولی سبب اصلی این اندیشه آن بود که او خود به این قربانی یعنی به این بهانه برای فرو نشاندن خشم و غضب خود نیاز داشت.	just because he himself desired a victim, something on which to vent his rage.
منظورم این نیست که کاری انجام بدهم.	I didn't mean to do anything.
اگر بنا باشد از حرف راست گفتن بترکند یک کلمه دروغ نخواهند گفت.	they would not say one thing for another, though they were to burst for it.
انتظار این افتخار عظمی را داشته باشد ولی به واسطه هوس عجیب پیرمرد به همسفرگی با شاهزاده مفتخر گشته بود.	though the position of that insignificant individual was such as could certainly not have caused him to expect that honor.
با صدای غرش بلند موتور به راه افتاد	the engine roared and they were off
وال بزرگ به مراتب ممکن است بیشتر از تمام شکارها سالم بماند	much more may the great whale outlast all hunting
باید بروم به آقای فدرستون خبر بدهم.	I must go and tell my uncle.
هرچند چیزهایی که همین جا به دست آورده بودیم خود غنایم پر ازشی بودند.	though what we had taken here was a rich prize.
همه مطمئن شدند هک دیگر کارش ساخته است.	it seemed certain that they had him.
انگار آن اعتماد به نفس چیزی بود خدادادی.	as if she had been born with it
چهره مرد نیز دوباره ناپدید گشت.	the face disappeared.
به امید اینکه اگر در عالم رؤیا باشم بیدار شوم.	hoping I might be in a dream.
دیشب به همین دلیل تو را به همراهی خود خواندم که دیگر کسی جز تو برایم باقی نمانده است.	I asked you to go with me yesterday because you are all I have left.
ولی معلوم نبود که آن کس کیست و ایشان هم دلشان نیامده بود	although she had never had the heart to say any thing about
به نظر من خیلی احمقانه و احساساتی بود.	I thought it damned silly and sentimental.
جمله شوهرش را لغت به لغت تعبیر کرد.	seized on her husband' s casual words
حالا محکوم به دیواره پل چسبیده بود تا فشار جمعیت او را از آنجا درو نسازد	who had clung so tight to the railing of the bridge as to resist the force of the crowd, and retain his position
چون در نظر او کاروانسرا قصر یا قلعه بود و کاروانسرا دار قلعه بیگی	for so innkeeper and inn seemed in his eyes , made answer
سر من خیلی هم خوب از بدنم جدا شده	that's good and beheaded
همین که کشتی به بندر رسید دسته جمعی از آن بروند.	when the ship reached port, desert her in a body.
کاملاً آماده برای شنیدن خبرهای بد یا خبرهای خوب.	quite ready for either good or bad news.
منتظر فرصتی برای مسطح کردن آن بود.	waiting for a suitable opportunity to iron it out.
توضیح آنکه دو تن از مسافران که آن شب در کاروانسرا اقامت کرده بودند	the cause of which was that two of the guests who had passed the night there
آنقدر دور شده بودیم که راه خود را گم کردیم	so far that we lost our way
جرات نداشتیم یک دقیقه تنها بگذاری مش.	not for one minute could we leave him alone.
خوار و حقیر و متأثر گذشته بودم.	with a resultant feeling of intense loneliness in life, and a contempt
اگرچه دیگر پیر و تقریباً سگ خلق شده بود.	though it was old and rather crotchety.
در نور ضعیف چوبدستیش به جستجو پرداخت.	searching them by the narrow beam of his wand
دروازه را گشود و خود را به تیر دروازه چسباند تا اسبها رد شوند	squeezing against the gatepost to let the three horses pass.
اما کسی را نداشت که برایش بگوید.	but she had nobody to tell.
چون درست قبل از مرگش سخت با هم دعوا کرده بودیم.	because we had a violent quarrel just before his death.
باز هم این توهم از اثر ضعیفی از احتمال خرافی عاری نبود.	was this conceit altogether without some faint show of superstitious probability.
پس به فرمان و نصیحت ضمیر خود گوش کرده و پیروی نمای آلبر.	listen to its dictates.
آن گاه هرمیون به بالای سر مرد اشاره کرد.	she replied, pointing at the luggage rack over the man's head
دالوخوف بطری روم را به دست گرفت و به طرف پنجره رفت.	who with a bottle of rum in his hand was approaching the window
من از وجود او عار و ننگی ندارم و مغرور نیستم تا او را از خود برانم.	I am not afraid of him, I am not proud,
چنانکه روستاها تقریباً از مردم تهی شد.	so that the villages were almost emptied.
نوک آن را روی دستش امتحان کرد	tried the point upon his hand
آن شب هرچه خواب دید وحشتناک بود.	his dreams that night were full of horrors.
من چند لحظه پیش آن را دور افکندم.	I just threw it down there.
دستم را به سوی لیوان شراب دراز کردم و لاجرعه سر کشیدم.	I reach for my wine glass and take a huge swig.
قدری هم از کار خودمان صحبت نماییم.	now let us talk about our own affairs.
که بکوشم و تلاش کنم که شرف و حیات تو را از تو بگیرم	to strive and labour to rob thee of honour and life
سرش پوشیده از خون خشک شده بود.	that his head was caked with dry blood
اما سؤال کردن ممکن بود که اسباب صدمه برای آن بیچاره شود	but how could he risk the question
تا این که در حریقی سوخت و از بین رفت.	until it and all it contained were consumed in flames.
راه بین لیوان فلاسک در نیمه میزودهانش متوقف شد.	the red thermos cup stopped dead halfway between the table and his mouth.
داداش من طالب افسانه نیستم و این هم افسانه است.	I am not a man for fairy tales, brother, and that's in the nature of a fairy tale.
بسیاری از آنان در دست و روی من فرو رفت.	many of which stuck in my hands and face.
از جارویش به روی زمین غلتید.	rolled off his broom.
هیچ حیوانی به محصول ناخنک نزده بود.	not an animal on the farm had stolen so much as a mouthful.
چهارصد و ۱۹ نفر که دم در وایستاده اند و احتمالا دارن گرمازده میشن.	nineteen out by the gate, probably getting heatstroke while you and me chin.
این نا مگذاری به مناسبت اینست که کفش آن گروه پاشنه بلند دارد و کفش این گروه پاشنه کوتاه	from the high and low heels of their shoes
برایش اصلاً آسان نیست که یکباره بزند زیر همه چیز و بخواهد مستقل مستقل بشود	it might not be so easy to burst forth at once into perfect independence,
تردیدی ندارم که اضطراب و آب و هوای نامساعد عقلش را زایل کرده بود.	I have no doubt that anxiety and exposure have driven him off his head.
من نمی خوام که تو کاری کنی که بعداً پشیمون به شی .	I didn't even remember how they got there.
چند بار از جلوی کتاب فروشی و رستوران رد شدم.	I drove back and forth between the bookstore and the restaurant a few times, hoping to see her on her way.
پهلوان مچ او را محکم گرفت و او را بی آنکه جرأت نفس کشیدن داشته باشد به سوی خویش کشاند	who grasped her tightly by the wrist, and drawing her towards him, while she dared not utter a word
صرفا با پوزش از اینکه بار اول توضیحات لازم را نداده است	which he had failed to mention in the first instance.
در آینه اخم کردم و به خودم نگاه کردم و یکی از موهای ابروهایم را برداشتم.	I frown at my reflection in the mirror and tweak out another eyebrow hair.
اما لحنش نیمه مهرآمیز و نیمه ملتمسانه بود	but saying them in a half soothing half beseeching tone
که احساساتش را به غلیان دربیاورد.	who could call forth her sensibility
او با نهایت شرم و حیا از ایشان خواهش کرد که بمانند و فنجانی چای بنوشند.	bashfully inquired whether whether he wouldn't take a cup of tea?
در چشمش چه اشنا بود اینکه این دو با هم حرف بزنند.	it seemed so familiar that they should be talking.
صدای یه مرد غمگین از یه جایی نزدیک قایق.	a sound a sorrowing man could make, somewhere near this boat.
به رام مهم نیست چرا شیاطین فرار کردن.	I don't care why the demons ran.
هرکس غیر از این بگوید یا بیندیشد مثل سگ دروغ گفته است	whoever maintains the contrary lies like a great scoundrel
وقتی که دید یه اتومبیل داره بهش میر سه به فرم ون یه تک ون داد و تو شکم کامیون رفت	a car's comin' so he cuts in an' whangs this here truck.
زیرا هر انسان زنده دارای خصوصیاتی است	for every living person has his own peculiarities
از دست من هیچ کاری بر نمیآید. هیچ کار !	I can do nothing.' he would commonly cry in such cases.
کسی را بیدار نکرده و خودش کارهایش را انجام داده	or giving the least sign of her activity
که از نظر همسرش بازی بی معنی و خونین جنایت و چپاول می آمد بازی بچه های فاسد و گمراه که در کمال اشتیاق و شور و مستی آغاز میشد و ادامه مییافت.	which to his wife seemed a puerile and bloodthirsty game of murder and rapine played with terrible earnestness by depraved children.
مطمئن بودم دو شب قبل ژاکت را تن لیزی دیده بودم	I'm sure I saw her wearing it the other night.
که من بیش از این برای شما کردم.	which I did for you in the oldendays.
جای آنکه در شب به آن سردی باز هم در آن شهر غریب سرگردان شوم	why rather than wander further about a strange town on so bitter a night
در زیر وزن و سنگینی افراد به کلی خمیده گشته بود	bent beneath the weight of the crowd upon it.
بلافاصله برای صرف شام مرا صدا زدند.	when I was called to dinner.
چون کارگر راهدار را بر سر پلکان در کار چرت زدن یافتند به او تجویز کردند که بر تخت درون اتاق اندکی استراحت کند.	the mender of roads, being found already dozing on the topmost stair, was advised to lay himself down on the pallet bed and take some rest.
حالت چهره این مرد به عیان حاکی بود که از حرکات دست و صدایی که از لبان آنا برمی آمد منزجر است.	by his expression, she saw clearly that he was repelled by her hand, and her gesture, and the sound made by her lips.
او تا پایان کار همان روح مشتاق بود.	she had been the same hungry soul to the end
عنوان شود و مسئولیت مستقیم آن به گردن آن مرد نباشد	the direct responsibility thereof not lying on his head
من نیز تا حدی که میسر بود چشم از آنان برنداشتم.	till they were lost in the distance.
مثل بقیه مردم برای زیستم بکوشم و به کار و تحمل رنج وی روی بیاورم.	strive to live and bend to toil like the rest.
آن هم با اشتهای زیاد ما کودکان که در حال رشد بودیم.	with the keen appetites of growing children
انگار او اولین انسانی بود که پابرزمین گذاشته باشد.	as if the child were the first that had ever been gotten upon the earth.
به خاطر صحبت در مورد چنین امری	during the discussion of such serious affairs
اعلی حضرت مرا به شرفم سوگند داد که هیچ یک از رعایای او را هر چند که راضی و خرسند باشند همراه خود نبرم.	his majesty engaged my honour not to carry away any of his subjects, although with their own consent and desire.
تا بقیه جلو بیایند و به او تسلیت بگویند.	to receive the spiritual renewal of condolences
چیزی روی زمین افتاده بود ورداشتم.	I picked up from the ground things that were lying there.
ما دو تن را به بدبختی و سیه روزی خویش واگذار	leave us to our misadventures
من خیلی از او توقع دارم. برای داشتن چنین توقعاتی هنوز خیلی زود است.	I'm expecting too much too soon.
من او را خیلی زود سر عقل آوردم!	I was soon too many for him.
می دونم که یک موقعی جزو عشاق تو بود ولی من فکر کردم خیلی وقته که فراموش کردی.	I knew he was once a beau of yours but I thought you'd fallen out long ago.
سربندش خیش شده بود و شالش را به سختی دور شانه مرطوبش پیچیده بود.	for her head rag was damp and the old shawl clutched tightly about her showed rain spots.
لیکن از اندوه رفتن از کوی معشوق خواب به چشمش نرود.	cannot sleep for sorrow at parting
یک تیرکمان قلابی و یک شمشیر حلبی و یک شیپور قلعی از پشت آن درآورد.	disclosing a rude bow and arrow, a lath sword and a tin trumpet, and
مگر اینکه خودت خانه را ترک کنی و بروی.	unless you give me cause.
اما اسکوایر چنین هوسی نکرده بود	but such was not the squire's pleasure
سپس در را پشت سر خود بست و چفت کرد.	he shut her door behind him and locked it.
به این ترتیب در مابقی طول راه فقط دربارة جمجمه شناسی صحبت کردیم.	so heard nothing but craniology for the rest of our drive.
صورتش را به پهلوی مجروح تک شاخ نزدیک کرد	lowered its head over the wound in the animal's side
اما دیدم یه چاقو به تنم رفت	then I felt that knife go in me
تمام مدت که لباس پوشید دندانش را نخ کشید و کیف سامسونت اش را برداشت محو تماشایش بودم	I watch fondly as he gets dressed, flosses his teeth and picks up his briefcase.
من حالا مطمئن شدم که نبایستی از او بترسم.	I'm sure now that I shouldn't be afraid of him
حتی کلاه بوقی او هم سلطنتی بود.	to her bell shaped hat
من در جوانی اندکی نواختن اپینت را فرا گرفته بودم.	I had learned in my youth to play a little upon the spinet.
به به لیف مرکلب یا مهر دار اعظم فرمان داد که در دربار منزلی برای من و مترجمم آماده کند	ordered his _bliffmarklub_, or high chamberlain, to appoint a lodging in the court for me and my interpreter
جوابم این بود که از او بخواهم همراه من بیاید و به همه جای خانه سر بزند و نتیجه زحماتم را ببیند.	I answered by inviting him to accompany me on a general inspection of the result of my labours.
من هیچ او را ندیدم و نتوانستم با او حرف بزنم.	I could not speak to her either, and I did not even see her.
در برخی موارد این جستن در هوا نشان رجزخوانی اوست.	in some cases, this breaching is his act of defiance.
با سر زیبایی پوشیده از موهای بلوند و فر دار.	complete with a cherubic head of blonde curls.
سپس هردو را با آن نوع مطبوع تکان داد که مخصوص مادران است	then releasing them withthat gentle manner of shaking off which is peculiar to mothers
که این برادرزاده فقیر و سیاه چشم بسیار ملایم و مهربان و از خیرخواه و ولینعمت خود صمیمانه سپاسگزار بود	that poor, dark eyed niece of hers was so meek, so kind, so devotedly grateful to her benefactors
می دونی این جوری خیلی بهتره تا بکشی مش.	I reckon that's a considerble sight better 'n killin' of him.
برای همین خیلی توجهم را جلب کرد.	so I took the more notice of it.
او دستش را بالاتر برد تا کف آن را نگاه کند	he drew in his hand and looked sharply into the palm.
از اتومبیل پیاده شد و به اطراف نگاهی انداخت.	got out, looked around
سرانجام گفت متأسفانه وقتش را ندارم.	I am afraid I won't have time, he said finally.
خدا را شاهد گرفته بود که برای پذیرایی از هزارها مهمان بودجه داشتند.	though heaven knew there was enough money to keep a thousand permanent houseguests.
آخه قصد نداشتم هیچ کد وم از ای نا رو به گم یهو از ده نم پرید.	I didn't mean to say any of it!
اول به خاطر سودی که ممکن است از این کار عایدش شود و سپس به خاطر مدح و تمجیدی که ممکن است در این راه بشنود برای چاپ به مطبعه بدهد.	moved more by the profit that may accrue to him from doing so than by any thought of praise.
از آنجا که از فن جنگ بیگانه نبودم	being no stranger to the art of war
حتماً تا به حال تصویری از من در ذهنتان بو جود آمده است	I suppose by this time you've got a kind of picture of me in your mind
دوباره پول را آماده نگه داشته بودم.	I had money ready again.
وقتی پیدا کردم با خود حضرت علیه بانو دول سینه صحبت خواهم کرد	as soon as I have found it I will speak to her grace
پرسید که حالا به نظر او چه اتفاقی رخ خواهد داد.	he asked the major what did he think was going to happen now.
سرم رو چرخ وندم که بتونم ببین مش.	I rolled my head around to look at her.
به لحاظ جسمی ضعیف و خسته بودم.	I felt physically weak and broken down
در نهایت موجب شد این پرونده ابعادی پیدا کند که به ما ارجاع شود.	finally brought the case within the scope of our observation.
همین امروز صبح باز هم بگومگو کردند	this morning there was a fresh quarrel
لذا به او گفتم از جاده پایین برود.	so I bid him take the road lower down.
تا در موقع ضرورت به کمک او بشتابند و از حیله و نیرنگش جان بداری کنند.	so that at the proper time they might aid him in his purpose and insure the success of the deception.
مردی که حالت غمگینش همیشه باعث ترسش شده بود.	whose depressed condition caused her dismay
من تالار را محل ملاقات اختیار کردم مسی و	I have chosen the drawing room, sir, as our place of meeting
با ریش و سبیل زبرش نوزاد را بوسید.	gave him what must have been a very scratchy, whiskery kiss.
آن دورنماهای گسترده و هوای فرح بخشی که انتظار داشت در ذهن شوهرش بیابد	the large vistas and wide fresh air which she had dreamed of finding in her husband's mind
به نقش کس دیگری در خودم حیات بخشیدن.	incorporating the role into me.
چون این غار که اسمش غار مک دونالد بود	for McDougal's cave was
فکر کردم شاید بگرشته پیش شما.	I thought he would return to you.
امکانی برای سوال کردن از او به دستم نیامده بود	I had no opportunity of asking her any question
من بسیار از این اصرار شما به دیدار من ممنون شدم.	I thank you for having insisted on seeing me.
همان طور که به تو گفتم چهار هفته دیگر ازدواج خواهیم کرد.	I told you we shall be married in four weeks.
پس از آنکه به انگلستان بازگشتم شنیدم که کشتی او غرق شده	I heard since my return, that his ship foundered
هنوز هم دست از نوشیدن نکشیده بودند.	they were still drinking
اگر به من اعتراض کنند که نیت او خیر بوده است	if it be made a charge against me that his wishes were honourable
آن دو بیگانه را از صمیم قلب دعوت کردند تا با هم غذا بخورند.	with signs of hearty good will invited them both to share what they had.
انتظار نداشتم که دوباره ببینمت	I didn't expect to see you again.
برعکس باید کوشید تا زندگی خود را تا سر حد امکان مبطوعتر ساخت.	on the contrary one must try to make one's life as pleasant as possible.
باز آنچه را دیده بود به یاد آورد.	again she recalled all she had seen.
چون راستوف نتوانست جواب او را بدهد بیشتر خشمگین شد	he was still more angry at having omitted to say it.
این بود که سر به زیر افکند و طبقه بالا رفت تا لباس عوض کند.	he went humbly up stairs to dress.
بار دیگر روشن کردن بخاری مرمری لازم شده بود.	once more a bright fire burned in the marble hearth.
متشکرم! با صدایی این حرف را زدم که انگار صدای خودم نبود.	OK, I say, in a voice which doesn't sound like mine.
چنان خوابیدم که هرگز در عمر خود نخوابیده بودم.	I turned in, and never slept better in my life.
ساختمان بیمارستان به درازا کشیده بود.	the building had lingered.
برای اینکه نه من شاعر بودم نه مادرش.	certainly not from his mother or from me.
من اونقدر تو رو دوست دارم که می تونم یه ذره بدخلقی رو تحمل کنم.	I love you too much to bear a grudge.
خیلی شرم آور است که او بخواهد مرا ترک کند.	it's shameful that she should wish to leave me.
هر یک منتظر بود که دیگری دعوا را شروع بکند.	each waiting for the others to start a fight.
دستش با خشونت دور کمر او حلقه شد و از زیر ملافه بدن لخت او را در آغوش گرفت .	his hands went round her roughly, under the wrapper, against her bare skin.
او به جای سلام و احوال پرسی با داد و فریاد به او گفت که	he barked, by way of a morning greeting.
بعد از دو سه ماه دیگر برایش نامه ننوشتم.	I'd stopped writing to after two or three months.
قبلاً بدان جا رسیده و منتظر ایشان بودند.	who had already dismounted, were waiting for them.
با این همه به خاطر تسکین حال من وعده داد که چنانکه دلخواه منست فرمان خواهد داد	however I suppose to pacify me he promised to give order as I desired
سپس گوشی تلفن را برداشت و شماره منزلش را گرفت.	seized his telephone, and had almost finished dialing his home number
بقیه که در اطراف مخفی شده و به انتظار رسیدن ما کمین کرده بودند به طرف ما دویدند.	all those that were in hiding seeing us came and joined us.
اگه بعد از اعترافات من باز هم مایل به ازدواج با شه	that if after what I was going to tell her she still wanted me
در این لحظه دست خود را باز کرد	here she flung her hand out
من میدونستم که شما حالات غریبی دارید	I knew that you were peculiar
شاید روزگار زی لا هم آن قدرها خوش و راحت نبوده.	maybe she hasn't had any too easy a time.
مطمئنم که به زودی خبری از او دریافت خواهی کرد.	I'm sure you'll hear from him soon.
یکی دو دقیقه به فکر فرو رفتم.	I reflected for a minute or two.
متاسفانه باید به اطلاع جمع برسانم که ایشان به زندان مجرد محکومند.	I grieve to inform the society in secret.
شاگردان مشغول حفظ کردن دروس فردای خود بودند	they were engaged in conning over their to morrow's task
زنی را که برای خود روا ندارد مگر به عنوان مترس!	, to recommend to another one whom you would not marry yourself
دستش را از دست من بیرون کشید	tugging his hand from mine
که چنین کلمات از دهان دختری جوان در غیر تیاتر شنیده شود.	to hear such words proceed from the mouth of any one but an actress on the stage
در میان عظمت و درخشندگی خود بر شهر پرجمعیت تابان گشت.	burst upon the crowded city in clear and radiant glory.
او را به خاطر آن همه ابراز رشادت به خاطر هیچ و پوچ مورد انتقاد شدید قرار داده	reproached him for his useless temerity.
تقریباً ده دقیقه گذشت تا صدایش زدند.	it was at least ten minutes before he was summoned.
چون وقتی یک کلمه خیرخواهانه از صمیم قلب ادا شود برابر با چندین کلمه است.	as much good will may be conveyed in one hearty word as in many.
پس نیازی نبود که مردان جانانه پارو بزنند.	they must not have had to ply their oars very hard.
دیگر مجال نداشتم که با ارتکاب عیوب و گناهان خاص همنوعان خود راه انحطاط و تدنی بپیمایم.	without an opportunity of degenerating into the vices and corruptions of my own species.
با من تصفیه حساب خواهد کرد آن هم به تنها شیوه ای که چنین مرد بی شعوری میتواند بامردی مثل من تصفیه حساب کند مردی با هوش	would get even with me in the only way such a brute can get even with a man of intelligence
امکان ندارد این تصور من درست باشد.	my supposition cannot be correct.
ولی دو سه سال پیش خیلی عشق این کار را داشتم.	but two or three years ago I had a great passion for taking likenesses
چشمش به یک چیز چرمی سبز رنگ افتاد	glimpsed something green and leathery
اما به بیت با خود گفت تف بر من اگر بخواهم به صرف اینکه این دختر توقع این جور چیزها را دارد با او عشق بازی کنم.	but he'd behanged if he'd make love to her merely because she expected it.
برای دیدن اطراف اصلاً کنجکاوی نداشت.	she had scarcely any curiosity about the grounds.
به تماشای این چشم انداز گسترده زندگی نشسته بباشد	to be present at this great spectacle of life
بارها سعی کرد که این کار را بکند.	again and again she tried to do so.
هر دو عقب رفتند و کنار آتش نشستند.	they both backed into chairs by the fire.
سکوت باشکوهی بر همه میخانه حک مفرما شده بود.	a solemn silence reigned through the whole room.
قبل از اینکه از ماشین پیاده شم صدای موزیک رو شنیدم.	I heard the music before I was out of the car.
سبیل خود را چنان با دقت و احتیاط میتابید	twirling the tips of his mustaches as circumspectly
من سایه زنی را دیدم که شب کلاهی بر سر داشت	I saw the shadow of a woman, in a cloak and bonnet
می خواهم خودم را در آینه تماشا کنم.	I want to see.
به ویژه چون برای خداحافظی آمده بود.	especially as he might be come to pay a farewell visit.
احساس کرد که شاید چنین پیشنهادی از جانب او کار درستی نبوده است.	feel that perhaps it was not right for him to have suggested it.
درد انگشت در حال ترمیمم را نادیده گرفتم و باز به پمپاژ قلب اون ادامه دادم.	I ignored the healing ache in my finger and started pumping her heart again.
جای بسی تأسف است که من نسبت به زیبایی حساس نیستم	it's a pity I'm 'insensible to beauty
چنانچه گویی دور تا انتظار شنیدن این خبر را داشت	as if the announcement were just what she might have expected.
کلاید متوجه شد که لحن دخترک هنوز هم قطعا دلگرم کننده است.	her attitude was decidedly encouraging, even here.
از آن بوی گند تن زندانیان برمی خاست.	with a horrible smell of foul sleep in it.
حاضر نبودم توی گروه اسلایترین باشم.	I wouldn't be in his house
نزدیک میدان اسبدوانی برپا شده و قرار بود مادیان ورانسکی روز قبل به آنجا آورده شود	had been put up close to the race course, and there his mare was to have been taken the previous day.
دوباره به تمرین آواز مشغول شد.	again began walking up and down the room.
من برای خاطر پدربزرگم این تبلیغ رو در مجله کردم	I put it in for my grandpa!
یاهوهای ماده طبعاً به من مایلاند و مرا یکی از ابناء نوع خود میدانند	since the females had a natural propensity to me, as one of their own species.
اما من متوجه شدم که از این سوال معذب شد	but I can see a slight flicker of annoyance pass across his face.
از هیچ کدو متون انتظار نداشتیم که از این کارها بکن ین.	I would never have believed it of any of you.
روی تیرک بادبان بزرگ کشتی خزیدم	crawled back along the bowsprit
پاهایش دیگر به اراده او نبود.	, his feet refused to obey him
چون مبادرت به این کار خارج از تحملش بود.	because even the thought of making any physical effort was unbearable.
به سرعت در زیر میزش پناه گرفت.	dived under his own desk
روت غمگینانه گفت من خیلی احمقم	I'm such a silly, she said plaintively.
بنابراین با دوست اندوهگینمان وداع کردیم	so we bade good bye to our rueful friend
با روپوش راغت یافته و اسباب شگفتی وی را فراهم ساخته بود به حضور طلبید.	having placed something on the chairs and covered it with a cloth.
ولی در طی همین پانزده روز تمام حقایق را فهمیدم.	but within the last fortnight I have learnt it all.
تا بلکه خود را از غارت و چپاول سربازان مصون دارند.	hoping thereby to secure themselves from being plundered.
که چون مرا خواهید دید که با لباس نظامی کامل برگشتم	when you see me return with an embroidered uniform!
گویی برای فریاد کشیدن هوا کم داشت.	as though she could not get breath to scream.
در سالن نشیمن مسافرین در ساعت مقرر نشست و ساکت مجله خواند.	he just sat quietly at the appointed hour in the residents' lounge and read a magazine.
از وجود تمام کسانی که لایق آموزش دانش سحر و جادو نیستن	of all who were unworthy to study magic.
خواننده یک بار دیگر اجازه دهد تا از موضوع خارج شویم	the reader will permit us one otherlittle digression
به ناچاری در روی کرسی از چوب که در آنجا بود نشست	he seated himself upon a log of wood.
ولی پس از ناهار کنت را به حضور طلبید	but after dinner called the count aside
در حالی که خودشان چند تا بچه و نا نخور در منزل دارند و باید به غذا و لباس آنان رسیدگی شود.	when they had their own bairns to feed and fend for?
ولی حالا در این شهر بازی زمان از حرکت ایستاده بود.	now it was only a haunted funhouse where all the clockwork had run down.
در جیب و بغل خود هر قدر تنخواه داشت بیرون آورده و در مخزنی نهاد.	threw into a drawer of his secretary, which he left open, all the pocket money he had about him
با آن به سپهبدان اشاره کرد و فرمان شروع نبرد را صادر نمود.	made a sign with it to the marshals, and ordered the action to begin.
بعد از این که سر و گوش آب دادم	after I've spied around a little
بئاتریس گفت. بد نیست چند صندلی زیر درخت بلوط بگذاریم و آنجا بنشینیم.	let's have some chairs out and sit under the chestnut.
هیچ وقت نتوانستم سر از کارش در بیاورم.	I could never get much out of him except the fact
او را که بعد از دادن نامه رفته بود	who had left the room after delivering the letter
بلکه اگر بخواهم که جان خود را برهانم و از نابودی کلی رعایای رفادار خود جلو گیرم بهتر آنکه دست او را در تصرف مملکتم آزاد بگذارم	but that I should leave the kingdom entirely open to him if I wished to avoid the death and total destruction of my good and loyal vassals
تا وقتی که به سرسرای ورودی رسیدند	until they reached the entrance hall
چنانکه گفتم یقین بدان که به محض اینکه شروع به کار کردی	for, as I have said, if thou wilt only make a beginning
خودش را در کنجی تاریک پنهان کرد و به در اتاق چشم دوخت.	he stepped aside, and, effacing himself upright in a dark corner, waited with his eyes fixed on the door.
یا شاید جنگ را به داخله دایره اول کشیده بودند	or possibly carrying on the war within the first circle
به وقت خود راهی برای تأمین هزینه این بازگشت هم پیدا خواهد کرد.	she could see her way to financing such a return she now departedonly to find that
